movie_id,movie_title,release_date,release_year,budget,revenue,profit,popularity
2,Ariel,1988-10-21,1988,0,0,0,3.860491
3,Shadows in Paradise,1986-10-16,1986,0,0,0,2.29211
5,Four Rooms,1995-12-09,1995,4000000,4300000,300000,9.026586
6,Judgment Night,1993-10-15,1993,0,12136938,12136938,5.538671
11,Star Wars,1977-05-25,1977,11000000,775398007,764398007,42.149697
12,Finding Nemo,2003-05-30,2003,94000000,940335536,846335536,25.497794
13,Forrest Gump,1994-07-06,1994,55000000,677945399,622945399,48.307194
14,American Beauty,1999-09-15,1999,15000000,356296601,341296601,20.726578
15,Citizen Kane,1941-04-30,1941,839727,23217674,22377947,15.811921
16,Dancer in the Dark,2000-05-17,2000,12800000,40031879,27231879,10.684806
17,The Dark,2006-01-26,2006,0,0,0,5.691508
18,The Fifth Element,1997-05-07,1997,90000000,263920180,173920180,24.30526
19,Metropolis,1927-01-10,1927,92620000,650422,-91969578,14.487867
20,My Life Without Me,2003-03-07,2003,0,9726954,9726954,10.310508
21,The Endless Summer,1966-06-15,1966,0,0,0,1.378819
22,Pirates of the Caribbean: The Curse of the Black Pearl,2003-07-09,2003,140000000,655011224,515011224,47.326665
24,Kill Bill: Vol. 1,2003-10-10,2003,30000000,180949000,150949000,25.261865
25,Jarhead,2005-11-04,2005,72000000,96889998,24889998,9.997032
26,Walk on Water,2004-02-05,2004,1400000,0,-1400000,1.709996
27,9 Songs,2004-07-16,2004,1000000,1574623,574623,18.847707
28,Apocalypse Now,1979-08-15,1979,31500000,89460381,57960381,13.5963
30,Magnetic Rose,1995-12-23,1995,0,0,0,0.987992
33,Unforgiven,1992-08-07,1992,14000000,159157447,145157447,10.942149
35,The Simpsons Movie,2007-07-25,2007,75000000,527068851,452068851,14.302911
38,Eternal Sunshine of the Spotless Mind,2004-03-19,2004,20000000,72258126,52258126,12.906327
55,Amores perros,2000-06-16,2000,2000000,20908467,18908467,5.958138
58,Pirates of the Caribbean: Dead Man's Chest,2006-06-20,2006,200000000,1065659812,865659812,29.455314
59,A History of Violence,2005-09-23,2005,32000000,60740827,28740827,11.119707
62,2001: A Space Odyssey,1968-04-10,1968,10500000,68700000,58200000,22.494622
63,Twelve Monkeys,1995-12-29,1995,29500000,168840000,139340000,12.297305
64,Talk to Her,2002-03-14,2002,9285469,51001550,41716081,6.648278
65,8 Mile,2002-11-08,2002,41000000,215000000,174000000,8.374355
66,Absolute Power,1997-02-14,1997,50000000,50068310,68310,7.66124
67,Paradise Now,2005-02-14,2005,0,3357075,3357075,3.714186
68,Brazil,1985-02-20,1985,15000000,0,-15000000,9.837287
69,Walk the Line,2005-09-13,2005,28000000,186438883,158438883,11.476443
70,Million Dollar Baby,2004-12-15,2004,30000000,216763646,186763646,14.471373
71,Billy Elliot,2000-05-18,2000,5000000,110000000,105000000,12.158424
73,American History X,1998-10-30,1998,20000000,23875127,3875127,18.157166
74,War of the Worlds,2005-06-28,2005,132000000,591739379,459739379,19.929377
75,Mars Attacks!,1996-12-12,1996,70000000,101371017,31371017,15.63424
76,Before Sunrise,1995-01-27,1995,2500000,5535405,3035405,11.304979
77,Memento,2000-10-11,2000,9000000,39723096,30723096,15.450789
78,Blade Runner,1982-06-25,1982,28000000,33139618,5139618,96.272374
79,Hero,2002-12-19,2002,31000000,177394432,146394432,9.861765
80,Before Sunset,2004-02-10,2004,2700000,15992615,13292615,7.048957
81,Nausica√§ of the Valley of the Wind,1984-03-11,1984,1000000,3301446,2301446,11.267366
82,Miami Vice,2006-07-27,2006,135000000,163794509,28794509,11.72545
83,Open Water,2004-08-06,2004,130000,54667954,54537954,10.652818
85,Raiders of the Lost Ark,1981-06-12,1981,18000000,389925971,371925971,19.901576
86,The Elementary Particles,2006-02-10,2006,6000000,0,-6000000,11.552537
87,Indiana Jones and the Temple of Doom,1984-05-23,1984,28000000,333000000,305000000,15.802306
88,Dirty Dancing,1987-08-21,1987,6000000,213954274,207954274,14.044122
89,Indiana Jones and the Last Crusade,1989-05-24,1989,48000000,474171806,426171806,14.788987
90,Beverly Hills Cop,1984-11-29,1984,15000000,316360478,301360478,8.503483
91,Land Without Bread,1933-12-01,1933,20000,0,-20000,2.475972
92,Megacities,1998-08-12,1998,0,0,0,0.406137
93,Anatomy of a Murder,1959-07-01,1959,0,0,0,9.473772
95,Armageddon,1998-07-01,1998,140000000,553799566,413799566,13.235112
96,Beverly Hills Cop II,1987-05-18,1987,20000000,299965036,279965036,9.200336
97,Tron,1982-07-09,1982,17000000,33000000,16000000,16.574021
98,Gladiator,2000-05-01,2000,103000000,457640427,354640427,23.186667
99,All About My Mother,1999-04-19,1999,8272296,67872296,59600000,10.000915
100,"Lock, Stock and Two Smoking Barrels",1998-03-05,1998,1350000,3897569,2547569,4.60786
101,Leon: The Professional,1994-09-14,1994,16000000,45284974,29284974,20.477329
102,Open Hearts,2002-09-06,2002,0,0,0,6.818513
103,Taxi Driver,1976-02-07,1976,1300000,28262574,26962574,14.092713
104,Run Lola Run,1998-08-20,1998,1530000,7267585,5737585,7.765379
105,Back to the Future,1985-07-03,1985,19000000,381109762,362109762,25.778509
106,Predator,1987-06-11,1987,18000000,98235548,80235548,18.495694
107,Snatch,2000-09-01,2000,10000000,83557872,73557872,14.014025
108,Three Colors: Blue,1993-01-10,1993,0,0,0,8.843517
109,Three Colors: White,1994-01-26,1994,0,0,0,6.5898
110,Three Colors: Red,1994-05-27,1994,0,0,0,7.832755
111,Scarface,1983-12-08,1983,25000000,65884703,40884703,11.299673
112,Italian for Beginners,2000-12-07,2000,0,0,0,5.396508
113,"Spring, Summer, Fall, Winter... and Spring",2003-09-19,2003,0,6502364,6502364,8.157887
114,Pretty Woman,1990-03-23,1990,14000000,463000000,449000000,13.348451
115,The Big Lebowski,1998-03-06,1998,15000000,46189568,31189568,15.952524
116,Match Point,2005-10-26,2005,15000000,85306374,70306374,9.020372
117,The Untouchables,1987-06-02,1987,25000000,76270454,51270454,11.062203
118,Charlie and the Chocolate Factory,2005-07-13,2005,150000000,474968763,324968763,22.038405
120,The Lord of the Rings: The Fellowship of the Ring,2001-12-18,2001,93000000,871368364,778368364,32.070725
121,The Lord of the Rings: The Two Towers,2002-12-18,2002,79000000,926287400,847287400,29.423537
122,The Lord of the Rings: The Return of the King,2003-12-01,2003,94000000,1118888979,1024888979,29.324358
123,The Lord of the Rings,1978-11-15,1978,4000000,30471420,26471420,7.914795
124,No End,1985-06-17,1985,0,0,0,3.256676
127,Blind Chance,1987-01-10,1987,0,0,0,3.208221
128,Princess Mononoke,1997-07-12,1997,26500000,159375308,132875308,17.166725
129,Spirited Away,2001-07-20,2001,15000000,274925095,259925095,41.048867
132,The Rolling Stones: Gimme Shelter,1970-12-06,1970,0,0,0,2.336022
133,Primary,1960-01-01,1960,0,0,0,0.380635
134,"O Brother, Where Art Thou?",2000-08-30,2000,26000000,71868327,45868327,12.434175
135,Dont Look Back,1967-05-17,1967,0,0,0,2.676174
136,Freaks,1932-02-20,1932,0,0,0,9.074348
137,Groundhog Day,1993-02-11,1993,14600000,70906973,56306973,12.989627
138,Dracula,1931-02-12,1931,355000,1012189,657189,7.503126
139,Mifune,1999-03-12,1999,0,0,0,2.539346
140,Bad Education,2004-03-19,2004,5000000,40266982,35266982,7.66414
141,Donnie Darko,2001-01-18,2001,6000000,1270522,-4729478,18.303148
142,Brokeback Mountain,2005-09-02,2005,14000000,178043761,164043761,11.787044
143,All Quiet on the Western Front,1930-04-29,1930,1250000,0,-1250000,15.235056
144,Wings of Desire,1987-01-01,1987,2500000,3200000,700000,6.357321
145,Breaking the Waves,1996-05-13,1996,0,3803298,3803298,8.558688
146,"Crouching Tiger, Hidden Dragon",2000-10-01,2000,17000000,213525736,196525736,19.944953
147,The 400 Blows,1959-05-04,1959,0,0,0,7.268688
148,The Secret Life of Words,2005-12-15,2005,5000000,0,-5000000,12.775583
149,Akira,1988-07-16,1988,8000000,553171,-7446829,10.888917
150,48 Hrs.,1982-12-07,1982,12000000,78868508,66868508,15.297121
152,Star Trek: The Motion Picture,1979-12-06,1979,35000000,139000000,104000000,8.277765
153,Lost in Translation,2003-08-31,2003,4000000,119723856,115723856,11.609441
154,Star Trek II: The Wrath of Khan,1982-06-03,1982,12000000,96800000,84800000,7.160236
155,The Dark Knight,2008-07-16,2008,185000000,1004558444,819558444,123.167259
156,Wilbur Wants to Kill Himself,2002-11-08,2002,0,0,0,2.651412
157,Star Trek III: The Search for Spock,1984-05-31,1984,18000000,87000000,69000000,6.197298
158,Knockin' on Heaven's Door,1997-02-20,1997,0,0,0,7.203307
159,Maybe... Maybe Not,1994-10-05,1994,0,0,0,8.593319
160,The Arrival of a Train at La Ciotat,1896-01-25,1896,0,0,0,5.256608
161,Ocean's Eleven,2001-12-07,2001,85000000,450717150,365717150,12.114932
162,Edward Scissorhands,1990-12-05,1990,20000000,53000000,33000000,17.612244
163,Ocean's Twelve,2004-12-09,2004,110000000,362744280,252744280,11.869347
164,Breakfast at Tiffany's,1961-10-05,1961,2500000,9500000,7000000,10.879289
165,Back to the Future Part II,1989-11-20,1989,40000000,332000000,292000000,13.689855
166,The Party,1980-01-01,1980,0,0,0,12.105748
167,K-PAX,2001-10-22,2001,48000000,50315140,2315140,12.400152
168,Star Trek IV: The Voyage Home,1986-11-25,1986,24000000,133000000,109000000,12.596956
169,Predator 2,1990-11-20,1990,35000000,57120318,22120318,11.736241
170,28 Days Later,2002-10-31,2002,5000000,82719885,77719885,17.656951
171,The Party 2,1982-12-08,1982,0,0,0,4.964833
172,Star Trek V: The Final Frontier,1989-06-09,1989,30000000,70200000,40200000,12.308007
173,"20,000 Leagues Under the Sea",1954-12-23,1954,5000000,28200000,23200000,8.722406
174,Star Trek VI: The Undiscovered Country,1991-12-05,1991,27000000,96900000,69900000,5.90057
175,The Big Blue,1988-05-11,1988,0,0,0,13.503815
176,Saw,2004-10-01,2004,1200000,103911669,102711669,23.508433
177,The Fisher King,1991-09-09,1991,24000000,41895491,17895491,11.184385
178,Blown Away,1994-07-01,1994,0,30156002,30156002,13.155071
179,The Interpreter,2005-04-08,2005,80000000,162944923,82944923,12.047671
180,Minority Report,2002-06-20,2002,102000000,358372926,256372926,20.666063
182,The Good German,2006-12-08,2006,32000000,5914908,-26085092,5.290831
183,The Wizard,1989-12-15,1989,6000000,14278900,8278900,5.763954
184,Jackie Brown,1997-12-24,1997,12000000,39673162,27673162,16.415498
185,A Clockwork Orange,1971-12-18,1971,2200000,26589000,24389000,17.112594
186,Lucky Number Slevin,2006-02-24,2006,27000000,56308881,29308881,11.15092
187,Sin City,2005-04-01,2005,40000000,158733820,118733820,15.010525
189,Sin City: A Dame to Kill For,2014-08-20,2014,65000000,39407616,-25592384,20.623642
192,The Name of the Rose,1986-09-24,1986,20000000,77200000,57200000,11.469751
193,Star Trek: Generations,1994-11-17,1994,38000000,120000000,82000000,8.105708
194,Am√©lie,2001-04-25,2001,10000000,173921954,163921954,12.879381
195,Trouble in Paradise,1932-10-21,1932,0,0,0,3.351442
196,Back to the Future Part III,1990-05-25,1990,40000000,244527583,204527583,13.043999
197,Braveheart,1995-05-24,1995,72000000,210000000,138000000,20.755149
198,To Be or Not to Be,1942-03-05,1942,0,0,0,7.274948
199,Star Trek: First Contact,1996-11-21,1996,46000000,150000000,104000000,8.808497
200,Star Trek: Insurrection,1998-12-10,1998,70000000,118000000,48000000,9.538877
201,Star Trek: Nemesis,2002-12-13,2002,60000000,67312826,7312826,11.367801
203,Mean Streets,1973-10-02,1973,500000,3000000,2500000,8.212399
204,The Wages of Fear,1953-04-22,1953,0,0,0,7.643793
205,Hotel Rwanda,2004-09-11,2004,17500000,38000000,20500000,10.262332
206,Paradise Found,2003-01-01,2003,0,0,0,1.623172
207,Dead Poets Society,1989-06-02,1989,16400000,235860116,219460116,19.905716
211,Berlin is in Germany,2001-11-01,2001,0,0,0,0.222747
212,Arsenic and Old Lace,1944-09-23,1944,1120175,0,-1120175,13.99011
213,North by Northwest,1959-07-07,1959,4000000,13275000,9275000,12.410427
214,Saw III,2006-10-27,2006,10000000,163876815,153876815,14.938035
215,Saw II,2005-10-28,2005,4000000,152925093,148925093,15.399863
216,Ali: Fear Eats the Soul,1974-03-05,1974,130000,0,-130000,5.855308
217,Indiana Jones and the Kingdom of the Crystal Skull,2008-05-21,2008,185000000,786636033,601636033,12.577266
218,The Terminator,1984-10-26,1984,6400000,78371200,71971200,19.293562
219,Volver,2006-03-16,2006,12899867,85582407,72682540,6.302926
220,East of Eden,1955-03-09,1955,1,5,4,6.42883
221,Rebel Without a Cause,1955-10-27,1955,1500000,0,-1500000,10.968169
222,Berlin: Symphony of a Great City,1927-09-23,1927,0,0,0,0.692745
223,Rebecca,1940-04-12,1940,1288000,6000000,4712000,8.590813
224,Man of Marble,1977-02-25,1977,0,0,0,2.78344
225,Man of Iron,1981-07-27,1981,0,0,0,0.886249
226,Boys Don't Cry,1999-09-02,1999,2000000,11540607,9540607,6.536006
227,The Outsiders,1983-03-25,1983,10000000,33697647,23697647,6.435926
228,The Blue Angel,1930-03-31,1930,0,0,0,2.40612
229,Bride of Frankenstein,1935-04-21,1935,393750,0,-393750,7.000417
231,Syriana,2005-11-23,2005,50000000,94000000,44000000,5.768575
232,Rumble Fish,1983-10-20,1983,10000000,2494480,-7505520,8.20519
233,The Wanderers,1979-07-13,1979,0,23000000,23000000,3.386374
234,The Cabinet of Dr. Caligari,1920-02-25,1920,18000,0,-18000,7.191271
235,Stand by Me,1986-08-22,1986,8000000,52287414,44287414,15.206957
236,Muriel's Wedding,1994-09-29,1994,3000000,15119639,12119639,5.254847
237,Young Adam,2003-09-26,2003,6400000,2500000,-3900000,5.235419
238,The Godfather,1972-03-14,1972,6000000,245066411,239066411,41.109264
239,Some Like It Hot,1959-03-18,1959,2883848,25000000,22116152,11.845107
240,The Godfather: Part II,1974-12-20,1974,13000000,47542841,34542841,36.629307
241,Natural Born Killers,1994-08-25,1994,34000000,50282766,16282766,11.226856
242,The Godfather: Part III,1990-12-24,1990,54000000,136766062,82766062,17.185349
243,High Fidelity,2000-03-17,2000,30000000,47126295,17126295,8.524956
244,King Kong,1933-04-07,1933,672000,10000000,9328000,8.73274
245,About a Boy,2002-04-26,2002,27000000,129000000,102000000,10.956665
246,Zatoichi,2003-09-06,2003,0,0,0,6.428263
247,The Killing,1956-05-08,1956,320000,0,-320000,10.223264
248,Pocketful of Miracles,1961-12-18,1961,2900000,5000000,2100000,2.649605
249,The War of the Roses,1989-12-08,1989,0,0,0,5.963782
250,In China They Eat Dogs,1999-09-10,1999,0,0,0,5.06264
251,Ghost,1990-07-12,1990,22000000,505000000,483000000,11.945397
252,Willy Wonka & the Chocolate Factory,1971-06-29,1971,3000000,4000000,1000000,12.416635
253,Live and Let Die,1973-07-05,1973,7000000,161777836,154777836,9.773768
254,King Kong,2005-12-14,2005,207000000,550000000,343000000,19.761164
255,Stolen Kisses,1968-08-13,1968,350000,0,-350000,6.564465
256,Antoine and Colette,1962-06-22,1962,0,0,0,1.673854
257,Oliver Twist,2005-09-23,2005,50000000,42093706,-7906294,12.369935
258,Bed and Board,1970-08-31,1970,0,0,0,11.97502
259,Love on the Run,1979-01-24,1979,0,0,0,3.762139
260,The 39 Steps,1935-06-01,1935,0,0,0,5.865697
261,Cat on a Hot Tin Roof,1958-02-17,1958,3000000,17570324,14570324,11.794846
262,The King of Comedy,1982-12-18,1982,20000000,0,-20000000,9.093411
265,Lili Marleen,1981-01-14,1981,0,0,0,2.525223
266,Contempt,1963-10-21,1963,900000,528428,-371572,7.543337
267,Live Flesh,1997-10-28,1997,0,1535558,1535558,6.715019
268,Batman,1989-06-23,1989,35000000,411348924,376348924,19.10673
269,Breathless,1960-03-16,1960,0,0,0,8.200586
271,Ronja Robbersdaughter,1984-12-20,1984,0,0,0,5.135373
272,Batman Begins,2005-06-10,2005,150000000,374218673,224218673,28.505341
273,The White Sound,2001-12-31,2001,250000,0,-250000,3.10114
274,The Silence of the Lambs,1991-02-01,1991,19000000,272742922,253742922,4.307222
275,Fargo,1996-04-05,1996,7000000,60611975,53611975,12.61469
276,The Edukators,2004-10-25,2004,0,0,0,5.681706
277,Underworld,2003-09-19,2003,22000000,95708457,73708457,20.624333
278,The Shawshank Redemption,1994-09-23,1994,25000000,28341469,3341469,51.645403
279,Amadeus,1984-10-26,1984,18000000,51973029,33973029,12.677592
280,Terminator 2: Judgment Day,1991-07-01,1991,100000000,520000000,420000000,22.661695
281,Strange Days,1995-10-13,1995,42000000,7959291,-34040709,11.223055
284,The Apartment,1960-06-15,1960,3000000,25000000,22000000,11.994281
285,Pirates of the Caribbean: At World's End,2007-05-19,2007,300000000,961000000,661000000,31.363664
286,Germany: A Summer's Fairytale,2006-10-03,2006,0,0,0,1.158527
287,Bull Durham,1988-06-15,1988,7000000,50888000,43888000,6.924072
288,High Noon,1952-03-27,1952,730000,8000000,7270000,16.715935
289,Casablanca,1942-11-26,1942,878000,10462500,9584500,13.916101
290,Barton Fink,1991-08-01,1991,9000000,6153939,-2846061,8.387026
291,Riding Giants,2004-07-09,2004,2600000,3166000,566000,2.203949
292,Dave Chappelle's Block Party,2005-09-12,2005,3000000,11718595,8718595,2.092791
293,A River Runs Through It,1992-10-09,1992,0,43440294,43440294,12.583826
294,Desert Hearts,1985-10-01,1985,350000,2400000,2050000,1.553107
296,Terminator 3: Rise of the Machines,2003-07-02,2003,200000000,435000000,235000000,20.818907
297,Meet Joe Black,1998-11-12,1998,90000000,142940100,52940100,14.026744
298,Ocean's Thirteen,2007-06-07,2007,85000000,311312624,226312624,12.16276
299,Ocean's Eleven,1960-02-17,1960,0,0,0,7.29506
300,The Science of Sleep,2006-02-11,2006,6000000,9524340,3524340,10.603991
301,Rio Bravo,1959-03-17,1959,0,5800000,5800000,10.847383
302,Swimming Pool,2003-05-18,2003,7800000,22441323,14641323,14.481103
303,Notorious,1946-08-15,1946,2000000,24464742,22464742,10.135111
306,Beverly Hills Cop III,1994-05-24,1994,50000000,119208989,69208989,11.787784
307,"Rome, Open City",1945-09-27,1945,0,0,0,6.130177
308,Broken Flowers,2005-05-17,2005,10000000,45742101,35742101,6.589304
309,The Celebration,1998-05-20,1998,1300000,0,-1300000,6.064954
310,Bruce Almighty,2003-05-23,2003,80000000,484572835,404572835,15.947524
311,Once Upon a Time in America,1984-02-16,1984,30000000,0,-30000000,32.182851
312,Beyond Silence,1996-12-18,1996,0,0,0,1.923957
313,Snow Cake,2006-02-09,2006,12000000,1381665,-10618335,11.556057
314,Catwoman,2004-07-22,2004,100000000,82102379,-17897621,13.340272
315,"Faster, Pussycat! Kill! Kill!",1965-08-06,1965,45000,0,-45000,4.220541
316,Grill Point,2002-02-12,2002,600000,0,-600000,0.637825
317,Grbavica: The Land of My Dreams,2006-03-01,2006,0,0,0,0.623465
318,The Million Dollar Hotel,2000-02-09,2000,8000000,0,-8000000,4.938231
319,True Romance,1993-09-09,1993,12500000,12281551,-218449,17.189328
320,Insomnia,2002-05-24,2002,46000000,113714830,67714830,11.424974
321,Mambo Italiano,2003-06-06,2003,4361898,3031801,-1330097,2.873356
322,Mystic River,2003-10-07,2003,25000000,156822020,131822020,12.602438
326,Snakes on a Plane,2006-08-06,2006,33000000,62022014,29022014,7.418574
327,Brother,2000-09-09,2000,12000000,15250000,3250000,8.134524
329,Jurassic Park,1993-06-11,1993,63000000,920100000,857100000,8.863776
330,The Lost World: Jurassic Park,1997-05-23,1997,73000000,229074524,156074524,0.788123
331,Jurassic Park III,2001-07-18,2001,93000000,368780809,275780809,0.648867
332,Inspector Gadget,1999-07-23,1999,75000000,0,-75000000,11.677244
333,Bollywood/Hollywood,2002-01-01,2002,0,0,0,2.015731
334,Magnolia,1999-12-08,1999,37000000,48451803,11451803,9.091636
335,Once Upon a Time in the West,1968-12-21,1968,5000000,5321508,321508,15.589351
336,"Duck, You Sucker",1971-10-20,1971,0,0,0,9.611094
337,Monsieur Ibrahim,2003-12-03,2003,0,11576431,11576431,8.260823
338,"Good bye, Lenin!",2003-02-09,2003,4800000,79384880,74584880,10.605595
339,Night on Earth,1991-10-03,1991,3500000,2015810,-1484190,8.291886
340,Everything is Illuminated,2005-09-16,2005,7000000,2697930,-4302070,7.738924
342,Summer Storm,2004-09-02,2004,2700000,0,-2700000,3.894549
343,Harold and Maude,1971-12-20,1971,1200000,0,-1200000,10.878112
344,"Bang, Boom, Bang",1999-08-26,1999,2888030,0,-2888030,3.931984
345,Eyes Wide Shut,1999-07-14,1999,65000000,162091208,97091208,13.268484
346,Seven Samurai,1954-04-26,1954,2000000,271841,-1728159,15.01777
347,People on Sunday,1930-02-04,1930,0,0,0,1.151573
348,Alien,1979-05-25,1979,11000000,104931801,93931801,23.37742
349,Cockles and Muscles,2005-03-30,2005,0,0,0,2.542936
350,The Devil Wears Prada,2006-06-30,2006,35000000,326551094,291551094,13.102384
363,Head-On,2004-03-11,2004,0,11030861,11030861,10.234986
364,Batman Returns,1992-06-19,1992,80000000,280000000,200000000,15.001681
377,A Nightmare on Elm Street,1984-11-14,1984,1800000,25504513,23704513,13.694713
378,Raising Arizona,1987-03-01,1987,6000000,29180280,23180280,14.011415
379,Miller's Crossing,1990-09-21,1990,14000000,5080409,-8919591,7.495853
380,Rain Man,1988-12-11,1988,25000000,412800000,387800000,11.267467
381,To Catch a Thief,1955-08-03,1955,2500000,8750000,6250000,5.490505
383,Mala Noche,1986-02-05,1986,22500,0,-22500,2.916721
387,Das Boot,1981-09-16,1981,14000000,85000000,71000000,8.80338
388,Inside Man,2006-03-23,2006,45000000,184376254,139376254,13.393548
389,12 Angry Men,1957-03-25,1957,350000,1000000,650000,16.503959
390,Lisbon Story,1994-12-16,1994,0,0,0,1.218279
391,A Fistful of Dollars,1964-09-12,1964,200000,14500000,14300000,12.429704
392,Chocolat,2000-12-14,2000,25000000,152500343,127500343,8.9256
393,Kill Bill: Vol. 2,2004-04-16,2004,30000000,152159461,122159461,21.533072
395,AVP: Alien vs. Predator,2004-08-12,2004,70000000,171183863,101183863,12.636205
396,Who's Afraid of Virginia Woolf?,1966-06-21,1966,7500000,33736689,26236689,5.564294
397,French Kiss,1995-05-05,1995,0,0,0,9.146544
398,Capote,2005-09-30,2005,7000000,49084830,42084830,6.01272
400,Things to Do in Denver When You're Dead,1995-12-01,1995,8000000,529766,-7470234,4.486179
401,Garden State,2004-07-28,2004,2500000,26781723,24281723,11.630809
402,Basic Instinct,1992-03-20,1992,49000000,352927224,303927224,16.628427
403,Driving Miss Daisy,1989-12-13,1989,7500000,145793296,138293296,10.703677
404,The Straight Story,1999-10-15,1999,10000000,0,-10000000,14.580995
405,La Strada,1954-07-16,1954,0,0,0,5.948021
406,La Haine,1995-05-31,1995,3000000,0,-3000000,12.108196
407,Short Sharp Shock,1998-10-15,1998,500000,0,-500000,1.463414
408,Snow White and the Seven Dwarfs,1937-12-20,1937,1488423,184925486,183437063,16.263878
409,The English Patient,1996-11-14,1996,27000000,231976425,204976425,15.564161
410,Summer in Berlin,2005-09-09,2005,0,0,0,1.11126
411,"The Chronicles of Narnia: The Lion, the Witch and the Wardrobe",2005-12-07,2005,180000000,748806957,568806957,18.13542
414,Batman Forever,1995-06-16,1995,100000000,336529144,236529144,13.321354
415,Batman & Robin,1997-06-20,1997,125000000,238207122,113207122,17.038824
421,The Life Aquatic with Steve Zissou,2004-12-10,2004,50000000,34808403,-15191597,6.936677
422,8¬Ω,1963-02-14,1963,0,0,0,6.747516
423,The Pianist,2002-09-24,2002,35000000,120072577,85072577,14.811594
424,Schindler's List,1993-11-29,1993,22000000,321365567,299365567,41.725123
425,Ice Age,2002-03-10,2002,59000000,383257136,324257136,17.328902
426,Vertigo,1958-05-09,1958,2479000,28000000,25521000,18.20822
427,Mon oncle,1958-05-10,1958,0,0,0,11.06066
428,Summer '04,2006-10-11,2006,0,0,0,0.533829
429,"The Good, the Bad and the Ugly",1966-12-23,1966,1200000,6000000,4800000,16.788787
430,"One, Two, Three",1961-12-15,1961,3000000,4000000,1000000,3.044499
431,Cube,1997-09-09,1997,250000,501818,251818,12.095263
433,Mary Poppins,1964-08-27,1964,6000000,102272727,96272727,15.11549
434,Tough Enough,2006-03-09,2006,0,0,0,1.634982
435,The Day After Tomorrow,2004-05-26,2004,125000000,544272402,419272402,15.049695
436,Maria Full of Grace,2004-01-18,2004,0,0,0,5.450934
437,Cube¬≤: Hypercube,2002-04-15,2002,0,0,0,15.317489
438,Cube Zero,2004-10-15,2004,825000,0,-825000,8.758493
439,La Dolce Vita,1960-02-05,1960,0,19516000,19516000,11.063822
440,Aliens vs Predator: Requiem,2007-12-25,2007,40000000,41797066,1797066,10.793324
441,Human Nature,2001-05-18,2001,6000000,705308,-5294692,7.714094
442,Popular Music,2004-09-24,2004,2224000,28000000,25776000,0.988777
445,Cach√©,2005-05-02,2005,0,36000000,36000000,5.69586
451,Leaving Las Vegas,1995-10-27,1995,3600000,49800000,46200000,10.332025
452,The Idiots,1998-04-28,1998,2500000,7235,-2492765,9.174221
453,A Beautiful Mind,2001-12-11,2001,60000000,313542341,253542341,11.93646
454,Romeo + Juliet,1996-10-31,1996,14500000,147298761,132798761,11.774061
455,Bend It Like Beckham,2002-04-11,2002,3500159,76578641,73078482,6.262677
457,Sissi,1955-12-22,1955,0,0,0,11.02505
458,Sissi: The Young Empress,1956-12-18,1956,0,0,0,6.321126
459,Sissi: The Fateful Years of an Empress,1957-12-18,1957,0,0,0,10.256081
460,Go for Zucker,2005-01-06,2005,0,0,0,1.817069
462,Erin Brockovich,2000-03-17,2000,52000000,256271286,204271286,10.135446
464,As It Is in Heaven,2004-09-03,2004,0,0,0,3.643125
465,Junior Size 36,1988-03-03,1988,0,0,0,3.200299
466,Klute,1971-06-21,1971,2500000,0,-2500000,9.328822
467,The Hole,2001-04-20,2001,0,0,0,4.406514
468,My Own Private Idaho,1991-10-17,1991,2500000,0,-2500000,7.289727
469,Stranger Than Paradise,1984-10-01,1984,0,0,0,11.33706
470,21 Grams,2003-09-06,2003,20000000,60427839,40427839,6.372278
471,Bandyta,1997-01-01,1997,0,0,0,0.707491
473,Pi,1998-07-10,1998,60000,3221152,3161152,10.621362
475,Bonnie and Clyde,1967-07-18,1967,2500000,50700000,48200000,12.109198
476,Drugstore Cowboy,1989-09-09,1989,2500000,4729352,2229352,8.026112
479,Shaft,2000-06-15,2000,46000000,107196498,61196498,7.420019
480,Monsoon Wedding,2001-08-30,2001,0,0,0,10.625504
481,7 Virgins,2005-10-14,2005,0,0,0,1.639857
482,Shaft,1971-07-02,1971,4000000,12121618,8121618,3.73688
483,Wild at Heart,1990-05-01,1990,9500000,14560247,5060247,8.528622
488,The African Queen,1951-12-03,1951,1300000,10750000,9450000,6.636872
489,Good Will Hunting,1997-12-05,1997,10000000,225933435,215933435,15.064833
490,The Seventh Seal,1957-02-16,1957,0,0,0,6.47828
492,Being John Malkovich,1999-09-30,1999,13000000,22863596,9863596,11.416319
493,Shaft's Big Score!,1972-06-08,1972,1978000,10000000,8022000,0.760855
494,Shaft in Africa,1973-06-14,1973,2142000,1458000,-684000,1.424722
496,Borat: Cultural Learnings of America for Make Benefit Glorious Nation of Kazakhstan,2006-11-01,2006,18000000,261572744,243572744,8.278336
497,The Green Mile,1999-12-10,1999,60000000,284600000,224600000,19.96678
499,Cl√©o from 5 to 7,1962-04-11,1962,0,0,0,4.480811
500,Reservoir Dogs,1992-09-02,1992,1200000,14661007,13461007,12.22034
501,Grizzly Man,2005-08-12,2005,0,0,0,8.535339
502,Fail-Safe,1964-10-07,1964,0,0,0,4.225974
503,Poseidon,2006-05-12,2006,160000000,181674817,21674817,6.581669
504,Monster,2003-11-16,2003,8000000,60378584,52378584,7.189024
505,Johnny Handsome,1989-09-12,1989,20000000,7237794,-12762206,9.059459
506,Marnie,1964-07-09,1964,2135161,7000000,4864839,6.409094
507,Killing Zoe,1993-10-01,1993,1500000,418961,-1081039,4.948569
508,Love Actually,2003-09-07,2003,40000000,244931766,204931766,10.586815
509,Notting Hill,1999-05-13,1999,42000000,363889678,321889678,9.874043
510,One Flew Over the Cuckoo's Nest,1975-11-18,1975,3000000,108981275,105981275,35.529554
511,The Promised Land,1975-02-21,1975,0,0,0,0.902102
512,Scoop,2006-07-27,2006,4000000,31584901,27584901,8.16339
513,Fire,1996-09-06,1996,0,501533,501533,5.398354
521,Dial M for Murder,1954-05-29,1954,1400000,3000000,1600000,7.853231
522,Ed Wood,1994-09-27,1994,18000000,5887457,-12112543,11.720358
523,Requiem,2006-03-02,2006,0,0,0,2.457138
524,Casino,1995-11-22,1995,52000000,116112375,64112375,10.137389
525,The Blues Brothers,1980-06-17,1980,27000000,115229890,88229890,10.076901
526,Ladyhawke,1985-03-27,1985,20000000,18432000,-1568000,8.157587
527,Once Were Warriors,1994-09-02,1994,0,2201126,2201126,4.025276
530,A Grand Day Out,1990-05-18,1990,0,0,0,7.617298
531,The Wrong Trousers,1993-12-17,1993,0,0,0,7.771233
532,A Close Shave,1995-12-24,1995,0,0,0,6.796858
533,The Curse of the Were-Rabbit,2005-09-04,2005,30000000,192452832,162452832,11.766244
534,Terminator Salvation,2009-05-20,2009,200000000,371353001,171353001,16.507496
535,Flashdance,1983-04-14,1983,4000000,92921203,88921203,9.888958
537,Not Here to Be Loved,2005-10-12,2005,0,0,0,1.078297
539,Psycho,1960-06-16,1960,806948,32000000,31193052,36.826309
540,D.E.B.S.,2004-01-21,2004,3500000,0,-3500000,5.161493
541,The Man with the Golden Arm,1955-12-14,1955,0,0,0,3.353068
542,The Crime of Padre Amaro,2002-10-01,2002,1800000,0,-1800000,2.195447
543,Blackmail,1929-06-30,1929,0,0,0,3.956703
544,There's Something About Mary,1998-07-15,1998,23000000,369884651,346884651,11.688958
546,Transamerica,2005-12-23,2005,1000000,13350369,12350369,7.398205
547,The Horse Whisperer,1998-05-14,1998,60000000,186883563,126883563,7.685548
548,Rashomon,1950-12-26,1950,250000,96568,-153432,9.887355
549,Basquiat,1996-08-09,1996,2962051,3011195,49144,4.797674
550,Fight Club,1999-10-15,1999,63000000,100853753,37853753,63.869599
551,The Poseidon Adventure,1972-12-01,1972,5000000,84563118,79563118,10.341849
552,Bread and Tulips,2000-03-03,2000,0,0,0,2.916247
553,Dogville,2003-05-19,2003,10000000,16680836,6680836,9.808595
554,The Cuckoo,2002-01-01,2002,0,0,0,2.481165
557,Spider-Man,2002-05-01,2002,139000000,821708551,682708551,29.413341
558,Spider-Man 2,2004-06-25,2004,200000000,783766341,583766341,10.834506
559,Spider-Man 3,2007-05-01,2007,258000000,890871626,632871626,27.614265
560,Secret Beyond the Door,1948-01-01,1948,0,0,0,2.842257
561,Constantine,2005-02-08,2005,100000000,230884728,130884728,9.615691
562,Die Hard,1988-07-15,1988,28000000,140767956,112767956,16.640522
563,Starship Troopers,1997-11-06,1997,105000000,121214377,16214377,14.412644
564,The Mummy,1999-04-16,1999,80000000,415885488,335885488,23.984065
565,The Ring,2002-10-18,2002,48000000,249348933,201348933,13.740965
567,Rear Window,1954-08-01,1954,1000000,36764313,35764313,17.911314
568,Apollo 13,1995-06-30,1995,52000000,355237933,303237933,18.761467
570,Fat Girl,2001-03-07,2001,0,0,0,2.063604
571,The Birds,1963-03-28,1963,2500000,11403529,8903529,11.591462
572,Next Door,2005-03-10,2005,2400000,0,-2400000,6.619629
573,Frenzy,1972-05-25,1972,3500000,12600000,9100000,5.316387
574,The Man Who Knew Too Much,1956-06-01,1956,2500000,10250000,7750000,12.547763
575,The Experiment,2001-03-07,2001,0,0,0,7.881933
576,The Wild Bunch,1969-06-17,1969,6244087,638641,-5605446,11.722424
577,To Die For,1995-05-20,1995,20000000,21284514,1284514,10.448481
578,Jaws,1975-06-18,1975,7000000,470654000,463654000,19.726114
579,Jaws 2,1978-06-16,1978,20000000,187884007,167884007,11.21306
580,Jaws: The Revenge,1987-07-17,1987,23000000,51881013,28881013,9.327986
581,Dances with Wolves,1990-11-09,1990,22000000,424208848,402208848,11.654349
582,The Lives of Others,2006-03-15,2006,2000000,70000000,68000000,9.02255
583,Life of Brian,1979-08-17,1979,4000000,20045115,16045115,10.714173
584,2 Fast 2 Furious,2003-06-05,2003,76000000,236350661,160350661,2.32462
585,"Monsters, Inc.",2001-11-01,2001,115000000,562816256,447816256,26.419962
586,Wag the Dog,1997-12-25,1997,15000000,64256513,49256513,7.603652
587,Big Fish,2003-12-25,2003,70000000,122919055,52919055,14.739983
588,Silent Hill,2006-04-21,2006,50000000,97607453,47607453,7.938457
590,The Hours,2002-12-27,2002,25000000,41597830,16597830,14.686487
591,The Da Vinci Code,2006-05-17,2006,125000000,767820459,642820459,18.566706
592,The Conversation,1974-04-07,1974,1600000,4420000,2820000,13.245638
593,Solaris,1972-03-20,1972,0,0,0,11.059785
594,The Terminal,2004-06-17,2004,60000000,219417255,159417255,14.092373
595,To Kill a Mockingbird,1962-12-25,1962,2000000,13129846,11129846,14.284787
596,The Grapes of Wrath,1940-03-15,1940,750000,0,-750000,9.668636
597,Titanic,1997-11-18,1997,200000000,1845034188,1645034188,26.88907
598,City of God,2002-02-05,2002,3300000,30641770,27341770,14.95927
599,Sunset Boulevard,1950-08-10,1950,1752000,5000000,3248000,11.709777
600,Full Metal Jacket,1987-06-26,1987,17000000,46357676,29357676,13.94148
601,E.T. the Extra-Terrestrial,1982-04-03,1982,10500000,792965326,782465326,19.358546
602,Independence Day,1996-06-25,1996,75000000,816969268,741969268,17.634197
603,The Matrix,1999-03-30,1999,63000000,463517383,400517383,33.366332
604,The Matrix Reloaded,2003-05-15,2003,150000000,738599701,588599701,16.229317
605,The Matrix Revolutions,2003-11-05,2003,150000000,424988211,274988211,15.368205
606,Out of Africa,1985-12-20,1985,31000000,128499205,97499205,14.004074
607,Men in Black,1997-07-02,1997,90000000,589390539,499390539,15.781024
608,Men in Black II,2002-07-03,2002,140000000,441818803,301818803,16.775716
609,Poltergeist,1982-06-04,1982,10700000,122200000,111500000,11.776326
612,Munich,2005-12-22,2005,70000000,130358911,60358911,9.668761
613,Downfall,2004-09-08,2004,18339750,92180910,73841160,7.69224
614,Wild Strawberries,1957-12-26,1957,0,0,0,6.89416
615,The Passion of the Christ,2004-02-25,2004,30000000,611899420,581899420,13.194168
616,The Last Samurai,2003-12-05,2003,140000000,456758981,316758981,19.582325
617,Wild Things,1998-03-20,1998,20000000,67200000,47200000,13.924623
618,The Birth of a Nation,1915-02-08,1915,100000,11000000,10900000,5.113205
619,The Bodyguard,1992-11-25,1992,25000000,411006740,386006740,9.805017
620,Ghostbusters,1984-06-07,1984,30000000,295212467,265212467,22.089729
621,Grease,1978-07-07,1978,6000000,181813770,175813770,7.854899
622,The Ninth Gate,1999-08-24,1999,38000000,58401898,20401898,11.316349
623,A Fish Called Wanda,1988-07-15,1988,7500000,62493712,54993712,11.400353
624,Easy Rider,1969-05-07,1969,360000,0,-360000,8.635841
625,The Killing Fields,1984-11-02,1984,14400000,34700291,20300291,11.460364
626,Un chien andalou,1929-06-05,1929,0,0,0,6.051472
627,Trainspotting,1996-02-23,1996,4000000,16491080,12491080,19.348466
628,Interview with the Vampire,1994-11-11,1994,60000000,223664608,163664608,11.970205
629,The Usual Suspects,1995-07-19,1995,6000000,23341568,17341568,16.302466
630,The Wizard of Oz,1939-08-15,1939,2777000,33754967,30977967,22.064932
631,Sunrise: A Song of Two Humans,1927-09-23,1927,0,121,121,4.249695
632,Stalag 17,1953-05-29,1953,1661530,0,-1661530,9.47371
633,Soldier of Orange,1977-09-22,1977,2300000,0,-2300000,2.348745
634,Bridget Jones's Diary,2001-04-13,2001,25000000,281929795,256929795,10.780524
635,Angel Heart,1987-03-06,1987,17000000,17185632,185632,7.290872
636,THX 1138,1971-03-11,1971,777000,2437000,1660000,8.152085
637,Life Is Beautiful,1997-12-20,1997,20000000,229400000,209400000,39.39497
638,Lost Highway,1997-01-15,1997,15000000,3675201,-11324799,8.449722
639,When Harry Met Sally...,1989-07-21,1989,16000000,92823546,76823546,8.34322
640,Catch Me If You Can,2002-12-25,2002,52000000,352114312,300114312,19.833077
641,Requiem for a Dream,2000-10-27,2000,4500000,7390108,2890108,6.874828
642,Butch Cassidy and the Sundance Kid,1969-09-23,1969,6000000,102308889,96308889,6.714577
643,Battleship Potemkin,1925-12-24,1925,0,45100,45100,12.912845
644,A.I. Artificial Intelligence,2001-06-29,2001,100000000,235926552,135926552,13.249364
646,Dr. No,1962-10-04,1962,950000,59600000,58650000,19.931606
647,Final Fantasy VII: Advent Children,2005-07-14,2005,0,0,0,15.260291
648,Beauty and the Beast,1946-10-29,1946,0,0,0,4.798852
649,Belle de Jour,1967-05-24,1967,0,0,0,10.142662
650,Boyz n the Hood,1991-07-12,1991,6500000,57504069,51004069,6.866506
651,M*A*S*H,1970-01-24,1970,3500000,81600000,78100000,7.701349
652,Troy,2004-05-13,2004,175000000,497409852,322409852,15.387275
653,Nosferatu,1922-03-15,1922,0,0,0,7.435873
654,On the Waterfront,1954-06-22,1954,910000,9600000,8690000,18.211093
655,"Paris, Texas",1984-05-19,1984,1746964,2181987,435023,11.635837
657,From Russia with Love,1963-10-11,1963,2000000,78898765,76898765,12.536729
658,Goldfinger,1964-09-17,1964,2500000,124881062,122381062,13.78884
659,The Tin Drum,1979-05-02,1979,0,0,0,5.614456
660,Thunderball,1965-12-16,1965,5500000,141195658,135695658,10.517835
661,The Marriage of Maria Braun,1979-02-20,1979,0,0,0,2.617272
662,La Jet√©e,1962-02-16,1962,0,0,0,7.282665
663,Saw IV,2007-10-25,2007,10000000,139352633,129352633,12.233863
664,Twister,1996-05-10,1996,92000000,494471524,402471524,8.739144
665,Ben-Hur,1959-12-26,1959,15000000,146900000,131900000,14.319743
666,Central Station,1998-01-16,1998,2900000,5596708,2696708,4.919716
667,You Only Live Twice,1967-06-12,1967,9500000,111584787,102084787,10.359669
668,On Her Majesty's Secret Service,1969-12-12,1969,6500000,81974493,75474493,9.356264
669,Nanook of the North,1922-06-11,1922,53000,0,-53000,2.593681
670,Oldboy,2003-01-01,2003,3000000,14980005,11980005,10.616859
671,Harry Potter and the Philosopher's Stone,2001-11-16,2001,125000000,976475550,851475550,38.187238
672,Harry Potter and the Chamber of Secrets,2002-11-13,2002,100000000,876688482,776688482,29.741452
673,Harry Potter and the Prisoner of Azkaban,2004-05-31,2004,130000000,789804554,659804554,28.460276
674,Harry Potter and the Goblet of Fire,2005-11-05,2005,150000000,895921036,745921036,24.903058
675,Harry Potter and the Order of the Phoenix,2007-06-28,2007,150000000,938212738,788212738,21.3643
676,Pearl Harbor,2001-05-21,2001,140000000,449220945,309220945,11.419388
677,Olympia Part One: Festival of the Nations,1938-04-20,1938,0,0,0,1.530927
678,Out of the Past,1947-11-13,1947,0,0,0,5.34379
679,Aliens,1986-07-18,1986,18500000,183316455,164816455,21.761179
680,Pulp Fiction,1994-09-10,1994,8000000,213928762,205928762,140.950236
681,Diamonds Are Forever,1971-12-13,1971,7200000,116019547,108819547,12.00491
682,The Man with the Golden Gun,1974-12-01,1974,7000000,97572000,90572000,12.127492
685,Olympia Part Two: Festival of Beauty,1938-04-20,1938,0,0,0,0.818906
686,Contact,1997-07-11,1997,90000000,171120329,81120329,14.374866
687,Dead Man Walking,1995-12-29,1995,11000000,39363635,28363635,6.891317
688,The Bridges of Madison County,1995-05-28,1995,24000000,182016617,158016617,5.951077
689,The Travelling Players,1975-01-01,1975,0,0,0,1.045352
690,Pickpocket,1959-12-16,1959,0,0,0,4.571519
691,The Spy Who Loved Me,1977-07-07,1977,14000000,185438673,171438673,9.781451
692,Pink Flamingos,1972-03-12,1972,12000,6000000,5988000,5.738871
693,Meet the Fockers,2004-12-22,2004,80000000,516642939,436642939,11.876386
694,The Shining,1980-05-22,1980,19000000,44017374,25017374,19.611589
695,Short Cuts,1993-09-05,1993,0,6110979,6110979,8.829337
696,Manhattan,1979-04-25,1979,0,39946780,39946780,12.050759
697,October (Ten Days that Shook the World),1928-01-20,1928,0,0,0,0.828625
698,Moonraker,1979-06-26,1979,34000000,210308099,176308099,10.576273
699,For Your Eyes Only,1981-06-23,1981,28000000,195312802,167312802,9.765123
700,Octopussy,1983-06-05,1983,27500000,187500000,160000000,10.619302
701,Our Hospitality,1923-11-19,1923,0,0,0,2.830289
702,A Streetcar Named Desire,1951-09-18,1951,1800000,8000000,6200000,7.301719
703,Annie Hall,1977-04-19,1977,4000000,38251425,34251425,18.146043
704,A Hard Day's Night,1964-07-06,1964,560000,12299668,11739668,5.719266
705,All About Eve,1950-11-09,1950,1400000,63463,-1336537,12.06308
706,Effi Briest,1974-06-20,1974,0,0,0,0.007319
707,A View to a Kill,1985-05-24,1985,30000000,152427960,122427960,12.840798
708,The Living Daylights,1987-06-29,1987,40000000,191185897,151185897,12.189038
709,Licence to Kill,1989-07-07,1989,32000000,156167015,124167015,11.137888
710,GoldenEye,1995-11-16,1995,58000000,352194034,294194034,14.686036
711,Finding Forrester,2000-12-21,2000,43000000,80049764,37049764,10.536255
712,Four Weddings and a Funeral,1994-03-09,1994,6000000,254700832,248700832,8.990345
713,The Piano,1993-05-19,1993,7000000,116700000,109700000,7.436758
714,Tomorrow Never Dies,1997-12-11,1997,110000000,333011068,223011068,17.159576
742,Together,2000-08-25,2000,0,0,0,3.358638
744,Top Gun,1986-05-16,1986,15000000,356830601,341830601,20.301019
745,The Sixth Sense,1999-08-06,1999,40000000,672806292,632806292,18.449169
746,The Last Emperor,1987-10-21,1987,23000000,43984230,20984230,11.076971
747,Shaun of the Dead,2004-04-09,2004,4000000,30039392,26039392,14.902948
750,Murder She Said,1961-01-01,1961,0,0,0,7.261845
751,Murder at the Gallop,1963-01-01,1963,0,0,0,7.282583
752,V for Vendetta,2006-03-15,2006,54000000,132511035,78511035,20.214422
753,Faces,1968-11-24,1968,275000,0,-275000,7.918418
754,Face/Off,1997-06-27,1997,80000000,245676146,165676146,11.467391
755,From Dusk Till Dawn,1996-01-19,1996,19000000,25836616,6836616,15.339153
756,Fantasia,1940-11-13,1940,2280000,83320000,81040000,8.03796
757,Murder Most Foul,1964-03-01,1964,0,0,0,3.119101
758,Murder Ahoy,1964-06-01,1964,0,0,0,1.954245
759,Gentlemen Prefer Blondes,1953-07-14,1953,0,0,0,7.174547
760,The Mad Adventures of Rabbi Jacob,1973-10-17,1973,0,0,0,7.18207
761,The Wing or the Thigh,1976-10-27,1976,0,0,0,6.218351
762,Monty Python and the Holy Grail,1975-03-13,1975,400000,5028948,4628948,10.43389
763,Braindead,1992-08-13,1992,3000000,242623,-2757377,13.645568
764,The Evil Dead,1981-10-15,1981,350000,29400000,29050000,10.421679
765,Evil Dead II,1987-03-13,1987,3600000,5923044,2323044,13.520764
766,Army of Darkness,1992-10-09,1992,11000000,0,-11000000,10.704612
767,Harry Potter and the Half-Blood Prince,2009-07-07,2009,250000000,933959197,683959197,19.083723
768,From Hell,2001-10-19,2001,35000000,74558115,39558115,7.79014
769,GoodFellas,1990-09-12,1990,25000000,46836394,21836394,15.424092
770,Gone with the Wind,1939-12-15,1939,4000000,400176459,396176459,14.240357
771,Home Alone,1990-11-09,1990,18000000,476684675,458684675,0.702543
772,Home Alone 2: Lost in New York,1992-11-19,1992,18000000,358991681,340991681,13.293722
773,Little Miss Sunshine,2006-07-26,2006,8000000,100523181,92523181,5.320117
774,Workers Leaving the Lumi√®re Factory,1895-06-10,1895,0,0,0,0.693917
775,A Trip to the Moon,1902-09-01,1902,5985,0,-5985,6.321801
776,The Rules of the Game,1939-06-08,1939,8847685,0,-8847685,5.568997
777,Grand Illusion,1937-06-04,1937,0,0,0,6.02384
778,Monsieur  Hulot's Holiday,1953-02-26,1953,0,0,0,4.328916
779,Vampyr,1932-05-06,1932,0,0,0,4.320771
780,The Passion of Joan of Arc,1928-04-21,1928,0,0,0,8.903953
781,Wintersleepers,1997-10-30,1997,0,0,0,1.781979
782,Gattaca,1997-09-07,1997,36000000,12532777,-23467223,12.89312
783,Gandhi,1982-11-30,1982,22000000,77737889,55737889,12.383755
784,Kolya,1996-05-05,1996,0,5770254,5770254,13.947867
786,Almost Famous,2000-09-15,2000,60000000,47383689,-12616311,9.086699
787,Mr. & Mrs. Smith,2005-06-07,2005,110000000,478207520,368207520,15.724373
788,Mrs. Doubtfire,1993-11-24,1993,25000000,441286195,416286195,11.16553
789,Closely Watched Trains,1966-11-18,1966,0,0,0,2.160866
790,The Fog,1980-02-08,1980,1000000,21378361,20378361,9.194572
791,The Fog,2005-10-14,2005,18000000,46201432,28201432,9.929809
792,Platoon,1986-12-18,1986,6000000,138530565,132530565,18.206972
793,Blue Velvet,1986-08-01,1986,6000000,8551228,2551228,7.882247
794,The Omen,1976-06-06,1976,2800000,60922980,58122980,16.641277
795,City of Angels,1998-04-10,1998,55000000,198685114,143685114,8.228219
796,Cruel Intentions,1999-03-05,1999,10500000,75902208,65402208,8.181065
797,Persona,1966-10-18,1966,0,0,0,8.862628
798,P√ºnktchen und Anton,1953-08-26,1953,0,0,0,0.076325
799,Annaluise & Anton,1999-03-11,1999,0,0,0,0.309062
800,Los Olvidados,1950-11-09,1950,0,0,0,3.563355
801,"Good Morning, Vietnam",1987-12-23,1987,13000000,123922370,110922370,9.023282
802,Lolita,1962-06-13,1962,2000000,9250000,7250000,9.551293
803,Night and Fog,1955-01-01,1955,0,0,0,11.144661
804,Roman Holiday,1953-09-02,1953,1500000,12000000,10500000,11.954806
805,Rosemary's Baby,1968-06-12,1968,3200000,33395426,30195426,11.504558
806,The Omen,2006-06-06,2006,25000000,119188334,94188334,5.670679
807,Se7en,1995-09-22,1995,33000000,327311859,294311859,18.45743
808,Shrek,2001-05-16,2001,60000000,484409218,424409218,17.987728
809,Shrek 2,2004-05-19,2004,150000000,919838758,769838758,16.22986
810,Shrek the Third,2007-05-17,2007,160000000,798958165,638958165,14.072479
811,Silent Running,1972-03-09,1972,1000000,0,-1000000,14.108597
812,Aladdin,1992-11-25,1992,28000000,504050219,476050219,16.357419
813,Airplane!,1980-07-02,1980,3500000,83453539,79953539,13.063203
814,An American Werewolf in London,1981-08-21,1981,10000000,31973249,21973249,13.390802
815,Animal Farm,1999-10-03,1999,23000000,0,-23000000,2.33561
816,Austin Powers: International Man of Mystery,1997-05-02,1997,16500000,67683989,51183989,11.749159
817,Austin Powers: The Spy Who Shagged Me,1999-06-08,1999,33000000,310940086,277940086,13.984182
818,Austin Powers in Goldmember,2002-07-26,2002,63000000,296655431,233655431,8.786653
819,Sleepers,1996-10-18,1996,44000000,165615285,121615285,9.198283
820,JFK,1991-12-20,1991,40000000,205405498,165405498,13.813146
821,Judgment at Nuremberg,1961-12-01,1961,3000000,10000000,7000000,9.697105
822,The Music Room,1958-10-10,1958,0,0,0,1.28194
823,Jin-Roh: The Wolf Brigade,1999-11-17,1999,0,0,0,5.993402
824,Moulin Rouge!,2001-03-09,2001,52500000,179213434,126713434,13.691781
825,Playing by Heart,1998-12-30,1998,20000000,3970078,-16029922,3.010088
826,The Bridge on the River Kwai,1957-10-02,1957,3000000,27200000,24200000,8.851646
827,Diabolique,1955-01-29,1955,0,0,0,6.028408
828,The Day the Earth Stood Still,1951-09-17,1951,1200000,0,-1200000,9.360003
829,Chinatown,1974-06-20,1974,6000000,30000000,24000000,12.29227
830,Forbidden Planet,1956-03-15,1956,1900000,3250000,1350000,6.379966
831,This Island Earth,1955-06-01,1955,800000,0,-800000,3.187177
832,M,1931-05-11,1931,0,0,0,12.752421
833,Umberto D.,1952-01-20,1952,0,0,0,5.71023
834,Underworld: Evolution,2006-01-12,2006,50000000,111340801,61340801,12.496805
836,Barren Lives,1963-08-22,1963,0,0,0,0.684876
837,Videodrome,1983-02-04,1983,5952000,2120439,-3831561,7.945039
838,American Graffiti,1973-08-01,1973,777000,140000000,139223000,9.188584
839,Duel,1972-10-01,1972,450000,0,-450000,12.331251
840,Close Encounters of the Third Kind,1977-11-16,1977,20000000,303788635,283788635,10.610446
841,Dune,1984-12-14,1984,40000000,30925690,-9074310,9.261189
842,The Assassination of Richard Nixon,2004-05-17,2004,0,3537961,3537961,10.107677
843,In the Mood for Love,2000-05-22,2000,0,12854953,12854953,8.703552
844,2046,2004-05-20,2004,12000000,19271312,7271312,7.157169
845,Strangers on a Train,1951-06-18,1951,1200000,7000000,5800000,15.41773
846,The X Files,1998-06-19,1998,66000000,189198313,123198313,12.311615
847,Willow,1988-05-01,1988,35000000,57269863,22269863,9.918312
848,Dragonslayer,1981-06-26,1981,18000000,14110013,-3889987,3.383201
849,Krull,1983-07-29,1983,27000000,16519460,-10480540,9.848674
850,A Christmas Story,1983-11-18,1983,0,19294144,19294144,7.337907
851,Brief Encounter,1945-11-24,1945,0,0,0,5.408818
853,Enemy at the Gates,2001-03-13,2001,68000000,96976270,28976270,10.704813
854,The Mask,1994-07-29,1994,23000000,351583407,328583407,14.13488
855,Black Hawk Down,2001-12-28,2001,92000000,172989651,80989651,10.064446
856,Who Framed Roger Rabbit,1988-06-21,1988,70000000,329803958,259803958,16.78596
857,Saving Private Ryan,1998-07-24,1998,70000000,481840909,411840909,21.758054
858,Sleepless in Seattle,1993-06-24,1993,21000000,227799884,206799884,10.234919
859,Dangerous Liaisons,1988-12-16,1988,14000000,34670720,20670720,11.46781
860,WarGames,1983-06-03,1983,12000000,79567667,67567667,8.321647
861,Total Recall,1990-06-01,1990,65000000,261317921,196317921,12.954444
862,Toy Story,1995-10-30,1995,30000000,373554033,343554033,21.946943
863,Toy Story 2,1999-10-30,1999,90000000,497366869,407366869,17.547693
864,Cool Runnings,1993-09-30,1993,14000000,154864401,140864401,8.30721
865,The Running Man,1987-11-13,1987,27000000,38122105,11122105,9.389976
866,Finding Neverland,2004-10-17,2004,25000000,116766556,91766556,15.529604
867,Sliver,1993-05-21,1993,40000000,116300000,76300000,11.23297
868,Tsotsi,2005-08-18,2005,3000000,9879971,6879971,6.081201
869,Planet of the Apes,2001-07-25,2001,100000000,362211740,262211740,17.319836
870,Dolls,2002-09-05,2002,0,0,0,4.416932
871,Planet of the Apes,1968-02-07,1968,5800000,33395426,27595426,17.784978
872,Singin' in the Rain,1952-04-10,1952,2540800,7200000,4659200,11.064858
873,The Color Purple,1985-12-18,1985,15000000,146292009,131292009,11.573562
874,A Man for All Seasons,1966-12-12,1966,3900000,28350000,24450000,6.997888
875,Shanghai Express,1932-02-02,1932,0,0,0,2.085774
876,Frank Herbert's Dune,2000-12-03,2000,20000000,0,-20000000,14.612842
877,Scarface,1932-04-09,1932,0,600000,600000,4.854436
878,The Punch Bowl,1944-01-28,1944,0,0,0,2.098595
879,Hook,1991-12-11,1991,70000000,300854823,230854823,14.508137
880,Antonia's Line,1995-09-12,1995,900000,0,-900000,2.030174
881,A Few Good Men,1992-12-11,1992,40000000,243240178,203240178,12.330249
883,Coffee and Cigarettes,2003-09-05,2003,0,7897645,7897645,5.32553
884,Crash,1996-07-17,1996,10000000,0,-10000000,7.540612
885,The Docks of New York,1928-09-16,1928,0,0,0,0.67543
886,The Cincinnati Kid,1965-10-15,1965,0,15260000,15260000,3.670599
887,The Best Years of Our Lives,1946-12-25,1946,2100000,23650000,21550000,6.069343
888,The Flintstones,1994-05-26,1994,46000000,341631208,295631208,15.019586
889,The Flintstones in Viva Rock Vegas,2000-04-28,2000,83000000,59468275,-23531725,6.053595
890,Brother of Sleep,1995-09-08,1995,0,0,0,0.751733
891,All the President's Men,1976-04-04,1976,8500000,70600000,62100000,12.421754
892,Delicatessen,1991-04-17,1991,4000000,1794187,-2205813,12.565447
895,Andrei Rublev,1966-12-16,1966,0,0,0,6.489852
896,The World of Apu,1959-05-01,1959,0,16000,16000,2.381806
897,Aparajito,1956-10-11,1956,0,170215,170215,2.80051
898,Birdman of Alcatraz,1962-07-03,1962,2650000,3100000,450000,4.471515
899,Broken Blossoms,1919-05-13,1919,0,0,0,3.185824
900,Bringing Up Baby,1938-02-18,1938,1073000,0,-1073000,6.60577
901,City Lights,1931-01-30,1931,1500000,19181,-1480819,10.891524
902,The City of Lost Children,1995-05-16,1995,18000000,1738611,-16261389,9.822423
903,Cool Hand Luke,1967-06-22,1967,3000000,16217773,13217773,9.718713
905,Pandora's Box,1929-01-30,1929,0,0,0,2.617488
907,Doctor Zhivago,1965-12-22,1965,11000000,111858363,100858363,8.489499
909,Meet Me in St. Louis,1944-11-23,1944,0,0,0,7.331511
910,The Big Sleep,1946-08-23,1946,0,0,0,6.987617
911,The Bank Dick,1940-11-29,1940,0,0,0,1.423358
912,The Thomas Crown Affair,1968-06-19,1968,4300000,0,-4300000,9.444818
913,The Thomas Crown Affair,1999-08-06,1999,48000000,124305181,76305181,10.961226
914,The Great Dictator,1940-10-15,1940,2000000,11000000,9000000,9.241748
916,Bullitt,1968-10-17,1968,5500000,42300873,36800873,7.01973
917,Mother India,1957-02-13,1957,0,0,0,0.97758
918,Blind Date,1987-03-27,1987,18000000,39321715,21321715,6.696292
919,Blood: The Last Vampire,2000-11-18,2000,0,0,0,2.925291
920,Cars,2006-06-08,2006,120000000,461983149,341983149,18.907948
921,Cinderella Man,2005-06-02,2005,88000000,108539911,20539911,6.363884
922,Dead Man,1995-12-23,1995,9000000,0,-9000000,6.505272
923,Dawn of the Dead,1978-09-02,1978,650000,55000000,54350000,19.24201
924,Dawn of the Dead,2004-03-19,2004,28000000,102356381,74356381,13.157873
925,Do the Right Thing,1989-06-30,1989,6500000,37295445,30795445,10.465403
926,Galaxy Quest,1999-12-23,1999,45000000,90683916,45683916,15.831374
927,Gremlins,1984-06-07,1984,11000000,153083102,142083102,11.333125
928,Gremlins 2: The New Batch,1990-06-15,1990,50000000,41482207,-8517793,14.383185
929,Godzilla,1998-05-20,1998,130000000,379014294,249014294,11.295121
931,Don't Look Now,1973-12-03,1973,1500000,0,-1500000,5.966221
932,The Murderers Are Among Us,1946-10-14,1946,0,0,0,0.8605
934,Rififi,1955-04-13,1955,0,460226,460226,4.071187
935,Dr. Strangelove or: How I Learned to Stop Worrying and Love the Bomb,1964-01-29,1964,1800000,9440272,7640272,9.80398
936,The Pink Panther,1963-12-19,1963,0,10878107,10878107,7.851263
938,For a Few Dollars More,1965-12-18,1965,600000,15000000,14400000,13.295342
939,The Jazz Singer,1927-10-06,1927,0,0,0,2.428332
940,The Lady Vanishes,1938-07-26,1938,0,0,0,6.078088
941,Lethal Weapon,1987-03-06,1987,15000000,120207127,105207127,13.183804
942,Lethal Weapon 2,1989-07-07,1989,25000000,227853986,202853986,12.834276
943,Lethal Weapon 3,1992-05-15,1992,35000000,321731527,286731527,10.786007
944,Lethal Weapon 4,1998-07-10,1998,140000000,285444603,145444603,14.470551
946,Letter from an Unknown Woman,1948-04-28,1948,0,0,0,2.955531
947,Lawrence of Arabia,1962-12-10,1962,15000000,69995385,54995385,10.893332
948,Halloween,1978-10-25,1978,300000,70000000,69700000,13.672759
949,Heat,1995-12-15,1995,60000000,187436818,127436818,17.924927
950,Ice Age: The Meltdown,2006-03-23,2006,80000000,660940780,580940780,16.646029
951,Kindergarten Cop,1990-12-21,1990,15000000,201957688,186957688,3.67003
953,Madagascar,2005-05-25,2005,75000000,532680671,457680671,16.136217
954,Mission: Impossible,1996-05-22,1996,80000000,457696359,377696359,15.793477
955,Mission: Impossible II,2000-05-24,2000,125000000,546388105,421388105,18.97178
956,Mission: Impossible III,2006-05-03,2006,150000000,397850012,247850012,15.687983
957,Spaceballs,1987-06-24,1987,22700000,38119483,15419483,9.10373
961,The General,1926-12-31,1926,750000,0,-750000,8.002953
962,The Gold Rush,1925-06-25,1925,923000,2500000,1577000,6.202041
963,The Maltese Falcon,1941-11-18,1941,375000,1000000,625000,5.782544
964,The Phantom of the Opera,1925-09-06,1925,0,0,0,11.083684
965,The Magnificent Ambersons,1942-07-10,1942,0,0,0,8.43511
966,The Magnificent Seven,1960-10-22,1960,2000000,4905000,2905000,10.650752
967,Spartacus,1960-10-06,1960,12000000,60000000,48000000,11.110376
968,Dog Day Afternoon,1975-08-11,1975,1800000,46665856,44865856,7.530126
975,Paths of Glory,1957-09-18,1957,935000,0,-935000,8.548518
976,Sweet Smell of Success,1957-06-27,1957,0,0,0,5.196222
977,Tabu,1931-03-18,1931,0,0,0,2.211623
978,Seven Years in Tibet,1997-09-12,1997,70000000,131457682,61457682,11.483493
979,Irreversible,2002-05-22,2002,0,792,792,16.76382
980,The Ox-Bow Incident,1943-03-11,1943,0,0,0,5.546182
981,The Philadelphia Story,1940-12-05,1940,0,0,0,8.888069
982,The Manchurian Candidate,1962-10-24,1962,80000000,96105910,16105910,7.991677
983,The Man Who Would Be King,1975-12-03,1975,0,0,0,6.189816
984,Dirty Harry,1971-12-21,1971,4000000,35976000,31976000,10.255315
985,Eraserhead,1977-03-19,1977,10000,7000000,6990000,7.871001
986,Chimes at Midnight,1965-12-22,1965,800,0,-800,7.076799
987,The Front Page,1974-12-01,1974,4000000,0,-4000000,5.789565
988,The China Syndrome,1979-03-16,1979,5900000,51718367,45818367,4.621214
989,The Mortal Storm,1940-06-14,1940,0,0,0,1.680612
990,The Hustler,1961-09-25,1961,2000000,7600000,5600000,9.333533
991,The Man Who Fell to Earth,1976-03-18,1976,1500000,0,-1500000,6.451499
992,"Sherlock, Jr.",1924-04-21,1924,0,0,0,5.858328
993,Sleuth,1972-12-10,1972,0,0,0,10.387423
994,Straw Dogs,1971-12-29,1971,2200000,3251794,1051794,6.632663
995,Stagecoach,1939-03-02,1939,531374,1103757,572383,7.970462
996,Double Indemnity,1944-04-24,1944,927262,2500000,1572738,6.49432
1018,Mulholland Drive,2001-05-16,2001,15000000,20117339,5117339,18.184056
1023,Adam's Apples,2005-04-15,2005,3700000,0,-3700000,6.044534
1024,Heavenly Creatures,1994-09-02,1994,5000000,3049135,-1950865,9.438042
1039,The Inheritors,1998-06-19,1998,0,0,0,0.639285
1040,The Leopard,1963-03-28,1963,0,0,0,4.540383
1049,Sommersby,1993-02-05,1993,0,140081992,140081992,4.359884
1050,Shower,1999-09-13,1999,0,0,0,4.359334
1051,The French Connection,1971-10-09,1971,1800000,41158757,39358757,6.694959
1052,Blow-Up,1966-12-18,1966,0,0,0,10.59036
1058,Breathless,1983-05-13,1983,0,19910002,19910002,7.587797
1059,The Hidden Fortress,1958-12-28,1958,0,0,0,5.624255
1073,Arlington Road,1999-03-19,1999,21500000,0,-21500000,8.605659
1075,"Black Cat, White Cat",1998-06-01,1998,0,0,0,6.261475
1088,Whale Rider,2003-01-30,2003,8000000,41400000,33400000,11.040186
1089,Point Break,1991-07-12,1991,24000000,83531958,59531958,11.453093
1090,The Thirteenth Floor,1999-04-16,1999,16000000,18564088,2564088,9.356587
1091,The Thing,1982-06-25,1982,15000000,19629760,4629760,16.83125
1092,The Third Man,1949-08-31,1949,0,596349,596349,8.513889
1093,Elevator to the Gallows,1958-01-29,1958,0,263404,263404,5.184701
1103,Escape from New York,1981-05-22,1981,6000000,50244700,44244700,10.124544
1114,The Weeping Camel,2003-06-29,2003,0,0,0,2.799536
1115,Ghosts,2005-09-15,2005,0,0,0,0.744845
1116,The Wind That Shakes the Barley,2006-06-23,2006,6500000,22889018,16389018,6.752524
1123,Catch a Fire,2006-10-27,2006,0,4291965,4291965,3.451518
1124,The Prestige,2006-10-19,2006,40000000,109676311,69676311,16.94556
1125,Dreamgirls,2006-12-25,2006,70000000,154937680,84937680,7.739633
1126,In My Father's Den,2004-06-11,2004,0,0,0,6.323198
1127,Princesses,2005-09-02,2005,0,0,0,2.923859
1162,The Miracle Worker,1962-05-22,1962,500000,2500000,2000000,4.368765
1163,The Miracle Worker,2000-11-12,2000,0,0,0,2.188867
1164,Babel,2006-09-08,2006,25000000,135330182,110330182,12.60853
1165,The Queen,2006-09-15,2006,15000000,123384128,108384128,7.904371
1213,The Talented Mr. Ripley,1999-12-25,1999,40000000,128798265,88798265,11.65502
1244,Eight Miles High,2007-02-01,2007,0,0,0,0.851733
1245,The Remains of the Day,1993-11-05,1993,11500000,23237911,11737911,12.222576
1246,Rocky Balboa,2006-12-20,2006,24000000,155721132,131721132,11.697604
1247,The Good Shepherd,2006-12-11,2006,85000000,59908565,-25091435,11.057536
1248,Hannibal Rising,2007-02-06,2007,50000000,82169884,32169884,2.159558
1249,Hollywoodland,2006-08-31,2006,0,16803753,16803753,7.464981
1250,Ghost Rider,2007-02-16,2007,110000000,228738393,118738393,11.902354
1251,Letters from Iwo Jima,2006-12-19,2006,19000000,68673228,49673228,11.649588
1252,Lonely Hearts,2006-04-30,2006,0,0,0,5.694413
1253,Breaking and Entering,2006-12-15,2006,0,8974829,8974829,4.217411
1254,"Don't Worry, I'm Fine",2006-09-06,2006,0,0,0,6.189495
1255,The Host,2006-07-27,2006,11000000,88489643,77489643,9.386916
1257,Because I Said So,2007-02-02,2007,0,69485490,69485490,14.764607
1259,Notes on a Scandal,2006-12-25,2006,15000000,49469904,34469904,8.593087
1260,Lotte from Gadgetville,2006-08-25,2006,0,0,0,0.270086
1262,Stranger Than Fiction,2006-09-09,2006,30000000,53653224,23653224,10.798092
1265,Bridge to Terabithia,2007-02-16,2007,60000000,137587063,77587063,8.460206
1266,Street Kings,2008-04-10,2008,20000000,65569869,45569869,13.246795
1267,Meet the Robinsons,2007-03-23,2007,150000000,169332978,19332978,10.529576
1268,Mr. Bean's Holiday,2007-03-22,2007,25000000,229736344,204736344,10.19853
1269,The Vexxer,2007-03-10,2007,0,0,0,2.889908
1271,300,2006-12-09,2006,65000000,422610419,357610419,18.108408
1272,Sunshine,2007-04-05,2007,50000000,32017803,-17982197,12.715571
1273,TMNT,2007-03-23,2007,34000000,95608995,61608995,11.358363
1277,Gloomy Sunday,1999-10-21,1999,0,585604,585604,0.737097
1278,The Dreamers,2003-09-01,2003,15000000,15121165,121165,6.685981
1279,Samaritan Girl,2004-02-10,2004,1000000,0,-1000000,2.596319
1280,3-Iron,2004-10-15,2004,0,0,0,12.949881
1281,Bean,1997-07-03,1997,18000000,251212670,233212670,12.799853
1282,Dogtown and Z-Boys,2001-01-18,2001,0,0,0,4.704091
1283,"Torrente, the Dumb Arm of the Law",1998-03-13,1998,0,0,0,3.809138
1284,Torrente 2: Mission in Marbella,2001-03-30,2001,0,0,0,5.854434
1285,Torrente 3 The Protector,2005-09-30,2005,0,0,0,4.522887
1294,Four Minutes,2006-06-23,2006,1400000,0,-1400000,7.505997
1358,A Brief History of Time,1991-10-01,1991,0,0,0,2.4312
1359,American Psycho,2000-04-13,2000,7000000,34266564,27266564,13.686715
1360,Frida,2002-08-29,2002,12000000,56298474,44298474,11.283472
1361,The Return of the King,1980-05-11,1980,0,0,0,1.800615
1362,The Hobbit,1977-11-27,1977,3000000,0,-3000000,16.425868
1363,The Hi-Lo Country,1998-12-30,1998,0,0,0,6.971268
1364,Sex and Lucia,2001-08-24,2001,0,2628241,2628241,8.164312
1365,Monster's Ball,2001-11-11,2001,4000000,44909486,40909486,6.341187
1366,Rocky,1976-11-21,1976,1000000,117235147,116235147,14.774066
1367,Rocky II,1979-06-15,1979,7000000,200182160,193182160,11.789813
1368,First Blood,1982-10-22,1982,15000000,125212904,110212904,14.778884
1369,Rambo: First Blood Part II,1985-05-21,1985,44000000,300400432,256400432,11.924462
1370,Rambo III,1988-05-24,1988,63000000,189015611,126015611,11.624866
1371,Rocky III,1982-05-28,1982,17000000,270000000,253000000,11.673366
1372,Blood Diamond,2006-12-07,2006,100000000,170877916,70877916,12.477872
1373,The Discovery of Heaven,2001-10-01,2001,0,0,0,1.009704
1374,Rocky IV,1985-11-21,1985,31000000,300473716,269473716,10.25721
1375,Rocky V,1990-10-18,1990,42000000,119946358,77946358,14.007329
1376,Sweet Sixteen,2002-05-21,2002,0,0,0,12.130265
1377,Houseboat,1958-11-19,1958,0,0,0,2.266744
1378,Shortbus,2006-05-20,2006,2000000,5179037,3179037,11.547748
1379,Lights in the Dusk,2006-02-03,2006,1380000,1615018,235018,2.329388
1380,Gleaming the Cube,1989-01-13,1989,0,2777280,2777280,1.511044
1381,The Fountain,2006-09-06,2006,35000000,15304890,-19695110,11.577121
1382,Me and You and Everyone We Know,2005-06-17,2005,0,0,0,9.0744
1387,Superstar: The Karen Carpenter Story,1988-04-30,1988,0,0,0,0.640356
1389,Out of Sight,1998-06-26,1998,48000000,77745568,29745568,7.349812
1391,Y Tu Mam√° Tambi√©n,2001-06-08,2001,5000000,33616692,28616692,13.962548
1392,Born into Brothels,2004-12-08,2004,350000,3515061,3165061,2.96237
1393,The Cave of the Yellow Dog,2005-07-27,2005,0,0,0,1.903911
1394,Nostalgia,1983-05-01,1983,0,0,0,4.235709
1396,Mirror,1975-03-07,1975,0,0,0,10.11584
1398,Stalker,1979-04-16,1979,0,0,0,7.787515
1402,The Pursuit of Happyness,2006-12-14,2006,55000000,307077295,252077295,20.981716
1403,Duel at Diablo,1966-06-15,1966,0,0,0,4.299387
1404,Ae Fond Kiss...,2004-02-13,2004,0,0,0,6.32444
1405,Greed,1924-12-04,1924,546883,0,-546883,6.925081
1406,City Slickers,1991-06-07,1991,27000000,179033791,152033791,7.334686
1407,La Vie en Rose,2007-02-08,2007,0,0,0,11.710507
1408,Cutthroat Island,1995-12-22,1995,98000000,10017322,-87982678,7.284477
1410,Dark Star,1974-04-01,1974,60000,0,-60000,4.933923
1411,The Rapture,1991-10-04,1991,1227401,1277401,50000,8.319631
1412,"Sex, Lies, and Videotape",1989-08-18,1989,1200000,0,-1200000,12.293656
1413,M. Butterfly,1993-09-09,1993,0,1499795,1499795,6.516976
1414,Lovers of the Arctic Circle,1998-09-04,1998,0,0,0,2.995334
1415,Party Monster,2003-09-05,2003,5000000,742898,-4257102,3.007842
1416,The Coast Guard,2002-11-22,2002,0,0,0,1.915235
1417,Pan's Labyrinth,2006-05-27,2006,19000000,83258226,64258226,26.817754
1418,Take My Eyes,2003-10-08,2003,0,0,0,5.557675
1419,Vollidiot,2007-04-11,2007,0,0,0,1.99742
1420,Breakfast on Pluto,2005-09-03,2005,0,0,0,4.984987
1421,The Man Who Loved Women,1977-04-27,1977,0,0,0,7.623327
1422,The Departed,2006-10-05,2006,90000000,289847354,199847354,18.515448
1427,Perfume: The Story of a Murderer,2006-09-13,2006,50000000,132180323,82180323,10.297304
1428,Once Upon a Time in Mexico,2003-09-11,2003,29000000,98185582,69185582,8.843365
1429,25th Hour,2002-12-16,2002,15000000,13060843,-1939157,10.271871
1430,Bowling for Columbine,2002-10-09,2002,4000000,35564473,31564473,11.393859
1433,The Devil's Backbone,2001-04-20,2001,4500000,6459020,1959020,11.111299
1435,Tarnation,2003-10-19,2003,218,1162014,1161796,1.620207
1439,Anna and the King,1999-12-16,1999,75000000,0,-75000000,17.65016
1440,Little Children,2006-10-06,2006,26000000,14821658,-11178342,7.311148
1441,The Contract,2006-04-05,2006,25000000,5549200,-19450800,5.615957
1443,The Virgin Suicides,1999-04-21,1999,6000000,10409377,4409377,10.505387
1444,Junebug,2005-08-03,2005,0,0,0,4.473848
1448,The Wisdom of Crocodiles,1998-11-27,1998,0,0,0,4.998306
1450,Blood: The Last Vampire,2009-04-02,2009,0,0,0,7.524117
1452,Superman Returns,2006-06-28,2006,270000000,391081192,121081192,13.284712
1479,"Clean, Shaven",1993-09-05,1993,68000,0,-68000,3.143971
1480,Touch of Evil,1958-04-23,1958,829000,2247465,1418465,9.665347
1481,Metal Skin,1994-02-21,1994,0,0,0,0.418409
1482,Laws of Gravity,1992-03-21,1992,0,0,0,0.529245
1483,Begotten,1990-04-30,1990,33000,0,-33000,2.592052
1484,The Deathmaker,1995-11-23,1995,0,0,0,0.805363
1485,Get Carter,1971-03-03,1971,1814462,0,-1814462,7.505268
1487,Hellboy,2004-04-02,2004,66000000,99318987,33318987,13.206854
1488,Mongolian Ping Pong,2005-06-11,2005,0,0,0,0.221652
1491,The Illusionist,2006-08-18,2006,40000000,86915017,46915017,11.494009
1492,1492: Conquest of Paradise,1992-10-09,1992,47000000,7191399,-39808601,11.618792
1493,Miss Congeniality,2000-12-14,2000,45000000,212000000,167000000,9.510762
1494,Curse of the Golden Flower,2006-12-21,2006,110,0,-110,6.238036
1495,Kingdom of Heaven,2005-05-03,2005,130000000,211643158,81643158,16.296471
1496,Cool as Ice,1991-10-18,1991,6000000,1193062,-4806938,2.329486
1497,Teenage Mutant Ninja Turtles II: The Secret of the Ooze,1991-03-22,1991,25000000,78000000,53000000,7.994266
1498,Teenage Mutant Ninja Turtles,1990-03-30,1990,13500000,202000000,188500000,13.184585
1499,Teenage Mutant Ninja Turtles III,1993-03-17,1993,21000000,42000000,21000000,8.13688
1523,The Last King of Scotland,2006-09-01,2006,6000000,48027970,42027970,9.424157
1534,Pathfinder,2007-01-11,2007,45000000,30822861,-14177139,11.101549
1535,Spy Game,2001-11-18,2001,92000000,143049560,51049560,18.186839
1537,Changing Lanes,2002-04-07,2002,45000000,94935764,49935764,7.81862
1538,Collateral,2004-08-04,2004,65000000,217764291,152764291,13.455112
1539,Keine Lieder √ºber Liebe,2005-10-26,2005,0,0,0,0.897484
1540,Heading South,2005-09-07,2005,0,0,0,2.355532
1541,Thelma & Louise,1991-05-24,1991,16000000,45361000,29361000,14.785388
1542,Office Space,1999-02-19,1999,10000000,12827813,2827813,12.329066
1543,Emma's Bliss,2006-07-16,2006,0,3500000,3500000,1.37038
1544,Imagine Me & You,2005-02-01,2005,0,2455831,2455831,6.008971
1546,Thumbsucker,2005-01-23,2005,0,1919197,1919197,5.884228
1547,The Lost Boys,1987-07-31,1987,8500000,32222567,23722567,9.099731
1548,Ghost World,2001-07-20,2001,7000000,0,-7000000,5.460971
1549,Games of Love and Chance,2003-11-25,2003,0,0,0,1.942173
1550,Pieces of April,2003-01-19,2003,300000,0,-300000,4.19275
1551,Flatliners,1990-08-09,1990,26000000,61489265,35489265,11.890138
1552,Parenthood,1989-07-31,1989,0,126297830,126297830,8.09806
1553,The Beat That My Heart Skipped,2005-02-17,2005,0,0,0,6.80183
1554,Down by Law,1986-05-01,1986,0,0,0,8.843551
1555,The Spanish Apartment,2002-05-17,2002,5300000,3897799,-1402201,5.94395
1556,Funeral Parade of Roses,1969-01-01,1969,0,0,0,3.502077
1557,23,1998-07-02,1998,0,0,0,8.271531
1559,Sweet Movie,1974-06-12,1974,0,0,0,3.532272
1560,Singapore Sling,1990-09-13,1990,0,0,0,2.583187
1561,Mouchette,1967-03-28,1967,0,0,0,3.081852
1562,28 Weeks Later,2007-04-26,2007,15000000,64238440,49238440,12.884191
1563,Sunless,1983-02-15,1983,0,30878,30878,3.827583
1566,The Bridge,1959-10-21,1959,0,0,0,2.288764
1567,I Stand Alone,1998-05-16,1998,0,0,0,6.138782
1568,Carne,1991-05-01,1991,0,0,0,1.607398
1571,Live Free or Die Hard,2007-06-20,2007,110000000,383531464,273531464,14.886039
1572,Die Hard: With a Vengeance,1995-05-19,1995,90000000,366101666,276101666,15.138855
1573,Die Hard 2,1990-07-02,1990,70000000,240031094,170031094,18.785984
1574,Chicago,2002-12-26,2002,45000000,306776732,261776732,13.325347
1576,Resident Evil,2002-03-15,2002,33000000,102984862,69984862,7.781293
1577,Resident Evil: Apocalypse,2004-09-10,2004,45000000,129394835,84394835,7.850797
1578,Raging Bull,1980-11-14,1980,18000000,23000000,5000000,8.868558
1579,Apocalypto,2006-12-07,2006,40000000,120175290,80175290,7.735233
1580,Rope,1948-08-23,1948,1500000,2200000,700000,7.248676
1581,The Holiday,2006-12-08,2006,85000000,194168700,109168700,14.043416
1583,Lammbock,2001-08-23,2001,0,0,0,9.634205
1584,School of Rock,2003-10-03,2003,35000000,131282949,96282949,17.95142
1585,It's a Wonderful Life,1946-12-20,1946,3180000,9644124,6464124,15.031588
1586,Secret Window,2004-03-12,2004,40000000,92913171,52913171,9.524283
1587,What's Eating Gilbert Grape,1993-12-17,1993,11000000,10032765,-967235,10.3919
1588,Bring It On,2000-08-25,2000,28000000,90449929,62449929,6.402888
1589,The Boys from County Clare,2003-09-12,2003,0,0,0,0.227122
1590,Copying Beethoven,2006-09-10,2006,11000000,0,-11000000,2.331416
1591,Nowhere in Africa,2001-12-11,2001,0,0,0,3.02027
1592,Primal Fear,1996-04-03,1996,30000000,102616183,72616183,10.326213
1593,Night at the Museum,2006-10-20,2006,110000000,574480841,464480841,16.661966
1594,A Shot in the Dark,1964-06-23,1964,0,12368234,12368234,6.872888
1595,Land of Plenty,2004-09-10,2004,0,0,0,1.824186
1596,Population 436,2006-07-04,2006,0,0,0,3.313662
1597,Meet the Parents,2000-10-06,2000,55000000,330444045,275444045,14.178281
1598,Cape Fear,1991-11-15,1991,35000000,182300000,147300000,10.302735
1599,I Heart Huckabees,2004-09-10,2004,22000000,0,-22000000,11.953055
1600,The Double Life of Veronique,1991-05-15,1991,0,1999955,1999955,9.661817
1607,A Bronx Tale,1993-09-14,1993,22000000,17287898,-4712102,6.115628
1608,When Saturday Comes,1996-03-01,1996,0,0,0,7.26141
1609,There's Only One Jimmy Grimble,2000-08-25,2000,0,0,0,3.858646
1610,Fever Pitch,1997-04-04,1997,0,0,0,6.906939
1611,The Miracle of Bern,2003-10-15,2003,0,0,0,12.485973
1613,The 51st State,2001-12-07,2001,28,14,-14,6.368323
1615,Erkan & Stefan 2,2002-06-20,2002,0,4508104,4508104,0.889831
1616,Erkan & Stefan 3,2005-05-19,2005,0,0,0,0.933011
1618,Still Crazy,1998-10-30,1998,0,0,0,11.089962
1619,The Way of the Gun,2000-09-08,2000,8500000,19125401,10625401,6.03633
1620,Hitman,2007-11-21,2007,24000000,99965753,75965753,13.765241
1621,Trading Places,1983-06-07,1983,40600000,90400000,49800000,14.285052
1622,Lemming,2005-05-11,2005,0,793604,793604,2.753316
1623,Brubaker,1980-06-20,1980,0,37121708,37121708,14.503963
1624,Liar Liar,1997-03-21,1997,45000000,302710615,257710615,10.102471
1626,Vivre Sa Vie,1962-09-20,1962,64000,24517,-39483,11.30591
1627,The Wild Child,1970-02-26,1970,0,0,0,3.473672
1628,Jules and Jim,1962-01-23,1962,0,0,0,5.979791
1629,La Chinoise,1967-08-30,1967,0,30857,30857,2.499754
1630,The People vs. Larry Flynt,1996-10-12,1996,36000000,20300385,-15699615,9.178371
1631,A Real Young Girl,1976-01-01,1976,0,0,0,16.295091
1632,Mississippi Burning,1988-12-08,1988,15000000,34604000,19604000,13.971865
1633,Fried Green Tomatoes,1991-12-27,1991,11000000,119418501,108418501,6.584254
1634,Free Willy,1993-07-16,1993,20000000,153698625,133698625,5.990572
1635,The Island,2005-07-20,2005,126000000,162949164,36949164,11.443647
1636,Bedazzled,2000-10-19,2000,48000000,90383208,42383208,8.781588
1637,Speed,1994-06-09,1994,30000000,350448145,320448145,10.859292
1639,Speed 2: Cruise Control,1997-06-13,1997,160000000,164508066,4508066,11.268531
1640,Crash,2004-01-13,2004,6500000,98410061,91910061,9.785147
1641,Forces of Nature,1999-03-12,1999,75000000,93888180,18888180,7.906035
1642,The Net,1995-07-28,1995,22000000,110627965,88627965,13.304342
1643,Last Tango in Paris,1972-10-14,1972,1250000,36144000,34894000,12.74564
1644,The Vanishing,1993-02-05,1993,0,0,0,7.492302
1645,A Time to Kill,1996-07-24,1996,40000000,152266007,112266007,13.309013
1646,Freedom Writers,2007-01-05,2007,21000000,41170784,20170784,13.585233
1647,The Recruit,2003-01-31,2003,0,101191884,101191884,11.485473
1648,Bill & Ted's Excellent Adventure,1989-02-17,1989,10000000,40485039,30485039,15.109261
1649,Bill & Ted's Bogus Journey,1991-07-19,1991,0,0,0,7.256293
1651,Mississippi Mermaid,1969-06-18,1969,0,0,0,2.478512
1652,00 Schneider - Jagd auf Nihil Baxter,1994-12-21,1994,0,0,0,1.931299
1653,The Motorcycle Diaries,2004-02-06,2004,0,16756372,16756372,7.667491
1654,The Dirty Dozen,1967-06-15,1967,5400000,45300000,39900000,15.640007
1655,Praxis Dr. Hasenbein,1997-01-30,1997,0,0,0,0.423345
1656,The Legend of Zorro,2005-10-24,2005,75000000,142400065,67400065,8.940007
1659,Texas - Doc Snyder h√§lt die Welt in Atem,1993-01-01,1993,0,0,0,0.676005
1660,Small Change,1976-03-17,1976,0,0,0,1.830794
1661,Gigantics,1999-09-30,1999,0,0,0,1.874545
1662,State of Grace,1990-09-14,1990,0,0,0,9.411171
1665,Last Days,2005-05-13,2005,0,1928985,1928985,4.790012
1666,The Bridge,2006-10-27,2006,0,0,0,3.800868
1667,March of the Penguins,2005-01-26,2005,8000000,127392239,119392239,9.435123
1669,The Hunt for Red October,1990-03-02,1990,30000000,199200000,169200000,15.91126
1672,The Professional,1981-10-21,1981,0,0,0,10.093285
1673,Comanche Station,1960-03-01,1960,0,0,0,3.65779
1675,Day for Night,1973-05-24,1973,0,17808,17808,10.101183
1676,Will Penny,1967-12-19,1967,0,0,0,4.010324
1677,Ray,2004-10-29,2004,40000000,124731534,84731534,10.603762
1678,Godzilla,1954-11-03,1954,1000000,0,-1000000,13.153272
1679,Godzilla Raids Again,1955-04-24,1955,0,0,0,2.772214
1680,King Kong vs. Godzilla,1962-08-11,1962,0,0,0,2.894775
1682,Mothra vs. Godzilla,1964-04-29,1964,0,0,0,2.967672
1683,The Reaping,2007-04-05,2007,40000000,62771059,22771059,9.825841
1685,Beneath the Planet of the Apes,1970-05-01,1970,3000000,18999718,15999718,12.325947
1686,Chelsea Girls,1966-09-15,1966,3000,0,-3000,0.505098
1687,Escape from the Planet of the Apes,1971-05-20,1971,2500000,12348905,9848905,12.120267
1688,Conquest of the Planet of the Apes,1972-06-29,1972,1700000,9700000,8000000,12.843375
1689,Little Buddha,1993-12-01,1993,35000000,4858139,-30141861,5.681522
1690,Hostel,2005-01-06,2005,4800000,80578934,75778934,12.093928
1691,Hostel: Part II,2007-06-08,2007,10200000,35619521,25419521,8.916747
1694,Re-Animator,1985-10-18,1985,900000,2023414,1123414,9.867238
1696,The Devil's Rejects,2005-07-22,2005,0,0,0,12.221507
1697,Grave Decisions,2006-08-17,2006,0,0,0,2.199488
1698,Anatomy,2000-02-03,2000,0,0,0,5.566781
1700,Misery,1990-11-28,1990,20000000,61276872,41276872,15.020845
1701,Con Air,1997-06-01,1997,75000000,224012234,149012234,11.545982
1702,Death Machine,1994-12-23,1994,0,1422749,1422749,9.217153
1705,Battle for the Planet of the Apes,1973-06-15,1973,1700000,8844595,7144595,11.644764
1710,Copycat,1995-10-27,1995,0,0,0,10.701801
1712,Giant,1956-10-10,1956,5400000,35000000,29600000,10.864284
1713,Jungle Fever,1991-06-07,1991,14000000,32482682,18482682,7.701918
1714,Fahrenheit 451,1966-09-14,1966,0,0,0,7.630417
1715,The Cider House Rules,1999-12-17,1999,24000000,88545092,64545092,9.526781
1716,The Last Metro,1980-09-17,1980,0,0,0,4.50377
1717,All the King's Men,2006-09-10,2006,55000000,9450897,-45549103,7.991168
1718,Santa Fe Trail,1940-12-13,1940,0,0,0,1.548028
1719,The Soft Skin,1964-05-05,1964,0,0,0,2.137534
1720,Noi the Albino,2003-02-28,2003,0,0,0,1.709303
1721,All the Way Boys,1972-12-22,1972,0,0,0,6.100067
1722,Captain Corelli's Mandolin,2001-08-17,2001,57000000,62112895,5112895,9.243715
1723,The Front,1976-09-17,1976,0,0,0,2.81672
1724,The Incredible Hulk,2008-06-12,2008,150000000,163712074,13712074,19.125537
1725,West Side Story,1961-10-18,1961,6000000,43656822,37656822,8.389903
1726,Iron Man,2008-04-30,2008,140000000,585174222,445174222,22.073099
1727,Bird on a Wire,1990-05-18,1990,20000000,0,-20000000,8.300805
1729,The Forbidden Kingdom,2008-04-18,2008,55000000,127906624,72906624,6.997601
1730,INLAND EMPIRE,2006-09-06,2006,0,849055,849055,6.610774
1731,Helen,2009-01-06,2009,0,0,0,1.97924
1732,The Prisoner of Zenda,1979-08-17,1979,0,0,0,1.090071
1734,The Mummy Returns,2001-04-28,2001,98000000,433013274,335013274,16.945657
1735,The Mummy: Tomb of the Dragon Emperor,2008-07-01,2008,145000000,401128639,256128639,14.250227
1736,Shoppen,2007-05-02,2007,0,0,0,1.116079
1738,Next,2007-04-24,2007,70000000,76066841,6066841,9.41746
1770,Michael Collins,1996-10-25,1996,28000000,16900000,-11100000,6.728199
1771,Captain America: The First Avenger,2011-07-22,2011,140000000,370569774,230569774,19.323582
1772,City of Hope,1991-10-11,1991,0,0,0,1.274819
1773,American Madness,1932-08-04,1932,0,0,0,0.649011
1774,The Big One,1997-09-06,1997,0,720074,720074,2.238505
1775,Canadian Bacon,1995-06-08,1995,11000000,178104,-10821896,5.391556
1776,Jesus Camp,2006-09-15,2006,0,0,0,4.886956
1777,Fahrenheit 9/11,2004-06-25,2004,6000000,119114517,113114517,6.83946
1778,The Backyard,2002-03-08,2002,0,0,0,0.132979
1779,Roger & Me,1989-09-01,1989,160000,6706368,6546368,4.877009
1781,An Inconvenient Truth,2006-01-24,2006,1000000,46243000,45243000,6.684925
1782,Afterwards,2008-10-01,2008,15400000,0,-15400000,4.820191
1783,To End All Wars,2001-09-02,2001,0,0,0,3.847676
1785,May Fools,1990-01-24,1990,0,0,0,2.321564
1786,Au Revoir les Enfants,1987-10-06,1987,0,0,0,8.052387
1787,Les Biches,1968-03-22,1968,0,0,0,1.454386
1788,Footloose,1984-02-17,1984,8200000,80035402,71835402,10.403992
1789,The Gazebo,1959-12-16,1959,0,0,0,1.527735
1790,Heaven with a Gun,1969-05-20,1969,0,0,0,0.418499
1791,The Piano Teacher,2001-05-14,2001,3000000,9801375,6801375,6.363081
1792,Stuck on You,2003-12-10,2003,55000000,33828318,-21171682,6.96675
1793,Max Dugan Returns,1983-03-25,1983,0,0,0,1.737488
1802,La C√©r√©monie,1995-08-30,1995,0,0,0,3.095894
1803,Angel,1984-04-19,1984,3000000,0,-3000000,5.246475
1807,Elephant,2003-05-18,2003,3000000,10012022,7012022,6.447312
1808,Velvet Goldmine,1998-10-23,1998,0,1053788,1053788,16.5293
1809,The Rules of Attraction,2002-10-11,2002,4000000,0,-4000000,6.781935
1810,Viva Zapata!,1952-02-07,1952,0,0,0,5.983838
1811,Nowhere,1997-05-09,1997,0,27354,27354,3.324489
1812,Trick,1999-07-23,1999,450000,2049595,1599595,2.493289
1813,The Devil's Advocate,1997-10-17,1997,57000000,152944660,95944660,10.920124
1815,The Big Sleep,1978-03-13,1978,0,0,0,1.713244
1816,A Chorus Line,1985-12-10,1985,0,14202899,14202899,3.998475
1817,Phone Booth,2002-09-09,2002,13000000,97837138,84837138,9.142772
1818,Shoot the Piano Player,1960-10-21,1960,0,0,0,8.277811
1819,"You, Me and Dupree",2006-07-14,2006,54000000,130431368,76431368,8.570085
1824,50 First Dates,2004-02-13,2004,75000000,196482882,121482882,11.134888
1825,Over the Top,1987-02-13,1987,25000000,16057580,-8942420,8.431956
1826,Russian Dolls,2005-06-15,2005,13000000,23727301,10727301,6.361343
1829,The Story of Adele H,1975-10-08,1975,0,0,0,3.542253
1830,Lord of War,2005-09-16,2005,42000000,24127895,-17872105,8.745216
1831,The Next Best Thing,2000-03-03,2000,25000000,24362772,-637228,2.971999
1832,Dogma,1999-11-12,1999,10000000,30652890,20652890,8.559088
1833,Rent,2005-11-23,2005,40000000,31670620,-8329380,9.530278
1834,"Murder, My Sweet",1944-12-09,1944,0,0,0,3.433265
1835,"Farewell, My Lovely",1975-08-08,1975,2500000,2000000,-500000,3.875842
1836,In My Skin,2002-12-04,2002,0,0,0,2.686234
1837,The Secret,2000-06-21,2000,0,0,0,1.036431
1838,We Shall Overcome,2006-03-24,2006,0,0,0,1.989615
1840,The Brasher Doubloon,1947-02-06,1947,0,0,0,0.632072
1841,Lady in the Lake,1947-01-23,1947,0,0,0,4.558579
1842,The Legend of Boggy Creek,1972-08-01,1972,100000,22000000,21900000,1.522753
1843,Dig!,2004-05-14,2004,0,127067,127067,1.527551
1844,Entrapment,1999-04-29,1999,66000000,212404396,146404396,10.62333
1845,2 Days in Paris,2007-02-09,2007,0,19776159,19776159,6.653254
1846,Marlowe,1969-09-19,1969,0,0,0,1.900216
1847,The Long Goodbye,1973-03-07,1973,0,0,0,7.204017
1848,Poodle Springs,1998-07-25,1998,0,0,0,1.833439
1849,Nine Hours to Rama,1963-04-30,1963,0,0,0,0.56799
1850,Man on the Moon,1999-12-22,1999,82000000,47434430,-34565570,13.217419
1852,World Trade Center,2006-08-09,2006,63000000,162945894,99945894,13.332102
1853,In the Realms of the Unreal,2004-01-01,2004,0,0,0,1.33424
1857,The Transformers: The Movie,1986-08-08,1986,6000000,5849647,-150353,6.759181
1858,Transformers,2007-06-27,2007,150000000,709709780,559709780,5.587707
1859,Ninotchka,1939-10-06,1939,1365000,2279000,914000,5.120036
1863,Sunflower,1970-03-14,1970,0,0,0,2.499612
1865,Pirates of the Caribbean: On Stranger Tides,2011-05-14,2011,380000000,1045713802,665713802,27.88772
1870,Fantomas Unleashed,1965-12-07,1965,0,0,0,6.212713
1871,Fantomas,1964-11-04,1964,0,0,0,5.870813
1872,Rise: Blood Hunter,2007-04-28,2007,0,0,0,4.482739
1873,Beyond Rangoon,1995-05-24,1995,0,0,0,2.04189
1874,Goodbye Bafana,2007-02-11,2007,30000000,0,-30000000,10.480169
1875,Fantomas vs. Scotland Yard,1967-03-16,1967,0,0,0,5.45311
1877,Doctor Mordrid,1992-11-02,1992,2000000,0,-2000000,2.428165
1878,Fear and Loathing in Las Vegas,1998-05-22,1998,18500000,10680275,-7819725,9.220346
1879,Guess Who's Coming to Dinner,1967-12-11,1967,4000000,56666667,52666667,5.032469
1880,Red Dawn,1984-08-10,1984,4200000,38376497,34176497,8.233168
1882,The Men,1950-07-20,1950,0,0,0,5.670881
1883,Malcolm X,1992-11-18,1992,34000000,48169908,14169908,14.207001
1884,The Ewok Adventure,1985-02-13,1985,3000000,0,-3000000,5.056089
1885,The Karate Kid,1984-06-22,1984,8000000,90815558,82815558,7.64499
1887,Marie Antoinette,2006-05-24,2006,40000000,60474340,20474340,8.852557
1888,The Fortune Cookie,1966-10-19,1966,0,0,0,3.626104
1890,Children of a Lesser God,1986-09-13,1986,0,31853080,31853080,8.503064
1891,The Empire Strikes Back,1980-05-17,1980,18000000,538400000,520400000,19.470959
1892,Return of the Jedi,1983-05-23,1983,32350000,572700000,540350000,14.586087
1893,Star Wars: Episode I - The Phantom Menace,1999-05-19,1999,115000000,924317558,809317558,15.649091
1894,Star Wars: Episode II - Attack of the Clones,2002-05-15,2002,120000000,649398328,529398328,14.072511
1895,Star Wars: Episode III - Revenge of the Sith,2005-05-17,2005,113000000,850000000,737000000,13.165421
1896,Salvador (Puig Antich),2006-05-23,2006,0,0,0,1.774804
1899,The Chinese Botanist's Daughters,2006-04-26,2006,3910000,0,-3910000,1.712251
1900,Traffic,2000-12-27,2000,48000000,207515725,159515725,8.338222
1901,In Good Company,2004-12-29,2004,0,0,0,7.684185
1902,Open Your Eyes,1997-12-19,1997,2900000,368234,-2531766,8.842959
1903,Vanilla Sky,2001-12-10,2001,68000000,203388341,135388341,10.071057
1904,Memoirs of a Geisha,2005-12-06,2005,85000000,162242962,77242962,7.680762
1906,Solo Sunny,1980-01-18,1980,0,0,0,0.887228
1907,The Beach,2000-02-11,2000,40000000,144056873,104056873,14.430311
1908,Inherit the Wind,1960-06-24,1960,0,0,0,6.302173
1909,Don Juan DeMarco,1994-10-01,1994,25000000,22200000,-2800000,7.438934
1911,The 13th Warrior,1999-08-27,1999,160000000,61698899,-98301101,10.308026
1912,Reclaim Your Brain,2007-09-11,2007,2500000,0,-2500000,2.529219
1913,The Sea Inside,2004-09-03,2004,12806000,38535221,25729221,14.69768
1914,FC Venus,2006-04-26,2006,0,0,0,1.564913
1915,"Manta, Manta",1991-10-02,1991,0,0,0,3.734177
1917,Who Killed Bambi?,2003-12-24,2003,0,0,0,0.682994
1918,Or (My Treasure),2004-09-09,2004,0,0,0,0.787469
1919,Away from Her,2006-09-11,2006,0,0,0,6.157162
1920,Crime of Passion,1957-01-09,1957,0,0,0,7.227515
1921,Sweet November,2001-02-16,2001,40000000,65754228,25754228,14.840318
1922,Irina Palm,2007-02-13,2007,0,0,0,2.350677
1923,Twin Peaks: Fire Walk with Me,1992-06-03,1992,10000000,4160851,-5839149,8.736538
1924,Superman,1978-12-13,1978,55000000,300218018,245218018,15.460102
1926,11'09''01 - September 11,2002-09-04,2002,0,0,0,3.103918
1927,Hulk,2003-06-19,2003,137000000,245360480,108360480,15.422638
1930,The Amazing Spider-Man,2012-06-27,2012,215000000,752215857,537215857,31.102267
1931,Stomp the Yard,2007-05-16,2007,13000000,75511123,62511123,5.607508
1933,The Others,2001-08-02,2001,0,0,0,11.046007
1934,Shakespeare in Love,1998-12-11,1998,25000000,289317794,264317794,13.813155
1936,River of No Return,1954-04-30,1954,0,0,0,5.321632
1937,Bonjour Tristesse,1958-03-17,1958,0,0,0,2.743088
1938,Angel Face,1952-12-10,1952,0,0,0,10.156514
1939,Laura,1944-10-11,1944,1020000,2000000,980000,9.884516
1940,Porgy and Bess,1959-06-24,1959,7000000,0,-7000000,1.678935
1941,Exodus,1960-03-27,1960,4000000,21750000,17750000,7.819581
1942,Bunny Lake Is Missing,1965-10-03,1965,0,0,0,11.74416
1944,The Door in the Floor,2004-07-18,2004,0,0,0,3.495966
1945,Nell,1994-12-23,1994,31000000,106683817,75683817,5.930957
1946,eXistenZ,1999-04-14,1999,15000000,2856712,-12143288,11.446138
1947,An Unfinished Life,2005-09-09,2005,30000000,18618284,-11381716,7.761954
1948,Crank,2006-08-31,2006,12000000,42931041,30931041,12.627593
1949,Zodiac,2007-03-02,2007,65000000,84785914,19785914,19.083823
1950,Lucky You,2007-05-01,2007,0,5761917,5761917,5.731132
1951,Manderlay,2005-05-16,2005,14200000,674918,-13525082,4.568999
1954,The Butterfly Effect,2004-01-22,2004,13000000,96060858,83060858,12.994939
1955,The Elephant Man,1980-10-02,1980,5000000,26010864,21010864,8.405672
1956,Gerry,2002-01-12,2002,3500000,0,-3500000,3.337747
1957,Enough,2002-05-24,2002,38000000,51801187,13801187,6.681287
1958,8 Women,2002-01-08,2002,8000000,0,-8000000,5.717082
1959,Swept from the Sea,1998-01-23,1998,0,0,0,9.688237
1961,My Name Is Bruce,2007-10-01,2007,1500000,173066,-1326934,8.708789
1963,The Bow,2005-05-12,2005,10,0,-10,2.717261
1964,A Friend of Mine,2006-10-05,2006,0,0,0,1.813452
1965,A Perfect Murder,1998-06-05,1998,60000000,128038368,68038368,9.430812
1966,Alexander,2004-11-21,2004,155000000,167298192,12298192,13.498641
1967,Ask the Dust,2006-02-02,2006,0,0,0,4.049118
1968,Fools Rush In,1997-02-14,1997,0,29481428,29481428,6.285574
1969,Bandidas,2006-01-18,2006,35000000,10496317,-24503683,19.294832
1970,The Grudge,2004-10-22,2004,10000000,183474602,173474602,9.740827
1975,The Grudge 2,2006-10-13,2006,20000000,39143839,19143839,6.768804
1976,Jezebel,1938-03-19,1938,1250000,0,-1250000,11.277226
1977,The Grudge 3,2009-05-12,2009,5000000,38610009,33610009,10.510468
1978,Stage Fright,1950-02-23,1950,0,0,0,4.329397
1979,Fantastic 4: Rise of the Silver Surfer,2007-06-13,2007,130000000,289047763,159047763,12.924254
1984,1984,1956-03-06,1956,0,0,0,6.113449
1985,The Constant Gardener,2005-08-31,2005,25000000,82466670,57466670,11.556484
1986,Live and Become,2005-03-30,2005,0,0,0,2.749427
1987,Benny's Video,1993-04-14,1993,0,0,0,5.865702
1988,A Mighty Heart,2007-01-01,2007,16000000,18928871,2928871,16.770196
1989,My Blueberry Nights,2007-05-16,2007,10000000,21786738,11786738,11.119593
1990,Paranoid Park,2007-05-21,2007,0,486021,486021,6.198003
1991,Death Proof,2007-05-21,2007,25000000,25037897,37897,13.412137
1992,Planet Terror,2007-04-06,2007,0,0,0,10.370384
1993,Golden Door,2006-09-22,2006,0,0,0,1.717836
1994,The Most Dangerous Game,1932-09-16,1932,200000,0,-200000,3.295206
1995,Lara Croft: Tomb Raider,2001-06-11,2001,115000000,274703340,159703340,15.851722
1996,Lara Croft Tomb Raider: The Cradle of Life,2003-07-21,2003,95000000,156505388,61505388,13.076349
1997,Two Brothers,2004-04-07,2004,74500000,62172050,-12327950,5.300303
1998,Holy Lola,2004-10-16,2004,0,0,0,0.605332
1999,In the Bedroom,2001-11-23,2001,1700000,0,-1700000,9.698269
2000,Aguirre: The Wrath of God,1972-12-29,1972,92000,0,-92000,10.996826
2001,We Own the Night,2007-05-25,2007,21000000,54926886,33926886,7.572144
2002,The Last Mistress,2007-05-30,2007,6500000,0,-6500000,3.200289
2003,Anatomy of Hell,2004-01-28,2004,0,0,0,4.579395
2004,Kebab Connection,2004-04-21,2004,0,0,0,6.624603
2005,Sister Act,1992-05-28,1992,31000000,231605150,200605150,18.83065
2006,"Bell, Book and Candle",1958-12-25,1958,0,0,0,6.441891
2007,Lorenzo's Oil,1992-12-30,1992,0,7286388,7286388,9.968395
2008,The Promise,2005-12-15,2005,0,0,0,2.447818
2009,"4 Months, 3 Weeks and 2 Days",2007-08-24,2007,852510,1185783,333273,9.990406
2010,The Mourning Forest,2007-05-24,2007,0,0,0,1.594746
2011,Persepolis,2007-05-23,2007,7300000,0,-7300000,9.537501
2012,Silent Light,2007-10-02,2007,0,0,0,1.933187
2013,The Diving Bell and the Butterfly,2007-05-22,2007,14000000,19777647,5777647,11.090265
2014,The Edge of Heaven,2007-09-27,2007,3800000,17804565,14004565,10.083019
2015,Secret Sunshine,2007-05-23,2007,0,0,0,2.899364
2016,Days of Glory,2006-05-25,2006,14500000,22963701,8463701,10.021547
2017,No Good Deed,2002-06-28,2002,12000000,0,-12000000,4.165629
2018,The Wedding Planner,2001-01-26,2001,35000000,94728529,59728529,8.056016
2019,Hard Target,1993-08-20,1993,18000000,74189677,56189677,7.834351
2020,The Bachelor,1999-11-05,1999,51000000,36911617,-14088383,5.061725
2021,Jack & Sarah,1995-06-02,1995,0,218626,218626,1.523446
2022,Mr. Deeds,2002-06-28,2002,50000000,171269535,121269535,6.674356
2023,Hidalgo,2004-03-05,2004,100000000,108103450,8103450,8.140709
2024,The Patriot,2000-06-28,2000,110000000,215294342,105294342,15.960788
2026,Hostage,2005-03-10,2005,52000000,77944725,25944725,9.686638
2028,Say Anything...,1989-04-14,1989,0,20036737,20036737,6.953646
2029,Tanguy,2001-11-21,2001,0,0,0,3.36053
2033,Infinity,1996-10-04,1996,0,0,0,1.226688
2034,Training Day,2001-10-05,2001,45000000,104876233,59876233,13.664622
2038,Iron Eagle III,1992-01-09,1992,0,0,0,8.48487
2039,Moonstruck,1987-12-18,1987,0,80640528,80640528,12.877291
2042,Savior,1998-11-20,1998,10000000,0,-10000000,3.699017
2043,Along Came a Spider,2001-04-06,2001,60000000,105178561,45178561,13.214068
2044,The Lake House,2006-06-16,2006,40000000,114830111,74830111,12.589019
2045,Unforgettable,1996-02-23,1996,18000000,0,-18000000,2.464425
2046,The Gift,2000-12-22,2000,10000000,12008642,2008642,7.886926
2047,The Real McCoy,1993-09-10,1993,0,0,0,3.790875
2048,"I, Robot",2004-07-15,2004,120000000,347234916,227234916,14.43075
2049,How to Cook Your Life,2007-05-10,2007,0,0,0,0.091729
2054,Mr. Holland's Opus,1995-12-29,1995,0,106269971,106269971,7.137117
2055,Open Range,2003-08-29,2003,22000000,68296293,46296293,16.532577
2056,The Station Agent,2003-01-26,2003,500000,8679814,8179814,5.85469
2057,Original Sin,2001-08-03,2001,42000000,35402320,-6597680,9.970359
2058,Addicted to Love,1997-05-23,1997,0,34673095,34673095,8.085194
2059,National Treasure,2004-11-19,2004,100000000,347451894,247451894,18.932203
2061,Pusher,1996-08-30,1996,0,0,0,6.160414
2062,Ratatouille,2007-06-22,2007,150000000,623722818,473722818,20.50803
2064,While You Were Sleeping,1995-04-21,1995,17000000,182057016,165057016,15.783615
2067,Mission to Mars,2000-03-10,2000,90000000,60874615,-29125385,9.021107
2069,The Whole Nine Yards,2000-02-18,2000,41300000,106371651,65071651,12.061521
2071,Shattered,1991-10-11,1991,22000000,11511031,-10488969,6.851939
2072,Cyberjack,1995-09-19,1995,2000000,0,-2000000,0.152374
2074,Flirting with Disaster,1996-03-22,1996,7000000,14702438,7702438,5.579088
2075,Prizzi's Honor,1985-06-14,1985,0,26657534,26657534,7.506871
2077,The Rink,1916-12-04,1916,0,0,0,1.817301
2078,The Pawnshop,1916-10-02,1916,0,0,0,1.745805
2079,The Count,1916-09-04,1916,0,0,0,2.389584
2080,X-Men Origins: Wolverine,2009-04-28,2009,150000000,373062864,223062864,1.456541
2082,Halloween,2007-08-31,2007,15000000,80253908,65253908,11.607678
2084,Birthday Girl,2001-09-06,2001,13000000,0,-13000000,6.271279
2085,Romeo Must Die,2000-03-20,2000,25000000,91036760,66036760,8.369176
2086,Nick of Time,1995-11-22,1995,8169363,8175346,5983,6.848591
2087,The Getaway,1994-02-11,1994,0,30,30,14.214403
2088,Romeo Is Bleeding,1993-09-13,1993,11500000,3275585,-8224415,9.796318
2089,Cutaway,2000-08-26,2000,9,0,-9,5.206363
2091,The Badge,2002-09-07,2002,6000000,0,-6000000,5.577591
2093,Amsterdamned,1988-02-11,1988,0,0,0,1.965789
2094,Roustabout,1964-11-11,1964,0,3000000,3000000,1.049308
2095,Desert Saints,2002-03-10,2002,0,0,0,4.464532
2097,"Gappa, the Triphibian Monster",1967-04-01,1967,0,0,0,1.885219
2098,Viva Las Vegas,1964-05-20,1964,0,0,0,6.363489
2099,Raw Deal,1986-06-06,1986,8500000,16209459,7709459,9.292099
2100,The Last Castle,2001-10-19,2001,72000000,27642707,-44357293,9.807552
2102,Solar Crisis,1990-07-14,1990,55000000,0,-55000000,0.653162
2103,Solaris,2002-11-27,2002,47000000,30002758,-16997242,10.642824
2104,Requiem,2001-12-28,2001,0,60700,60700,1.286005
2105,American Pie,1999-07-09,1999,11000000,235483004,224483004,18.344227
2107,L.A. Story,1991-02-08,1991,0,0,0,7.775188
2108,The Breakfast Club,1985-02-15,1985,1000000,51525171,50525171,12.627678
2109,Rush Hour,1998-09-18,1998,33000000,244386864,211386864,11.840557
2110,Wasabi,2001-10-31,2001,15300000,0,-15300000,12.426505
2111,Balzac and the Little Chinese Seamstress,2002-10-09,2002,0,0,0,1.084138
2112,Payback,1999-02-05,1999,90000000,161626121,71626121,9.112008
2114,Final Fantasy: The Spirits Within,2001-07-02,2001,137000000,85131830,-51868170,10.223851
2115,Light of Day,1987-02-06,1987,0,0,0,1.745096
2116,Out of Time,2003-10-03,2003,50000000,55495563,5495563,10.738888
2117,Sophie Scholl: The Final Days,2005-02-13,2005,0,0,0,4.972236
2118,L.A. Confidential,1997-09-19,1997,35000000,126216940,91216940,10.989442
2119,Days of Thunder,1990-06-27,1990,60000000,157920733,97920733,7.046753
2122,The Whole Ten Yards,2004-04-07,2004,40000000,26155781,-13844219,7.15606
2123,"Me, Myself & Irene",2000-06-22,2000,51000000,149270999,98270999,9.95456
2124,Color of Night,1994-08-19,1994,40000000,19726050,-20273950,14.228963
2125,Wedlock,1991-05-10,1991,0,0,0,2.059349
2132,Totally Blonde,2001-01-01,2001,0,0,0,0.696229
2133,The Perfect Storm,2000-03-15,2000,120000000,325756637,205756637,18.911961
2134,The Time Machine,1960-08-17,1960,750000,0,-750000,12.054356
2135,The Time Machine,2002-03-04,2002,80000000,123729176,43729176,8.918134
2139,Cleopatra Jones and the Casino of Gold,1975-07-11,1975,0,0,0,0.487831
2140,Kiss of the Dragon,2001-07-06,2001,25000000,64437847,39437847,7.637345
2141,James Dean,2001-08-04,2001,0,0,0,1.934817
2142,Cop Land,1997-08-15,1997,15000000,44862187,29862187,9.15931
2143,Carla's Song,1996-09-20,1996,0,0,0,1.826608
2144,One Night at McCool's,2001-04-19,2001,0,0,0,6.059018
2148,The Cotton Club,1984-12-14,1984,58000000,25928721,-32071279,9.508061
2149,Body of Evidence,1993-01-15,1993,30000000,13273595,-16726405,4.655727
2151,Man with the Screaming Brain,2005-04-03,2005,0,0,0,12.809011
2152,Dixie Chicks: Shut Up and Sing,2006-10-27,2006,0,0,0,1.831001
2153,The Driver,1978-06-08,1978,0,0,0,6.163618
2154,The Dark Side of The Moon,1990-05-30,1990,0,0,0,1.576967
2155,Reindeer Games,2000-02-25,2000,42000000,32168970,-9831030,12.11759
2157,Lost in Space,1998-04-03,1998,80000000,136159423,56159423,12.000579
2160,Voyage to the Bottom of the Sea,1961-07-12,1961,1580000,7000000,5420000,3.013584
2161,Fantastic Voyage,1966-08-24,1966,5115000,12000000,6885000,12.53841
2162,Chill Factor,1999-09-01,1999,70000000,11263966,-58736034,3.062626
2163,Breakdown,1997-05-02,1997,36000000,50159144,14159144,7.926621
2164,Stargate,1994-10-27,1994,55000000,196567262,141567262,13.328924
2165,Liberty Stands Still,2002-01-18,2002,11000000,0,-11000000,11.774131
2166,The Revengers' Comedies,1998-06-09,1998,0,0,0,1.537225
2168,2:37,2006-05-26,2006,850000,0,-850000,6.558245
2169,Manta - Der Film,1991-09-18,1991,0,0,0,0.987668
2171,Wet Hot American Summer,2001-07-27,2001,5000000,295206,-4704794,6.386082
2172,Pathfinder,1987-09-01,1987,0,0,0,2.372321
2176,The Glass House,2001-09-14,2001,30000000,23619609,-6380391,6.418936
2179,Tenacious D in The Pick of Destiny,2006-11-22,2006,22000000,13405595,-8594405,7.98193
2180,Heartbreak Hotel,2006-03-24,2006,0,0,0,0.967551
2182,Attack of the Killer Tomatoes!,1978-10-01,1978,90000,0,-90000,3.625313
2185,Big Trouble,2002-04-05,2002,40000000,8493890,-31506110,5.761051
2186,Within the Woods,1978-11-23,1978,1600,0,-1600,1.657273
2189,Tomboy,1985-11-14,1985,0,14100000,14100000,7.313067
2191,Stranded,2001-09-23,2001,0,0,0,1.440453
2192,Temple of the White Elephant,1964-03-28,1964,0,0,0,0.118964
2193,My Tutor,1983-03-04,1983,0,22587000,22587000,4.67546
2195,Beste Zeit,2008-01-31,2008,0,0,0,0.965482
2196,Death at a Funeral,2007-02-09,2007,9000000,46,-8999954,8.832907
2197,Sounds of Sand,2007-05-02,2007,5000000,0,-5000000,0.580717
2199,My Mom's a Werewolf,1989-11-11,1989,0,0,0,0.946475
2200,Jacob the Liar,1974-12-22,1974,0,0,0,2.072612
2202,Lassie Come Home,1943-10-07,1943,0,0,0,2.343313
2204,Alice in the Cities,1974-05-17,1974,0,0,0,2.988528
2207,16 Blocks,2006-03-01,2006,55000000,65664721,10664721,11.887779
2210,Earth Girls Are Easy,1988-09-08,1988,10000000,3916303,-6083697,11.509677
2211,Aimee & Jaguar,1999-02-10,1999,0,0,0,0.841272
2212,Nightwatch,1997-01-31,1997,0,1179002,1179002,6.122067
2232,The Legend of Paul and Paula,1973-03-14,1973,0,0,0,1.116048
2239,Hallam Foe,2007-02-16,2007,8000000,60641,-7939359,8.762536
2241,Sun Alley,1999-10-07,1999,0,0,0,3.767086
2246,Malice,1993-09-29,1993,0,46405336,46405336,9.861672
2251,Unfaithful,2002-05-10,2002,50000000,119137784,69137784,8.96839
2252,Eastern Promises,2007-09-14,2007,51500000,55112356,3612356,9.897909
2253,Valkyrie,2008-12-25,2008,75000000,200276000,125276000,8.635464
2255,Chasing Amy,1997-04-04,1997,250000,12021272,11771272,12.311564
2259,The House of the Spirits,1993-10-19,1993,25000000,0,-25000000,10.687795
2260,Capturing the Friedmans,2003-05-30,2003,0,3117985,3117985,4.453296
2261,Wattstax,1973-02-04,1973,0,0,0,1.832365
2262,Veronika Voss,1982-02-08,1982,0,0,0,1.126574
2263,Music Box,1989-12-22,1989,0,6263883,6263883,5.397405
2264,Lola,1981-08-20,1981,0,0,0,1.900407
2266,"Paris, je t'aime",2006-05-16,2006,13000000,4857367,-8142633,6.980486
2267,The Last Mimzy,2007-02-09,2007,0,27297451,27297451,6.183051
2268,The Golden Compass,2007-12-04,2007,180000000,372234864,192234864,11.481379
2269,Day Watch,2006-01-01,2006,4200000,38862717,34662717,7.42908
2270,Stardust,2007-08-09,2007,70000000,135560026,65560026,14.784525
2274,The Seeker: The Dark Is Rising,2007-10-05,2007,0,0,0,6.627076
2275,The General's Daughter,1999-06-18,1999,60000000,149705852,89705852,14.039655
2277,Bicentennial Man,1999-12-17,1999,100000000,93700000,-6300000,9.369918
2280,Big,1988-06-03,1988,18000000,151668774,133668774,9.562292
2282,√Ä nos amours,1983-11-16,1983,0,0,0,3.609326
2284,Mr. Magorium's Wonder Emporium,2007-11-14,2007,0,69474661,69474661,8.696467
2286,Crusade in Jeans,2006-11-15,2006,0,0,0,11.322545
2287,Rize,2005-01-15,2005,0,0,0,1.355932
2288,Closer,2004-12-01,2004,27000000,115505027,88505027,10.860952
2289,Cold Mountain,2003-12-24,2003,79000000,173013509,94013509,9.645543
2290,Jakob the Liar,1999-09-16,1999,0,0,0,9.217935
2291,Jacob's Ladder,1990-11-02,1990,25000000,25965144,965144,8.176863
2292,Clerks,1994-09-13,1994,27000,3151130,3124130,10.513367
2293,Mallrats,1995-10-20,1995,6000000,2122561,-3877439,8.25547
2294,Jay and Silent Bob Strike Back,2001-08-22,2001,22000000,33788161,11788161,11.619446
2295,Clerks II,2006-05-25,2006,5000000,26888376,21888376,8.466725
2297,Kafka,1991-11-15,1991,11000000,0,-11000000,7.693274
2300,Space Jam,1996-11-15,1996,80000000,250200000,170200000,11.054251
2302,Avalon,1990-10-05,1990,0,0,0,1.949265
2307,A Pyromaniac's Love Story,1995-04-28,1995,0,0,0,0.463307
2309,Inkheart,2008-12-11,2008,60000000,57490374,-2509626,13.570926
2310,Beowulf,2007-11-05,2007,70000000,195735876,125735876,9.951195
2312,In the Name of the King: A Dungeon Siege Tale,2007-11-29,2007,60000000,0,-60000000,6.502566
2313,Prime,2005-09-21,2005,0,0,0,6.916209
2319,The Dust Factory,2004-01-01,2004,0,0,0,1.437667
2320,Executive Decision,1996-03-15,1996,55000000,121969216,66969216,13.106291
2321,Married to the Mob,1988-08-19,1988,10000000,21486757,11486757,5.611184
2322,Sneakers,1992-09-09,1992,0,105232691,105232691,7.207325
2323,Field of Dreams,1989-04-21,1989,0,84431625,84431625,16.759454
2324,Local Color,2006-09-19,2006,3250000,32788,-3217212,1.393391
2325,Leningrad,2009-01-01,2009,0,0,0,4.495038
2330,Taxi,1998-04-04,1998,0,268254,268254,7.668149
2331,Jesus,1999-12-25,1999,20000000,0,-20000000,2.524781
2332,Taxi 2,2000-03-24,2000,0,60726164,60726164,6.411782
2333,Buddenbrooks,2008-12-25,2008,0,0,0,1.246082
2334,Taxi 3,2003-01-29,2003,14500000,65497208,50997208,5.892859
2335,Taxi 4,2007-02-10,2007,0,0,0,10.442485
2348,Holy Matrimony,1994-04-08,1994,0,616938,616938,2.293644
2349,Peas at 5:30,2004-03-04,2004,0,0,0,0.842078
2355,Reign Over Me,2007-03-23,2007,20000000,22222308,2222308,10.027137
2357,10 Items or Less,2006-09-11,2006,0,580527,580527,3.898236
2359,Sicko,2007-05-18,2007,9000000,24538513,15538513,6.766086
2360,Saving Grace,2000-01-24,2000,10000000,26330482,16330482,5.13955
2362,Westworld,1973-10-22,1973,0,0,0,6.529052
2363,Les Cousins,1959-03-11,1959,0,0,0,2.605844
2370,Topaz,1969-12-18,1969,4000000,6000000,2000000,5.757907
2371,Teheran '43,1980-06-06,1980,0,0,0,1.878184
2383,The Bear,1988-10-21,1988,0,138241022,138241022,4.158572
2395,Asterix at the Olympic Games,2008-01-13,2008,97250400,132900000,35649600,9.671944
2397,Fallout,1998-01-01,1998,0,0,0,1.687428
2428,The Greatest Story Ever Told,1965-02-15,1965,20000000,15473333,-4526667,3.961342
2433,The Young Girls of Rochefort,1967-03-08,1967,0,0,0,3.454623
2436,Double Dragon,1994-11-04,1994,3500000,2341309,-1158691,5.190767
2438,The Country Girl,1954-05-17,1954,0,0,0,2.024972
2440,Joint Security Area,2000-09-09,2000,0,0,0,10.187128
2441,Cows,1992-02-26,1992,0,0,0,1.9687
2442,The Final Cut,1996-03-01,1996,0,551281,551281,1.797462
2444,The Red Squirrel,1993-04-21,1993,0,0,0,1.622754
2447,The Nativity Story,2006-12-01,2006,35000000,0,-35000000,4.68645
2453,Harley Davidson and the Marlboro Man,1991-08-23,1991,23000000,7434726,-15565274,7.338188
2454,The Chronicles of Narnia: Prince Caspian,2008-05-15,2008,225000000,419651413,194651413,12.490891
2455,Confidentially Yours,1983-08-10,1983,0,0,0,2.672873
2457,Children of Paradise,1945-03-15,1945,0,0,0,5.353954
2459,An Elephant Can Be Extremely Deceptive,1976-09-22,1976,0,0,0,3.12581
2460,Earth,1996-05-20,1996,0,0,0,1.502487
2462,Hibernatus,1969-09-10,1969,0,0,0,3.793346
2463,Running Out of Time,1999-09-23,1999,0,0,0,4.075709
2469,Tie Me Up! Tie Me Down!,1989-12-12,1989,0,0,0,10.788319
2470,Belle √âpoque,1992-12-04,1992,0,0,0,3.565278
2486,Eragon,2006-12-14,2006,100000000,249288105,149288105,9.851133
2487,Lady Snowblood,1973-12-01,1973,0,0,0,7.228457
2493,The Princess Bride,1987-09-18,1987,16000000,30857814,14857814,15.15267
2501,The Bourne Identity,2002-06-14,2002,60000000,214034224,154034224,21.040126
2502,The Bourne Supremacy,2004-07-23,2004,75000000,288500217,213500217,20.40426
2503,The Bourne Ultimatum,2007-08-03,2007,70000000,442824138,372824138,18.173269
2516,Our Mother's House,1967-10-09,1967,0,0,0,1.385444
2517,Nobody Knows,2004-08-07,2004,0,0,0,5.196429
2525,The Bible: In the Beginning...,1966-09-28,1966,18000000,0,-18000000,4.309564
2527,This Man Must Die,1969-09-04,1969,0,0,0,2.043639
2528,Madame Bovary,1991-04-03,1991,0,1942423,1942423,1.233405
2539,Spanglish,2004-12-17,2004,80000000,55041367,-24958633,11.202764
2546,Zazie dans le m√©tro,1960-10-28,1960,0,0,0,3.297004
2565,Joe Versus the Volcano,1990-03-09,1990,0,39404261,39404261,9.019396
2566,Time to Leave,2005-05-16,2005,0,0,0,3.333665
2567,The Aviator,2004-12-17,2004,116000000,102000000,-14000000,9.86738
2574,The Lovers,1958-09-05,1958,0,0,0,2.461408
2575,The Tailor of Panama,2001-02-11,2001,21000000,28008462,7008462,6.226933
2576,The Diary of Anne Frank,1959-03-18,1959,3000000,0,-3000000,5.733434
2577,Code 46,2003-09-02,2003,7500000,0,-7500000,6.101401
2587,"Brother Sun, Sister Moon",1972-03-03,1972,3000000,0,-3000000,1.763243
2588,Chaotic Ana,2007-08-24,2007,6500000,0,-6500000,4.502465
2593,The Fire Within,1963-10-14,1963,0,0,0,2.441347
2594,Monsieur Batignole,2002-03-06,2002,0,0,0,3.590903
2604,Born on the Fourth of July,1989-12-20,1989,14000000,161001698,147001698,13.617646
2605,Short Circuit,1986-05-09,1986,0,40697761,40697761,12.171218
2608,Maid to Order,1987-07-10,1987,0,9868521,9868521,1.542276
2609,"Planes, Trains and Automobiles",1987-11-26,1987,0,49230280,49230280,9.420183
2610,Shopgirl,2005-10-21,2005,10284523,11588205,1303682,4.349046
2611,Only the Lonely,1991-05-24,1991,0,21830957,21830957,10.313689
2612,Mr. Destiny,1990-10-12,1990,20000000,15379253,-4620747,4.414928
2613,Prelude to a Kiss,1992-07-10,1992,0,22697691,22697691,4.582718
2614,Innerspace,1987-06-30,1987,0,25893810,25893810,10.134408
2616,Uncle Buck,1989-08-16,1989,15000000,79258538,64258538,8.13754
2617,The Great Outdoors,1988-06-17,1988,24000000,43455230,19455230,11.666172
2619,Splash,1984-03-09,1984,8000000,69821334,61821334,8.441602
2620,Armed and Dangerous,1986-08-15,1986,12000000,15945534,3945534,5.037671
2621,Return to Me,2000-04-07,2000,24000000,36609995,12609995,5.269733
2623,An Officer and a Gentleman,1982-07-28,1982,0,129795554,129795554,7.936216
2625,Mr. Jones,1993-10-08,1993,0,0,0,6.579753
2636,The Specialist,1994-10-07,1994,45000000,170362582,125362582,10.388183
2637,The Mothman Prophecies,2002-01-25,2002,32000000,55157539,23157539,8.50563
2639,Deconstructing Harry,1997-08-26,1997,20000000,10686841,-9313159,6.280515
2640,Heathers,1988-10-01,1988,0,1108462,1108462,13.311827
2642,Two Weeks Notice,2002-12-19,2002,60000000,93354918,33354918,7.738531
2648,Aces Go Places V: The Terracotta Hit,1989-01-01,1989,0,0,0,0.852792
2649,The Game,1997-09-12,1997,50000000,109423648,59423648,14.825587
2652,Hard Candy,2005-01-14,2005,950000,7022209,6072209,9.62025
2654,In the Mouth of Madness,1994-12-12,1994,8000000,8946600,946600,8.497643
2655,What Lies Beneath,2000-07-21,2000,100000000,155464351,55464351,9.500497
2657,Pleasantville,1998-09-17,1998,0,0,0,11.0874
2661,Batman,1966-07-30,1966,1377800,0,-1377800,8.991532
2662,House of 1000 Corpses,2003-04-11,2003,7000000,16829545,9829545,11.00913
2665,Airplane II: The Sequel,1982-12-10,1982,0,27150534,27150534,7.181664
2666,Dark City,1998-02-27,1998,27000000,27200316,200316,12.851984
2667,The Blair Witch Project,1999-07-14,1999,60000,248000000,247940000,14.838386
2668,Sleepy Hollow,1999-11-18,1999,100000000,206071502,106071502,11.072361
2669,The Bounty,1984-05-04,1984,25000000,8613462,-16386538,7.492912
2671,Ringu,1998-01-31,1998,1200000,8690429,7490429,6.486126
2675,Signs,2002-08-02,2002,72000000,408247917,336247917,11.211568
2687,Memoirs of an Invisible Man,1992-02-28,1992,40000000,14358033,-25641967,6.064099
2690,Irma la Douce,1963-06-04,1963,0,0,0,5.967967
2692,The Red Elvis,2007-02-13,2007,0,0,0,0.123453
2694,Tuya's Marriage,2006-09-21,2006,0,0,0,1.819151
2698,Evan Almighty,2007-06-09,2007,175000000,173000000,-2000000,9.156877
2699,Titanic,1996-11-17,1996,13000000,0,-13000000,3.435807
2701,Abraham,1994-04-03,1994,10000000,0,-10000000,1.888149
2721,Z,1969-02-26,1969,0,83305,83305,11.943621
2722,The Other Side of the Bed,2002-04-27,2002,0,0,0,1.99771
2728,Postal,2007-08-11,2007,0,0,0,13.441185
2731,Indochine,1992-04-15,1992,0,0,0,10.762325
2734,David,1997-03-23,1997,15000000,0,-15000000,2.404939
2742,Naked Lunch,1991-12-27,1991,16000000,0,-16000000,7.919299
2748,Journey to Italy,1954-09-07,1954,0,0,0,4.092146
2749,15 Minutes,2001-03-01,2001,60000000,56359980,-3640020,12.149946
2750,24 Hour Party People,2002-02-13,2002,0,0,0,12.655728
2752,40 Days and 40 Nights,2002-03-01,2002,17000000,0,-17000000,8.628928
2753,The Assault,1986-02-06,1986,0,203781,203781,1.899468
2754,Abel,1986-02-27,1986,0,0,0,2.385264
2755,About Schmidt,2002-12-13,2002,30000000,105834556,75834556,11.066473
2756,The Abyss,1989-08-09,1989,70000000,90000098,20000098,9.809585
2757,Adaptation.,2002-12-06,2002,19000000,32801173,13801173,11.624481
2758,Addams Family Values,1993-11-19,1993,0,48919043,48919043,17.555909
2759,"The Adventures of Priscilla, Queen of the Desert",1994-05-31,1994,0,11220670,11220670,8.328596
2760,The Lodger: A Story of the London Fog,1927-02-14,1927,12000,0,-12000,9.299853
2761,Secret Agent,1936-06-12,1936,0,0,0,4.119907
2762,Young and Innocent,1937-11-01,1937,0,0,0,3.824884
2764,All Stars,1997-05-01,1997,0,0,0,0.508677
2767,Les Amants du Pont-Neuf,1991-10-16,1991,28000000,0,-28000000,3.62449
2768,American Gigolo,1980-02-08,1980,4800000,22743674,17943674,11.53267
2769,An American in Paris,1951-08-08,1951,2723903,4500000,1776097,5.565203
2770,American Pie 2,2001-08-10,2001,30000000,287553595,257553595,10.25103
2771,American Splendor,2003-08-15,2003,0,6003587,6003587,7.05435
2777,Birdcage Inn,1998-10-31,1998,0,0,0,2.155611
2778,Clifford,1994-04-01,1994,19000000,7411659,-11588341,2.459293
2779,The Curse of the Jade Scorpion,2001-08-05,2001,0,0,0,5.739829
2786,Pierrot le Fou,1965-08-29,1965,300000,0,-300000,5.606909
2787,Pitch Black,2000-02-18,2000,23000000,53187659,30187659,6.424399
2788,Reality Bites,1994-02-18,1994,11500000,20079850,8579850,6.514592
2789,The Chronicles of Riddick,2004-06-11,2004,105000000,115772733,10772733,5.060352
2791,The Chronicles of Riddick: Dark Fury,2004-06-15,2004,0,0,0,1.628881
2798,Oscar,1967-10-10,1967,0,0,0,4.51157
2800,Rumor Has It...,2005-12-23,2005,70000000,88933562,18933562,6.158212
2805,Tears of the Black Tiger,2000-10-05,2000,0,0,0,1.078123
2813,Violette,1978-05-24,1978,0,0,0,2.199067
2817,Same Old Song,1997-11-12,1997,0,0,0,7.272304
2830,My Boss's Daughter,2003-08-21,2003,14000000,0,-14000000,13.49615
2832,Identity,2003-04-25,2003,30000000,90259536,60259536,17.955897
2841,A Very Long Engagement,2004-10-26,2004,47000000,0,-47000000,10.896295
2860,Claire's Knee,1970-12-11,1970,0,0,0,3.534856
2861,A Good Marriage,1982-05-19,1982,0,0,0,0.816074
2882,Hunting and Gathering,2007-02-10,2007,0,0,0,6.532872
2887,And the Band Played On,1993-09-11,1993,0,0,0,2.643288
2890,"Andr√© Hazes, Zij Gelooft in Mij",2000-01-27,2000,0,0,0,0.113732
2891,An Angel at My Table,1990-09-05,1990,0,0,0,2.649447
2892,Angel Baby,1995-09-09,1995,0,0,0,0.775616
2894,The Lady and the Duke,2001-09-07,2001,0,0,0,0.765716
2895,The Apostle,1997-10-09,1997,5000000,0,-5000000,9.21174
2897,Around the World in Eighty Days,1956-10-17,1956,6000000,42000000,36000000,6.164226
2898,As Good as It Gets,1997-12-19,1997,50000000,314178011,264178011,9.374049
2899,Asterix & Obelix: Mission Cleopatra,2002-01-29,2002,0,111127553,111127553,11.117405
2900,The Astronaut's Wife,1999-08-26,1999,75000000,19598588,-55401412,14.705865
2907,The Addams Family,1991-11-22,1991,30000000,191502426,161502426,12.962525
2909,In the Dust of the Stars,1976-07-01,1976,0,0,0,0.704362
2911,The Last Drop,2005-05-23,2005,0,0,0,1.631359
2912,The Butcher,1970-02-27,1970,0,0,0,2.183945
2923,B. Monkey,1998-11-07,1998,0,0,0,2.399824
2924,Backdraft,1991-05-24,1991,75000000,152368585,77368585,9.883727
2925,The First Wives Club,1996-09-20,1996,26000000,116400000,90400000,10.177303
2926,The Three Musketeers,1973-12-11,1973,0,0,0,11.811966
2927,Moon 44,1990-02-15,1990,0,0,0,5.854206
2928,Michael,1996-12-25,1996,0,119718203,119718203,9.473162
2929,Frankenstein,1910-03-18,1910,0,0,0,1.659883
2959,License to Wed,2007-07-04,2007,35000000,69307224,34307224,7.102076
2963,The Impossible Voyage,1904-10-01,1904,7500,0,-7500,1.529176
2965,"20,000 Leagues Under the Sea",1997-03-23,1997,0,0,0,1.240829
2966,"20,000 Leagues Under the Sea",1997-05-11,1997,0,0,0,3.600607
2969,A Daughter Of Destiny,1928-01-25,1928,0,0,0,1.405597
2972,The Golem: How He Came Into the World,1920-10-28,1920,0,0,0,1.52413
2973,Aelita: Queen of Mars,1924-09-24,1924,0,0,0,1.952217
2974,The Hands of Orlac,1924-09-23,1924,0,0,0,0.979118
2976,Hairspray,2007-07-13,2007,50000000,90450008,40450008,7.768045
2977,Becoming Jane,2007-03-02,2007,16500000,37311672,20811672,7.829737
2978,Ghostbusters II,1989-06-15,1989,37000000,215394738,178394738,16.414239
2979,Return of the Ghostbusters,2007-01-01,2007,0,0,0,1.670747
2981,The Lost World,1925-06-22,1925,0,0,0,2.968503
2982,The Lost World,1960-07-13,1960,0,0,0,1.586734
2984,A Countess from Hong Kong,1967-01-05,1967,3500000,2000000,-1500000,4.928589
2988,The Harrad Experiment,1973-05-11,1973,0,0,0,0.952641
2989,Roar,1981-11-12,1981,17000000,2000000,-15000000,1.307263
2990,Pacific Heights,1990-09-28,1990,0,29381956,29381956,4.817146
2993,One on Top of the Other,1969-08-15,1969,0,0,0,1.550671
2994,Danger: Diabolik,1968-01-23,1968,400000,0,-400000,2.586658
2998,Zabriskie Point,1970-02-09,1970,7000000,1000000,-6000000,6.258456
3001,How to Steal a Million,1966-07-13,1966,0,0,0,12.389626
3003,The Lost World,2001-12-25,2001,0,0,0,3.045997
3004,Twelve Plus One,1969-10-06,1969,0,0,0,0.97354
3007,Woman in the Moon,1929-10-14,1929,0,0,0,1.235633
3009,The Trial,1962-12-21,1962,0,0,0,5.310729
3010,The Cardinal,1963-12-12,1963,0,0,0,1.642624
3011,Good Neighbor Sam,1964-07-22,1964,0,0,0,3.314695
3012,The Victors,1963-11-22,1963,0,0,0,1.047518
3013,Bloodline,1979-01-01,1979,0,0,0,2.493634
3014,The Man Between,1953-11-18,1953,0,0,0,5.291637
3016,Dr. Jekyll and Mr. Hyde,1920-03-18,1920,0,0,0,1.562169
3019,Dr. Jekyll and Mr. Hyde,1931-12-31,1931,0,0,0,4.749049
3021,1408,2007-07-12,2007,25000000,94679598,69679598,9.196884
3022,Dr. Jekyll and Mr. Hyde,1941-08-12,1941,0,0,0,2.225578
3023,Abbott and Costello Meet Dr. Jekyll and Mr. Hyde,1953-08-01,1953,0,0,0,4.004759
3024,The Strange Case of Dr. Jekyll and Mr. Hyde,1968-01-07,1968,0,0,0,0.424452
3025,The Two Faces of Dr. Jekyll,1960-10-24,1960,0,0,0,2.065918
3026,The Testament of Dr. Cordelier,1959-01-01,1959,0,0,0,0.573507
3028,Jekyll and Hyde ... Together Again,1982-11-10,1982,0,0,0,1.352979
3030,End of the World,1977-08-01,1977,0,0,0,1.239669
3031,Island of Lost Souls,1932-12-01,1932,0,0,0,13.466333
3033,Gods and Monsters,1998-01-21,1998,10000000,6451628,-3548372,6.788021
3034,Young Frankenstein,1974-12-15,1974,2800000,86273333,83473333,9.339316
3035,Frankenstein,1931-11-21,1931,291000,12000000,11709000,8.091603
3036,Mary Shelley's Frankenstein,1994-11-04,1994,45000000,112006296,67006296,14.287753
3037,Yella,2007-02-14,2007,3000000,0,-3000000,7.322719
3040,Night Watch,2004-06-27,2004,4200000,32000000,27800000,8.803869
3041,In Bed,2005-08-03,2005,0,0,0,1.029472
3043,Flesh for Frankenstein,1973-11-30,1973,450000,0,-450000,3.104212
3048,The Great Global Warming Swindle,2007-03-08,2007,0,0,0,1.248779
3049,Ace Ventura: Pet Detective,1994-02-04,1994,15000000,107217396,92217396,11.247957
3050,Doctor Dolittle,1998-06-22,1998,71000000,294456605,223456605,9.439079
3051,Eye of the Devil,1966-07-01,1966,0,0,0,4.760853
3052,Don't Make Waves,1967-06-20,1967,0,0,0,4.910542
3053,The Fearless Vampire Killers,1967-02-01,1967,2000000,0,-2000000,9.182414
3054,The Wrecking Crew,1968-12-30,1968,0,2400000,2400000,0.955774
3055,Valley of the Dolls,1967-12-27,1967,5000000,50000000,45000000,2.474398
3056,Frankenstein,2004-10-09,2004,0,0,0,1.533848
3057,Frankenstein,2004-10-05,2004,0,0,0,1.215853
3059,Intolerance: Love's Struggle Throughout the Ages,1916-09-04,1916,8394751,0,-8394751,4.282118
3060,The Big Parade,1925-11-05,1925,245000,22000000,21755000,2.084627
3061,The Crowd,1928-02-18,1928,0,0,0,6.78748
3062,42nd Street,1933-02-02,1933,439000,2281000,1842000,4.718154
3063,Duck Soup,1933-11-17,1933,0,0,0,6.819957
3064,Chances Are,1989-03-10,1989,0,0,0,4.901036
3065,Mystery Science Theater 3000: The Movie,1996-04-19,1996,0,0,0,2.985163
3072,Frankenstein Unbound,1990-11-02,1990,0,0,0,2.079742
3073,Abbott and Costello Meet Frankenstein,1948-06-15,1948,0,0,0,4.372409
3074,The Ghost of Frankenstein,1942-03-13,1942,0,0,0,4.021579
3075,Frankenstein Must Be Destroyed,1969-05-22,1969,0,0,0,2.049849
3076,Frankenstein Meets the Wolf Man,1943-03-05,1943,0,0,0,5.841791
3077,Son of Frankenstein,1939-01-13,1939,0,0,0,3.563588
3078,It Happened One Night,1934-02-22,1934,325000,4500000,4175000,6.465257
3079,The Curse of Frankenstein,1957-05-02,1957,0,0,0,4.307941
3080,Top Hat,1935-09-06,1935,609000,3202000,2593000,7.122093
3081,The Goddess,1958-06-24,1958,0,0,0,0.132149
3082,Modern Times,1936-02-05,1936,1,8500000,8499999,8.159556
3083,Mr. Smith Goes to Washington,1939-10-19,1939,1500000,9600000,8100000,8.168694
3084,Wuthering Heights,1939-04-13,1939,0,0,0,11.474476
3085,His Girl Friday,1940-01-18,1940,0,0,0,9.88321
3086,The Lady Eve,1941-02-25,1941,0,0,0,8.35844
3087,Yankee Doodle Dandy,1942-06-06,1942,0,0,0,3.658274
3088,My Darling Clementine,1946-12-03,1946,0,0,0,8.869419
3089,Red River,1948-08-26,1948,3000000,9012000,6012000,6.09018
3090,The Treasure of the Sierra Madre,1948-01-24,1948,3800000,4307000,507000,8.070589
3092,Seance on a Wet Afternoon,1964-06-19,1964,0,0,0,2.459915
3093,Basic Instinct 2,2006-03-29,2006,70000000,38629478,-31370522,15.321902
3097,"The Tulse Luper Suitcases, Part 1: The Moab Story",2003-05-24,2003,10000000,25800,-9974200,0.524432
3101,I Love You to Death,1990-04-06,1990,0,0,0,8.11216
3102,My Step Brother Frankenstein,2005-03-13,2005,0,0,0,0.602554
3103,House of Frankenstein,1944-12-01,1944,0,0,0,2.542558
3104,Frankenstein Created Woman,1967-03-15,1967,0,0,0,2.302582
3107,Destroy All Monsters,1968-08-01,1968,0,0,0,3.74447
3109,The Quiet Man,1952-07-21,1952,0,0,0,8.762386
3110,Shane,1953-04-23,1953,3100000,20000000,16900000,6.63816
3111,A Star Is Born,1954-09-29,1954,5019770,0,-5019770,7.051183
3112,The Night of the Hunter,1955-04-03,1955,795000,0,-795000,7.892337
3114,The Searchers,1956-03-13,1956,3750000,0,-3750000,7.803856
3115,Godzilla vs. The Sea Monster,1966-12-17,1966,0,0,0,2.099352
3116,Midnight Cowboy,1969-05-25,1969,3600000,44785053,41185053,10.579988
3117,Frankenstein and the Monster from Hell,1973-03-31,1973,0,0,0,8.388808
3118,Frankenstein 90,1984-08-14,1984,0,0,0,0.000195
3121,Nashville,1975-06-11,1975,2200000,0,-2200000,9.042678
3122,Lady Frankenstein,1971-10-22,1971,0,0,0,3.530313
3124,The Evil of Frankenstein,1964-04-08,1964,0,0,0,1.816665
3125,Dracula vs. Frankenstein,1971-12-01,1971,0,0,0,1.513005
3127,The Revenge of Frankenstein,1958-06-01,1958,0,0,0,3.522296
3131,Gangs of New York,2002-12-14,2002,100000000,193772504,93772504,14.922399
3132,Bad Company,2002-06-07,2002,70000000,65977295,-4022705,9.540021
3133,Badlands,1973-10-15,1973,0,0,0,16.641976
3134,Baise-moi,2000-06-28,2000,0,940944,940944,12.589992
3144,Rock 'n' Roll Frankenstein,1999-01-01,1999,0,0,0,0.072413
3145,The Horror of Frankenstein,1970-11-08,1970,0,0,0,2.150514
3146,The War of the Gargantuas,1966-07-31,1966,0,0,0,2.382208
3149,Jesse James Meets Frankenstein's Daughter,1966-04-09,1966,0,0,0,0.29177
3159,Frankenstein's Castle of Freaks,1974-02-19,1974,0,0,0,0.296813
3160,Frankenstein Conquers the World,1965-08-08,1965,0,0,0,1.469081
3162,Blackenstein,1973-01-01,1973,0,0,0,0.47033
3164,Frankenstein 1970,1958-07-20,1958,0,0,0,0.867198
3168,Three-Step Dance,2003-08-31,2003,0,0,0,0.119376
3170,Bambi,1942-08-14,1942,858000,267447150,266589150,13.698132
3171,Bambi Meets Godzilla,1969-01-01,1969,0,0,0,2.032918
3172,Bandits,2001-10-12,2001,75000000,67631903,-7368097,13.136791
3173,Bangkok Dangerous,1999-11-01,1999,0,0,0,6.503788
3175,Barry Lyndon,1975-12-18,1975,11000000,20000000,9000000,14.003467
3176,Battle Royale,2000-12-16,2000,4500000,25000000,20500000,12.701098
3177,Battle Royale II: Requiem,2003-07-05,2003,9000000,0,-9000000,7.500419
3178,Beat,2000-01-29,2000,0,0,0,0.758451
3179,Beavis and Butt-Head Do America,1996-12-15,1996,12000000,0,-12000000,8.855685
3210,The Projected Man,1966-01-01,1966,0,0,0,0.720828
3291,"Good Night, and Good Luck.",2005-09-16,2005,7000000,54600000,47600000,7.523098
3293,Pirates of Silicon Valley,1999-05-10,1999,0,0,0,8.172132
3309,Mildred Pierce,1945-09-24,1945,1453000,5638000,4185000,4.497049
3396,The Yes Men,2003-09-07,2003,0,0,0,2.647884
3397,And Along Come Tourists,2007-05-21,2007,0,0,0,0.623793
3405,Anyone Can Play,1968-02-02,1968,0,0,0,0.598241
3418,Death Watch,1980-01-23,1980,0,0,0,2.02305
3423,The Things of Life,1970-03-13,1970,0,0,0,2.349658
3426,Cesar and Rosalie,1972-10-26,1972,0,0,0,2.984046
3427,Max and the Junkmen,1971-02-17,1971,0,0,0,0.989599
3432,Mr. Brooks,2007-06-01,2007,20000000,41637263,21637263,7.423812
3469,Far from the Madding Crowd,1967-01-01,1967,0,0,0,4.377296
3472,Dirty Pretty Things,2002-09-05,2002,0,0,0,5.349653
3476,That Most Important Thing: Love,1975-02-12,1975,0,0,0,1.268137
3478,Ludwig,1972-12-29,1972,0,0,0,1.3379
3479,Dirty Hands,1975-01-01,1975,0,0,0,1.301798
3480,The Old Gun,1975-08-22,1975,0,0,0,2.445603
3482,The Train,1964-09-21,1964,5800000,6800000,1000000,4.412564
3483,The Blood of Fu Manchu,1968-08-23,1968,0,0,0,0.463793
3484,The Mask of Fu Manchu,1932-11-05,1932,0,0,0,1.151116
3485,The Castle of Fu Manchu,1969-05-29,1969,0,0,0,0.795213
3486,The Fiendish Plot of Dr. Fu Manchu,1980-08-08,1980,0,0,0,0.886041
3489,88 Minutes,2007-02-14,2007,30000000,16930884,-13069116,8.552967
3509,A Scanner Darkly,2006-05-25,2006,8700000,7659918,-1040082,11.643026
3511,The Broken,2008-01-18,2008,6700000,0,-6700000,3.365903
3512,Under Siege 2: Dark Territory,1995-07-13,1995,60000000,104324083,44324083,7.490247
3513,Legionnaire,1998-12-03,1998,20000000,0,-20000000,5.951361
3515,I'll Sleep When I'm Dead,2003-05-14,2003,0,490964,490964,2.787144
3520,Casanova '70,1965-06-15,1965,0,0,0,1.807802
3525,Working Girl,1988-12-20,1988,28000000,103173635,75173635,8.318954
3526,Frances,1982-12-03,1982,0,5000000,5000000,2.077869
3527,Don't Come Knocking,2005-05-19,2005,11000000,0,-11000000,3.348019
3529,The Thin Man,1934-05-25,1934,226408,1423000,1196592,10.573867
3536,U-571,2000-04-20,2000,62000000,127666415,65666415,7.879924
3537,Fame,1980-05-16,1980,0,21202829,21202829,5.511557
3539,Off Beat,2004-09-11,2004,0,0,0,1.149831
3541,The Mad Dog Killer,1977-10-29,1977,0,0,0,0.834117
3542,Lady Chatterley,2006-11-01,2006,0,0,0,1.963102
3543,Bagdad Cafe,1987-11-12,1987,0,3587303,3587303,5.289632
3547,Reflections in a Golden Eye,1967-10-10,1967,4500000,0,-4500000,3.13517
3549,After the Wedding,2006-02-24,2006,0,0,0,5.099115
3554,Mahogany,1975-10-08,1975,0,0,0,1.08732
3556,Mad Dog Coll,1961-05-12,1961,0,0,0,0.669692
3558,"Girl, Interrupted",1999-12-21,1999,40000000,0,-40000000,8.285062
3563,I Now Pronounce You Chuck & Larry,2007-07-12,2007,85000000,186072214,101072214,6.645799
3565,Underground,1928-07-01,1928,0,0,0,0.076335
3573,Emma,1996-08-02,1996,6000000,22231658,16231658,6.593011
3574,Doctor X,1932-08-27,1932,0,0,0,1.5217
3575,The Return of Doctor X,1939-12-02,1939,0,0,0,0.668053
3576,Calling Dr. Gillespie,1942-08-01,1942,0,0,0,0.026687
3577,The Tunnel,2001-01-21,2001,0,0,0,2.577643
3578,The Tunnel,1933-10-26,1933,0,0,0,0.35565
3580,Changeling,2008-01-30,2008,55000000,113020255,58020255,11.672394
3581,Death Line,1972-01-01,1972,0,0,0,1.819461
3582,The Millionairess,1960-10-18,1960,0,0,0,3.001543
3586,Pr√™t-√†-Porter,1994-12-23,1994,15000000,11300653,-3699347,6.259433
3587,Bogus,1996-09-06,1996,32000000,0,-32000000,2.523605
3589,It Happened Tomorrow,1944-05-28,1944,0,0,0,0.576112
3591,One Million Years B.C.,1966-12-01,1966,0,0,0,4.091602
3592,One Million B.C.,1940-04-26,1940,0,0,0,0.461924
3593,Dr. Cyclops,1940-04-09,1940,0,0,0,0.662919
3594,The Number 23,2007-02-23,2007,30000000,77566815,47566815,8.140941
3595,Ransom,1996-11-08,1996,80000000,309492681,229492681,8.772188
3596,Things to Come,1936-02-20,1936,0,0,0,2.638559
3597,I Know What You Did Last Summer,1997-10-17,1997,17000000,125586134,108586134,7.417157
3598,Lost Horizon,1937-09-01,1937,4000000,0,-4000000,3.166544
3600,I Still Know What You Did Last Summer,1998-11-13,1998,65000000,40002112,-24997888,11.023042
3602,I'll Always Know What You Did Last Summer,2006-06-24,2006,0,0,0,5.223401
3603,Black Sheep,2006-09-09,2006,0,4947717,4947717,7.434577
3604,Flash Gordon,1980-09-01,1980,35000000,27107960,-7892040,6.346979
3632,Flash Gordon,1936-10-10,1936,0,0,0,1.149111
3635,Girl with a Pearl Earring,2003-08-31,2003,0,31466789,31466789,7.008512
3638,No Reservations,2007-07-25,2007,28000000,92601050,64601050,9.672317
3640,Mostly Martha,2001-09-09,2001,0,0,0,7.458993
3681,What's New Pussycat?,1965-06-22,1965,0,0,0,2.705723
3682,54,1998-08-28,1998,13000000,16757163,3757163,8.736869
3683,Flags of Our Fathers,2006-10-18,2006,90000000,65900249,-24099751,9.224494
3686,Last of the Renegades,1964-09-17,1964,0,0,0,3.29263
3687,Flesh Gordon,1974-07-30,1974,700000,0,-700000,3.062497
3692,Secret Agent Super Dragon,1966-02-17,1966,0,0,0,0.910855
3698,"Amigo, Stay Away",1972-02-04,1972,0,0,0,0.152268
3699,Seven Blood-Stained Orchids,1972-06-30,1972,0,0,0,0.642375
3701,Gang War in Milan,1973-02-21,1973,0,0,0,1.065237
3716,In July,2000-08-23,2000,0,0,0,7.202994
3763,Onibaba,1964-11-21,1964,0,0,0,3.614257
3764,The Naked Island,1960-11-23,1960,0,0,0,1.771462
3766,The Lady from Shanghai,1947-12-24,1947,2300000,0,-2300000,8.694857
3767,Gilda,1946-02-14,1946,0,0,0,4.562074
3777,Throne of Blood,1957-01-15,1957,0,0,0,6.471043
3780,Red Beard,1965-04-03,1965,0,0,0,4.249501
3782,Ikiru,1952-10-09,1952,0,55240,55240,7.843562
3784,Frankie and Johnny,1991-10-18,1991,0,22773535,22773535,6.889748
3786,Buck Rogers in the 25th Century,1979-03-02,1979,0,0,0,0.91043
3865,Dark Blue Almost Black,2006-03-24,2006,0,0,0,2.486575
3870,1900,1976-09-03,1976,9000000,0,-9000000,6.317822
3875,Brothers,2004-08-27,2004,0,0,0,7.682647
3877,Things We Lost in the Fire,2007-09-26,2007,16000000,2849142,-13150858,11.446274
3902,I'm Not There.,2007-10-01,2007,20000000,4001121,-15998879,9.351557
3933,Corpse Bride,2005-09-09,2005,40000000,117195061,77195061,12.920032
3934,M√©nage,1986-04-23,1986,0,0,0,2.010505
3935,The Last Woman,1976-04-20,1976,0,0,0,1.694961
3936,Blondie Has Servant Trouble,1940-07-25,1940,0,0,0,0.486412
3937,Blondie on a Budget,1940-02-29,1940,0,0,0,0.44415
3938,Blondie Plays Cupid,1940-10-31,1940,0,0,0,0.56455
3941,Blondie Goes Latin,1941-02-27,1941,0,0,0,0.411367
3962,Bis zum Ellenbogen,2007-11-01,2007,0,0,0,0.672189
3966,Blondie Knows Best,1946-10-17,1946,0,0,0,0.001908
3980,Critters,1986-04-11,1986,2000000,13167232,11167232,10.113807
3981,What Women Want,2000-12-15,2000,70000000,374111707,304111707,9.963079
3989,Team America: World Police,2004-10-10,2004,32000000,50907422,18907422,11.428941
4011,Beetlejuice,1988-02-29,1988,15000000,73326666,58326666,10.627364
4012,The Believer,2001-01-19,2001,1500000,416925,-1083075,8.128106
4024,Last Year at Marienbad,1961-05-25,1961,0,0,0,8.334883
4025,The Prize,1963-12-25,1963,0,0,0,1.502123
4031,Going Places,1974-05-12,1974,0,0,0,2.836965
4032,My Girl,1991-11-27,1991,16500000,0,-16500000,8.605742
4034,That Man from Rio,1964-02-05,1964,0,0,0,2.789067
4043,Law of Desire,1987-02-06,1987,0,0,0,12.009833
4049,The Glass Cell,1978-04-05,1978,0,0,0,0.002841
4104,Benny & Joon,1993-04-16,1993,0,23202734,23202734,10.597116
4105,Black Rain,1989-09-22,1989,30000000,45892212,15892212,6.973408
4107,Bloody Sunday,2002-01-16,2002,0,773228,773228,7.757913
4108,The Transporter,2002-10-02,2002,21000000,43928932,22928932,13.217421
4111,Blondie of the Follies,1932-09-01,1932,0,0,0,0.582278
4112,Blondie Johnson,1933-02-25,1933,0,0,0,0.19177
4133,Blow,2001-04-04,2001,53000000,83282296,30282296,12.332223
4134,Het zwijgen,2006-03-23,2006,0,0,0,0.039352
4140,Blindsight,2006-09-11,2006,0,0,0,0.086952
4141,Shoot 'Em Up,2007-07-26,2007,39000000,26820641,-12179359,7.259086
4146,The Wonderful Crook,1974-01-01,1974,0,0,0,0.367704
4147,Road to Perdition,2002-07-12,2002,80000000,181001478,101001478,13.426684
4148,Revolutionary Road,2008-12-19,2008,35000000,75225693,40225693,12.265867
4154,Three Seasons,1999-04-30,1999,0,0,0,0.632591
4169,Breach,2007-02-12,2007,0,33231264,33231264,6.885359
4170,Trade,2007-01-23,2007,12000000,0,-12000000,13.033004
4171,Odette Toulemonde,2006-11-06,2006,0,0,0,2.156849
4173,Stromboli,1950-02-15,1950,0,0,0,3.197594
4174,Spellbound,1945-12-28,1945,1500000,7000000,5500000,5.47596
4175,Under Capricorn,1949-09-08,1949,0,0,0,2.972892
4176,Murder on the Orient Express,1974-11-24,1974,0,27634716,27634716,9.590695
4180,Three Men and a Cradle,1985-09-18,1985,0,2052466,2052466,2.850417
4182,Life Upside Down,1964-09-01,1964,0,0,0,0.106273
4191,The Bride Wore Black,1968-03-22,1968,747000,44566,-702434,2.775402
4192,Death on the Nile,1978-10-06,1978,7920000,14560084,6640084,11.162277
4193,Evil Under the Sun,1982-03-05,1982,0,6110000,6110000,10.526095
4195,Bluebeard,1963-01-25,1963,0,0,0,1.122109
4196,Lenin: The Train,1988-11-30,1988,0,0,0,1.383406
4199,The Man in the Iron Mask,1977-07-07,1977,0,0,0,4.206418
4201,The Fifth Musketeer,1979-04-06,1979,0,0,0,0.776852
4202,Danton,1983-01-12,1983,0,0,0,1.547715
4203,Women on the Verge of a Nervous Breakdown,1988-03-14,1988,700000,7179298,6479298,5.470331
4204,$5 a Day,2008-01-01,2008,0,0,0,2.326842
4226,Shriek If You Know What I Did Last Friday the Thirteenth,2000-10-17,2000,5000000,0,-5000000,3.956594
4228,The French Revolution,1989-10-01,1989,0,0,0,1.225507
4232,Scream,1996-12-20,1996,14000000,173046663,159046663,13.326443
4233,Scream 2,1997-12-09,1997,24000000,172363301,148363301,11.264845
4234,Scream 3,2000-02-03,2000,40000000,161834276,121834276,9.738371
4235,The Sicilian Clan,1969-12-01,1969,0,0,0,4.844351
4241,Visitor Q,2001-03-17,2001,0,0,0,3.577025
4244,The Kid,2000-07-07,2000,65000000,69700000,4700000,15.045725
4247,Scary Movie,2000-07-07,2000,19000000,278019771,259019771,12.446738
4248,Scary Movie 2,2001-07-04,2001,45000000,141220678,96220678,10.869056
4250,Pornorama,2007-10-11,2007,0,0,0,1.394429
4251,Veer-Zaara,2004-11-12,2004,7000000,29385320,22385320,3.319516
4252,Chalte Chalte,2003-06-12,2003,0,0,0,1.499512
4253,Hum Tum,2004-05-28,2004,0,0,0,2.58331
4254,Kal Ho Naa Ho,2003-11-27,2003,0,13200241,13200241,5.584308
4255,The Party at Kitty and Stud's,1970-02-10,1970,5000,0,-5000,1.045731
4256,Scary Movie 3,2003-10-24,2003,48000000,220673217,172673217,11.142209
4257,Scary Movie 4,2006-04-13,2006,45000000,178262620,133262620,13.096692
4258,Scary Movie 5,2013-04-11,2013,20000000,78378744,58378744,14.27281
4266,The Breach,1970-08-26,1970,0,0,0,1.448326
4267,Get Out Your Handkerchiefs,1978-01-11,1978,0,0,0,2.411369
4269,Une Chambre en Ville,1982-10-27,1982,0,0,0,0.828192
4271,Life Is a Long Quiet River,1988-02-03,1988,0,0,0,4.520077
4274,Fort Saganne,1984-05-11,1984,6000000,0,-6000000,1.848788
4279,The Married Couple of the Year Two,1971-04-07,1971,0,0,0,0.982414
4281,Appointment with Death,1988-04-15,1988,0,960040,960040,10.158324
4283,Primeval,2007-01-12,2007,0,10597734,10597734,2.454709
4285,After Five In The Forest Primeval,1995-09-30,1995,0,0,0,0.634599
4286,The Innocent,1976-09-09,1976,0,0,0,11.95878
4288,The Final Terror,1983-05-01,1983,0,0,0,1.269709
4289,Dinocroc,2004-04-20,2004,0,0,0,4.638634
4290,Supergator,2007-07-14,2007,0,0,0,1.101814
4291,Kikujiro,1999-06-05,1999,0,0,0,4.75173
4296,Millennium,1989-08-25,1989,0,0,0,2.742085
4307,The Flower of My Secret,1995-09-22,1995,0,0,0,2.286788
4311,The Sleeping Car Murder,1965-11-17,1965,0,0,0,0.881091
4326,Herr Lehmann,2003-10-01,2003,0,0,0,5.345104
4327,Charlie's Angels,2000-11-02,2000,92000000,264105545,172105545,9.774985
4338,I Woke Up Early The Day I Died,1998-09-13,1998,0,0,0,0.563637
4339,The Nasty Girl,1990-02-15,1990,0,0,0,0.73486
4344,Hotel Very Welcome,2007-02-13,2007,0,0,0,0.501029
4347,Atonement,2007-08-29,2007,30000000,129266061,99266061,8.913338
4348,Pride & Prejudice,2005-09-16,2005,28000000,121147947,93147947,14.439083
4349,The Kingdom,2007-08-22,2007,70000000,86658558,16658558,13.842333
4351,Bordertown,2006-05-18,2006,21000000,0,-21000000,7.814821
4365,Munchies,1987-03-01,1987,0,0,0,1.107734
4368,Dark Wolf,2003-04-15,2003,2500000,0,-2500000,0.944886
4369,Just a Question of Love,2000-01-01,2000,0,0,0,2.607919
4375,Triple Cross,1966-12-09,1966,0,0,0,10.188296
4377,The Child I Never Was,2002-01-01,2002,0,0,0,0.473153
4379,Monster-in-Law,2005-05-13,2005,43000000,154749918,111749918,6.328385
4380,Shall We Dance?,2004-10-15,2004,50000000,170128460,120128460,9.082538
4398,Lissi and the Wild Emperor,2007-10-24,2007,0,0,0,3.387671
4412,Les Mis√©rables,1958-03-11,1958,0,0,0,2.898182
4413,The Brave One,2007-09-14,2007,70000000,69766619,-233381,11.8027
4415,Les Mis√©rables,1998-05-01,1998,0,14096321,14096321,12.238488
4419,Les Mis√©rables,1948-01-21,1948,0,0,0,0.486958
4421,G.I. Jane,1997-08-22,1997,50000000,48169156,-1830844,9.37934
4435,Asoka,2001-09-13,2001,0,19000000,19000000,1.484908
4436,Kein Bund f√ºr's Leben,2007-08-30,2007,0,0,0,0.787058
4437,2010,1984-12-06,1984,28000000,40400657,12400657,7.482865
4441,Candy,2006-02-15,2006,0,2077763,2077763,4.772204
4442,The Brothers Grimm,2005-08-26,2005,88000000,105316267,17316267,15.66148
4443,Nuits rouges,1974-11-20,1974,0,0,0,0.060535
4457,Witchery,1988-12-01,1988,0,0,0,3.371289
4459,Night Without Sleep,1952-09-26,1952,0,0,0,0.14314
4460,The Snows of Kilimanjaro,1952-08-18,1952,0,0,0,1.799027
4461,Decision Before Dawn,1951-12-21,1951,0,0,0,1.030026
4462,Diplomatic Courier,1952-06-13,1952,0,0,0,1.722209
4464,Seabiscuit,2003-07-22,2003,87000000,148336445,61336445,7.851669
4474,My Super Ex-Girlfriend,2006-06-20,2006,0,60896147,60896147,12.819565
4475,The Private Lives of Pippa Lee,2009-07-07,2009,0,0,0,3.574829
4476,Legends of the Fall,1994-12-16,1994,30000000,160638883,130638883,12.199047
4477,The Devil's Own,1997-03-12,1997,90000000,140807547,50807547,10.675073
4478,Indecent Proposal,1993-04-07,1993,38000000,266614059,228614059,7.118123
4479,Les Mis√©rables,1978-12-27,1978,0,0,0,6.290962
4480,Jean de Florette,1986-08-27,1986,4940939,0,-4940939,4.883274
4481,Manon of the Spring,1986-11-19,1986,0,0,0,5.939394
4482,French Twist,1995-02-08,1995,0,0,0,2.518051
4483,The Return of Martin Guerre,1982-05-12,1982,0,0,0,1.233692
4484,La Cage aux folles,1978-10-25,1978,0,20424259,20424259,3.140011
4485,Diva,1981-03-11,1981,0,0,0,2.211854
4486,Jesus of Montreal,1989-05-17,1989,0,0,0,1.602592
4488,Friday the 13th,1980-05-09,1980,550000,59754601,59204601,12.146747
4494,Rapture,1979-06-09,1979,0,0,0,0.791425
4495,The Spirit of the Beehive,1973-10-08,1973,0,0,0,5.446736
4497,Viridiana,1961-05-17,1961,0,0,0,5.407513
4498,The Executioner,1963-09-01,1963,0,0,0,1.351875
4499,"Pepi, Luci, Bom",1980-10-27,1980,0,0,0,1.253508
4507,Jamon Jamon,1992-09-03,1992,0,0,0,4.117851
4512,The Assassination of Jesse James by the Coward Robert Ford,2007-09-02,2007,30000000,14711793,-15288207,10.111313
4513,30 Days of Night,2007-10-17,2007,30000000,75505973,45505973,8.764548
4515,Lions for Lambs,2007-10-22,2007,35000000,63215872,28215872,5.80986
4516,My Best Friend,2006-09-12,2006,0,0,0,7.37236
4517,Elizabeth: The Golden Age,2007-09-09,2007,55000000,74237563,19237563,7.608243
4518,Elizabeth,1998-09-13,1998,30000000,82150642,52150642,7.566321
4519,Conversations with My Gardener,2007-06-06,2007,0,0,0,1.732983
4520,Sleuth,2007-10-12,2007,0,342835,342835,7.612498
4523,Enchanted,2007-11-20,2007,85000000,340487652,255487652,11.447798
4529,The Defector,1966-10-20,1966,0,0,0,0.222979
4538,The Darjeeling Limited,2007-09-29,2007,16000000,24377151,8377151,6.493474
4539,Hearts of Darkness: A Filmmaker's Apocalypse,1991-09-06,1991,0,0,0,4.617117
4540,Emil and the Detectives,1931-12-02,1931,0,0,0,0.54007
4543,The Meaning of Life,1983-03-31,1983,0,0,0,11.085432
4546,The Count of Monte-Cristo,1975-01-10,1975,0,0,0,4.946081
4547,Panic Room,2002-03-29,2002,48000000,196397415,148397415,14.969502
4548,The Count of Monte Cristo,1998-09-07,1998,0,0,0,3.662748
4550,Sympathy for Lady Vengeance,2005-07-29,2005,0,23803308,23803308,7.400261
4551,Be Cool,2005-03-04,2005,53000000,95226116,42226116,13.314233
4552,A Tale of Two Sisters,2003-06-13,2003,110,0,-110,6.247028
4553,The Machinist,2004-02-09,2004,5000000,8203235,3203235,10.737565
4556,Nightwatching,2007-09-06,2007,0,0,0,0.925278
4558,Orpheus,1950-09-29,1950,0,0,0,5.017839
4561,The Story of O,1975-08-28,1975,0,0,0,5.100454
4564,Sex and the City,2008-05-12,2008,65000000,415252786,350252786,9.170332
4566,Michael Clayton,2007-09-28,2007,25000000,92991835,67991835,7.857078
4578,Flesh,1968-12-16,1968,0,0,0,1.100836
4579,Heat,1972-10-06,1972,0,0,0,0.466019
4580,Je t'aime moi non plus,1976-03-10,1976,0,0,0,0.690072
4584,Sense and Sensibility,1995-12-13,1995,16500000,135000000,118500000,10.673167
4587,Mermaids,1990-12-14,1990,31000000,35419397,4419397,5.55237
4588,"Lust, Caution",2007-09-28,2007,15000000,0,-15000000,6.96177
4592,Carolina,2003-07-04,2003,0,0,0,2.537388
4593,The Discreet Charm of the Bourgeoisie,1972-09-15,1972,800000,0,-800000,4.8779
4595,Jour de F√™te,1949-05-04,1949,0,0,0,2.058081
4597,Armored,2009-12-04,2009,20000000,22942221,2942221,9.951662
4599,Raising Helen,2004-05-27,2004,50000000,49718611,-281389,12.448933
4612,Absolon,2003-01-01,2003,0,0,0,4.113554
4613,Scorched,2003-05-17,2003,0,0,0,4.163428
4614,The Sum of All Fears,2002-05-31,2002,68000000,193000000,125000000,9.268136
4627,Krabat and the Legend of the Satanic Mill,2008-09-07,2008,8000000,0,-8000000,4.562917
4628,Enigma,1983-01-28,1983,0,0,0,0.778734
4629,December Boys,2007-09-20,2007,4000000,46474,-3953526,4.661689
4638,Hot Fuzz,2007-02-14,2007,12000000,80573774,68573774,13.535195
4639,Best Seller,1987-09-25,1987,0,4278150,4278150,2.173823
4641,Read It and Weep,2006-07-21,2006,0,0,0,3.627385
4643,The Guardian,2006-09-28,2006,70000000,55011732,-14988268,10.031817
4644,The Year of Getting to Know Us,2008-01-24,2008,0,0,0,2.515378
4645,√ñdipussi,1988-03-10,1988,0,0,0,2.238474
4652,The Golden Goose,1964-09-26,1964,0,0,0,0.486657
4657,Jindabyne,2006-07-20,2006,0,0,0,1.625032
4658,Arctic Tale,2007-06-17,2007,0,0,0,1.499028
4676,Grande √©cole,2004-02-04,2004,0,0,0,0.717425
4680,Two Men in Town,1973-10-24,1973,0,0,0,2.740764
4683,A Gorgeous Girl Like Me,1972-09-13,1972,0,457163,457163,0.326486
4688,Across the Universe,2007-09-14,2007,0,0,0,9.161581
4689,Sympathy for Mr. Vengeance,2002-03-29,2002,4000000,1954937,-2045063,6.314697
4695,Pappa ante Portas,1991-02-21,1991,0,0,0,1.844696
4701,A Tale of Two Cities,1958-02-07,1958,0,0,0,2.584719
4703,Daisy Miller,1974-05-22,1974,2000000,0,-2000000,1.053839
4704,At Long Last Love,1975-03-01,1975,6000000,1500000,-4500000,0.619076
4705,The Sensuous Nurse,1975-12-19,1975,0,0,0,1.592784
4706,The Lady Vanishes,1979-04-30,1979,0,0,0,1.146957
4708,Is Paris Burning?,1966-10-26,1966,0,0,0,2.076076
4709,Holiday for Henrietta,1952-12-17,1952,0,0,0,0.001197
4710,Masculin F√©minin,1966-03-22,1966,0,0,0,3.774605
4722,Body Snatchers,1993-06-09,1993,13000000,428868,-12571132,6.559693
4723,Southland Tales,2006-05-15,2006,17000000,374743,-16625257,6.242588
4727,The Gendarme of St. Tropez,1964-09-08,1964,0,0,0,6.479033
4728,The Gendarme in New York,1965-10-28,1965,0,0,0,4.363057
4729,The Gendarme Gets Married,1968-10-30,1968,0,0,0,4.269485
4734,Van Gogh,1991-10-30,1991,0,138000,138000,1.484109
4747,Nathalie Granger,1972-10-06,1972,0,0,0,0.356234
4762,The Lost Honor of Katharina Blum,1975-10-10,1975,1000000,0,-1000000,7.172922
4771,Gone Baby Gone,2007-10-19,2007,19000000,34619699,15619699,6.148516
4772,Cul-de-sac,1966-02-01,1966,0,0,0,3.681667
4780,Obsession,1976-08-01,1976,0,0,0,3.417112
4781,The War Is Over,1966-05-10,1966,0,0,0,0.661107
4786,Rudo & Cursi,2008-12-19,2008,0,0,0,3.54169
4787,Cassandra's Dream,2007-06-18,2007,0,0,0,6.062873
4789,The Garden of the Finzi-Continis,1970-12-04,1970,0,0,0,2.105027
4790,The Nada Gang,1974-03-21,1974,0,0,0,0.516866
4798,"Je t'aime, je t'aime",1968-04-24,1968,0,0,0,1.236641
4806,Runaway Bride,1999-07-30,1999,70000000,309457509,239457509,8.919469
4808,Charade,1963-12-05,1963,4000000,13474588,9474588,7.098731
4809,Good Morning Miss Dove,1955-11-23,1955,0,0,0,0.398853
4816,Ghost Dog: The Way of the Samurai,1999-09-13,1999,0,0,0,9.368099
4820,Never So Few,1959-12-07,1959,0,0,0,2.424056
4822,Kismet,1955-10-08,1955,0,0,0,0.462062
4823,Final Analysis,1992-02-07,1992,0,28590665,28590665,4.43707
4824,The Jackal,1997-11-14,1997,60000000,159330280,99330280,11.131917
4825,Guys and Dolls,1955-11-03,1955,5500000,0,-5500000,4.860664
4832,The 11th Hour,2007-08-17,2007,0,0,0,2.215689
4836,Layer Cake,2004-09-30,2004,6500000,11850214,5350214,9.642214
4837,La Collectionneuse,1967-03-02,1967,0,0,0,1.683348
4839,Love Life,2007-11-08,2007,0,0,0,0.560775
4857,"Farewell, Friend",1968-08-14,1968,0,0,0,2.014299
4858,The Invasion,2007-08-17,2007,80000000,15071514,-64928486,5.228837
4868,Genghis Khan,1965-06-23,1965,0,0,0,6.946494
4879,Ten Little Indians,1965-09-09,1965,0,0,0,2.922684
4880,Nichts als Gespenster,2006-11-29,2006,0,0,0,0.333738
4882,A Bullet for Pretty Boy,1970-07-15,1970,0,0,0,0.000603
4883,Ten Little Indians,1974-09-24,1974,0,0,0,8.597074
4885,Ten Little Indians,1987-01-01,1987,0,0,0,1.832792
4886,And Then There Were None,1945-10-31,1945,0,0,0,4.496034
4887,Takva: A Man's Fear of God,2006-12-01,2006,0,0,0,0.862463
4889,Billion Dollar Brain,1967-11-02,1967,0,0,0,2.129835
4893,Where the Spies Are,1966-01-26,1966,0,0,0,0.406593
4896,Muxm√§uschenstill,2004-01-28,2004,40000,0,-40000,0.338723
4909,The Day of the Jackal,1973-05-15,1973,0,0,0,6.320225
4910,The Man Who Haunted Himself,1970-02-18,1970,400000,0,-400000,8.219562
4911,Dark Blue,2002-12-14,2002,15000000,9237470,-5762530,4.98408
4912,Confessions of a Dangerous Mind,2002-12-30,2002,30000000,33013805,3013805,7.645827
4912,Confessions of a Dangerous Mind,2002-12-30,2002,30000000,33013805,3013805,11.331072
4913,"Sorry, Haters",2005-09-10,2005,200000,0,-200000,1.359754
4916,Guilty as Sin,1993-06-04,1993,0,22886222,22886222,5.385108
4917,A Boy and His Dog,1975-11-20,1975,0,0,0,8.386787
4918,The Fourth Protocol,1987-08-28,1987,0,0,0,3.246823
4921,Vivere,2007-04-26,2007,0,0,0,0.068606
4922,The Curious Case of Benjamin Button,2008-11-24,2008,150000000,333932083,183932083,17.934821
4923,Zardoz,1974-02-06,1974,0,0,0,10.698934
4925,Dead Bang,1989-03-24,1989,0,8125592,8125592,1.698895
4926,Cry Terror!,1958-05-02,1958,0,0,0,2.554227
4927,Edge of Seventeen,1998-05-14,1998,1500000,870751,-629249,1.666469
4928,"The World, the Flesh and the Devil",1959-05-20,1959,0,0,0,1.441529
4929,Hang 'em High,1968-07-31,1968,1800000,6800000,5000000,7.266576
4930,House of Cards,1968-09-16,1968,0,0,0,0.332318
4931,Madigan,1968-03-29,1968,0,0,0,1.651189
4932,A Guide for the Married Man,1967-01-01,1967,0,0,0,2.063207
4933,The Buccaneer,1958-12-11,1958,0,0,0,0.720247
4934,Firecreek,1968-01-24,1968,0,0,0,9.443289
4935,Howl's Moving Castle,2004-11-19,2004,24000000,234710455,210710455,16.136048
4938,The Last Frontier,1955-12-07,1955,0,0,0,0.758097
4939,Send Me No Flowers,1964-10-14,1964,0,0,0,2.163293
4942,Leatherheads,2008-03-24,2008,58000000,41299492,-16700508,9.37102
4944,Burn After Reading,2008-09-05,2008,37000000,163720069,126720069,13.206799
4946,The Swimming Pool,1969-01-15,1969,0,0,0,3.303818
4948,Womanlight,1979-08-29,1979,0,0,0,0.627959
4949,A Time for Killing,1967-08-01,1967,2000000,0,-2000000,5.437705
4951,10 Things I Hate About You,1999-03-30,1999,16000000,53478166,37478166,12.069966
4952,Pillow Talk,1959-10-07,1959,0,0,0,2.208919
4953,Be Kind Rewind,2008-01-20,2008,0,0,0,4.848692
4954,Drop Zone,1994-12-08,1994,45000000,0,-45000000,9.579155
4955,M√§dchen in Uniform,1958-07-07,1958,0,0,0,0.564358
4956,Christine,1958-12-19,1958,0,0,0,0.631242
4958,The Legend of Bagger Vance,2000-11-02,2000,80000000,39459427,-40540573,9.034884
4959,The International,2009-02-03,2009,50000000,60161391,10161391,6.583609
4960,"Synecdoche, New York",2008-10-24,2008,21000000,0,-21000000,6.295807
4961,Mimic,1997-08-22,1997,30000000,25480490,-4519510,9.128905
4962,"Farewell, Home Sweet Home",1999-12-01,1999,0,0,0,0.63125
4964,Knocked Up,2007-06-01,2007,30000000,219076518,189076518,9.058516
4965,Impostor,2001-12-03,2001,40000000,0,-40000000,8.209652
4966,Pan Tadeusz,1999-10-18,1999,0,0,0,0.5853
4967,Keeping the Faith,2000-04-14,2000,30000000,37036004,7036004,6.045585
4968,The Piano Player,2003-07-22,2003,0,0,0,1.260539
4970,Gothika,2003-11-21,2003,40000000,141591324,101591324,10.939066
4972,The Green Butchers,2003-03-08,2003,0,0,0,6.438965
4973,Under the Sand,2000-09-11,2000,0,0,0,1.860018
4974,Five Times Two,2004-09-01,2004,0,0,0,4.545971
4975,Love Is the Devil: Study for a Portrait of Francis Bacon,1998-09-16,1998,0,0,0,1.354102
4977,Paprika,2006-10-01,2006,0,944915,944915,7.128022
4978,An American Tail,1986-11-21,1986,9000000,84542002,75542002,11.928545
4979,Windows on Monday,2006-02-10,2006,0,0,0,0.405594
4982,American Gangster,2007-11-02,2007,100000000,266465037,166465037,9.644542
4983,"Run, Simon, Run",1970-12-01,1970,0,0,0,0.001586
4984,White Lightning,1973-08-06,1973,0,0,0,2.580493
4985,The Longest Yard,1974-08-21,1974,2900000,43008075,40108075,9.460843
4986,Fuzz,1972-07-14,1972,0,0,0,1.707715
4988,Semi-Tough,1977-11-18,1977,0,0,0,2.630796
4989,Shamus,1973-01-31,1973,0,0,0,0.674968
4990,Hustle,1975-12-25,1975,0,0,0,0.739836
4992,Shark!,1969-10-08,1969,0,0,0,0.412384
4993,5 Card Stud,1968-07-28,1968,0,0,0,1.372254
4995,Boogie Nights,1997-09-11,1997,15000000,43101594,28101594,7.595679
4997,Wonderland,2003-10-23,2003,5000000,2466444,-2533556,8.062123
4998,Import/Export,2007-05-21,2007,0,0,0,4.824224
5000,Forbidden Games,1952-05-09,1952,0,10188,10188,3.936747
5001,Before Night Falls,2000-09-03,2000,0,8524534,8524534,3.933132
5002,Lifeguard,1976-07-23,1976,0,0,0,0.484227
5038,Vicky Cristina Barcelona,2008-08-15,2008,15000000,96408652,81408652,9.648539
5040,Pharaoh,1966-03-10,1966,0,0,0,0.739512
5048,Prospero's Books,1991-09-05,1991,0,1750301,1750301,1.572239
5051,The Baby of M√¢con,1993-05-01,1993,0,0,0,4.46536
5052,Topkapi,1964-09-02,1964,0,0,0,4.769209
5055,Ashes and Diamonds,1958-10-03,1958,0,0,0,2.896039
5056,Deadlier Than the Male,1967-02-12,1967,0,0,0,1.244935
5060,Carry On Screaming,1966-05-20,1966,0,0,0,6.933646
5061,Carry On Don't Lose Your Head,1966-12-10,1966,0,0,0,5.744152
5062,The Inquisitor,1981-09-21,1981,0,0,0,2.445608
5063,The Passerby,1982-04-14,1982,0,0,0,0.634683
5064,Carry On Doctor,1967-12-02,1967,0,0,0,1.353069
5065,Carry On Cowboy,1966-03-01,1966,0,0,0,5.236409
5066,Carry On Cleo,1964-11-08,1964,0,0,0,6.143986
5067,The Burning Court,1962-03-20,1962,0,0,0,0.252374
5070,How Much Do You Love Me?,2005-10-26,2005,0,0,0,6.599255
5071,The Crazy Stranger,1997-08-10,1997,0,0,0,1.481076
5072,Severance,2006-05-19,2006,0,0,0,9.632547
5086,Ator IV: The Hobgoblin,1990-01-01,1990,0,0,0,0.22135
5121,The Sugarland Express,1974-04-05,1974,3000000,12800000,9800000,4.506948
5122,The Day of the Locust,1975-05-07,1975,0,0,0,1.610164
5123,August Rush,2007-11-21,2007,25000000,66122026,41122026,8.874048
5125,Rendition,2007-09-07,2007,27500000,24748670,-2751330,13.482558
5126,Martian Child,2007-11-02,2007,0,0,0,5.038252
5137,Sky Captain and the World of Tomorrow,2004-09-17,2004,70000000,57958696,-12041304,9.64113
5139,The Fox & the Child,2007-12-27,2007,13000000,0,-13000000,4.625825
5143,Hannah and Her Sisters,1986-02-07,1986,6400000,40084041,33684041,9.57874
5145,The Business,2005-09-02,2005,0,0,0,3.10889
5146,The In-Laws,2003-05-23,2003,0,20440627,20440627,6.585107
5147,The Lost Continent,1968-06-19,1968,0,0,0,0.716881
5153,Cabiria,1914-06-01,1914,210,0,-210,0.704028
5155,Ossessione,1943-05-16,1943,0,0,0,2.112961
5156,Bicycle Thieves,1948-11-24,1948,133000,361712,228712,13.233136
5157,Beneath the Valley of the Ultra-Vixens,1979-05-11,1979,239000,0,-239000,4.565827
5165,L'Avventura,1960-05-15,1960,0,0,0,9.595757
5168,To Be and to Have,2002-05-19,2002,1000000,0,-1000000,1.57002
5172,The Astronaut Farmer,2006-10-15,2006,13000000,11130889,-1869111,6.862146
5174,Rush Hour 3,2007-08-08,2007,140000000,258022233,118022233,9.718111
5175,Rush Hour 2,2001-08-03,2001,90000000,347325802,257325802,8.345985
5176,3:10 to Yuma,2007-09-06,2007,55000000,70016220,15016220,18.079094
5177,Dark Horse,2005-05-13,2005,0,0,0,2.571665
5178,The Good Heart,2009-09-11,2009,3800000,0,-3800000,3.572157
5179,The Prime of Miss Jean Brodie,1969-02-24,1969,0,0,0,2.641535
5183,Travels with My Aunt,1972-12-12,1972,0,0,0,4.884367
5185,The Private Life of Sherlock Holmes,1970-10-29,1970,10000000,1500000,-8500000,4.127728
5187,Three of Hearts,1993-04-30,1993,0,0,0,4.689828
5201,Wild Orchids,1929-02-23,1929,322000,0,-322000,0.422399
5203,Wild Orchid,1989-12-22,1989,7000000,0,-7000000,17.395203
5204,Control,2003-11-20,2003,500000,0,-500000,3.569896
5205,Pumping Iron,1977-01-18,1977,1000000,0,-1000000,5.866383
5206,The Boss of It All,2006-09-21,2006,3000000,0,-3000000,4.066106
5227,Hercules in New York,1969-02-23,1969,0,0,0,3.97439
5228,Stay Hungry,1976-04-23,1976,5000000,24854765,19854765,2.44274
5236,Kiss Kiss Bang Bang,2005-09-05,2005,15000000,15785148,785148,11.76054
5237,Dust Devil,1992-08-08,1992,8000000,0,-8000000,11.774191
5241,Two Moon Junction,1988-04-29,1988,0,1547397,1547397,2.262915
5247,Mercy,2000-02-11,2000,0,0,0,1.520526
5248,Virtual Sexuality,1999-07-02,1999,0,0,0,0.451689
5252,Ardor,2002-11-08,2002,0,0,0,1.878372
5255,The Polar Express,2004-11-10,2004,165000000,305875730,140875730,14.27536
5256,Momentum,2003-03-26,2003,0,0,0,1.418634
5257,The Dish,2000-07-11,2000,0,0,0,6.263988
5259,The Band's Visit,2007-05-19,2007,0,0,0,9.410107
5261,What to Do in Case of Fire?,2001-11-01,2001,0,0,0,1.510797
5279,Gosford Park,2001-11-07,2001,19800000,87754044,67954044,14.101101
5289,Chaos,2005-01-17,2005,20000000,10289,-19989711,9.51795
5302,Without You I'm Nothing,1990-05-11,1990,0,1218730,1218730,0.138263
5319,Hum Dil De Chuke Sanam,1999-06-18,1999,0,0,0,1.531604
5332,Dancing at Lughnasa,1998-09-04,1998,0,0,0,1.157399
5333,Apartment Zero,1988-09-30,1988,4000000,670774,-3329226,3.927714
5334,Billy Budd,1962-11-12,1962,0,0,0,3.557657
5335,Teorema,1968-09-04,1968,0,0,0,2.136487
5336,"Sal√≤, or the 120 Days of Sodom",1975-11-22,1975,0,0,0,7.705479
5353,The Hunting Party,2007-09-03,2007,0,0,0,5.178628
5375,Fred Claus,2007-11-03,2007,100000000,97838349,-2161651,5.502098
5393,Happily N'Ever After,2006-09-14,2006,47000000,38085778,-8914222,13.139893
5413,Omagh,2004-05-22,2004,0,0,0,0.769035
5421,Monster Hunter,1981-10-11,1981,0,0,0,1.06733
5422,Erotic Nights of the Living Dead,1980-11-18,1980,0,0,0,1.420104
5424,The Grim Reaper,1980-08-07,1980,0,0,0,1.188769
5425,Beyond the Darkness,1979-11-15,1979,0,0,0,8.541796
5434,Death Smiles on a Murderer,1973-01-11,1973,0,0,0,0.723834
5458,Cruel Intentions 2,2000-11-09,2000,0,0,0,4.333637
5460,Cruel Intentions 3,2004-05-25,2004,0,0,0,3.319071
5465,The Million Game,1970-10-18,1970,0,0,0,0.951375
5470,Beowulf,1999-04-01,1999,20000000,1531251,-18468749,7.745765
5471,Beowulf & Grendel,2005-09-14,2005,0,92076,92076,5.606454
5473,De Dominee,2004-09-02,2004,0,0,0,0.30404
5481,Shock,1977-08-12,1977,0,0,0,0.992774
5482,Rabid Dogs,1974-01-01,1974,0,0,0,1.709155
5483,Lisa and the Devil,1973-05-08,1973,1000000,0,-1000000,1.958345
5484,Four Times That Night,1972-04-15,1972,0,0,0,0.198206
5485,Baron Blood,1972-02-25,1972,0,0,0,1.017532
5486,A Bay of Blood,1971-08-08,1971,0,0,0,4.725878
5488,"I'm a Cyborg, But That's OK",2006-12-07,2006,0,4354510,4354510,4.369975
5491,Battlefield Earth,2000-05-10,2000,44000000,21400000,-22600000,5.276926
5493,Returner,2002-08-31,2002,0,0,0,4.223815
5494,George and the Dragon,2004-03-28,2004,32000000,0,-32000000,5.02811
5503,The Fugitive,1993-08-06,1993,44000000,368875760,324875760,10.08937
5506,The Ladykillers,1955-12-08,1955,0,0,0,12.509812
5511,Le Samoura√Ø,1967-10-25,1967,0,39481,39481,9.091288
5511,Le Samoura√Ø,1967-10-25,1967,0,39481,39481,9.091288
5516,The Ladykillers,2004-03-25,2004,0,0,0,13.106691
5519,Finders Killers,1971-03-27,1971,0,0,0,0.000112
5521,Finder's Fee,2001-01-01,2001,0,0,0,6.693644
5528,The Chorus,2004-03-17,2004,0,0,0,14.758133
5544,Hiroshima Mon Amour,1959-06-10,1959,0,0,0,6.953676
5546,Dead Weekend,1995-10-08,1995,0,0,0,0.549569
5548,RoboCop,1987-07-17,1987,13000000,53000000,40000000,13.485583
5549,RoboCop 2,1990-06-22,1990,35000000,45681173,10681173,10.969876
5550,RoboCop 3,1993-04-17,1993,22000000,10696210,-11303790,8.685798
5551,Space Cowboys,2000-07-31,2000,65000000,128884132,63884132,7.45761
5552,Immortal,2004-03-13,2004,24665810,0,-24665810,9.785721
5558,The Phantom of Liberty,1974-09-10,1974,0,0,0,2.427337
5559,Bee Movie,2007-10-28,2007,150000000,287594577,137594577,8.774374
5562,Le Beau Serge,1958-06-06,1958,0,0,0,1.569349
5589,≈†√≠lenƒõ smutn√° princezna,1968-06-07,1968,0,0,0,0.375001
5590,Donkey Skin,1970-12-20,1970,0,0,0,4.668104
5592,A Girl Cut in Two,2007-08-08,2007,0,0,0,1.824206
5595,Fermat's Room,2007-10-07,2007,0,0,0,3.950545
5601,Shock Treatment,1973-01-18,1973,0,0,0,0.747647
5602,The Common Man,1975-02-26,1975,0,0,0,0.729701
5608,"The Nibelungs, Tale 1: Siegfried",1966-12-13,1966,0,0,0,1.311263
5618,"Cousin, Cousine",1975-11-19,1975,0,0,0,0.624726
5620,Count Dracula,1970-04-03,1970,0,0,0,5.419176
5622,And the Ship Sails On,1983-10-06,1983,0,0,0,1.715072
5638,Alice's Restaurant,1969-08-20,1969,0,0,0,1.921563
5646,Wild Gals of the Naked West,1962-05-09,1962,0,0,0,1.504398
5648,The Immoral Mr. Teas,1959-01-01,1959,0,0,0,0.50489
5651,Up!,1976-10-01,1976,0,0,0,2.342003
5652,The James Dean Story,1957-08-13,1957,0,0,0,0.505885
5653,Luther,2003-10-29,2003,0,0,0,7.182909
5654,War and Peace,2007-10-19,2007,0,0,0,0.920385
5677,Trancers,1984-11-07,1984,400000,0,-400000,6.272745
5678,The Wrong Guys,1988-05-13,1988,0,0,0,1.224667
5680,"Elvira, Mistress of the Dark",1988-09-30,1988,0,5596267,5596267,5.554398
5683,Pee-wee's Big Adventure,1985-07-26,1985,6000000,40940662,34940662,11.461437
5686,A Night in Heaven,1983-04-21,1983,0,0,0,0.845334
5689,The Blue Lagoon,1980-07-05,1980,4500000,58853106,54353106,11.578578
5691,The Canterbury Tales,1972-07-01,1972,0,0,0,2.987674
5693,Hoosiers,1986-11-14,1986,9000000,28607524,19607524,6.484495
5698,The Great Train Robbery,1903-12-01,1903,150,0,-150,4.248169
5707,Shooting War,2000-12-07,2000,0,0,0,0.468108
5708,Control,2007-09-26,2007,0,8159508,8159508,8.00969
5709,Amazon Women on the Moon,1987-09-18,1987,0,0,0,2.646976
5717,Man Push Cart,2005-09-01,2005,0,0,0,3.472216
5718,King of California,2007-01-24,2007,0,1027699,1027699,13.088825
5719,Mudhoney,1965-05-25,1965,60000,0,-60000,0.666828
5721,Vixen!,1968-10-15,1968,76000,6000000,5924000,1.310245
5722,Beyond the Valley of the Dolls,1970-07-17,1970,2090000,40000000,37910000,3.129943
5723,Once,2007-03-23,2007,160000,20710513,20550513,10.357064
5725,Supervixens,1975-04-02,1975,0,0,0,4.363355
5726,Mondo Topless,1966-11-17,1966,0,0,0,1.075191
5728,Day of the Idiots,1981-10-31,1981,0,0,0,0.23842
5729,L'√Çge d'Or,1930-10-28,1930,0,7940,7940,2.76145
5731,Summer City,1977-12-22,1977,0,0,0,0.076562
5741,Lorna,1964-09-11,1964,60000,0,-60000,1.59241
5742,"Cherry, Harry & Raquel!",1970-04-22,1970,90000,0,-90000,1.164316
5744,Fanny Hill,1964-09-25,1964,0,0,0,0.356967
5747,Common Law Cabin,1967-07-01,1967,0,0,0,0.48006
5748,Good Morning... and Goodbye!,1967-11-01,1967,0,0,0,0.650033
5753,Deadly Prey,1987-11-02,1987,0,0,0,1.737379
5757,Man of the Year,1995-09-15,1995,0,209935,209935,0.540436
5759,Baghead,2008-01-21,2008,0,0,0,1.74461
5761,Hannah Takes the Stairs,2007-03-11,2007,0,0,0,0.564638
5764,Princess of Thieves,2001-03-11,2001,0,0,0,2.638317
5765,Knight Moves,1992-01-14,1992,0,0,0,7.431507
5767,Two for the Road,1967-04-27,1967,0,0,0,14.701129
5769,Tom Jones,1963-10-06,1963,1000000,37600000,36600000,3.315827
5780,Torn Curtain,1966-07-13,1966,3000000,13000000,10000000,6.243248
5781,That Obscure Object of Desire,1977-08-17,1977,0,0,0,6.049944
5800,Can I Do It Till I Need Glasses?,1977-08-01,1977,0,0,0,0.831305
5801,Pather Panchali,1955-08-26,1955,0,536364,536364,3.900709
5804,The Key to Reserva (La clave Reserva),2007-12-14,2007,0,0,0,6.053682
5816,Waiter,2006-09-28,2006,0,0,0,4.71491
5817,"You, the Living",2007-09-21,2007,0,0,0,3.253596
5820,The Sentinel,2006-04-19,2006,60000000,77920346,17920346,12.915358
5822,Sweet Sweetback's Baadasssss Song,1971-04-23,1971,150000,15200000,15050000,1.435148
5825,National Lampoon's Christmas Vacation,1989-12-01,1989,27000000,71320000,44320000,9.802574
5833,Casper's Haunted Christmas,2000-10-31,2000,0,0,0,3.569907
5839,The Magliari,1959-09-23,1959,0,0,0,0.145653
5842,Versus,2000-10-23,2000,10000,0,-10000,2.304575
5844,Alive,2002-09-12,2002,0,0,0,1.877915
5845,Aragami,2003-03-27,2003,0,0,0,2.102954
5846,Sky High,2003-12-05,2003,0,0,0,0.791678
5850,Times and Winds,2006-09-29,2006,0,0,0,1.442059
5851,Showtime,2002-03-14,2002,85000000,77741732,-7258268,4.917863
5852,Angel Eyes,2001-05-15,2001,53000000,29700000,-23300000,5.3962
5854,Family Plot,1976-04-09,1976,2000000,7900000,5900000,4.845776
5856,Hotel St. Pauli,1988-03-03,1988,0,0,0,0.60281
5857,I Know Who Killed Me,2007-07-27,2007,12000000,9620399,-2379601,4.961439
5871,The World is Big and Salvation Lurks Around the Corner,2008-03-14,2008,0,0,0,2.114403
5876,The Mist,2007-11-21,2007,18000000,57096190,39096190,8.435642
5879,In the Realm of the Senses,1976-05-15,1976,0,0,0,8.932494
5881,Twice Upon a Time,2006-11-08,2006,0,0,0,0.269749
5889,Azumi,2003-05-10,2003,0,0,0,6.415721
5890,Azumi 2: Death or Love,2005-03-12,2005,0,0,0,6.754744
5894,Blue in the Face,1995-09-15,1995,2000000,1275000,-725000,11.528147
5896,Bolero,1984-08-31,1984,7000000,8914881,1914881,1.456485
5898,Brain Dead,1990-01-16,1990,2000000,0,-2000000,10.28123
5899,The Northerners,1992-04-17,1992,0,0,0,0.91237
5900,The Dress,1996-03-21,1996,0,0,0,0.670145
5902,A Bridge Too Far,1977-06-15,1977,22000000,50750000,28750000,7.719173
5910,Fireworks,1997-09-03,1997,0,0,0,5.044722
5915,Into the Wild,2007-09-11,2007,15000000,56255142,41255142,15.423538
5916,The Getaway,1972-12-13,1972,3352254,58831997,55479743,10.037593
5917,Tom Horn,1980-03-28,1980,0,0,0,1.95931
5919,The Towering Inferno,1974-12-14,1974,14000000,116000000,102000000,7.469056
5920,Le Mans,1971-06-23,1971,0,0,0,3.571383
5921,Nevada Smith,1966-06-10,1966,0,0,0,6.974375
5922,The Hunter,1980-08-01,1980,0,0,0,5.432879
5923,The Sand Pebbles,1966-12-20,1966,12000000,20000000,8000000,11.354247
5924,Papillon,1973-12-13,1973,12000000,53267000,41267000,15.698433
5925,The Great Escape,1963-06-20,1963,4000000,11744471,7744471,14.384114
5927,Junior Bonner,1972-08-02,1972,0,0,0,1.464329
5928,The Reivers,1969-12-25,1969,0,0,0,1.813867
5937,John Rabe,2009-04-02,2009,20000000,0,-20000000,9.154152
5951,The Jane Austen Book Club,2007-09-09,2007,0,0,0,10.061477
5953,The Lady in the Car with Glasses and a Gun,1970-10-22,1970,0,0,0,0.813526
5955,The Pledge,2001-01-09,2001,35000000,29400000,-5600000,12.806634
5956,Joshua,2007-01-21,2007,0,719968,719968,6.941735
5961,Fanny & Alexander,1982-12-17,1982,0,4971340,4971340,5.472431
5965,Scorcher,2003-01-01,2003,0,0,0,1.483815
5966,Along Came Polly,2004-01-16,2004,42000000,171963386,129963386,15.725542
5967,The Umbrellas of Cherbourg,1964-02-19,1964,0,0,0,8.133881
5968,The Woman in Red,1984-08-15,1984,25300000,0,-25300000,19.856025
5971,We're No Angels,1989-12-15,1989,20000000,0,-20000000,14.348459
5991,The Last Laugh,1924-12-23,1924,0,0,0,3.553763
5994,The Family Man,2000-12-12,2000,60000000,0,-60000000,6.287072
5995,Miffo,2003-07-31,2003,0,0,0,0.768593
5996,We're No Angels,1955-01-01,1955,0,0,0,5.825214
5998,"Dr. Mabuse, the Gambler",1922-04-27,1922,0,0,0,3.275117
6003,Romeo and Juliet,1968-04-02,1968,0,38901218,38901218,6.99099
6007,Elling,2001-03-16,2001,0,0,0,2.148946
6016,The Good Thief,2003-04-03,2003,0,0,0,4.022761
6020,Sorority Boys,2002-03-22,2002,12000000,0,-12000000,3.500267
6022,Evening,2007-06-09,2007,0,0,0,2.291288
6023,P.S. I Love You,2007-11-15,2007,30000000,156835339,126835339,10.304881
6028,The Mirror Crack'd,1980-09-19,1980,0,11000000,11000000,2.481504
6029,Secret of the Blackbirds,1983-01-01,1983,0,0,0,1.002194
6037,Murder by Death,1976-06-23,1976,0,0,0,5.570606
6038,Shanghai Knights,2003-02-06,2003,50000000,88323487,38323487,7.469778
6058,The Patriot,1998-07-10,1998,25000000,0,-25000000,5.903348
6068,Six Days Seven Nights,1998-06-12,1998,70000000,164000000,94000000,18.324219
6069,The Witches of Eastwick,1987-06-12,1987,0,63766510,63766510,13.031671
6071,Kiss of Death,1995-04-21,1995,40000000,0,-40000000,7.797512
6072,One Eight Seven,1997-07-29,1997,20000000,5716080,-14283920,6.476493
6073,The Mexican,2001-03-01,2001,57000000,147845033,90845033,9.958406
6075,Carlito's Way,1993-11-10,1993,30000000,36516012,6516012,8.698509
6076,Rabbit Without Ears,2007-12-01,2007,0,81303447,81303447,6.370074
6077,13 Tzameti,2005-09-01,2005,0,767311,767311,2.38476
6078,The Strange Case of the End of Civilization as We Know It,1977-09-18,1977,0,0,0,0.835451
6079,Empties,2007-03-08,2007,0,0,0,1.697787
6081,Revenge of the Pink Panther,1978-07-19,1978,0,49579269,49579269,6.970037
6103,Thirteen at Dinner,1985-09-19,1985,0,0,0,1.470012
6105,Dead Man's Folly,1986-01-08,1986,0,0,0,0.784587
6106,Salvador,1986-04-23,1986,4500000,0,-4500000,4.714357
6107,Murder in Three Acts,1986-09-30,1986,0,0,0,1.18855
6110,Murder on the Orient Express,2001-04-22,2001,0,0,0,0.490485
6114,Dracula,1992-11-13,1992,40000000,215862692,175862692,16.777675
6116,Spice World,1997-12-19,1997,25000000,100000000,75000000,4.257516
6145,Fracture,2007-04-20,2007,0,91354215,91354215,10.113628
6163,The Hessen Affair,2009-01-14,2009,20000000,0,-20000000,0.727069
6166,Dinner for One,1963-06-08,1963,0,0,0,2.317554
6171,Dreamcatcher,2003-03-21,2003,68000000,75715436,7715436,7.694847
6172,My F√ºhrer,2007-01-11,2007,0,0,0,2.044515
6173,Read My Lips,2001-10-17,2001,0,0,0,2.98332
6182,The Dream Catcher,1999-08-08,1999,0,0,0,0.289621
6183,Barefoot,2005-03-30,2005,0,0,0,2.561207
6187,Dry Cleaning,1997-09-24,1997,0,0,0,1.018341
6217,Cat People,1982-04-02,1982,0,0,0,6.126046
6264,Prince Valiant,1997-07-24,1997,0,0,0,1.74053
6277,Crime Spree,2003-04-16,2003,0,0,0,2.529571
6278,Reign of Fire,2002-07-12,2002,60000000,43061982,-16938018,13.067306
6279,Sister Act 2: Back in the Habit,1993-12-09,1993,38000000,57319029,19319029,12.986842
6280,Junior,1994-11-22,1994,60000000,37000000,-23000000,6.710215
6282,Coyote Ugly,2000-07-30,2000,45000000,113916474,68916474,15.650836
6283,MouseHunt,1997-12-19,1997,38000000,122417389,84417389,6.456233
6309,Flood,2007-08-24,2007,0,0,0,6.500496
6312,Brotherhood of the Wolf,2001-01-31,2001,29000000,70752904,41752904,11.564252
6317,Rosenstrasse,2003-09-18,2003,0,0,0,0.638808
6318,Vaya con Dios,2002-03-28,2002,0,0,0,1.011025
6320,Police,1985-09-04,1985,0,0,0,1.03609
6341,Blue Thunder,1983-02-05,1983,22000000,42313354,20313354,10.456371
6346,The Chamber,1996-10-11,1996,50000000,22540359,-27459641,3.998494
6360,Actresses,2007-05-19,2007,0,0,0,1.138369
6373,The Very Thought of You,1998-05-08,1998,0,0,0,1.233052
6382,The Nugget,2002-10-17,2002,0,0,0,0.115117
6391,Jellyfish,2007-05-05,2007,1800000,0,-1800000,0.750591
6393,Taking Care of Business,1990-08-16,1990,0,0,0,3.063907
6396,SLC Punk,1998-09-24,1998,0,299200,299200,4.370812
6399,A Friend Is a Treasure,1981-12-09,1981,0,0,0,5.928981
6404,Nosferatu the Vampyre,1979-04-11,1979,0,0,0,5.207465
6414,Beautiful Boxer,2004-04-29,2004,0,0,0,1.722765
6415,Three Kings,1999-09-27,1999,75000000,108000000,33000000,12.287636
6417,Dallas Pashamende,2005-02-02,2005,0,0,0,0.002954
6418,Hotel Chevalier,2007-09-03,2007,0,0,0,4.933446
6435,Practical Magic,1998-10-16,1998,75000000,46683377,-28316623,7.757795
6436,Star Command,1996-03-11,1996,0,0,0,0.506128
6439,Racing Stripes,2005-01-06,2005,30000000,93772522,63772522,4.817052
6440,The Shipping News,2001-12-18,2001,0,0,0,8.191094
6443,The Forest for the Trees,2004-09-16,2004,0,0,0,0.796554
6444,Auntie Danielle,1990-04-04,1990,0,0,0,2.467484
6461,Cherry Blossoms,2008-03-05,2008,0,0,0,4.233778
6463,Other People's Money,1991-10-18,1991,0,0,0,2.129442
6466,Freddy vs. Jason,2003-08-15,2003,30000000,114908830,84908830,14.015739
6470,Fire Birds,1990-05-25,1990,22000000,0,-22000000,2.65559
6471,The Jerk,1979-12-14,1979,0,73961419,73961419,5.873021
6472,Guarding Tess,1994-03-11,1994,20000000,0,-20000000,8.847461
6473,The Marksman,2005-01-01,2005,0,0,0,6.281762
6474,Navajo Joe,1966-11-25,1966,0,0,0,4.401621
6476,From Noon Till Three,1976-08-13,1976,0,0,0,1.695541
6477,Alvin and the Chipmunks,2007-12-13,2007,60000000,361366633,301366633,11.805233
6478,Beyond the Sea,2004-12-17,2004,23000000,0,-23000000,8.963653
6479,I Am Legend,2007-12-14,2007,150000000,585349010,435349010,11.379355
6488,Arachnophobia,1990-08-09,1990,31000000,53208180,22208180,5.418428
6498,Nightwatch,1994-02-25,1994,0,0,0,4.189514
6499,Turbo: A Power Rangers Movie,1997-03-27,1997,10000000,17979739,7979739,5.436745
6519,The Dukes of Hazzard,2005-08-05,2005,50000000,110803676,60803676,9.039467
6520,First Knight,1995-07-07,1995,55000000,127600435,72600435,15.178338
6521,The Contender,2000-10-13,2000,9000000,0,-9000000,15.072042
6522,Life,1999-04-16,1999,80000000,73345029,-6654971,7.579444
6523,North to Alaska,1960-11-07,1960,3500000,0,-3500000,2.827496
6524,Life Stinks,1991-07-26,1991,0,0,0,2.468817
6529,Hondo,1953-11-25,1953,0,0,0,3.768829
6535,Talk to Me,2007-07-13,2007,0,4778376,4778376,7.960831
6537,The Orphanage,2007-08-27,2007,0,44000000,44000000,16.213592
6538,Charlie Wilson's War,2007-12-19,2007,75000000,119000410,44000410,9.979162
6547,Schtonk!,1992-03-12,1992,0,0,0,0.865615
6552,Idle Hands,1999-04-30,1999,25000000,4152230,-20847770,6.851628
6557,27 Dresses,2008-01-10,2008,30000000,160259319,130259319,10.342202
6575,Walk Hard: The Dewey Cox Story,2007-12-21,2007,35000000,18317151,-16682849,7.219935
6589,Underdog,2007-08-03,2007,0,0,0,7.674338
6591,What Have You Done to Solange?,1972-03-09,1972,0,0,0,2.697093
6593,Godzilla vs. Mechagodzilla II,1993-12-11,1993,9500000,0,-9500000,2.13239
6609,Keoma,1976-11-25,1976,0,0,0,2.739487
6610,The Wonderful Country,1959-10-21,1959,0,0,0,0.528246
6615,Lars and the Real Girl,2007-10-12,2007,12000000,11293663,-706337,8.025118
6619,Death in Venice,1971-03-01,1971,0,0,0,3.770948
6620,Sabrina,1954-09-28,1954,2238813,10000000,7761187,7.359741
6623,The Peacemaker,1997-09-26,1997,50000000,0,-50000000,8.868114
6636,The Mugger,2007-04-01,2007,0,0,0,0.168087
6637,National Treasure: Book of Secrets,2007-12-13,2007,130000000,457363168,327363168,12.854373
6639,Love in the Time of Cholera,2007-10-04,2007,45000000,4607608,-40392392,5.20735
6641,Love and Other Disasters,2006-09-09,2006,0,0,0,5.630199
6643,The Unforgiven,1960-01-01,1960,0,0,0,2.914053
6644,El Dorado,1966-12-17,1966,4653000,6000000,1347000,7.070669
6646,Treasure Island,1950-07-18,1950,0,0,0,2.67963
6687,Transsiberian,2008-01-18,2008,15000000,5926410,-9073590,12.497651
6691,Priceless,2006-12-13,2006,0,2036198,2036198,6.18064
6715,The Cure,1995-04-21,1995,0,0,0,2.686342
6723,The Rookie,1990-12-06,1990,10000000,21633874,11633874,8.110591
6733,Where Is Fred?,2006-11-15,2006,0,0,0,2.961854
6793,The Haunted Castle,1921-04-07,1921,0,0,0,0.768064
6795,Zathura: A Space Adventure,2005-11-06,2005,65000000,64321501,-678499,10.695639
6844,The Ten Commandments,1956-10-05,1956,13000000,122700000,109700000,11.14704
6877,Failure to Launch,2006-03-10,2006,50000000,128406887,78406887,9.438013
6878,Homeward Bound: The Incredible Journey,1993-02-03,1993,0,0,0,7.186506
6883,Two-Minute Warning,1976-11-12,1976,0,0,0,1.712445
6884,Evil Alien Conquerors,2003-12-03,2003,0,0,0,0.309733
6916,"Watch Out, We're Mad",1974-03-29,1974,0,36782781,36782781,5.244333
6917,The Gate,1987-04-21,1987,2500000,0,-2500000,4.742709
6933,One Missed Call,2008-01-04,2008,20000000,0,-20000000,11.104479
6934,Yesterday,2004-09-03,2004,0,0,0,1.678469
6935,Yamakasi,2001-04-04,2001,0,0,0,7.165551
6936,Ben X,2007-08-26,2007,1500000,0,-1500000,3.873511
6945,Miracle on Ice,1981-03-01,1981,0,0,0,0.818768
6947,The Village,2004-07-30,2004,60000000,256697520,196697520,8.172707
6948,The Woods,2006-09-25,2006,0,0,0,3.601261
6949,"What's Up, Doc?",1972-03-09,1972,0,0,0,3.427108
6950,Outbreak,1995-03-10,1995,50000000,189859560,139859560,13.676444
6951,Turner & Hooch,1989-07-28,1989,0,71079915,71079915,12.372038
6957,The 40 Year Old Virgin,2005-08-11,2005,26000000,109449237,83449237,11.519662
6961,The Wedding Date,2005-02-04,2005,15000000,47175038,32175038,5.615303
6962,The Hunt for the Hidden Relic,2002-12-05,2002,0,0,0,1.277066
6963,The Weather Man,2005-10-20,2005,20000000,12482775,-7517225,8.345866
6964,Something's Gotta Give,2003-12-12,2003,80000000,266728738,186728738,8.524847
6967,The White Massai,2005-09-14,2005,7000000,0,-7000000,1.195186
6968,The Baader Meinhof Complex,2008-09-24,2008,27000000,0,-27000000,5.155749
6970,Welcome to Woop Woop,1998-08-13,1998,0,0,0,0.569827
6972,Australia,2008-11-18,2008,130000000,49554002,-80445998,9.566135
6973,In the Valley of Elah,2007-08-31,2007,23000000,29541790,6541790,9.604552
6974,The Angry Red Planet,1959-11-23,1959,0,0,0,2.891661
6976,Whoever Slew Auntie Roo?,1971-10-31,1971,0,0,0,0.736877
6977,No Country for Old Men,2007-11-08,2007,25000000,171600000,146600000,15.565484
6978,Big Trouble in Little China,1986-05-30,1986,25000000,11000000,-14000000,11.109932
6980,Horse Sense,1999-11-20,1999,0,0,0,0.587167
6984,Home Movies,1980-05-16,1980,0,0,0,0.84119
7006,White Noise 2: The Light,2007-01-05,2007,0,0,0,6.176386
7007,Rising Sun,1993-07-30,1993,0,107198790,107198790,6.279082
7008,The Wilby Conspiracy,1975-02-01,1975,0,0,0,2.552926
7010,The Wild Geese,1978-07-05,1978,10000000,0,-10000000,13.696437
7011,Making Contact,1985-11-21,1985,0,0,0,0.712615
7012,The Day After,1983-11-20,1983,0,0,0,10.099175
7014,Themroc,1973-03-01,1973,0,0,0,2.018911
7015,American Heart,1992-03-17,1992,0,0,0,1.455045
7085,The Desperado Trail,1965-10-14,1965,0,0,0,1.975282
7088,Christmas in Boston,2005-12-14,2005,0,0,0,3.221714
7090,Ken Park,2002-08-31,2002,1300000,447741,-852259,12.630419
7091,Vampire's Kiss,1988-09-17,1988,2000000,725131,-1274869,3.265426
7092,Van Helsing: The London Assignment,2004-05-11,2004,0,0,0,5.003222
7093,Vatel,2000-05-01,2000,35000000,0,-35000000,2.516301
7095,Jack,1996-08-09,1996,45000000,58620973,13620973,6.287245
7096,Merlin,1998-04-26,1998,0,0,0,9.30654
7131,Van Helsing,2004-05-05,2004,160000000,300257475,140257475,12.643312
7182,Venom,2005-09-16,2005,0,0,0,4.871297
7183,Perfect Stranger,2007-04-12,2007,60795000,73090611,12295611,9.925255
7191,Cloverfield,2008-01-15,2008,25000000,170764026,145764026,12.868098
7210,Hardcover,2008-04-02,2008,0,0,0,0.512893
7211,Dan in Real Life,2007-10-26,2007,25000000,68377859,43377859,8.936547
7214,Coach Carter,2005-01-14,2005,30000000,76669806,46669806,11.093737
7216,Zombie Holocaust,1980-03-27,1980,0,0,0,2.873528
7219,Zombie Flesh Eaters,1979-08-25,1979,0,0,0,6.798595
7220,The Punisher,2004-04-15,2004,33000000,54700105,21700105,18.250919
7227,Airport '77,1977-03-11,1977,6000000,30000000,24000000,9.394776
7229,Ruby & Quentin,2003-10-22,2003,27440000,0,-27440000,9.306171
7233,Rebound,2005-07-01,2005,45000000,16809014,-28190986,4.373457
7234,Wizards of the Lost Kingdom,1985-10-01,1985,0,0,0,0.62048
7237,Wizards of the Lost Kingdom II,1989-03-01,1989,0,0,0,0.341603
7249,Futurama: Bender's Big Score,2007-11-27,2007,0,0,0,5.32979
7267,TBS,2008-01-31,2008,0,0,0,0.851168
7269,Space Raiders,1983-07-01,1983,0,0,0,0.841084
7270,Matchstick Men,2003-09-01,2003,62000000,65565672,3565672,5.539265
7274,La Le√≥n,2007-07-11,2007,0,0,0,0.114889
7278,Meet the Spartans,2008-01-24,2008,30000000,84646831,54646831,6.416753
7288,Duplex,2003-09-26,2003,40000000,19322135,-20677865,12.160363
7290,2001: A Space Travesty,2000-10-31,2000,26000000,0,-26000000,2.641696
7291,36th Precinct,2004-11-24,2004,0,0,0,12.727685
7294,The Man Without a Past,2002-03-01,2002,0,0,0,4.006786
7295,8MM 2,2005-11-22,2005,0,0,0,3.330757
7298,One Way,2006-10-21,2006,0,0,0,2.306467
7299,Equilibrium,2002-12-06,2002,20000000,5359645,-14640355,12.671637
7300,One Fine Day,1996-12-20,1996,0,97529550,97529550,7.009946
7301,Lonesome Jim,2005-11-16,2005,0,0,0,3.624575
7303,Maid in Manhattan,2002-12-13,2002,55000000,154906693,99906693,7.291939
7304,Running Scared,2006-01-06,2006,17000000,9500000,-7500000,7.435544
7305,Alive,1993-01-15,1993,32000000,36733909,4733909,8.662287
7326,Juno,2007-12-05,2007,7500000,231411584,223911584,11.791591
7340,Carrie,1976-11-03,1976,1800000,33800000,32000000,9.277692
7341,The Rage: Carrie 2,1999-03-11,1999,21000000,17762705,-3237295,4.766591
7342,Carrie,2002-11-04,2002,0,0,0,9.362573
7343,City of Men,2007-08-31,2007,0,307076,307076,3.527212
7344,Absurdistan,2008-01-20,2008,0,0,0,0.590386
7345,There Will Be Blood,2007-12-28,2007,25000000,77208711,52208711,8.200627
7346,Sparrow,2008-06-04,2008,0,0,0,1.417527
7347,Elite Squad,2007-10-12,2007,4000000,0,-4000000,10.759577
7348,Robinson Crusoe on Mars,1964-06-01,1964,1200000,0,-1200000,2.003358
7350,The Bucket List,2007-12-25,2007,45000000,175372502,130372502,9.070643
7351,Julia,2008-02-09,2008,6000000,1300000,-4700000,2.002032
7353,Fireflies in the Garden,2008-02-10,2008,0,0,0,9.713124
7364,Sahara,2005-04-06,2005,130000000,119269486,-10730514,8.946243
7392,"Ilsa, Harem Keeper of the Oil Sheiks",1976-02-29,1976,0,0,0,1.437921
7442,Sleeping with the Enemy,1991-02-08,1991,19000000,174999005,155999005,8.560694
7443,Chicken Run,2000-06-21,2000,45000000,224834564,179834564,11.834245
7445,Brothers,2009-01-27,2009,26000000,43318349,17318349,9.108917
7446,Tropic Thunder,2008-08-09,2008,92000000,188072649,96072649,8.980941
7450,Titan A.E.,2000-06-16,2000,75000000,36754634,-38245366,7.515631
7451,xXx,2002-08-09,2002,70000000,277448382,207448382,12.722381
7452,"The Cook, the Thief, His Wife & Her Lover",1989-09-10,1989,0,0,0,5.970136
7453,The Hitchhiker's Guide to the Galaxy,2005-01-15,2005,50000000,104478416,54478416,13.257255
7454,The Bunker,2001-09-14,2001,0,0,0,4.415318
7456,Die Wolke,2006-03-16,2006,0,0,0,1.574594
7457,Alpha Dog,2006-01-27,2006,0,15309302,15309302,7.655603
7459,Speed Racer,2008-05-09,2008,120000000,93945766,-26054234,7.134168
7461,Vantage Point,2008-02-01,2008,40000000,151161491,111161491,7.001645
7483,Free Zone,2005-04-18,2005,0,0,0,3.11224
7484,Open Season,2006-09-29,2006,85000000,197309027,112309027,11.744242
7485,Shooter,2007-03-22,2007,61000000,95696996,34696996,14.246918
7500,Sonatine,1993-04-10,1993,0,0,0,5.167934
7501,Knockaround Guys,2001-09-07,2001,15000000,12000000,-3000000,6.557426
7504,Earth,1998-09-16,1998,0,528972,528972,3.877988
7506,Harum Scarum,1965-11-24,1965,0,0,0,0.699336
7508,Taare Zameen Par,2007-12-21,2007,2600000,28430000,25830000,6.093304
7509,Water,2005-09-08,2005,0,10422387,10422387,2.135874
7510,Running with Scissors,2006-10-27,2006,12000000,6754898,-5245102,4.926507
7511,The Last Kiss,2006-09-10,2006,20000000,0,-20000000,9.996541
7512,Idiocracy,2006-09-01,2006,30000000,495303,-29504697,12.130803
7514,The Harder They Come,1972-09-01,1972,0,0,0,6.820596
7515,London,2005-02-10,2005,0,0,0,4.96473
7516,Smokin' Aces,2006-12-09,2006,17000000,57103895,40103895,7.906434
7517,Live Free or Die,2006-03-11,2006,0,0,0,0.385761
7518,Over the Hedge,2006-04-22,2006,80000000,343397247,263397247,9.382953
7520,Cocktail,1988-07-29,1988,20000000,171504781,151504781,9.270831
7547,Come Early Morning,2006-01-10,2006,6000000,0,-6000000,4.834354
7548,The Libertine,2004-09-16,2004,0,0,0,4.451619
7549,Fearless,2006-01-26,2006,0,6971266,6971266,6.187094
7551,D√©j√† Vu,2006-11-22,2006,75000000,180557550,105557550,14.922904
7552,Fun with Dick and Jane,2005-12-21,2005,100000000,202026112,102026112,13.473381
7553,Waiting...,2005-10-07,2005,3000000,18637690,15637690,5.054419
7555,Rambo,2008-01-24,2008,50000000,113244290,63244290,9.91556
7735,The Wave,2008-03-11,2008,7500000,19000000,11500000,6.010332
7736,Katzelmacher,1969-10-07,1969,0,0,0,1.3981
7737,Resident Evil: Extinction,2007-09-20,2007,45000000,148412065,103412065,3.009134
7797,Youth Without Youth,2007-10-26,2007,0,0,0,3.934387
7837,The Time Shifters,1999-10-17,1999,0,0,0,1.504521
7839,Wedding Daze,2006-09-09,2006,0,0,0,5.847729
7840,"10,000 BC",2008-02-22,2008,105000000,266000000,161000000,13.99377
7857,Amarcord,1973-12-13,1973,0,0,0,5.871166
7859,Half Nelson,2006-08-11,2006,700000,4911725,4211725,12.155115
7860,Lemon Tree,2008-02-08,2008,0,0,0,1.729031
7861,Outsourced,2006-09-12,2006,0,0,0,8.735319
7862,The Counterfeiters,2007-02-09,2007,0,0,0,9.637382
7863,Shine,1996-01-21,1996,0,0,0,11.664053
7870,Down in the Valley,2005-05-13,2005,8000000,852872,-7147128,11.448612
7871,Side Effects,2005-03-07,2005,0,0,0,0.873783
7872,The Road to Guantanamo,2006-03-09,2006,0,0,0,1.514503
7873,Harsh Times,2005-09-11,2005,2000000,5967038,3967038,7.659357
7874,Black Snake Moan,2006-12-08,2006,15000000,10903846,-4096154,7.050403
7913,Rang De Basanti,2006-01-26,2006,2200000,11502151,9302151,4.102052
7916,Far Cry,2008-01-01,2008,30000000,0,-30000000,4.845377
7942,"Run, Fatboy, Run",2007-09-06,2007,10000000,33000000,23000000,11.840495
7944,Shine a Light,2008-02-07,2008,0,0,0,2.43629
7972,Before the Devil Knows You're Dead,2007-09-26,2007,18000000,25005257,7005257,9.309967
7973,Caramel,2007-07-01,2007,0,0,0,4.882962
7974,The Match Factory Girl,1990-09-20,1990,474700,0,-474700,2.994887
7975,I Hired a Contract Killer,1990-09-13,1990,0,0,0,2.894405
7978,The Wolfman,2010-02-11,2010,150000000,0,-150000000,9.297209
7979,The Kite Runner,2007-10-14,2007,20000000,73276047,53276047,5.970067
7980,The Lovely Bones,2009-12-26,2009,65000000,93525586,28525586,12.738789
7983,Lowlands,1954-02-11,1954,8500000,0,-8500000,0.146824
7984,In the Name of the Father,1993-12-12,1993,13000000,65796862,52796862,7.405895
7985,Penelope,2006-03-01,2006,15000000,0,-15000000,13.442999
7988,The Island,1980-06-13,1980,0,0,0,1.282124
7992,It's a Free World...,2007-09-01,2007,0,0,0,1.116784
8005,Robin Hood: Men in Tights,1993-07-28,1993,20000000,35739755,15739755,17.136672
8007,Behind Enemy Lines,2001-11-17,2001,40000000,91753202,51753202,11.185625
8008,Mouth to Mouth,2005-06-02,2005,0,0,0,1.586873
8009,Highlander,1986-03-07,1986,16000000,5900000,-10100000,16.870392
8010,Highlander II: The Quickening,1991-01-30,1991,30000000,15556340,-14443660,8.032638
8011,Highlander: The Final Dimension,1994-11-29,1994,26000000,36800000,10800000,6.866634
8012,Get Shorty,1995-10-20,1995,30250000,115101622,84851622,12.669608
8014,Valley of Flowers,2006-07-15,2006,6000000,0,-6000000,0.307463
8016,Germany Year Zero,1948-12-01,1948,0,0,0,2.666104
8043,Breakheart Pass,1975-12-25,1975,0,0,0,8.419469
8046,Gigli,2003-08-01,2003,54000000,7266209,-46733791,11.415316
8047,Matador,1986-03-07,1986,0,0,0,3.518094
8049,The Grocer's Son,2007-06-15,2007,0,0,0,0.730041
8051,Punch-Drunk Love,2002-10-25,2002,25000000,17000000,-8000000,6.753969
8052,Hard Eight,1996-02-28,1996,3000000,222559,-2777441,7.04756
8053,The Three Burials of Melquiades Estrada,2005-11-17,2005,15000000,12036149,-2963851,9.117934
8054,The Imaginarium of Doctor Parnassus,2009-10-01,2009,30000000,64352607,34352607,6.859934
8055,The Reader,2008-12-10,2008,32000000,113019290,81019290,7.931732
8056,Train of Life,1998-09-16,1998,154790,0,-154790,3.040512
8060,Married Life,2007-09-12,2007,12000000,0,-12000000,2.381704
8063,The Red Tent,1969-12-23,1969,10000000,0,-10000000,2.555606
8064,Chiko,2008-02-09,2008,0,0,0,4.896953
8065,21,2008-03-27,2008,35000000,69823199,34823199,8.33756
8066,Stay,2005-09-24,2005,50000000,8342132,-41657868,6.572049
8067,A Life Less Ordinary,1997-10-24,1997,12000000,0,-12000000,15.996171
8068,Desperado,1995-08-25,1995,7000000,25405445,18405445,6.950458
8069,Barbarella,1968-10-10,1968,9000000,2500000,-6500000,14.304205
8070,The Green Room,1978-04-05,1978,0,0,0,0.544128
8071,Tout Va Bien,1972-04-28,1972,0,0,0,0.742592
8072,Alphaville,1965-05-05,1965,220000,0,-220000,4.658149
8073,Band of Outsiders,1964-08-05,1964,120000,182857,62857,5.648187
8074,2 or 3 Things I Know About Her,1967-03-17,1967,0,0,0,7.273791
8075,Weekend,1967-12-29,1967,0,0,0,2.937013
8076,Tuvalu,1999-11-19,1999,0,0,0,2.664512
8077,Alien¬≥,1992-05-22,1992,50000000,159773545,109773545,17.126768
8078,Alien: Resurrection,1997-11-12,1997,70000000,162000000,92000000,15.57784
8079,Om Shanti Om,2007-11-07,2007,9100000,37707444,28607444,4.384156
8080,Suspect Zero,2004-08-27,2004,27000000,13000000,-14000000,7.550891
8088,Broken Embraces,2009-03-01,2009,18000000,0,-18000000,6.777379
8090,Untraceable,2008-01-22,2008,35000000,32483410,-2516590,7.85217
8092,This Boy‚Äôs Life,1993-04-09,1993,0,4104962,4104962,9.665142
8093,Khadak,2006-08-31,2006,0,0,0,0.521339
8094,The Magdalene Sisters,2002-10-24,2002,0,20957001,20957001,5.725912
8095,Cleopatra,1963-06-12,1963,31115000,71000000,39885000,8.591238
8128,The Sorcerer's Apprentice,1978-03-01,1978,0,0,0,1.18221
8129,My Name Is Joe,1998-05-15,1998,0,0,0,1.878973
8130,Desperately Seeking Susan,1985-03-29,1985,5000000,27400000,22400000,8.679349
8141,You Kill Me,2007-02-09,2007,4000000,2426851,-1573149,4.725299
8144,Dig Your Grave Friend... Sabata's Coming,1971-04-02,1971,0,0,0,0.005954
8193,Napoleon Dynamite,2004-06-11,2004,400000,46118097,45718097,10.287419
8194,A Guide To Recognizing Your Saints,2006-09-29,2006,0,516139,516139,7.34846
8195,Ronin,1998-09-25,1998,55000000,41610884,-13389116,9.672094
8197,Midnight in the Garden of Good and Evil,1997-11-21,1997,35000000,25105255,-9894745,5.145907
8198,The Quiet American,2002-11-22,2002,30000000,27674124,-2325876,8.230447
8199,Dreamland,2006-01-23,2006,0,0,0,1.211471
8202,√Üon Flux,2005-11-30,2005,62000000,52304001,-9695999,12.201912
8204,The Spiderwick Chronicles,2008-02-14,2008,90000000,162839667,72839667,11.133784
8208,The Man Who Knew Too Much,1934-11-30,1934,0,0,0,7.294135
8209,1. Mai ‚Äì Helden bei der Arbeit,2008-02-08,2008,200000,0,-200000,0.146868
8211,Our Folks,1967-09-15,1967,0,0,0,0.92235
8213,Sometime in August,2009-02-08,2009,0,0,0,0.503049
8214,Drifting Clouds,1996-01-26,1996,0,0,0,4.294364
8216,Meet the Feebles,1989-08-12,1989,750000,0,-750000,3.336298
8217,Alice,1990-12-25,1990,0,0,0,7.196816
8219,Labyrinth of Passion,1982-09-29,1982,0,0,0,3.805265
8220,Dark Habits,1983-03-10,1983,0,0,0,1.254097
8221,What Have I Done to Deserve This?,1984-10-24,1984,0,706685,706685,2.154915
8222,High Heels,1991-10-23,1991,0,1710057,1710057,4.563892
8223,Kika,1993-10-28,1993,0,0,0,3.647321
8224,8MM,1999-02-26,1999,40000000,96618699,56618699,7.473718
8247,Jumper,2008-02-10,2008,85000000,222231186,137231186,11.03897
8265,Welcome to the Sticks,2008-01-09,2008,11000000,53191886,42191886,7.250134
8266,Female Agents,2008-02-08,2008,0,0,0,5.2678
8267,The Pope's Toilet,2007-05-21,2007,0,0,0,1.589157
8269,Promise Me This,2007-05-26,2007,0,0,0,1.247433
8270,The Lookout,2007-03-09,2007,16000000,5367030,-10632970,12.153493
8271,Disturbia,2007-04-12,2007,20000000,117760134,97760134,18.006896
8272,The Savages,2007-01-19,2007,0,0,0,4.546164
8273,American Wedding,2003-08-01,2003,55000000,231449203,176449203,14.397139
8274,American Pie Presents: Band Camp,2005-10-30,2005,10000000,0,-10000000,8.67163
8275,American Pie Presents: The Naked Mile,2006-12-07,2006,0,0,0,8.152676
8276,I've Loved You So Long,2008-03-19,2008,0,0,0,8.352169
8277,American Pie Presents: Beta House,2007-12-10,2007,0,0,0,7.777928
8279,Paris,2008-01-19,2008,19000000,23550000,4550000,4.249948
8280,The Secret of the Grain,2007-12-24,2007,0,0,0,9.542657
8281,I Always Wanted to Be a Gangster,2008-01-18,2008,0,0,0,1.839285
8282,Summer Hours,2008-03-05,2008,0,0,0,3.937956
8284,The Limits of Control,2009-05-01,2009,0,0,0,9.205574
8285,The Spirit,2008-12-25,2008,60000000,39031337,-20968663,5.762005
8286,The Unfaithful Wife,1969-01-01,1969,0,0,0,1.6617
8288,A Midsummer Night's Sex Comedy,1982-07-16,1982,0,0,0,11.212722
8289,Gorky Park,1983-12-15,1983,0,16175602,16175602,4.598954
8290,Don't Look Now: We're Being Shot At,1966-12-07,1966,0,0,0,7.727202
8291,Poetic Justice,1993-07-23,1993,14000000,27515786,13515786,6.972599
8292,Four Brothers,2005-08-11,2005,45000000,92374674,47374674,6.84109
8293,Howards End,1992-03-13,1992,0,25966555,25966555,10.854598
8316,The Countess,2009-02-09,2009,8500000,0,-8500000,4.334513
8319,Chapter 27,2007-01-25,2007,0,0,0,3.695319
8321,In Bruges,2008-02-08,2008,15000000,34533783,19533783,9.895652
8324,Fast Food Nation,2006-05-16,2006,0,0,0,5.397239
8325,Tiptoes,2003-09-08,2003,0,0,0,9.311904
8326,Holes,2003-04-18,2003,20000000,0,-20000000,17.193267
8327,The Holy Mountain,1973-05-01,1973,0,0,0,4.190266
8328,Step Up 2: The Streets,2008-02-14,2008,23000000,150816700,127816700,7.667579
8329,[REC],2007-04-10,2007,1500000,30448000,28948000,8.504511
8332,Antibodies,2005-04-24,2005,1900000,0,-1900000,2.266307
8333,The Taking of Pelham One Two Three,1974-10-02,1974,0,0,0,7.762833
8336,The Naked Man,1998-08-02,1998,0,0,0,0.942562
8337,They Live,1988-11-23,1988,4000000,13008928,9008928,11.292364
8338,Blindness,2008-05-14,2008,25000000,19844979,-5155021,7.462378
8340,Turtles Can Fly,2005-01-07,2005,0,0,0,3.281608
8341,Samsara,2001-01-01,2001,3000000,0,-3000000,0.976452
8342,No Man's Land,2001-09-08,2001,1012153,0,-1012153,5.0511
8346,My Big Fat Greek Wedding,2002-02-22,2002,5000000,368744044,363744044,6.719949
8348,Thunderbolt and Lightfoot,1974-05-23,1974,0,21700000,21700000,8.283863
8349,The Red Baron,2008-03-29,2008,18000000,40239,-17959761,4.918419
8353,Limite,1931-05-17,1931,0,0,0,0.861507
8355,Ice Age: Dawn of the Dinosaurs,2009-06-29,2009,90000000,886686817,796686817,12.980624
8356,An Affair to Remember,1957-07-11,1957,0,0,0,9.813419
8357,What the #$*! Do We (K)now!?,2004-04-23,2004,0,10000000,10000000,7.631049
8358,Cast Away,2000-12-22,2000,90000000,429632142,339632142,21.296343
8359,Kit Kittredge: An American Girl,2008-07-02,2008,0,0,0,5.310976
8363,Superbad,2007-08-17,2007,20000000,121463226,101463226,16.205105
8366,Manitou's Shoe,2001-07-11,2001,0,0,0,6.009793
8367,Robin Hood: Prince of Thieves,1991-06-14,1991,48000000,390493908,342493908,10.639244
8368,The Garden of Eden,2008-01-01,2008,0,0,0,0.160182
8371,Guter Junge,2008-04-09,2008,0,0,0,0.019351
8372,Lonesome Cowboys,1968-12-20,1968,0,0,0,0.284143
8373,Transformers: Revenge of the Fallen,2009-06-19,2009,150000000,836297228,686297228,4.351756
8374,The Boondock Saints,1999-01-22,1999,6000000,30471,-5969529,12.457908
8382,Today You Die,2005-09-13,2005,0,0,0,2.38008
8383,Red Sun,1970-08-31,1970,0,0,0,0.01549
8386,How High,2001-12-21,2001,12000000,31155435,19155435,6.796277
8388,¬°Three Amigos!,1986-12-12,1986,25000000,0,-25000000,6.377624
8390,"Definitely, Maybe",2008-02-08,2008,0,55447968,55447968,12.553657
8391,When Night Is Falling,1995-05-05,1995,0,0,0,3.302524
8392,My Neighbor Totoro,1988-04-16,1988,0,0,0,13.507299
8393,The Gods Must Be Crazy,1980-09-10,1980,5000000,60000000,55000000,10.973482
8398,The Hitcher,2007-01-19,2007,10000000,25399945,15399945,7.160967
8408,Day of the Dead,1985-07-19,1985,3500000,34000000,30500000,8.801822
8409,A Man Apart,2003-04-04,2003,36000000,44350926,8350926,17.714247
8410,The Wild Blue Yonder,2005-09-05,2005,0,0,0,0.921349
8413,Event Horizon,1997-08-15,1997,60000000,26673242,-33326758,11.335072
8414,Interview,2007-01-20,2007,0,0,0,3.518929
8415,Gunhed,1989-01-01,1989,0,0,0,0.82363
8416,The Conformist,1970-10-21,1970,750000,0,-750000,9.931025
8417,Jud S√º√ü,1940-09-24,1940,0,0,0,0.375369
8418,Kolberg,1945-01-30,1945,0,0,0,0.463907
8420,...And God Created Woman,1956-11-28,1956,0,0,0,3.28239
8421,Zidane - A 21st Century Portrait,2006-05-23,2006,0,0,0,0.610932
8422,Rocco and His Brothers,1960-10-06,1960,0,0,0,4.21602
8424,Love Me If You Dare,2003-09-17,2003,0,0,0,6.138669
8425,The Clockmaker of St. Paul,1974-01-16,1974,0,0,0,0.750675
8427,I Spy,2002-10-31,2002,70000000,33561137,-36438863,10.404277
8428,Pump up the Volume,1990-08-22,1990,0,11541758,11541758,4.289341
8429,Paisan,1946-12-10,1946,0,0,0,3.080515
8430,The Messiah,1975-10-24,1975,0,0,0,0.016421
8434,Summer Things,2002-08-30,2002,0,0,0,1.234015
8435,A Cock and Bull Story,2005-07-17,2005,0,0,0,2.536178
8436,The Page Turner,2006-08-09,2006,0,0,0,2.051237
8438,Murder in the First,1995-01-20,1995,0,17381942,17381942,9.518564
8439,Bus 174,2002-10-22,2002,0,217201,217201,1.512013
8440,Carandiru,2003-03-21,2003,3684600,0,-3684600,4.345806
8441,The Man of the Year,2003-01-01,2003,0,0,0,0.691669
8443,Lower City,2005-05-16,2005,0,0,0,1.93022
8444,Dom√©sticas,2001-01-25,2001,0,0,0,0.208379
8445,Madicken of June Hill,1980-07-07,1980,0,0,0,2.322229
8446,Bugsy Malone,1976-06-26,1976,0,0,0,5.348193
8447,Angels and Insects,1995-09-10,1995,0,0,0,2.15166
8452,The 6th Day,2000-11-17,2000,82000000,96085477,14085477,8.41311
8453,Fanaa,2006-05-26,2006,5300000,22175908,16875908,3.003526
8456,Never Back Down,2008-03-04,2008,20000000,41627431,21627431,14.753931
8457,Drillbit Taylor,2008-03-20,2008,40000000,0,-40000000,7.855932
8460,The Skulls II,2002-04-09,2002,3800000,0,-3800000,4.184295
8461,Funny Games,2007-10-20,2007,15000000,7938872,-7061128,6.841586
8462,The Joyless Street,1925-03-01,1925,0,0,0,0.418457
8463,Torch Song Trilogy,1988-01-01,1988,0,4865997,4865997,1.14619
8464,Top of the Food Chain,1999-09-11,1999,0,0,0,0.820675
8467,Dumb and Dumber,1994-12-16,1994,16000000,247275374,231275374,9.844558
8468,Highway 61,1991-09-05,1991,0,0,0,1.078271
8469,Animal House,1978-07-27,1978,2700000,141000000,138300000,7.525382
8470,John Q,2002-02-15,2002,36000000,102244770,66244770,8.867562
8471,Far North,2007-08-30,2007,0,0,0,1.338785
8487,Wild Wild West,1999-06-29,1999,170000000,222104681,52104681,9.887602
8488,Hitch,2005-02-10,2005,70000000,368100420,298100420,13.35076
8489,Ali,2001-12-11,2001,107000000,87713825,-19286175,9.303104
8490,Borderline,1980-10-31,1980,8500000,0,-8500000,0.603112
8491,Weekend at Bernie's,1989-07-05,1989,6500000,30218387,23718387,8.051891
8494,Weekend at Bernie's II,1993-07-09,1993,0,0,0,7.348632
8512,Devil in a Blue Dress,1995-09-15,1995,27000000,16140822,-10859178,4.646132
8536,Superman II,1980-12-04,1980,54000000,190458706,136458706,10.301621
8545,Little Voice,1998-11-05,1998,0,0,0,7.214017
8555,Creep,2004-08-10,2004,0,0,0,5.604026
8556,Am I Beautiful?,1998-09-17,1998,0,0,0,0.486655
8557,True North,2006-09-11,2006,0,0,0,1.325624
8583,Dangerous Beauty,1998-02-20,1998,0,0,0,4.79927
8584,Shanghai Noon,2000-05-26,2000,55000000,56932305,1932305,10.308442
8587,The Lion King,1994-06-23,1994,45000000,788241776,743241776,21.605761
8588,Shooting Dogs,2006-03-08,2006,0,0,0,10.81576
8592,Dick Tracy,1990-06-15,1990,47000000,103738726,56738726,8.304776
8617,Prom Night,2008-04-10,2008,0,14796236,14796236,7.18216
8618,The History Boys,2006-10-02,2006,4000000,13401952,9401952,3.403583
8619,Master and Commander: The Far Side of the World,2003-11-14,2003,150000000,212011111,62011111,8.693298
8643,The Exorcism of Emily Rose,2005-09-09,2005,19000000,144216468,125216468,10.966015
8645,The Happening,2008-06-11,2008,60000000,163403799,103403799,6.22229
8649,Bringing Out the Dead,1999-10-22,1999,32000000,0,-32000000,8.825864
8651,En Route,2004-02-10,2004,0,0,0,0.200145
8652,Dream,2008-09-26,2008,0,0,0,0.862305
8653,The Isle,2000-04-22,2000,50000,21075,-28925,3.882092
8656,Deep Impact,1998-05-08,1998,75000000,140464664,65464664,11.644633
8665,K-19: The Widowmaker,2002-07-19,2002,100000000,35168966,-64831034,7.718723
8669,Charlie Bartlett,2008-02-22,2008,12000000,0,-12000000,6.135652
8672,My Best Fiend,1999-05-17,1999,0,0,0,1.807445
8675,Orgazmo,1997-09-06,1997,1000000,0,-1000000,5.919725
8676,Fool's Gold,2008-02-07,2008,70000000,111231041,41231041,9.4548
8677,The Bourne Identity,1988-05-08,1988,0,0,0,1.723682
8681,Taken,2008-02-18,2008,25000000,226830568,201830568,16.367481
8688,Snake Eyes,1998-08-07,1998,73000000,103891409,30891409,11.604533
8689,Cannibal Holocaust,1980-02-07,1980,100000,0,-100000,7.417324
8690,Eaten Alive!,1980-03-19,1980,0,0,0,1.669519
8691,Cannibal Ferox,1981-04-24,1981,0,0,0,2.767334
8692,Invasion of the Flesh Hunters,1980-08-04,1980,0,0,0,1.107117
8696,Calendar Girls,2003-09-02,2003,10000000,96542059,86542059,5.109575
8697,Who Am I?,1998-01-17,1998,0,0,0,8.912292
8698,The League of Extraordinary Gentlemen,2003-07-11,2003,78000000,179265204,101265204,10.488765
8699,Anchorman: The Legend of Ron Burgundy,2004-07-09,2004,26000000,90574188,64574188,10.33012
8703,Three Wishes for Cinderella,1973-11-01,1973,0,0,0,6.19728
8736,Dikkenek,2006-06-21,2006,0,0,0,7.348332
8737,Cast a Giant Shadow,1966-03-30,1966,0,0,0,0.790084
8738,The Final Countdown,1980-01-31,1980,0,16647800,16647800,11.319726
8740,The Vanishing,1988-10-27,1988,0,0,0,11.096035
8741,The Thin Red Line,1998-12-25,1998,52000000,98126565,46126565,9.783966
8743,At Point Blank,2003-12-13,2003,0,0,0,0.437956
8744,Albino Alligator,1996-09-09,1996,6000000,0,-6000000,2.363293
8745,It Happened at the World's Fair,1963-04-03,1963,0,0,0,1.531777
8747,The Black Balloon,2008-03-08,2008,0,0,0,2.307735
8748,Eagle vs Shark,2007-07-15,2007,0,0,0,5.327507
8749,Hamlet Goes Business,1987-08-21,1987,0,0,0,0.824719
8764,Top Secret!,1984-06-08,1984,9000000,20458340,11458340,5.971241
8765,Nirvana,1997-01-24,1997,0,0,0,3.376578
8766,Hellraiser: Bloodline,1996-03-08,1996,4000000,16675000,12675000,5.263187
8767,Stuntwoman,1977-10-05,1977,0,0,0,1.43083
8768,The Little Thief,1988-12-21,1988,0,0,0,0.602935
8769,Christine,1983-12-08,1983,0,21200000,21200000,7.106757
8770,Uncounted,2008-01-01,2008,0,0,0,0.106981
8776,The Toth Family,1969-11-29,1969,0,0,0,0.199328
8779,Journey to the Beginning of Time,1955-08-04,1955,0,0,0,1.515302
8780,Baby Mama,2008-04-23,2008,30000000,63833449,33833449,10.901355
8785,The Saragossa Manuscript,1965-02-09,1965,0,0,0,2.277685
8810,Mad Max 2: The Road Warrior,1981-12-24,1981,2000000,24600832,22600832,11.189831
8814,Doom,2005-10-20,2005,60000000,55987321,-4012679,11.953553
8816,My Life as a Dog,1985-12-12,1985,0,0,0,4.195896
8818,Evita,1996-12-14,1996,55000000,141047179,86047179,6.709803
8827,99 francs,2007-09-25,2007,0,0,0,8.204654
8831,Timecop,1994-09-15,1994,27000000,101646581,74646581,8.907074
8832,Il Divo,2008-05-23,2008,7275000,11260366,3985366,7.728333
8833,Double Trouble,1984-10-19,1984,0,0,0,6.744702
8834,Conspiracy Theory,1997-08-07,1997,75000000,136982834,61982834,14.261798
8835,Legally Blonde,2001-07-13,2001,18000000,141774679,123774679,12.769371
8836,The X Files: I Want to Believe,2008-07-24,2008,30000000,68369434,38369434,9.863584
8838,Mercury Rising,1998-04-03,1998,60000000,0,-60000000,6.644644
8839,Casper,1995-05-26,1995,50000000,287928194,237928194,12.812539
8840,DragonHeart,1996-05-31,1996,57000000,115267375,58267375,23.63659
8841,The Class,2008-09-24,2008,0,28814580,28814580,10.940451
8842,Against the Ropes,2004-02-20,2004,39000000,6614280,-32385720,1.381022
8843,The Cell,2000-08-17,2000,33000000,104155843,71155843,13.234894
8844,Jumanji,1995-12-15,1995,65000000,262797249,197797249,17.015539
8845,Under Siege,1992-10-08,1992,35000000,156563139,121563139,9.918269
8846,Alone,2004-10-28,2004,0,0,0,0.666796
8847,Standard Operating Procedure,2008-02-12,2008,0,0,0,1.848068
8848,The Bank Job,2008-02-28,2008,20000000,64822796,44822796,8.732701
8849,Alfie,2004-10-22,2004,60000000,13395939,-46604061,10.411608
8850,The Shadow,1994-07-01,1994,25000000,48063435,23063435,7.881107
8851,The Blob,1958-09-12,1958,240000,0,-240000,7.079055
8852,Prince of Darkness,1987-10-23,1987,3000000,14182492,11182492,8.587231
8854,Steel,1997-08-15,1997,16000000,1686429,-14313571,2.890462
8856,"The Karate Kid, Part II",1986-06-18,1986,113,115103979,115103866,9.231318
8859,"Dude, Where‚Äôs My Car?",2000-12-15,2000,13000000,73180723,60180723,10.890236
8860,Metro,1997-01-16,1997,55000000,31987563,-23012437,10.519481
8866,The Truth About Cats & Dogs,1996-04-26,1996,0,0,0,5.121203
8867,The Punisher,1989-10-05,1989,9000000,0,-9000000,12.597613
8868,Asterix vs. Caesar,1985-03-06,1985,0,0,0,7.174178
8869,Eight Legged Freaks,2002-07-17,2002,0,0,0,10.800753
8870,Red Planet,2000-11-10,2000,80000000,33463969,-46536031,8.534176
8871,How the Grinch Stole Christmas,2000-11-17,2000,123000000,345141403,222141403,11.642462
8872,Wayne's World,1992-02-14,1992,20000000,121697323,101697323,10.180776
8873,Wayne's World 2,1993-12-10,1993,0,47965000,47965000,10.931683
8874,My Best Friend's Wedding,1997-06-19,1997,38000000,299288605,261288605,4.678572
8875,Timber Falls,2007-12-07,2007,2600000,0,-2600000,2.304122
8879,Pale Rider,1985-06-28,1985,0,41410568,41410568,9.385078
8880,Che: Part Two,2009-01-24,2009,40000000,0,-40000000,7.500907
8881,Che: Part One,2008-09-05,2008,30000000,0,-30000000,5.68041
8882,Gomorrah,2008-05-16,2008,0,0,0,13.439495
8883,Flame & Citron,2008-03-25,2008,6500000,0,-6500000,3.46355
8884,Franklyn,2008-10-16,2008,12000000,0,-12000000,11.939996
8885,Waltz with Bashir,2008-06-25,2008,2000000,11125849,9125849,7.636625
8886,Palermo Shooting,2008-11-20,2008,0,0,0,0.595492
8888,A Year Ago in Winter,2008-11-10,2008,0,0,0,0.875165
8892,A Christmas Tale,2008-05-16,2008,0,7356393,7356393,3.855934
8893,It's Hard Being Loved by Jerks,2009-09-17,2009,0,0,0,0.110946
8895,Adoration,2008-01-01,2008,4700000,0,-4700000,1.417696
8896,Delta,2008-09-11,2008,1500000,0,-1500000,0.973987
8897,Frontier of the Dawn,2008-05-22,2008,0,0,0,0.666584
8898,The Headless Woman,2008-08-21,2008,2700000,0,-2700000,1.20873
8899,Lorna's Silence,2008-08-27,2008,0,0,0,4.720788
8900,Lion's Den,2008-05-29,2008,0,0,0,1.220666
8902,Linha de Passe,2008-09-05,2008,0,0,0,0.384534
8904,Service,2008-06-24,2008,0,0,0,0.744425
8905,Three Monkeys,2008-05-16,2008,0,0,0,2.632026
8906,Cloud 9,2008-05-17,2008,98,0,-98,1.23697
8908,Maradona by Kusturica,2008-05-20,2008,0,0,0,1.391898
8909,Wanted,2008-06-19,2008,75000000,258270008,183270008,12.457896
8913,Pet Sematary,1989-04-21,1989,11500000,57469467,45969467,8.365761
8914,Deep Blue Sea,1999-07-28,1999,60000000,73648228,13648228,7.493615
8915,Amelia,2009-10-22,2009,40000000,19258519,-20741481,5.308718
8916,Antz,1998-10-02,1998,60000000,171757863,111757863,16.025625
8920,Garfield,2004-06-10,2004,50000000,200804534,150804534,10.003679
8922,Jeepers Creepers,2001-07-01,2001,10000000,59217789,49217789,10.414363
8923,Green Street Hooligans,2005-09-09,2005,0,3154346,3154346,7.772618
8926,Afterschool,2008-05-18,2008,0,0,0,2.27035
8927,Involuntary,2008-11-28,2008,0,0,0,1.347649
8929,Johnny Mad Dog,2008-05-20,2008,0,0,0,3.534935
8930,Modern Life,2008-10-27,2008,88,0,-88,0.400281
8931,The Bastards,2008-05-20,2008,0,0,0,0.477939
8932,Salt of This Sea,2008-05-16,2008,0,0,0,0.200636
8933,O'Horten,2007-12-26,2007,0,0,0,0.870359
8935,Parking,2008-05-23,2008,0,0,0,0.252271
8937,Tokyo Sonata,2008-09-27,2008,0,0,0,3.127124
8938,Tokyo!,2008-05-14,2008,0,0,0,2.033465
8939,Tulpan,2009-03-04,2009,0,0,0,1.792689
8940,Tyson,2008-05-16,2008,0,0,0,2.558751
8941,Versailles,2008-05-19,2008,0,0,0,0.705023
8942,Wendy and Lucy,2008-05-22,2008,200000,0,-200000,3.328853
8944,What Just Happened,2008-10-17,2008,25000000,6673422,-18326578,10.510245
8948,The Pearl Color,2009-01-08,2009,0,0,0,0.203305
8951,Don't Think About It,2007-09-01,2007,0,0,0,0.627887
8952,I Love You Phillip Morris,2009-01-18,2009,13000000,10652035,-2347965,5.773752
8953,Steamboy,2004-07-17,2004,20000000,0,-20000000,8.354775
8954,Reservation Road,2007-09-13,2007,0,0,0,4.368639
8960,Hancock,2008-07-01,2008,150000000,624029371,474029371,11.017324
8961,Bad Boys II,2003-07-18,2003,130000000,273339556,143339556,8.191436
8963,Crimson Tide,1995-05-12,1995,53000000,157387195,104387195,8.657365
8965,Atlantis: Milo's Return,2003-02-25,2003,0,0,0,7.751536
8966,Twilight,2008-11-20,2008,37000000,392616625,355616625,31.282029
8967,The Tree of Life,2011-05-18,2011,32000000,54674226,22674226,11.204539
8968,Boogeyman,2005-02-04,2005,20000000,67192859,47192859,9.704289
8970,The Out-of-Towners,1999-04-02,1999,75000000,29000000,-46000000,9.019881
8973,Lord of Illusions,1995-08-25,1995,0,0,0,4.102409
8974,The War of the Worlds,1953-08-13,1953,2000000,2000000,0,5.609399
8975,The Marine,2006-10-13,2006,20000000,22165608,2165608,6.679168
8976,A Lot Like Love,2005-04-22,2005,30000000,42886719,12886719,10.596719
8978,Assault on Precinct 13,2005-01-19,2005,30000000,35294470,5294470,11.552956
8980,Mortadelo & Filemon: The Big Adventure,2003-02-07,2003,0,0,0,2.415286
8981,Dear Frankie,2004-05-18,2004,0,0,0,3.571208
8982,The Protector,2005-08-11,2005,6000000,27165581,21165581,9.005167
8983,Felidae,1994-11-03,1994,0,0,0,2.225467
8984,Disclosure,1994-12-09,1994,55000000,214015089,159015089,11.812244
8985,Visions of Europe,2004-05-01,2004,2000000,0,-2000000,0.958683
8986,Milk Money,1994-08-31,1994,0,18137661,18137661,3.770115
8987,The River Wild,1994-09-30,1994,45000000,0,-45000000,10.511241
8988,Stop-Loss,2008-03-28,2008,25000000,11207130,-13792870,5.430566
8989,Harry and the Hendersons,1987-06-05,1987,0,49998613,49998613,9.296024
8991,Undead,2003-09-04,2003,0,0,0,2.764816
8992,The Sure Thing,1985-03-01,1985,0,0,0,4.285337
8995,C(r)ook,2004-11-11,2004,0,0,0,1.151656
8996,Europa Europa,1990-01-01,1990,0,0,0,2.917635
8997,Hollow Man II,2006-05-23,2006,0,0,0,6.269922
8998,Friends with Money,2006-09-07,2006,6500000,13368437,6868437,8.869162
8999,Derailed,2005-11-11,2005,22000000,57479076,35479076,10.600475
9003,Hellraiser,1987-09-11,1987,1000000,14564027,13564027,10.81305
9005,The Ice Harvest,2005-11-23,2005,0,0,0,8.485861
9007,Just Like Heaven,2005-09-16,2005,58000000,102854431,44854431,8.351773
9008,The Insider,1999-10-28,1999,90000000,60289912,-29710088,11.3569
9009,Dark Water,2005-06-27,2005,30000000,25473093,-4526907,6.53565
9010,Silentium,2004-01-01,2004,0,0,0,1.748713
9011,The Prophecy 3: The Ascent,2000-03-14,2000,0,0,0,7.372901
9012,Jackass: The Movie,2002-10-21,2002,5000000,64282312,59282312,14.095586
9013,Midnight Run,1988-07-20,1988,30000000,38413606,8413606,5.564321
9016,Treasure Planet,2002-11-26,2002,140000000,109578115,-30421885,16.141913
9017,Outpost,2007-03-11,2007,0,0,0,5.004215
9021,The Santa Clause 2,2002-10-31,2002,65000000,172855065,107855065,5.205729
9022,All the Boys Love Mandy Lane,2008-02-15,2008,750000,0,-750000,9.935837
9023,Spirit: Stallion of the Cimarron,2002-05-24,2002,80000000,122563539,42563539,16.724836
9024,For Love or Money,1993-10-01,1993,30000000,11146270,-18853730,8.468869
9025,Dog Days,2001-09-03,2001,0,0,0,8.682774
9026,The Importance of Being Earnest,2002-05-17,2002,0,0,0,8.287054
9027,The Guru,2002-08-21,2002,0,0,0,4.720788
9028,The Great Silence,1968-02-21,1968,0,0,0,3.237317
9029,What Happens in Vegas,2008-05-07,2008,35000000,170000000,135000000,10.054226
9030,The Eye,2008-02-01,2008,12000000,56309766,44309766,8.233662
9031,I'm for the Hippopotamus,1979-11-30,1979,0,0,0,5.079099
9032,Big Daddy,1999-06-25,1999,34200000,234801895,200601895,8.011869
9033,The Prophecy II,1998-01-20,1998,0,0,0,7.747663
9034,The Banger Sisters,2002-09-20,2002,10000000,0,-10000000,8.992438
9035,Slither,2006-03-31,2006,15500000,0,-15500000,10.375
9036,Eight Below,2006-02-17,2006,40000000,120455994,80455994,13.876881
9037,Grease 2,1982-06-11,1982,13200000,15171476,1971476,14.202364
9038,The Heartbreak Kid,2007-10-05,2007,60000000,127766650,67766650,9.149612
9039,Trapped,2002-09-20,2002,30000000,6916869,-23083131,5.781667
9040,Serpico,1973-12-05,1973,3000000,29800000,26800000,12.842165
9041,One Deadly Summer,1983-05-11,1983,0,0,0,1.786832
9042,The Cave,2005-08-25,2005,30000000,15007991,-14992009,8.077253
9043,The Family Stone,2005-12-14,2005,0,0,0,7.041967
9044,Tristan & Isolde,2006-04-07,2006,31000000,28000000,-3000000,15.672195
9045,Amen.,2002-02-13,2002,0,0,0,4.576053
9048,A Chinese Ghost Story III,1991-07-18,1991,0,0,0,3.346003
9050,A Chinese Ghost Story II,1990-07-13,1990,0,0,0,2.704684
9051,10,1979-10-04,1979,0,74865517,74865517,8.539083
9053,DOA: Dead or Alive,2006-09-07,2006,21000000,480314,-20519686,5.756379
9054,Gone Fishin',1997-05-30,1997,53000000,0,-53000000,2.289647
9056,Police Story,1985-12-14,1985,0,0,0,6.489294
9057,Terminal Velocity,1994-09-23,1994,50000000,16478900,-33521100,8.012225
9058,Only You,1994-09-17,1994,0,0,0,4.936761
9059,Tales from the Crypt: Demon Knight,1995-01-13,1995,0,0,0,9.455342
9060,Dumplings,2004-08-19,2004,0,0,0,3.382258
9061,Just Cause,1995-02-17,1995,0,0,0,9.195256
9062,Love Story,1970-12-16,1970,2200000,136400000,134200000,6.127903
9063,The Element of Crime,1984-05-18,1984,0,0,0,2.924388
9064,Hellbound: Hellraiser II,1988-12-23,1988,3000000,12090735,9090735,8.541732
9065,Europa,1991-05-11,1991,0,0,0,3.16238
9066,The Brady Bunch Movie,1995-02-16,1995,0,0,0,4.233092
9067,Tank Girl,1995-03-31,1995,25000000,4064495,-20935505,7.602087
9070,Mighty Morphin Power Rangers: The Movie,1995-06-30,1995,15000000,66000000,51000000,7.024227
9071,Living in Oblivion,1995-01-20,1995,500000,1148752,648752,10.058329
9072,Little Man,2006-08-31,2006,64000000,101595121,37595121,7.067602
9073,Free Willy 2 - The Adventure Home,1995-07-19,1995,0,0,0,7.575098
9074,The Man,2005-09-08,2005,0,12382362,12382362,11.127884
9075,Black Book,2006-09-01,2006,21000000,26193068,5193068,7.440511
9076,Nur √ºber meine Leiche,1995-08-31,1995,0,0,0,0.161326
9077,Tarantula,1955-12-14,1955,0,0,0,4.453327
9078,The Sword in the Stone,1963-12-25,1963,3000000,22182353,19182353,10.636458
9079,Dying Young,1991-06-20,1991,0,0,0,10.762636
9080,Spies Like Us,1985-12-06,1985,0,0,0,6.310054
9081,Waking Life,2001-01-23,2001,0,3176880,3176880,12.051214
9082,Blind Spot: Hitler's Secretary,2002-02-10,2002,0,0,0,0.432019
9084,The Little Polar Bear,2001-10-04,2001,0,0,0,1.246355
9085,Harlem Nights,1989-11-17,1989,30000000,60864870,30864870,9.01086
9086,Young Guns II,1990-08-01,1990,20000000,0,-20000000,11.977636
9087,The American President,1995-11-17,1995,62000000,107879496,45879496,6.318445
9089,Home for the Holidays,1995-11-02,1995,0,17519169,17519169,8.416802
9090,"To Wong Foo, Thanks for Everything! Julie Newmar",1995-09-07,1995,0,47774193,47774193,7.653446
9091,Sudden Death,1995-12-22,1995,35000000,64350171,29350171,5.23158
9092,Snow White: A Tale of Terror,1997-07-18,1997,26000000,0,-26000000,4.584166
9093,The Four Feathers,2002-09-08,2002,35000000,29882645,-5117355,6.894153
9095,Mary Reilly,1996-02-23,1996,47000000,12379402,-34620598,12.866139
9096,Medicine Man,1992-02-07,1992,40000000,0,-40000000,7.431005
9098,Regular Guys,1996-05-30,1996,0,0,0,1.165202
9099,Sgt. Bilko,1996-03-29,1996,0,0,0,5.70904
9100,The Craft,1996-05-03,1996,15000000,24769466,9769466,12.860385
9101,Down Periscope,1996-03-01,1996,0,0,0,5.184977
9102,Screamers,1995-09-08,1995,20000000,5781885,-14218115,12.758848
9103,The Quest,1996-04-19,1996,30000000,57400547,27400547,7.941972
9104,Buffalo Soldiers,2001-09-08,2001,15000000,0,-15000000,6.134588
9208,Broken Arrow,1996-02-09,1996,50000000,150270147,100270147,14.957626
9252,Otto - The New Movie,1987-07-16,1987,0,0,0,0.000844
9255,Hot Shots! Part Deux,1993-05-21,1993,25000000,133752825,108752825,13.482371
9256,Kops,2003-02-06,2003,0,8,8,2.939129
9257,S.W.A.T.,2003-08-08,2003,80000000,116643346,36643346,13.334952
9260,Welcome to Collinwood,2002-05-24,2002,1200000,0,-1200000,3.031934
9261,The Wedding Banquet,1993-08-04,1993,1000000,6933459,5933459,2.709403
9262,My Mom's New Boyfriend,2008-04-30,2008,0,0,0,3.70379
9263,Now and Then,1995-10-20,1995,12000000,27400000,15400000,8.681325
9264,Poison Ivy,1992-05-08,1992,0,0,0,6.901684
9266,Blue Crush,2002-08-08,2002,25000000,51842679,26842679,6.455738
9267,And Now for Something Completely Different,1971-09-28,1971,0,0,0,9.132013
9268,Eraser,1996-06-21,1996,100000000,242295562,142295562,6.919314
9270,Brick,2005-01-30,2005,475000,3919254,3444254,9.00314
9271,Virtuosity,1995-08-04,1995,30000000,24048000,-5952000,5.188399
9272,The Good Son,1993-09-24,1993,17000000,44456478,27456478,7.873794
9273,Ace Ventura: When Nature Calls,1995-11-10,1995,30000000,212385533,182385533,8.205448
9274,"Fire, Ice & Canned Beer",2002-02-21,2002,0,0,0,0.575105
9275,Death to Smoochy,2002-03-28,2002,55000000,0,-55000000,8.127591
9276,The Faculty,1998-12-25,1998,15000000,40283321,25283321,13.462253
9277,The Sting,1973-12-25,1973,5500000,159616327,154116327,12.016821
9278,Freejack,1992-01-17,1992,0,0,0,10.272925
9279,Jingle All the Way,1996-11-15,1996,60000000,129832389,69832389,7.898202
9280,Femme Fatale,2002-11-06,2002,35000000,16838910,-18161090,6.426438
9281,Witness,1985-02-08,1985,12000000,68706993,56706993,10.312017
9282,11:14,2003-05-16,2003,6000000,0,-6000000,14.454722
9283,Beautiful Girls,1996-02-09,1996,0,0,0,4.670562
9285,Road Trip,2000-05-19,2000,16000000,119754278,103754278,8.00158
9286,Final Destination 3,2006-02-10,2006,25000000,117719158,92719158,11.872997
9287,Troublemakers,1994-11-25,1994,0,0,0,2.230426
9288,Dungeons & Dragons: Wrath of the Dragon God,2005-01-01,2005,0,0,0,6.722598
9289,The Longest Day,1962-09-25,1962,10000000,50100000,40100000,10.770928
9290,Crocodile Dundee in Los Angeles,2001-04-12,2001,21150000,39438674,18288674,6.640385
9291,The Longest Yard,2005-05-19,2005,82000000,190320568,108320568,7.349843
9292,Hudson Hawk,1991-05-23,1991,65000000,17218080,-47781920,9.782014
9293,John Tucker Must Die,2006-07-27,2006,18000000,41009669,23009669,7.810301
9294,Phenomenon,1996-07-05,1996,32000000,152036382,120036382,5.575992
9295,Soloalbum,2003-03-26,2003,0,0,0,1.071716
9296,S1m0ne,2002-08-23,2002,0,19576023,19576023,5.759483
9297,Monster House,2006-07-21,2006,75000000,140175006,65175006,15.402378
9298,Ali G Indahouse,2002-03-21,2002,0,0,0,13.994306
9299,Thesis,1996-04-11,1996,0,2647055,2647055,7.110912
9300,Orlando,1992-09-01,1992,4000000,0,-4000000,3.800785
9301,The Princess and the Warrior,2000-10-12,2000,0,0,0,1.826108
9302,Up Close & Personal,1996-03-01,1996,60000000,0,-60000000,3.402749
9303,Bound,1996-09-13,1996,4500000,7011317,2511317,12.449574
9304,Multiplicity,1996-07-19,1996,45000000,0,-45000000,8.768806
9305,Microcosmos,1996-05-20,1996,0,0,0,10.793031
9306,The Island of Dr. Moreau,1996-08-23,1996,40000000,49627779,9627779,12.725343
9308,High School High,1996-10-25,1996,0,21302121,21302121,4.220058
9310,American Dreamz,2006-03-04,2006,17000000,7314027,-9685973,4.936369
9311,Smilla's Sense of Snow,1997-02-13,1997,35000000,0,-35000000,3.132331
9312,Mortal Kombat,1995-08-18,1995,18000000,122195920,104195920,10.870138
9313,The Man in the Iron Mask,1998-03-12,1998,0,0,0,7.960605
9314,Nineteen Eighty-Four,1984-10-10,1984,0,0,0,11.513066
9315,Flightplan,2005-09-22,2005,55000000,223387299,168387299,12.419851
9316,Ong-Bak: The Thai Warrior,2003-01-21,2003,0,15,15,7.89916
9317,Cabbage Soup,1981-12-02,1981,0,0,0,5.082509
9318,Asterix in Britain,1986-12-03,1986,0,0,0,5.711211
9319,The Last Boy Scout,1991-12-11,1991,29000000,59509925,30509925,10.550259
9320,The Avengers,1998-08-13,1998,60000000,48585416,-11414584,9.562953
9321,The Polar Bear,1998-11-12,1998,0,0,0,0.779077
9322,La Femme Nikita,1990-02-21,1990,0,5000000,5000000,6.586401
9323,Ghost in the Shell,1995-11-18,1995,0,2287714,2287714,10.686166
9325,The Jungle Book,1967-10-17,1967,4000000,205843612,201843612,22.845448
9326,Romancing the Stone,1984-03-30,1984,10000000,86572238,76572238,6.827193
9327,The Nutty Professor,1996-06-26,1996,54000000,128769345,74769345,9.651581
9331,Clear and Present Danger,1994-08-03,1994,62000000,215887717,153887717,7.513245
9333,Last Man Standing,1996-09-20,1996,67000000,47267001,-19732999,11.845918
9334,The Scorpion King,2002-04-16,2002,60000000,165333180,105333180,9.488117
9335,Transporter 2,2005-08-02,2005,32000000,85167639,53167639,11.359659
9336,Police Academy,1984-03-22,1984,4500000,146198896,141698896,8.354488
9337,Girls on Top,2001-03-29,2001,0,0,0,1.416551
9339,Click,2006-06-22,2006,82500000,237681299,155181299,9.796552
9340,The Goonies,1985-06-06,1985,19000000,61503218,42503218,14.280703
9341,The Core,2003-03-28,2003,60000000,74208267,14208267,11.664861
9342,The Mask of Zorro,1998-07-16,1998,95000000,250288523,155288523,11.348096
9343,Fitzcarraldo,1982-03-04,1982,7362000,0,-7362000,4.760938
9344,Kids,1995-07-28,1995,1500000,7412216,5912216,4.877872
9345,Exit,2006-10-06,2006,0,0,0,1.25348
9346,Risky Business,1983-08-05,1983,6200000,63541777,57341777,6.505209
9348,Species,1995-07-07,1995,35000000,113374103,78374103,13.492845
9349,Universal Soldier,1992-07-10,1992,23000000,0,-23000000,8.035769
9350,Cliffhanger,1993-05-28,1993,70000000,255000211,185000211,9.830853
9352,EuroTrip,2004-02-20,2004,25000000,20796847,-4203153,6.275468
9353,Nacho Libre,2006-06-16,2006,32000000,80197993,48197993,12.042646
9354,"Honey, I Shrunk the Kids",1989-06-22,1989,32000000,222724172,190724172,12.358786
9355,Mad Max Beyond Thunderdome,1985-06-29,1985,12305523,36230219,23924696,12.689648
9356,Look Who's Talking Too,1990-12-14,1990,0,0,0,6.42968
9357,One Hour Photo,2002-08-21,2002,12000000,52223306,40223306,10.753445
9358,Final Destination 2,2003-01-31,2003,26000000,90426405,64426405,12.638573
9359,Maverick,1994-05-20,1994,0,0,0,15.050326
9360,Anaconda,1997-04-11,1997,45000000,136885767,91885767,14.386089
9361,The Last of the Mohicans,1992-09-25,1992,40000000,75505856,35505856,15.228794
9362,Tremors,1990-01-19,1990,11000000,48572000,37572000,15.750026
9364,Wuthering Heights,2011-09-05,2011,8000000,100915,-7899085,5.276685
9366,Donnie Brasco,1997-02-27,1997,35000000,41954997,6954997,12.201954
9367,El Mariachi,1992-09-04,1992,220000,2040920,1820920,9.972591
9369,Asterix Conquers America,1994-09-27,1994,0,0,0,7.569419
9372,Super Size Me,2004-01-17,2004,65000,28575078,28510078,5.266103
9373,The Texas Chainsaw Massacre,2003-10-17,2003,9500000,107071655,97571655,7.810068
9374,Death Becomes Her,1992-07-30,1992,55000000,149022650,94022650,11.017417
9375,Crazy,2000-06-07,2000,0,0,0,1.071062
9377,Ferris Bueller's Day Off,1986-06-11,1986,6000000,70136369,64136369,12.724645
9378,Thir13en Ghosts,2001-10-26,2001,0,0,0,8.819223
9379,Otto - The Alien from East Frisia,1989-07-12,1989,0,0,0,0.062538
9381,Babylon A.D.,2008-08-20,2008,70000000,72108608,2108608,9.273808
9382,Boys on the Side,1995-02-03,1995,21000000,23450000,2450000,3.030309
9383,Hollow Man,2000-08-04,2000,95000000,190213455,95213455,7.912103
9384,Starsky & Hutch,2004-03-05,2004,60000000,170268750,110268750,10.776138
9385,The Twelve Tasks of Asterix,1976-09-08,1976,0,0,0,7.715483
9386,In the Line of Fire,1993-07-08,1993,40000000,176997168,136997168,12.637158
9387,Conan the Barbarian,1982-04-02,1982,20000000,79114085,59114085,10.52008
9388,Thank You for Smoking,2005-09-05,2005,6500000,24793509,18293509,9.369527
9389,Renaissance,2006-03-16,2006,18000000,1831348,-16168652,9.746725
9390,Jerry Maguire,1996-12-06,1996,50000000,273552592,223552592,11.807601
9391,Enduring Love,2004-11-26,2004,0,0,0,1.643329
9392,The Descent,2005-07-08,2005,0,0,0,8.794041
9393,Before the Fall,2004-07-04,2004,4500000,3764219,-735781,5.69684
9394,They Call Me Trinity,1970-12-22,1970,0,0,0,9.449417
9395,Above the Law,1988-04-08,1988,7500000,18869631,11369631,5.283245
9396,Crocodile Dundee II,1988-05-19,1988,0,239606210,239606210,8.948565
9397,Evolution,2001-06-08,2001,80000000,98376292,18376292,5.395127
9398,Zoolander,2001-09-28,2001,28000000,60780981,32780981,10.40782
9399,Lionheart,1990-06-07,1990,6000000,24078196,18078196,4.619068
9400,Set It Off,1996-11-06,1996,9000000,41590886,32590886,6.85606
9401,2 Days in the Valley,1996-09-11,1996,0,0,0,4.989276
9403,Private Parts,1997-03-07,1997,28000000,41230799,13230799,10.928417
9404,First Strike,1996-02-10,1996,0,21890845,21890845,9.206356
9405,Double Team,1997-04-04,1997,30000000,0,-30000000,5.452961
9406,An American Werewolf in Paris,1997-12-25,1997,22000000,26570463,4570463,7.145784
9407,Red Corner,1997-10-30,1997,48000000,0,-48000000,3.288944
9408,Surf's Up,2007-06-08,2007,85000000,149044513,64044513,11.526339
9409,Another Stakeout,1993-07-22,1993,0,0,0,12.967239
9410,Great Expectations,1998-01-19,1998,25000000,55494066,30494066,9.941228
9411,Fallen,1998-01-16,1998,0,25232289,25232289,6.381612
9413,Picture Perfect,1997-08-01,1997,19000000,44332015,25332015,4.347079
9414,The Man Who Knew Too Little,1997-11-14,1997,20000000,13801755,-6198245,4.827771
9415,Murder at 1600,1997-04-18,1997,0,25804707,25804707,8.428986
9416,Money Talks,1997-08-22,1997,0,0,0,13.855037
9417,Wrongfully Accused,1998-08-21,1998,0,0,0,9.852635
9421,The Dinner Game,1998-04-15,1998,12500000,78599508,66099508,6.122739
9422,A Civil Action,1998-03-05,1998,70000000,56702901,-13297099,9.353499
9423,Virus,1999-01-14,1999,75000000,14010690,-60989310,7.116537
9424,Disturbing Behavior,1998-07-24,1998,15000000,17507368,2507368,11.054751
9425,Soldier,1998-10-23,1998,75000000,14567883,-60432117,7.970031
9426,The Fly,1986-08-15,1986,15000000,60629159,45629159,13.534589
9427,The Full Monty,1997-08-13,1997,3500000,257850122,254350122,8.333322
9428,The Royal Tenenbaums,2001-10-05,2001,21000000,71441250,50441250,9.707542
9429,A Night at the Roxbury,1998-10-01,1998,17000000,30331165,13331165,12.480685
9430,Go,1999-04-09,1999,6500000,28451622,21951622,8.344282
9431,Bordello of Blood,1996-08-16,1996,15000000,5600000,-9400000,3.450402
9433,The Edge,1997-09-06,1997,0,43312294,43312294,15.174973
9434,Grosse Pointe Blank,1997-04-11,1997,0,28084357,28084357,7.556814
9437,Kiss the Girls,1997-10-03,1997,27000000,60527873,33527873,12.235391
9438,Mr. Magoo,1997-12-25,1997,30000000,0,-30000000,9.474269
9439,The Nameless,1999-10-08,1999,0,0,0,2.564327
9440,Primary Colors,1998-03-20,1998,65000000,0,-65000000,8.455425
9441,Stepmom,1998-12-25,1998,0,0,0,7.17892
9442,Dead Men Don't Wear Plaid,1982-05-21,1982,0,18196170,18196170,5.515136
9443,Chariots of Fire,1981-05-15,1981,5500000,58972904,53472904,6.877698
9444,Anastasia,1997-11-20,1997,53000000,139804348,86804348,11.911173
9445,Apt Pupil,1998-10-23,1998,14000000,0,-14000000,15.352714
9446,Jungle 2 Jungle,1997-03-07,1997,0,0,0,12.640569
9447,Babe: Pig in the City,1998-11-25,1998,90000000,69131860,-20868140,6.229629
9448,The Big Hit,1998-04-24,1998,13000000,27007143,14007143,5.975082
9449,The Borrowers,1997-12-05,1997,29000000,0,-29000000,14.924667
9450,Brassed Off,1996-11-01,1996,0,0,0,3.117071
9451,Election,1999-04-23,1999,0,0,0,7.174396
9452,Bulworth,1998-05-15,1998,30000000,29202884,-797116,3.385342
9453,Caligula,1979-01-21,1979,17500000,23438120,5938120,11.157288
9454,Ever After: A Cinderella Story,1998-07-31,1998,26000000,65705772,39705772,13.309701
9455,The Corruptor,1999-03-12,1999,25000000,15156200,-9843800,9.208831
9456,The Crow: Salvation,2000-10-31,2000,10000000,0,-10000000,6.311201
9457,Deep Rising,1998-01-30,1998,45000000,11203026,-33796974,6.922458
9458,Desperate Measures,1998-01-30,1998,50000000,0,-50000000,3.713996
9459,Woodstock,1970-03-26,1970,600000,34505110,33905110,3.624542
9460,Black Mask,1996-11-07,1996,0,0,0,7.632785
9461,Enter the Dragon,1973-08-17,1973,850000,90000000,89150000,10.687757
9462,The Way of the Dragon,1972-06-01,1972,130000,85000000,84870000,11.116474
9463,Vampire Hunter D,1985-12-21,1985,0,0,0,3.74515
9464,Buffalo '66,1998-01-20,1998,1500000,2375097,875097,9.167761
9465,Cookie's Fortune,1999-01-22,1999,10000000,10920544,920544,3.380684
9466,Celebrity,1998-09-07,1998,0,0,0,5.704352
9469,He Got Game,1998-05-01,1998,25000000,21567853,-3432147,13.06943
9470,Kung Fu Hustle,2004-02-10,2004,20000000,100914445,80914445,8.636632
9471,Charlie's Angels: Full Throttle,2003-06-27,2003,120000000,259175788,139175788,7.821116
9472,DodgeBall: A True Underdog Story,2004-06-18,2004,20000000,167722310,147722310,11.967379
9473,"South Park: Bigger, Longer & Uncut",1999-06-30,1999,21000000,0,-21000000,11.818055
9474,My Name Is Nobody,1973-12-13,1973,0,0,0,6.022453
9475,Scent of a Woman,1992-12-23,1992,31000000,134095253,103095253,14.505987
9476,A Knight's Tale,2001-05-11,2001,65000000,117487473,52487473,10.90061
9477,King Arthur,2004-07-07,2004,120000000,203567857,83567857,8.862107
9478,Ants in the Pants,2000-03-29,2000,0,0,0,2.832858
9479,The Nightmare Before Christmas,1993-10-09,1993,18000000,75634409,57634409,17.730913
9480,Daredevil,2003-02-14,2003,78000000,179179718,101179718,11.415558
9481,The Bone Collector,1999-11-04,1999,73000000,151493655,78493655,8.884406
9482,Judge Dredd,1995-06-30,1995,90000000,113493481,23493481,8.184815
9483,Schultze Gets the Blues,2003-09-02,2003,0,0,0,0.573946
9486,Johnny English,2003-04-06,2003,40000000,160583018,120583018,8.739991
9487,A Bug's Life,1998-11-25,1998,120000000,363258859,243258859,16.869209
9488,Spy Kids 2: The Island of Lost Dreams,2002-08-07,2002,38000000,119723358,81723358,7.164131
9489,You've Got Mail,1998-12-17,1998,65000000,250821495,185821495,10.237996
9490,Half Baked,1998-01-16,1998,8000000,17460020,9460020,7.022548
9491,Blue Steel,1990-03-16,1990,0,0,0,5.200399
9493,Twins,1988-12-09,1988,15000000,216614388,201614388,5.952494
9494,Look Who's Talking,1989-10-12,1989,7500000,296000000,288500000,5.795045
9495,The Crow,1994-05-11,1994,15000000,94000000,79000000,15.799336
9496,Werner - Volles Roo√§√§√§!!!,1999-09-16,1999,0,0,0,1.405313
9497,Kleines Arschloch - Der Film,1997-03-06,1997,0,0,0,1.238404
9499,Le Divorce,2003-08-08,2003,0,12991996,12991996,8.73915
9501,Crying Freeman,1995-04-23,1995,6100000,0,-6100000,7.603066
9502,Kung Fu Panda,2008-06-04,2008,130000000,631744560,501744560,16.897541
9503,Pope Joan,2009-10-22,2009,0,27412220,27412220,7.289967
9504,Glengarry Glen Ross,1992-09-15,1992,12500000,10725228,-1774772,6.792215
9506,Anger Management,2003-04-11,2003,75000000,195745823,120745823,9.409379
9507,Runaway,1984-12-14,1984,0,0,0,2.537509
9509,Man on Fire,2004-04-23,2004,70000000,130293714,60293714,9.635691
9510,1¬Ω Knights - In Search of the Ravishing Princess Herzelinde,2008-12-17,2008,67000000,0,-67000000,6.871788
9511,Rabbit Without Ears 2,2009-11-24,2009,0,48720000,48720000,6.065049
9513,Garfield: A Tail of Two Kitties,2006-06-15,2006,0,141702264,141702264,7.217377
9514,Werner - Das muss kesseln!!!,1996-06-27,1996,0,0,0,1.282317
9515,The Matador,2005-05-12,2005,10000000,17297244,7297244,3.867472
9516,Menace II Society,1993-05-26,1993,3500000,27900000,24400000,5.260924
9517,Bully,2001-06-15,2001,0,480811,480811,4.877774
9519,Chopper,2000-06-21,2000,0,236185,236185,9.035898
9520,The Thief Lord,2006-01-04,2006,0,0,0,2.919269
9522,Wedding Crashers,2005-07-14,2005,40000000,285176741,245176741,11.100597
9523,Lantana,2001-10-04,2001,0,0,0,2.994899
9524,Comedian Harmonists,1997-12-25,1997,0,0,0,0.799079
9526,A Prairie Home Companion,2006-06-09,2006,10000000,0,-10000000,5.114498
9527,Ballermann 6,1997-10-16,1997,0,0,0,1.106747
9528,Ladies in Lavender,2004-06-14,2004,0,20377075,20377075,3.837975
9529,Candyman,1992-10-16,1992,6000000,25792310,19792310,12.721362
9530,RV,2006-04-28,2006,50000000,87528173,37528173,11.511424
9531,Superman III,1983-06-17,1983,39000000,75850624,36850624,9.614638
9532,Final Destination,2000-03-16,2000,23000000,53302314,30302314,14.961416
9533,Red Dragon,2002-09-29,2002,78000000,209196298,131196298,2.968157
9534,Ferpect Crime,2004-09-10,2004,6000000,0,-6000000,4.160272
9535,Analyze This,1999-03-05,1999,80000000,176885658,96885658,7.634017
9536,Bio-Dome,1996-01-12,1996,15000000,0,-15000000,6.387469
9538,Scanners,1981-01-14,1981,4100000,14225876,10125876,10.574039
9539,Martyrs,2008-09-03,2008,6500000,0,-6500000,7.716326
9540,Dead Ringers,1988-09-23,1988,13000000,8038508,-4961492,5.53202
9541,Jersey Girl,2004-03-25,2004,35000000,36098382,1098382,5.706507
9542,The Hitcher,1986-02-21,1986,6000000,5844868,-155132,5.648114
9543,Prince of Persia: The Sands of Time,2010-05-19,2010,150000000,335154643,185154643,18.459955
9544,FearDotCom,2002-08-09,2002,40000000,18902015,-21097985,5.160215
9545,Sniper,1993-01-29,1993,0,18994653,18994653,9.337393
9546,Ricochet,1991-10-04,1991,0,0,0,5.462639
9547,Old Shatterhand,1964-04-30,1964,0,0,0,1.364777
9548,The Adventures of Ford Fairlane,1990-07-11,1990,49000000,20423389,-28576611,3.834949
9549,The Right Stuff,1983-10-20,1983,27000000,21500000,-5500000,14.902397
9550,House of Flying Daggers,2004-05-19,2004,0,92863945,92863945,9.3002
9551,Dieter - The Movie,2006-03-04,2006,6907750,0,-6907750,0.836297
9552,The Exorcist,1973-12-26,1973,8000000,441306145,433306145,12.137595
9555,Rabbit-Proof Fence,2002-02-04,2002,0,0,0,4.403771
9556,Darkman,1990-08-24,1990,16000000,48878502,32878502,8.899418
9557,Boat Trip,2002-10-01,2002,20000000,8586376,-11413624,6.515316
9558,King of New York,1990-07-18,1990,1000000,2554476,1554476,11.230031
9559,A Perfect World,1993-11-24,1993,30000000,135130999,105130999,8.040589
9560,A Walk in the Clouds,1995-08-11,1995,20000000,50012507,30012507,9.715639
9561,TerrorStorm: A History of Government-Sponsored Terrorism,2006-01-01,2006,0,0,0,0.563891
9562,Timeline,2003-11-26,2003,80000000,43935763,-36064237,6.982762
9563,Any Given Sunday,1999-12-16,1999,55000000,100230832,45230832,10.571434
9564,Asterix & Obelix Take on Caesar,1999-02-01,1999,0,1644060,1644060,8.150265
9565,No More School,2000-12-07,2000,0,0,0,1.309854
9566,The Fan,1996-08-15,1996,55000000,18626419,-36373581,12.202063
9567,Tears of the Sun,2003-03-07,2003,70000000,85632458,15632458,10.614987
9568,The Dentist,1996-06-07,1996,2500000,0,-2500000,3.040468
9569,Hard to Kill,1990-02-09,1990,10000000,47410000,37410000,7.176601
9570,The Black Hole,1979-12-18,1979,20000000,35841901,15841901,7.499388
9571,Dazed and Confused,1993-09-24,1993,6900000,7993039,1093039,6.8652
9572,Ants in the Pants 2,2002-03-13,2002,0,0,0,1.512735
9573,Blood Work,2002-08-04,2002,50000000,26199517,-23800483,5.852263
9574,Flubber,1997-11-26,1997,80000000,177977226,97977226,7.016942
9576,Tootsie,1982-12-16,1982,21000000,177200000,156200000,8.451188
9577,To the Limit,2007-02-09,2007,0,0,0,0.573479
9581,Fulltime Killer,2001-08-03,2001,0,0,0,4.788907
9582,A Guy Thing,2003-01-17,2003,20000000,17432163,-2567837,4.444724
9583,Divine Secrets of the Ya-Ya Sisterhood,2002-06-07,2002,27000000,0,-27000000,4.327218
9584,Convoy,1978-06-27,1978,12000000,22765081,10765081,4.925738
9585,Not Without My Daughter,1991-01-11,1991,0,0,0,9.505757
9586,The Bonfire of the Vanities,1990-12-21,1990,47000000,15691192,-31308808,5.507082
9587,Little Women,1994-12-21,1994,18000000,0,-18000000,9.774994
9588,Quigley Down Under,1990-10-17,1990,0,0,0,12.620366
9589,Christiane F.,1981-04-01,1981,0,0,0,5.64576
9591,That Thing You Do!,1996-10-04,1996,0,34585416,34585416,8.685761
9592,Open Water 2: Adrift,2006-07-10,2006,1200000,0,-1200000,11.500311
9593,Last Action Hero,1993-06-18,1993,85000000,137298489,52298489,9.434006
9594,Double Impact,1991-07-31,1991,15000000,30102717,15102717,6.600651
9595,Hot Shots!,1991-07-31,1991,26000000,181096164,155096164,11.026793
9597,Vidocq,2001-09-12,2001,0,0,0,11.195104
9598,Babe,1995-07-18,1995,30000000,254134910,224134910,14.404764
9599,The Blob,1988-08-05,1988,19000000,8247943,-10752057,10.874079
9600,Big Momma's House,2000-05-31,2000,30000000,173959438,143959438,7.978985
9602,Coming to America,1988-06-28,1988,39000000,288752301,249752301,7.830087
9603,Clueless,1995-07-19,1995,12000000,0,-12000000,9.882383
9604,Red Heat,1988-06-17,1988,29000000,34994648,5994648,14.25013
9605,Single White Female,1992-08-14,1992,16000000,48017402,32017402,7.246119
9606,Metropolis,2001-05-26,2001,14500000,95789342,81289342,9.298092
9607,Super Mario Bros.,1993-05-28,1993,48000000,20915465,-27084535,7.198455
9608,The Legend of Sleepy Hollow,1999-10-23,1999,0,0,0,0.721164
9609,Of Mice and Men,1992-09-16,1992,0,5471088,5471088,6.112112
9610,Conan the Destroyer,1984-06-29,1984,18000000,100000000,82000000,10.151366
9611,Romy and Michele's High School Reunion,1997-04-25,1997,0,29235353,29235353,5.889414
9612,Coneheads,1993-07-23,1993,0,0,0,10.722729
9613,Spider,2002-12-13,2002,0,0,0,5.812918
9614,Happy Gilmore,1996-02-16,1996,12000000,41205099,29205099,9.592265
9615,The Fast and the Furious: Tokyo Drift,2006-06-03,2006,85000000,158468292,73468292,2.238808
9616,The Order,2003-09-05,2003,35000000,11560806,-23439194,5.370818
9618,Tango & Cash,1989-12-22,1989,55000000,63408614,8408614,7.507261
9619,Dante's Peak,1997-02-07,1997,116000000,178127760,62127760,7.240753
9620,Paycheck,2003-12-25,2003,60000000,96269812,36269812,12.571789
9621,Elizabethtown,2005-10-06,2005,57000000,52034889,-4965111,11.82081
9622,Beverly Hills Ninja,1997-01-17,1997,0,0,0,12.16305
9623,The Juror,1996-02-02,1996,44000000,0,-44000000,6.010579
9624,On Deadly Ground,1994-02-18,1994,50000000,49000000,-1000000,6.678661
9625,The Glimmer Man,1996-10-04,1996,45000000,0,-45000000,5.918737
9626,Red Sonja,1985-04-09,1985,17900000,6948633,-10951367,10.014248
9627,Flaming Frontier,1965-12-14,1965,0,0,0,1.720155
9629,Thunder at the Border,1966-12-13,1966,0,0,0,1.55251
9631,The Negotiator,1998-07-29,1998,50000000,44547681,-5452319,7.65502
9636,Control,2004-12-07,2004,6800000,0,-6800000,7.535399
9637,Scooby-Doo,2002-06-14,2002,84000000,275650703,191650703,8.592826
9638,Phantasm,1979-03-28,1979,300000,11988469,11688469,6.609336
9639,Grimm Love,2006-08-27,2006,0,0,0,9.008456
9641,Cheaper by the Dozen 2,2005-12-21,2005,60000000,129181830,69181830,7.101422
9642,Asterix and the Vikings,2006-04-05,2006,0,0,0,6.096196
9643,Rossini,1997-01-23,1997,0,0,0,1.092225
9644,National Lampoon's Loaded Weapon 1,1993-02-04,1993,0,0,0,11.511683
9645,Ghost Ship,2002-10-25,2002,35000000,68349884,33349884,13.955376
9646,Here Is Your Life,1966-12-26,1966,0,0,0,0.762877
9647,Scrooged,1988-11-22,1988,0,60328000,60328000,11.465634
9648,The Man Who Sued God,2001-10-25,2001,0,0,0,1.741405
9650,Hard Luck,2007-08-22,2007,0,0,0,1.507646
9651,Supergirl,1984-11-19,1984,35000000,14296438,-20703562,11.932675
9652,The Passenger,1975-02-28,1975,0,0,0,9.202533
9653,M√§dchen in Uniform,1931-11-27,1931,0,0,0,1.480025
9654,The Italian Job,2003-05-30,2003,60000000,176070171,116070171,13.995044
9655,She's the Man,2006-03-17,2006,20000000,33889159,13889159,6.916201
9656,Black Christmas,2006-12-25,2006,9000000,21510851,12510851,7.888302
9657,Otto - The Movie,1985-07-19,1985,0,0,0,2.010996
9659,Mad Max,1979-04-12,1979,400000,100000000,99600000,11.412619
9660,Operation Petticoat,1959-12-05,1959,0,6800000,6800000,3.918878
9662,The Triplets of Belleville,2003-06-11,2003,8000000,1477676,-6522324,8.35586
9663,Starman,1984-12-13,1984,22000000,28744356,6744356,9.763928
9664,Flyboys,2006-09-22,2006,60000000,17800000,-42200000,5.460942
9665,Glory,1989-12-15,1989,18000000,26828365,8828365,7.521346
9666,Ju-on: The Grudge 2,2003-08-15,2003,0,0,0,5.165962
9667,The Jacket,2005-03-04,2005,29000000,21126225,-7873775,12.092096
9669,Ringu 2,1999-01-23,1999,6000000,18686644,12686644,5.277814
9671,Crocodile Dundee,1986-09-26,1986,5000000,328203506,323203506,7.791212
9672,Infamous,2006-11-16,2006,13000000,1151330,-11848670,5.169999
9673,Voll Normaaal,1994-11-10,1994,0,0,0,1.048591
9674,Ringu 0,2000-01-22,2000,6000000,0,-6000000,5.007142
9675,Sideways,2004-10-22,2004,16000000,109502303,93502303,12.646518
9676,The Black Dahlia,2006-09-15,2006,50000000,49111202,-888798,6.506572
9677,Forklift Driver Klaus: The First Day on the Job,2001-08-08,2001,0,0,0,3.067015
9678,Little Nicky,2000-11-10,2000,85000000,0,-85000000,6.10979
9679,Gone in Sixty Seconds,2000-06-09,2000,90000000,237202299,147202299,14.091765
9680,Uncle Sam,1997-07-04,1997,0,0,0,4.586944
9681,Casanova,2005-12-25,2005,0,37691644,37691644,11.568302
9682,Pulse,2006-08-11,2006,38000000,29907685,-8092315,10.307277
9683,Bubble Boy,2001-08-24,2001,0,0,0,10.295438
9684,Sweet and Lowdown,1999-12-03,1999,0,0,0,6.836569
9685,Igby Goes Down,2002-09-13,2002,9000000,4777465,-4222535,5.536107
9686,New York Stories,1989-03-10,1989,15000000,0,-15000000,9.686985
9687,Keeping Mum,2005-12-02,2005,169000,18564702,18395702,5.742659
9688,Melinda and Melinda,2004-10-29,2004,0,20085825,20085825,6.117784
9689,Hollywood Ending,2002-05-03,2002,16000000,0,-16000000,9.987317
9690,Verschwende deine Jugend,2003-07-03,2003,0,0,0,0.742665
9691,Assassins,1995-10-06,1995,50000000,30303072,-19696928,11.065939
9692,The Woodsman,2004-12-24,2004,0,4678405,4678405,6.984903
9693,Children of Men,2006-09-22,2006,76000000,69959751,-6040249,14.114606
9694,One Missed Call,2003-11-03,2003,0,0,0,6.703174
9695,Karla,2006-01-20,2006,0,0,0,3.277457
9696,Ichi the Killer,2001-12-22,2001,1400000,0,-1400000,8.992796
9697,Lady in the Water,2006-07-21,2006,75000000,42285169,-32714831,8.704554
9698,Straight to Hell,1986-01-01,1986,0,0,0,1.044389
9699,Trail of the Pink Panther,1982-12-03,1982,0,9056073,9056073,4.918228
9700,The Lost City,2005-09-03,2005,9600000,4386236,-5213764,2.637004
9701,North Country,2005-02-12,2005,35000000,25224242,-9775758,8.781298
9702,Bound by Honor,1993-02-05,1993,35000000,0,-35000000,6.398031
9703,The Last Legion,2007-04-19,2007,67000000,25303038,-41696962,8.920545
9705,Swordfish,2001-06-07,2001,102000000,147080413,45080413,9.646208
9706,Rasen,1998-01-31,1998,2900000,0,-2900000,1.199512
9707,Bubba Ho-tep,2002-06-09,2002,1000000,0,-1000000,5.574383
9708,The Wicker Man,2006-09-01,2006,40000000,38755073,-1244927,9.423256
9709,My Summer of Love,2004-08-20,2004,0,0,0,4.21593
9710,Allan Quatermain and the Lost City of Gold,1986-12-17,1986,0,0,0,10.877201
9711,Species III,2004-11-26,2004,0,0,0,7.711755
9713,Holy Man,1998-10-08,1998,60000000,0,-60000000,5.403617
9714,Home Alone 3,1997-12-12,1997,32000000,79082515,47082515,8.04209
9715,Hope Floats,1998-05-29,1998,0,0,0,6.54478
9716,Everyone Says I Love You,1996-12-06,1996,20000000,0,-20000000,9.649113
9717,Shoot to Kill,1988-02-12,1988,0,29300000,29300000,2.514717
9718,Talladega Nights: The Ballad of Ricky Bobby,2006-08-04,2006,72500000,162966177,90466177,6.936688
9719,Pumpkin,2002-06-28,2002,0,0,0,2.008306
9721,7 Seconds,2005-06-28,2005,13000000,0,-13000000,4.673777
9722,Bewitched,2005-06-21,2005,85000000,131426169,46426169,9.276085
9724,The Mistress of Spices,2005-09-11,2005,0,0,0,2.286543
9725,Friday the 13th Part 2,1981-05-01,1981,1250000,21722776,20472776,8.710824
9726,A Good Year,2006-09-09,2006,35000000,42064105,7064105,7.82187
9727,End Game,2006-03-22,2006,5000000,0,-5000000,2.534678
9728,Friday the 13th Part III,1982-08-13,1982,4000000,36690067,32690067,7.99229
9729,Where the Truth Lies,2005-10-07,2005,25000000,0,-25000000,3.750466
9730,Friday the 13th: The Final Chapter,1984-04-13,1984,2600000,32980880,30380880,10.175913
9731,Friday the 13th: A New Beginning,1985-03-22,1985,2200000,21930418,19730418,9.094477
9732,The Lion King 2: Simba's Pride,1998-10-24,1998,0,0,0,9.417261
9736,Love Me No More,2008-04-30,2008,0,0,0,5.922081
9737,Bad Boys,1995-04-07,1995,19000000,141407024,122407024,9.262184
9738,Fantastic Four,2005-06-29,2005,100000000,330579719,230579719,19.382082
9739,Demolition Man,1993-10-08,1993,57000000,159055768,102055768,11.626116
9740,Hannibal,2001-02-08,2001,87000000,351692268,264692268,2.48875
9741,Unbreakable,2000-11-13,2000,75000000,248118121,173118121,14.67855
9742,Werner - Beinhart!,1990-11-29,1990,0,0,0,1.74424
9745,Jack Frost,1998-12-10,1998,27000000,0,-27000000,7.372419
9746,Kundun,1997-12-25,1997,28000000,5684789,-22315211,5.01752
9748,D.O.A.,1988-03-18,1988,0,12706478,12706478,2.793619
9749,Fletch,1985-05-31,1985,8000000,59612888,51612888,6.040486
9750,Balls of Fury,2007-08-29,2007,0,41098065,41098065,5.325766
9753,Survival Island,2005-01-01,2005,9000000,0,-9000000,5.92516
9754,Firewall,2006-02-10,2006,45000000,82800000,37800000,6.500892
9755,Bloodsuckers,2005-07-30,2005,1700000,0,-1700000,0.722339
9756,Half Light,2006-01-17,2006,0,0,0,10.050905
9757,Norbit,2007-02-08,2007,60000000,95673607,35673607,7.667874
9759,Cellular,2004-09-06,2004,25000000,56422687,31422687,5.918816
9760,Epic Movie,2007-01-25,2007,20000000,86865564,66865564,5.549609
9761,Elephants Dream,2006-03-24,2006,150000,0,-150000,1.802597
9762,Step Up,2006-08-11,2006,12000000,114194847,102194847,14.21769
9763,Goal!: The Dream Begins,2005-06-06,2005,30000000,27610873,-2389127,9.783762
9764,Dersu Uzala,1975-08-02,1975,4000000,0,-4000000,4.713259
9765,Der gro√üe Bagarozy,1999-10-06,1999,0,0,0,0.468805
9766,Gridiron Gang,2006-09-15,2006,30000000,41480851,11480851,5.025475
9767,The Break-Up,2006-06-01,2006,52000000,204999686,152999686,6.327193
9768,Cry-Baby,1990-04-05,1990,11000000,8266343,-2733657,8.290384
9769,Lolita,1997-09-27,1997,62000000,1060056,-60939944,10.618141
9770,Mad City,1997-11-07,1997,50000000,10541523,-39458477,4.909738
9771,Major League: Back to the Minors,1998-04-17,1998,0,3572443,3572443,8.207548
9772,Air Force One,1997-07-25,1997,85000000,315156409,230156409,12.173291
9773,Alien Autopsy,2006-04-07,2006,0,0,0,11.409916
9775,November,2003-09-26,2003,0,0,0,0.391031
9776,Head of State,2003-01-01,2003,0,0,0,3.363245
9777,Proof,2005-09-05,2005,20000000,7535331,-12464669,7.983902
9778,Serendipity,2001-10-05,2001,28000000,77516304,49516304,5.715737
9779,The Sisterhood of the Traveling Pants,2005-06-01,2005,25000000,39053061,14053061,9.263965
9781,Detroit Rock City,1999-08-13,1999,6500000,4217115,-2282885,6.074832
9782,The Night Listener,2006-02-12,2006,0,0,0,11.478867
9783,Sublime,2007-06-15,2007,0,0,0,3.229071
9784,Man About Town,2006-06-08,2006,0,0,0,3.874408
9785,The Invisible,2007-04-27,2007,30000000,26810113,-3189887,6.097503
9786,Art School Confidential,2006-11-10,2006,0,0,0,11.611468
9787,Lords of Dogtown,2005-06-03,2005,25000000,13411957,-11588043,4.350049
9788,Accepted,2006-08-18,2006,23000000,38505009,15505009,7.06088
9789,My Brother Is an Only Child,2007-04-20,2007,5000000,6463286,1463286,4.391819
9791,Animal Factory,2000-08-01,2000,0,0,0,6.432071
9792,The Hills Have Eyes,2006-03-10,2006,15000000,69623713,54623713,18.960549
9793,The Hills Have Eyes 2,2007-03-22,2007,15000000,0,-15000000,5.559312
9794,Employee of the Month,2006-10-06,2006,12000000,38368909,26368909,8.596352
9795,Earthsea,2004-12-13,2004,0,0,0,2.313791
9796,Turistas,2006-12-01,2006,10000000,0,-10000000,11.951258
9797,"Ivan the Terrible, Part I",1945-04-23,1945,0,0,0,2.121177
9798,Enemy of the State,1998-11-20,1998,90000000,250649836,160649836,12.978751
9799,The Fast and the Furious,2001-06-22,2001,38000000,207283925,169283925,1.406181
9800,Philadelphia,1993-12-22,1993,26000000,206678440,180678440,13.373006
9801,Bridget Jones: The Edge of Reason,2004-11-10,2004,50000000,40203020,-9796980,7.78817
9802,The Rock,1996-06-06,1996,75000000,335062621,260062621,13.249824
9803,Seven Dwarfs,2004-10-28,2004,0,0,0,4.582736
9804,Waterworld,1995-07-28,1995,175000000,264218220,89218220,16.885184
9806,The Incredibles,2004-11-05,2004,92000000,631442092,539442092,22.220214
9807,Aladdin,1986-01-01,1986,0,0,0,2.729721
9809,Let's Go to Prison,2006-11-17,2006,4000000,4630045,630045,3.856827
9810,The New Swiss Family Robinson,1998-12-25,1998,0,0,0,0.770475
9812,Thursday,1998-09-25,1998,0,0,0,4.311326
9813,The Quiet,2005-09-12,2005,900000,381420,-518580,4.997751
9815,Goal! II: Living the Dream,2007-02-09,2007,230400,0,-230400,4.59233
9816,Save the Last Dance,2001-01-12,2001,13000000,91038276,78038276,4.794088
9817,Save the Last Dance 2,2006-10-10,2006,0,0,0,3.981958
9819,Marvin's Room,1996-12-18,1996,23000000,12803305,-10196695,5.307984
9820,The Parent Trap,1998-07-28,1998,0,0,0,7.768828
9821,The Mighty,1998-10-23,1998,0,0,0,6.78844
9822,Mighty Joe Young,1998-12-25,1998,90000000,0,-90000000,6.939576
9823,Mortal Kombat: Annihilation,1997-11-21,1997,30000000,51376861,21376861,6.532498
9824,Mystery Men,1999-08-06,1999,68000000,29762011,-38237989,10.466306
9825,Lake Placid,1999-07-15,1999,27000000,56870414,29870414,13.787108
9826,The Phantom,1996-06-06,1996,45000000,17300889,-27699111,8.079541
9827,Phantoms,1998-01-23,1998,0,5624282,5624282,10.754614
9828,Unknown,2006-11-03,2006,3700000,3338228,-361772,13.505066
9829,United 93,2006-04-28,2006,15000000,76286096,61286096,10.527141
9830,Haven,2004-09-11,2004,0,0,0,3.652969
9833,The Phantom of the Opera,2004-12-08,2004,70000000,154648887,84648887,7.682562
9834,The Net 2.0,2006-02-15,2006,0,0,0,2.692438
9835,Jane Austen's Mafia!,1998-07-24,1998,10000000,19000000,9000000,6.046893
9836,Happy Feet,2006-11-16,2006,100000000,384335608,284335608,15.088318
9837,The Prince of Egypt,1998-12-15,1998,70000000,218613188,148613188,11.898185
9838,King Solomon's Mines,1985-03-20,1985,12500000,238227,-12261773,6.138795
9839,Beyond Borders,2003-10-23,2003,35000000,0,-35000000,8.940335
9840,The Dreamlife of Angels,1998-09-16,1998,500000,0,-500000,0.417705
9841,Rest Stop,2006-10-07,2006,0,0,0,4.657671
9842,School for Scoundrels,2006-09-29,2006,20000000,17807569,-2192431,10.725567
9843,Big Nothing,2006-12-01,2006,0,0,0,11.802069
9844,The Opposite of Sex,1998-05-22,1998,5000000,5879254,879254,14.734622
9845,Dance with the Devil,1997-10-31,1997,0,0,0,2.919575
9846,To Live and Die in L.A.,1985-11-01,1985,0,17307019,17307019,6.186999
9847,The Tripper,2006-04-20,2006,0,0,0,2.030435
9849,My Favorite Martian,1999-02-11,1999,65000000,36850101,-28149899,12.65102
9867,The Go-Getter,2007-01-22,2007,0,0,0,4.555069
9869,Patriot Games,1992-06-04,1992,45000000,178051587,133051587,11.075674
9870,Forgetting Sarah Marshall,2008-04-17,2008,30000000,105173115,75173115,15.106676
9871,Ginger Snaps,2000-08-01,2000,5000000,0,-5000000,5.603312
9872,Explorers,1985-07-12,1985,25000000,9873044,-15126956,4.935932
9873,F/X,1986-02-07,1986,0,20603715,20603715,6.620556
9874,Cobra,1986-03-21,1986,0,49042224,49042224,6.892829
9876,Stop! Or My Mom Will Shoot,1992-02-21,1992,0,70611210,70611210,14.40112
9877,Urban Legend,1998-09-25,1998,14000000,72527595,58527595,6.081401
9878,The Boy in the Plastic Bubble,1976-11-12,1976,0,0,0,1.756032
9879,Striptease,1996-06-28,1996,50000000,113309743,63309743,11.341502
9880,The Princess Diaries,2001-08-03,2001,37000000,165335153,128335153,7.387171
9882,The Siege,1998-11-06,1998,70000000,116672912,46672912,9.019114
9884,Collateral Damage,2002-02-06,2002,85000000,78382433,-6617567,10.175503
9885,Wolf Creek,2005-01-01,2005,1000000,27762648,26762648,7.483385
9886,Johnny Mnemonic,1995-05-26,1995,25000000,19075720,-5924280,11.715868
9889,Shallow Hal,2001-11-01,2001,40000000,141069860,101069860,12.520688
9890,The Stepford Wives,2004-06-10,2004,90000000,102000000,12000000,10.81552
9893,Sleepover,2004-07-09,2004,0,0,0,5.327657
9894,The Cable Guy,1996-06-10,1996,47000000,102825796,55825796,7.586577
9895,Man of the Year,2006-10-09,2006,20000000,41237648,21237648,7.018483
9896,Rat Race,2001-07-30,2001,48000000,85498534,37498534,12.330275
9898,The Killing Floor,2007-05-10,2007,0,0,0,1.604539
9899,The Producers,2005-12-25,2005,45000000,38058335,-6941665,5.037224
9900,Grandma's Boy,2006-01-06,2006,0,6538177,6538177,6.741159
9901,Freedom Downtime,2001-01-01,2001,0,0,0,0.298721
9902,Wrong Turn,2003-05-30,2003,12600000,28650575,16050575,14.079718
9903,The Hoax,2006-10-14,2006,25000000,11772461,-13227539,4.78586
9904,The Wild,2006-03-06,2006,80000000,37384046,-42615954,7.904333
9905,Shallow Grave,1994-12-22,1994,0,0,0,8.223026
9906,The Ant Bully,2006-07-27,2006,50000000,55181129,5181129,7.000272
9907,Barnyard,2006-08-04,2006,51000000,72779000,21779000,6.984949
9909,Dangerous Minds,1995-08-11,1995,0,180000000,180000000,9.481338
9910,Two for the Money,2005-10-07,2005,35000000,30526509,-4473491,9.003792
9911,Outlaw,2007-03-09,2007,0,0,0,2.719018
9912,The World's Fastest Indian,2005-10-12,2005,25000000,0,-25000000,5.581311
9913,The Skeleton Key,2005-07-29,2005,43000000,91974818,48974818,10.947957
9914,Shadow Man,2006-09-06,2006,0,0,0,6.060635
9917,Waist Deep,2006-06-23,2006,0,21353303,21353303,4.212434
9918,Glory Road,2006-01-13,2006,0,42647449,42647449,5.244654
9919,How to Lose a Guy in 10 Days,2003-02-07,2003,50000000,177371441,127371441,5.188107
9920,Ultraviolet,2006-03-03,2006,30000000,31070211,1070211,11.096655
9921,Shadowboxer,2005-09-09,2005,0,0,0,3.146891
9922,The Postman,1997-12-25,1997,80000000,17626234,-62373766,6.537407
9923,Domino,2005-09-22,2005,50000000,22944502,-27055498,6.394143
9924,The Hard Corps,2006-08-15,2006,0,0,0,7.874411
9927,The Ringer,2005-12-23,2005,0,40442437,40442437,9.605509
9928,Robots,2005-03-10,2005,75000000,260696994,185696994,12.949715
9929,Asterix and Cleopatra,1968-12-16,1968,0,0,0,7.681293
9930,Legal Eagles,1986-06-18,1986,0,0,0,12.798828
9932,Analyze That,2002-12-06,2002,60000000,55003135,-4996865,9.927412
9935,Hallettsville,2009-03-05,2009,0,0,0,0.19514
9939,The Chatroom,2002-01-01,2002,0,0,0,0.002495
9940,Cheerleader Massacre,2003-03-25,2003,0,0,0,0.65575
9941,Down and Out in Beverly Hills,1986-01-31,1986,14000000,62134225,48134225,9.970485
9942,Major League,1989-02-16,1989,11000000,49797148,38797148,5.304376
9943,Das merkw√ºrdige Verhalten geschlechtsreifer Gro√üst√§dter zur Paarungszeit,1998-08-27,1998,0,0,0,0.763398
9944,The Pelican Brief,1993-12-16,1993,45000000,195268056,150268056,8.708306
9945,Vampires,1998-04-15,1998,20000000,0,-20000000,13.318722
9946,End of Days,1999-11-24,1999,100000000,211989043,111989043,9.62371
9947,Elektra,2005-01-13,2005,43000000,56681566,13681566,13.802674
9948,The Fox and the Hound 2,2006-11-09,2006,24000000,0,-24000000,7.432461
9949,Haunted Highway,2006-12-02,2006,0,0,0,0.360787
9950,Find Me Guilty,2006-03-16,2006,13000000,2636637,-10363363,15.295949
9951,The Dudesons Movie,2006-03-31,2006,0,0,0,1.26363
9952,Rescue Dawn,2006-09-09,2006,10000000,7177143,-2822857,9.604564
9953,A Love Song for Bobby Long,2004-09-02,2004,0,1841260,1841260,5.185771
9954,The Covenant,2006-09-08,2006,20000000,37597471,17597471,12.72212
9955,Blades of Glory,2007-03-30,2007,53000000,0,-53000000,5.956794
9956,The Brave,1997-07-30,1997,0,0,0,8.269506
9957,The Benchwarmers,2006-04-07,2006,0,0,0,10.318021
9958,Trailer Park Boys: The Movie,2006-10-06,2006,5000000,3833507,-1166493,3.172765
9959,Freedomland,2006-02-17,2006,37665000,14655628,-23009372,5.388535
9960,Lord of the Flies,1963-08-13,1963,250000,0,-250000,7.597775
9962,The Good Girl,2002-01-12,2002,8000000,16856124,8856124,4.388338
9963,Premonition,2007-02-08,2007,20000000,84146832,64146832,10.163764
9964,Bad Taste,1987-12-01,1987,25710,0,-25710,7.409599
9965,"Wake Up, Ron Burgundy: The Lost Movie",2004-12-28,2004,0,0,0,3.055036
9966,The Messengers,2007-02-02,2007,16000000,1109660,-14890340,9.629399
9967,Uncommon Valor,1983-12-16,1983,0,27900000,27900000,9.987072
9968,The Big White,2005-10-27,2005,18000000,0,-18000000,12.283163
9969,Deck the Halls,2006-11-22,2006,0,47231070,47231070,5.162761
9971,The Last Run,2004-01-01,2004,0,0,0,0.994808
9972,Lock Up,1989-08-04,1989,24000000,22099847,-1900153,4.701379
9973,Air Buddies,2006-12-12,2006,9000000,0,-9000000,7.775902
9974,Kill Your Darlings,2006-04-12,2006,0,0,0,0.313775
9975,Curious George,2006-02-10,2006,50000000,69834815,19834815,12.602502
9976,Satan's Little Helper,2004-01-01,2004,0,0,0,2.233189
9977,Children of the Revolution,1996-06-14,1996,0,0,0,1.129648
9978,Stormbreaker,2006-07-21,2006,40000000,23937870,-16062130,8.778999
9980,Maximum Overdrive,1986-07-25,1986,10000000,7433663,-2566337,6.614078
9981,Kicking & Screaming,2005-05-13,2005,45000000,56070433,11070433,9.875573
9982,Chicken Little,2005-11-04,2005,150000000,314432665,164432665,18.584609
9986,Charlotte's Web,2006-12-15,2006,85000000,144000000,59000000,10.254314
9987,Headspace,2005-01-01,2005,0,0,0,0.720343
9988,Beerfest,2006-08-25,2006,17500000,19179969,1679969,7.481125
9989,Antitrust,2001-01-12,2001,30000000,18195610,-11804390,8.142166
9990,Walking Tall: Lone Justice,2007-09-25,2007,0,0,0,0.719011
9991,Mean Machine,2001-12-26,2001,0,0,0,6.00447
9992,Arthur and the Invisibles,2006-12-13,2006,86000000,107944236,21944236,11.621534
9993,Little Fish,2005-07-19,2005,0,0,0,4.066487
9994,The Great Mouse Detective,1986-07-02,1986,14000000,38625550,24625550,11.183924
9995,Turn It Up,2000-09-06,2000,0,0,0,1.316179
9997,Gabriel,2007-11-15,2007,0,0,0,3.840024
9999,The Free Will,2006-08-23,2006,0,0,0,1.038858
10000,La estrategia del caracol,1993-12-25,1993,0,0,0,0.281609
10001,Young Einstein,1988-12-15,1988,0,0,0,2.562888
10002,Mona Lisa,1986-06-13,1986,0,5794184,5794184,3.095584
10003,The Saint,1997-04-03,1997,68000000,118063304,50063304,10.97633
10004,Desperation,2006-05-23,2006,0,0,0,3.636449
10005,Behind Enemy Lines II: Axis of Evil,2006-10-17,2006,0,0,0,11.063562
10006,Wild Seven,2006-01-01,2006,0,0,0,1.118792
10007,See No Evil,2006-05-19,2006,8000000,0,-8000000,5.659608
10008,An American Haunting,2005-05-05,2005,0,0,0,5.026855
10009,Brother Bear,2003-10-23,2003,100000000,0,-100000000,12.300905
10010,Brother Bear 2,2006-08-17,2006,0,0,0,10.861154
10011,Abominable,2006-04-10,2006,0,0,0,1.462272
10012,Cursed,2005-02-25,2005,35000000,19294901,-15705099,8.949722
10013,Peggy Sue Got Married,1986-10-05,1986,18000000,41382841,23382841,7.471655
10014,A Nightmare on Elm Street Part 2: Freddy's Revenge,1985-10-31,1985,3000000,29999213,26999213,8.668146
10015,Heartbreak Ridge,1986-12-15,1986,15000000,42724017,27724017,7.390012
10016,Ghosts of Mars,2001-08-24,2001,28000000,14010832,-13989168,7.058599
10017,The Wraith,1986-11-21,1986,2700000,3500000,800000,7.657918
10018,Life Is All You Get,1997-03-20,1997,0,0,0,0.772622
10019,Mannequin,1987-02-13,1987,6000000,42721196,36721196,8.525782
10020,Beauty and the Beast,1991-11-13,1991,25000000,377350553,352350553,23.433511
10021,The Secret of My Success,1987-04-10,1987,12000000,110996879,98996879,5.409557
10022,The Pacifier,2005-03-04,2005,56000000,113006880,57006880,7.81645
10023,Dragnet,1987-06-25,1987,20000000,66673516,46673516,7.907938
10024,My Sister's Keeper,2009-06-26,2009,30000000,95714875,65714875,6.793972
10025,Just My Luck,2006-05-12,2006,28000000,38159905,10159905,6.053567
10027,Unleashed,2005-02-02,2005,45000000,50871113,5871113,7.90583
10028,Honey,2003-11-24,2003,18000000,62646763,44646763,11.863954
10029,Very Bad Things,1998-09-11,1998,30000000,9898412,-20101588,10.432293
10030,Good Luck Chuck,2007-09-21,2007,25000000,59192128,34192128,7.456047
10032,Van Wilder 2: The Rise of Taj,2006-12-01,2006,0,6086508,6086508,5.985236
10033,Just Friends,2005-11-23,2005,0,50817508,50817508,8.208492
10034,High Heels and Low Lifes,2001-07-16,2001,0,0,0,0.958387
10035,100 Girls,2000-09-01,2000,0,0,0,5.136537
10036,7 Dwarves: The Forest Is Not Enough,2006-10-25,2006,0,0,0,6.637562
10037,The Hunt for Eagle One: Crash Point,2006-06-27,2006,0,0,0,0.462522
10040,Miss Congeniality 2: Armed and Fabulous,2005-03-11,2005,0,0,0,5.739442
10041,Broken,2006-01-01,2006,810000,0,-810000,1.491366
10044,My Lucky Stars,1985-02-10,1985,0,0,0,5.649524
10045,District B13,2004-11-09,2004,12000000,9584131,-2415869,7.594102
10046,Blueberry,2004-02-09,2004,53000000,0,-53000000,7.892626
10047,The Messenger: The Story of Joan of Arc,1999-10-18,1999,60000000,66976317,6976317,9.471838
10048,Stealth,2005-07-28,2005,135000000,76932943,-58067057,13.89018
10049,Attack Force,2006-12-05,2006,0,0,0,8.844451
10050,Get Over It,2001-03-08,2001,10000000,0,-10000000,7.867139
10051,Avenue Montaigne,2006-02-15,2006,0,0,0,2.084571
10052,Dragonfly,2002-02-22,2002,60000000,52322400,-7677600,4.924078
10053,When a Stranger Calls,2006-02-03,2006,15000000,66966987,51966987,5.149058
10054,Spy Kids,2001-03-18,2001,35000000,147934180,112934180,9.576745
10055,Room 6,2006-01-01,2006,0,0,0,1.126642
10056,Killer's Kiss,1955-09-21,1955,75000,0,-75000,6.107034
10057,The Three Musketeers,1993-11-11,1993,30000000,53898845,23898845,6.34785
10060,Get Rich or Die Tryin',2005-11-09,2005,40000000,46442528,6442528,9.820229
10061,Escape from L.A.,1996-08-09,1996,50000000,42277365,-7722635,12.229381
10063,The Breed,2006-05-17,2006,0,1675484,1675484,4.148276
10064,Edison,2005-07-29,2005,0,0,0,5.394304
10065,The Amityville Horror,2005-04-15,2005,19000000,108047131,89047131,13.088552
10066,House of Wax,2005-04-30,2005,40000000,68766121,28766121,7.163099
10067,The Shaggy Dog,2006-03-09,2006,50000000,61112916,11112916,4.878907
10068,Nine 1/2 Weeks,1986-02-14,1986,17000000,6735922,-10264078,6.706262
10069,Stay Alive,2006-03-24,2006,9000000,27105095,18105095,4.854551
10070,Feast,2005-10-14,2005,0,658573,658573,7.888988
10071,The Brothers Solomon,2007-09-07,2007,0,0,0,7.985172
10072,A Nightmare on Elm Street 3: Dream Warriors,1987-02-27,1987,5000000,44793222,39793222,10.035081
10073,Date Movie,2006-02-17,2006,20000000,48548426,28548426,5.682129
10074,Hot Rod,2007-08-03,2007,0,14334401,14334401,6.117846
10075,Blood and Chocolate,2007-01-26,2007,0,0,0,5.415846
10077,A Sound of Thunder,2005-05-15,2005,80000000,5989640,-74010360,4.980191
10078,Magicians,2007-05-18,2007,0,1752038,1752038,6.478953
10081,The Principal,1987-09-18,1987,0,0,0,8.332485
10083,No Way Out,1987-08-14,1987,15000000,35509515,20509515,11.457803
10085,Unrest,2006-10-22,2006,0,0,0,2.159288
10086,Man Bites Dog,1992-05-01,1992,0,0,0,8.758096
10087,Man to Man,2005-04-13,2005,0,0,0,0.848599
10089,Evil Bong,2006-10-31,2006,0,0,0,2.789905
10090,Reno 911!: Miami,2007-02-23,2007,10000000,20342161,10342161,4.468247
10092,Cry_Wolf,2005-09-16,2005,1000000,10047674,9047674,9.454335
10093,The Return,2006-11-10,2006,15000000,11992014,-3007986,9.338989
10094,Gone,2006-10-26,2006,0,0,0,1.674934
10096,13 Going on 30,2004-04-13,2004,37000000,96455697,59455697,12.632595
10097,The Tiger's Tail,2006-09-26,2006,0,0,0,1.709576
10098,The Kid,1921-01-21,1921,250000,2500000,2250000,8.168456
10102,La Grande Bouffe,1973-05-16,1973,0,0,0,4.88779
10103,Windstruck,2004-06-03,2004,0,5331377,5331377,1.896423
10105,Saints and Soldiers,2003-09-11,2003,780000,0,-780000,7.975389
10107,Firehouse Dog,2007-04-04,2007,0,0,0,7.078447
10109,The White Dragon,2004-10-28,2004,0,0,0,1.00155
10110,Empire of the Sun,1987-12-09,1987,35000000,22238696,-12761304,10.220906
10111,Confetti,2006-05-05,2006,0,0,0,1.873214
10112,The Aristocats,1970-12-23,1970,4000000,55675257,51675257,9.834047
10115,Stick It,2006-04-21,2006,0,0,0,7.255225
10116,Shinobi: Heart Under Blade,2005-09-17,2005,0,0,0,4.419592
10117,Action Jackson,1988-02-12,1988,7000000,20256975,13256975,14.054862
10118,Material Girls,2006-08-18,2006,0,11449638,11449638,4.581577
10119,The Color of Milk,2004-08-27,2004,0,0,0,1.205013
10120,Blonde and Blonder,2008-01-18,2008,0,0,0,1.848167
10122,Flight of the Navigator,1986-07-30,1986,0,18564613,18564613,5.526865
10124,Heartstopper,2006-01-01,2006,3000000,0,-3000000,1.292089
10125,Fine Dead Girls,2002-06-24,2002,0,0,0,0.427798
10126,Colors,1988-04-15,1988,6000000,46616067,40616067,5.529808
10127,Critters 2,1988-04-29,1988,4500000,3813293,-686707,9.97523
10128,Alien Nation,1988-10-07,1988,16000000,32155047,16155047,15.133316
10129,Herbstmilch,1989-01-19,1989,0,0,0,0.02205
10130,Gorillas in the Mist,1988-09-23,1988,22000000,0,-22000000,11.978983
10131,A Nightmare on Elm Street 4: The Dream Master,1988-08-19,1988,7000000,72500000,65500000,8.120317
10132,Talk Radio,1988-12-21,1988,4000000,3468572,-531428,6.865513
10133,Cypher,2002-10-01,2002,7500000,0,-7500000,7.348974
10134,Cyborg,1989-04-07,1989,500000,10166459,9666459,8.473602
10135,Road House,1989-05-19,1989,15000000,30050028,15050028,2.943427
10136,The Golden Child,1986-12-12,1986,25000000,79817939,54817939,8.236472
10137,Stuart Little,1999-12-17,1999,133000000,300135367,167135367,8.3595
10138,Iron Man 2,2010-04-28,2010,200000000,623933331,423933331,19.083344
10139,Milk,2008-11-26,2008,20000000,54586584,34586584,10.680121
10140,The Chronicles of Narnia: The Voyage of the Dawn Treader,2010-08-13,2010,155000000,415686217,260686217,12.383398
10141,Dirty Rotten Scoundrels,1988-12-14,1988,0,42039085,42039085,6.78824
10142,Casualties of War,1989-08-18,1989,22500000,18671317,-3828683,7.435688
10144,The Little Mermaid,1989-11-17,1989,40000000,222300000,182300000,17.496832
10145,The Forgotten,2004-09-24,2004,42000000,117575636,75575636,6.40146
10146,Men...,1985-12-19,1985,0,0,0,0.490588
10147,Bad Santa,2003-11-26,2003,23000000,76488889,53488889,10.930143
10149,Smoke,1995-06-09,1995,7000000,8349430,1349430,5.552946
10150,The Last Unicorn,1982-11-19,1982,0,6455530,6455530,6.634939
10151,Snow White,2005-08-07,2005,0,0,0,0.30335
10152,Dumb and Dumberer: When Harry Met Lloyd,2003-06-13,2003,19000000,39267515,20267515,9.280038
10153,Sphere,1998-02-13,1998,75000000,13100000,-61900000,7.124735
10154,Mickey Blue Eyes,1999-08-16,1999,0,0,0,6.951414
10155,U Turn,1997-10-03,1997,19000000,6682098,-12317902,7.923639
10156,History of the World: Part I,1981-06-12,1981,11000000,31672907,20672907,9.270492
10157,Police Academy 2: Their First Assignment,1985-03-28,1985,0,55600000,55600000,9.021668
10158,White Men Can't Jump,1992-03-26,1992,0,90753806,90753806,8.795941
10159,The Rundown,2003-09-26,2003,85000000,80916492,-4083508,8.304835
10160,A Nightmare on Elm Street 5: The Dream Child,1989-08-11,1989,8000000,22168359,14168359,7.534739
10161,My Left Foot: The Story of Christy Brown,1989-07-21,1989,645180,14743391,14098211,5.841931
10162,Waking Ned,1998-09-15,1998,0,0,0,4.502687
10163,The Lawnmower Man,1992-03-05,1992,10000000,32101000,22101000,6.685948
10164,Cadillac Man,1990-05-18,1990,0,27575086,27575086,6.882529
10165,Fear and Desire,1953-04-01,1953,53000,0,-53000,4.482793
10166,The Witches,1990-02-16,1990,0,15360553,15360553,8.208991
10167,Half Past Dead,2002-11-15,2002,13000000,0,-13000000,8.650691
10168,The Freshman,1990-07-20,1990,0,0,0,4.470254
10169,Men at Work,1990-08-24,1990,0,0,0,8.339485
10170,The Russia House,1990-12-19,1990,22997992,0,-22997992,10.445117
10171,Voyager,1991-03-21,1991,0,0,0,4.984732
10172,Are We Done Yet?,2007-04-04,2007,0,0,0,6.370205
10173,Marked for Death,1990-10-05,1990,12000000,46044400,34044400,5.845712
10174,Madonna: Truth or Dare,1991-05-10,1991,4,29,25,1.325299
10176,The Quiet Earth,1985-09-08,1985,1000000,0,-1000000,7.782919
10177,Evil Aliens,2006-03-10,2006,500000,0,-500000,2.002373
10178,The Caine Mutiny,1954-06-24,1954,2000000,21750000,19750000,8.999948
10179,The Ice Pirates,1984-03-16,1984,9000000,0,-9000000,3.291281
10180,Flickering Lights,2000-11-03,2000,0,0,0,2.553711
10183,Frozen River,2008-08-01,2008,0,0,0,4.747364
10184,He's Just Not That Into You,2009-02-06,2009,40000000,177259441,137259441,8.376094
10185,The Midnight Meat Train,2008-08-07,2008,15000000,3533227,-11466773,13.389735
10186,The Rocker,2008-08-20,2008,15000000,8762890,-6237110,9.469873
10187,Swing Vote,2008-08-01,2008,21000000,17600000,-3400000,5.204249
10188,The Sisterhood of the Traveling Pants 2,2008-08-06,2008,27000000,44352417,17352417,4.631978
10189,Pineapple Express,2008-08-06,2008,27000000,101624843,74624843,8.461369
10190,Towelhead,2008-09-12,2008,0,367638,367638,3.376907
10191,How to Train Your Dragon,2010-03-05,2010,165000000,494878759,329878759,14.416681
10192,Shrek Forever After,2010-05-16,2010,165000000,752600867,587600867,11.803808
10193,Toy Story 3,2010-06-16,2010,200000000,1066969703,866969703,16.96647
10195,Thor,2011-04-21,2011,150000000,449326618,299326618,29.158489
10196,The Last Airbender,2010-06-30,2010,150000000,318502923,168502923,9.544657
10197,Nine,2009-12-03,2009,80000000,53825515,-26174485,5.658857
10198,The Princess and the Frog,2009-12-08,2009,105000000,267045765,162045765,16.616517
10199,The Tale of Despereaux,2008-12-19,2008,60000000,50877145,-9122855,12.364579
10200,The Day the Earth Stood Still,2008-12-10,2008,80000000,233093859,153093859,9.265322
10201,Yes Man,2008-12-09,2008,70000000,225990978,155990978,9.756289
10202,Bedtime Stories,2008-12-24,2008,80000000,212874442,132874442,10.739419
10204,Around the World in 80 Days,2004-06-16,2004,110000000,72178895,-37821105,7.825072
10205,Cut,2000-02-23,2000,0,0,0,1.137456
10206,Buffy the Vampire Slayer,1992-07-24,1992,7000000,16624456,9624456,4.941989
10207,Message in a Bottle,1999-02-22,1999,80000000,118880016,38880016,5.101392
10208,Muppets from Space,1999-07-14,1999,24000000,16290976,-7709024,7.531668
10209,Hideous Kinky,1998-11-17,1998,12000000,0,-12000000,2.402484
10210,A Midsummer Night's Dream,1999-04-25,1999,11000000,0,-11000000,6.078792
10212,Ravenous,1999-03-16,1999,12000000,0,-12000000,5.486645
10213,From Dusk Till Dawn 3: The Hangman's Daughter,1999-10-30,1999,5000000,0,-5000000,4.839043
10214,Son of the Mask,2005-02-18,2005,84000000,0,-84000000,6.512277
10215,Sliding Doors,1998-04-23,1998,6000000,58000000,52000000,9.7866
10216,Species II,1998-04-10,1998,35000000,19165560,-15834440,13.495247
10217,The Sweet Hereafter,1997-05-14,1997,5000000,3263585,-1736415,6.002992
10218,Swingers,1996-10-18,1996,200000,4505922,4305922,6.578025
10219,Snow Falling on Cedars,1999-12-22,1999,0,0,0,2.813811
10220,Rounders,1998-09-11,1998,12000000,22921898,10921898,8.783454
10222,Kickboxer,1989-04-20,1989,1500000,14697005,13197005,6.939994
10223,A Simple Plan,1998-12-11,1998,0,0,0,5.765416
10225,Friday the 13th Part VI: Jason Lives,1986-08-01,1986,3000000,19472057,16472057,8.122042
10226,High Tension,2003-06-18,2003,0,0,0,5.460821
10227,PlayTime,1967-12-16,1967,0,0,0,8.741959
10228,Pok√©mon: The First Movie: Mewtwo Strikes Back,1998-07-18,1998,30000000,163644662,133644662,7.556826
10229,A Walk to Remember,2002-01-25,2002,11000000,41227069,30227069,8.054499
10232,Shadow of Angels,1976-01-31,1976,0,0,0,0.364246
10234,Funny Games,1997-05-14,1997,0,0,0,9.314129
10235,Alexander Nevsky,1938-11-24,1938,0,0,0,1.915541
10236,The Way We Were,1973-10-17,1973,0,45000000,45000000,13.377996
10237,The Honeymoon Killers,1970-02-04,1970,0,0,0,2.746721
10238,Cries and Whispers,1972-12-21,1972,0,0,0,9.983092
10239,Autumn Tale,1998-09-07,1998,0,0,0,3.842644
10241,A Tale of Winter,1992-01-01,1992,0,0,0,1.172867
10242,What Ever Happened to Baby Jane?,1962-10-31,1962,980000,0,-980000,4.857003
10243,The Flight of the Phoenix,1965-12-15,1965,0,0,0,4.570894
10244,Gods of the Plague,1970-07-24,1970,0,0,0,0.726975
10246,Porky's,1981-11-13,1981,4000000,125728258,121728258,12.650546
10247,He Was a Quiet Man,2007-11-23,2007,0,0,0,4.176044
10248,The Ring Thing,2004-01-01,2004,0,0,0,0.486952
10249,The Rocketeer,1991-06-21,1991,42000000,62000000,20000000,10.536644
10251,5ive Girls,2006-01-01,2006,3000000,0,-3000000,3.148351
10253,Dragon Wars: D-War,2007-02-08,2007,70000000,53587404,-16412596,6.280906
10254,Born to Fight,2004-08-05,2004,0,0,0,0.682037
10257,The Twins Effect II,2004-08-12,2004,0,0,0,3.192815
10258,The Madagascar Penguins in a Christmas Caper,2005-09-23,2005,0,0,0,3.126703
10260,My New Partner,1984-09-19,1984,0,0,0,1.904295
10261,Switch,1991-05-10,1991,0,0,0,3.292828
10263,Tamara,2005-05-12,2005,4750000,206871,-4543129,3.743679
10264,Hamlet,1990-12-19,1990,0,20710451,20710451,12.50303
10265,Seoul Raiders,2005-02-05,2005,0,0,0,1.827823
10268,You Are So Beautiful,2005-11-07,2005,0,0,0,2.770788
10269,Yentl,1983-11-18,1983,12000000,30400000,18400000,2.592296
10270,The Challenge,2005-01-01,2005,300000,0,-300000,0.428523
10271,The Story Of My Life,2004-09-08,2004,0,0,0,1.15926
10272,Jekyll + Hyde,2006-05-05,2006,0,0,0,0.627559
10274,The Deal,2005-06-17,2005,0,0,0,0.964706
10275,The Shaolin Temple,1982-01-21,1982,0,16157801,16157801,2.038062
10276,What About Bob?,1991-05-17,1991,35000000,63710000,28710000,11.787942
10278,Return to Paradise,1998-08-10,1998,0,0,0,4.831458
10279,Summer of Sam,1999-07-02,1999,0,0,0,6.14854
10280,Thinner,1996-10-25,1996,0,0,0,4.856229
10281,Friday the 13th Part VII: The New Blood,1988-05-13,1988,2800000,19170001,16370001,7.909022
10283,Friday the 13th Part VIII: Jason Takes Manhattan,1989-07-28,1989,5000000,14000000,9000000,7.743144
10285,Jason Goes to Hell: The Final Friday,1993-08-13,1993,3000000,15938065,12938065,9.223325
10288,Fido,2006-09-07,2006,8000000,426224,-7573776,5.284805
10292,Urban Legends: Bloody Mary,2005-07-19,2005,3500000,0,-3500000,7.778296
10293,Pauline at the Beach,1983-02-23,1983,0,0,0,2.704568
10294,Vacancy,2007-04-20,2007,19000000,35300645,16300645,7.712309
10296,The Football Factory,2004-05-13,2004,0,0,0,8.623333
10297,How to Marry a Millionaire,1953-10-29,1953,0,0,0,6.000494
10299,"Hush... Hush, Sweet Charlotte",1964-12-15,1964,0,0,0,3.705312
10303,The Jewel of the Nile,1985-12-04,1985,25000000,96773200,71773200,10.571841
10304,Starship Troopers 2: Hero of the Federation,2004-04-20,2004,7000000,0,-7000000,12.348655
10305,Merci pour le Chocolat,2000-08-01,2000,0,0,0,3.596246
10306,Poltergeist III,1988-06-10,1988,10500000,14144000,3644000,7.977693
10307,Stigmata,1999-09-10,1999,29000000,50041732,21041732,9.304144
10308,Why Does Herr R. Run Amok?,1970-06-27,1970,0,0,0,0.620251
10309,The Merchant of Four Seasons,1971-11-04,1971,0,0,0,1.262664
10310,The Bitter Tears of Petra von Kant,1972-10-05,1972,0,0,0,2.077361
10311,Martha,1974-05-27,1974,0,0,0,0.758408
10312,Patch Adams,1998-12-25,1998,50000000,202292902,152292902,12.52181
10313,The Men Who Stare at Goats,2009-10-17,2009,24000000,68729358,44729358,6.253084
10314,She's All That,1999-01-29,1999,10000000,103166989,93166989,7.064982
10315,Fantastic Mr. Fox,2009-10-23,2009,40000000,46471023,6471023,8.695893
10316,The Ides of March,2011-09-24,2011,12500000,75993061,63493061,6.82647
10317,Our Brand Is Crisis,2015-09-11,2015,28000000,7002261,-20997739,12.158176
10319,Woyzeck,1979-05-25,1979,0,0,0,2.828665
10320,The Ring Two,2005-03-17,2005,50000000,161451538,111451538,16.15818
10322,Being There,1979-12-19,1979,0,30177511,30177511,12.320636
10323,Clash of the Titans,1981-03-15,1981,15000000,41092328,26092328,7.50381
10324,If Lucy Fell,1996-03-08,1996,0,0,0,2.891918
10326,Forever Young,1992-12-16,1992,0,128000000,128000000,5.050509
10327,"Legally Blonde 2: Red, White & Blonde",2003-07-02,2003,45000000,124914842,79914842,7.288046
10328,Cocoon,1985-06-21,1985,0,85313124,85313124,5.773277
10329,Congo,1995-06-09,1995,50000000,152022101,102022101,7.260574
10330,Freaky Friday,2003-08-03,2003,26000000,110230332,84230332,7.867999
10331,Night of the Living Dead,1968-10-01,1968,114000,30000000,29886000,14.384198
10333,The Prince of Tides,1991-12-25,1991,30000000,74787599,44787599,2.960942
10336,Spawn,1997-07-31,1997,40000000,87840042,47840042,11.366417
10337,Bugsy,1991-12-10,1991,30000000,49114016,19114016,5.516316
10338,Those Magnificent Men in Their Flying Machines or How I Flew from London to Paris in 25 hours 11 minutes,1965-06-03,1965,5600000,29950000,24350000,5.191425
10339,Moby Dick,1956-06-27,1956,4500000,10400000,5900000,4.31583
10340,Lady and the Tramp,1955-06-16,1955,0,93600000,93600000,12.994387
10341,Until the End of the World,1991-09-12,1991,23000000,0,-23000000,2.14652
10342,Teaching Mrs. Tingle,1999-08-11,1999,13000000,8946237,-4053763,8.345784
10344,The Fly II,1989-02-10,1989,0,38903179,38903179,9.207436
10345,K-9,1989-04-28,1989,17000000,78247647,61247647,5.772293
10347,Dobermann,1997-06-18,1997,0,0,0,6.774793
10348,Thunderbolt,1995-09-08,1995,0,0,0,4.542915
10349,The Dark Half,1993-04-23,1993,15000000,10611160,-4388840,13.412785
10350,Wing Commander,1999-03-11,1999,30000000,0,-30000000,5.924059
10351,Wishmaster,1997-09-19,1997,5000000,15719109,10719109,5.215107
10353,The Visitors II: The Corridors of Time,1998-02-11,1998,0,0,0,7.698423
10354,True Crime,1999-03-19,1999,0,0,0,11.600645
10355,Shiri,1999-02-13,1999,5000000,0,-5000000,7.036727
10356,The Good Shepherd,2004-03-21,2004,0,0,0,1.915832
10357,Volcano,1997-04-25,1997,90000000,0,-90000000,13.147917
10358,Zack and Miri Make a Porno,2008-09-18,2008,24000000,42105111,18105111,6.449332
10360,Hunger,2008-05-15,2008,0,2724474,2724474,14.322814
10361,Ginger Snaps 2: Unleashed,2004-01-30,2004,0,0,0,3.523822
10362,Two Lovers,2008-11-19,2008,12000000,3148182,-8851818,8.032616
10363,Purple Noon,1960-03-10,1960,0,0,0,3.804493
10364,Catch-22,1970-06-24,1970,18000000,24911670,6911670,4.984905
10366,Universal Soldier: The Return,1999-08-05,1999,45000000,10667893,-34332107,7.805145
10368,Tea with Mussolini,1999-03-25,1999,12000000,21001563,9001563,3.094893
10370,Premutos: Lord of the Living Dead,1997-01-01,1997,150000,0,-150000,0.591754
10371,For Richer or Poorer,1997-12-11,1997,35000000,31611225,-3388775,8.412203
10372,Ewoks: The Battle for Endor,1985-11-24,1985,0,0,0,10.002017
10373,Quadrophenia,1979-09-14,1979,0,0,0,4.739658
10375,D-Tox,2002-01-04,2002,55000000,6416302,-48583698,13.374415
10376,The Legend of 1900,1998-10-28,1998,9000000,0,-9000000,7.668214
10377,My Cousin Vinny,1992-03-13,1992,11000000,64088552,53088552,7.922216
10378,Big Buck Bunny,2008-04-10,2008,150000,0,-150000,5.271855
10379,Drop Dead Fred,1991-04-19,1991,6788000,13878334,7090334,7.88101
10380,An American Tail: Fievel Goes West,1991-11-21,1991,0,40766041,40766041,8.800701
10381,Plunkett & MacLeane,1999-01-22,1999,0,0,0,10.285949
10383,Lost Souls,2000-10-13,2000,0,0,0,6.604577
10384,Supernova,2000-01-14,2000,90000000,14828081,-75171919,5.496624
10385,Hanging Up,2000-02-16,2000,40000000,36037909,-3962091,6.474767
10386,The Iron Giant,1999-08-06,1999,70000000,23159305,-46840695,15.441459
10387,The Emperor and the Assassin,1998-10-08,1998,0,0,0,1.531997
10388,The Limey,1999-05-15,1999,10000000,3193102,-6806898,7.807741
10389,The Eye,2002-05-09,2002,0,0,0,4.827322
10390,For Love of the Game,1999-09-17,1999,50000000,0,-50000000,4.950061
10391,Bless the Child,2000-08-11,2000,40000000,0,-40000000,4.750291
10393,The Replacements,2000-08-07,2000,0,0,0,13.450661
10394,Gangster No. 1,2000-06-09,2000,0,0,0,2.811699
10395,Wolf,1994-06-17,1994,0,0,0,14.063845
10396,Tequila Sunrise,1988-12-02,1988,23000000,0,-23000000,6.399977
10397,Angela's Ashes,1999-12-25,1999,25,13,-12,4.496585
10398,Double Jeopardy,1999-09-24,1999,70000000,177841558,107841558,10.876463
10399,Mansfield Park,1999-11-12,1999,0,0,0,6.646005
10400,The Hurricane,1999-09-17,1999,50000000,73956241,23956241,5.716009
10401,The Girl on the Bridge,1999-03-31,1999,0,0,0,1.917227
10402,Deuce Bigalow: Male Gigolo,1999-12-10,1999,17000000,65535067,48535067,6.567794
10403,The Player,1992-04-03,1992,8000000,21706101,13706101,6.230854
10404,Raise the Red Lantern,1991-12-20,1991,0,0,0,7.948888
10406,Encino Man,1992-05-22,1992,0,40693477,40693477,8.000189
10407,Housesitter,1992-06-12,1992,0,0,0,4.569249
10408,Flodder Does Manhattan!,1992-06-03,1992,0,0,0,5.832738
10409,Strictly Ballroom,1992-08-20,1992,3000000,33946224,30946224,3.233531
10410,Hoffa,1992-12-25,1992,35000000,0,-35000000,5.027522
10411,The Distinguished Gentleman,1992-12-04,1992,0,46434570,46434570,9.64078
10412,Romper Stomper,1992-03-05,1992,0,0,0,5.157926
10413,Nowhere to Run,1993-01-15,1993,0,0,0,9.812648
10414,The Mighty Ducks,1992-10-01,1992,10000000,50752337,40752337,6.113646
10416,What Planet Are You From?,2000-03-03,2000,60000000,0,-60000000,1.994868
10419,Swing Kids,1993-03-05,1993,0,5632086,5632086,4.379054
10420,The Mistress,2006-08-07,2006,0,0,0,1.028906
10423,Dragon: The Bruce Lee Story,1993-05-07,1993,14000000,63513743,49513743,5.079464
10424,Jennifer Eight,1992-11-06,1992,20000000,11390479,-8609521,4.620936
10425,The Death and Life of Bobby Z,2007-07-23,2007,22000000,413454,-21586546,10.77166
10426,Friday After Next,2002-11-22,2002,20000000,33526835,13526835,5.794821
10427,Red Rock West,1993-07-08,1993,8000000,2000000,-6000000,5.137903
10428,Hackers,1995-09-14,1995,20000000,7563728,-12436272,14.810519
10429,Takedown,2000-03-15,2000,0,0,0,4.419472
10431,War,2007-08-24,2007,25000000,40452643,15452643,12.077833
10432,Hack!,2007-07-20,2007,0,0,0,9.752789
10433,Mad Dog and Glory,1993-03-05,1993,0,11081586,11081586,4.769347
10434,"Faraway, So Close!",1993-09-09,1993,0,810455,810455,2.958988
10435,Chaplin,1992-12-18,1992,0,0,0,8.243107
10436,The Age of Innocence,1993-09-17,1993,34000000,32255440,-1744560,8.013617
10437,The Muppet Christmas Carol,1992-12-10,1992,0,27281507,27281507,14.630571
10438,Beethoven's 2nd,1993-12-14,1993,15000000,118243066,103243066,5.886769
10439,Hocus Pocus,1993-07-16,1993,28000000,39514713,11514713,10.390708
10440,Manhattan Murder Mystery,1993-08-18,1993,13500000,11285588,-2214412,8.939404
10442,So I Married an Axe Murderer,1993-07-30,1993,20000000,11585483,-8414517,8.051914
10443,Fearless,1993-10-15,1993,0,0,0,9.284624
10445,Shadowlands,1993-12-25,1993,22000000,0,-22000000,2.96586
10447,No Escape,1994-04-29,1994,20000000,15340000,-4660000,9.715187
10448,Rapa Nui,1994-09-09,1994,20000000,305070,-19694930,7.180346
10449,When a Man Loves a Woman,1994-04-29,1994,0,50021959,50021959,4.322544
10450,The Silence of the Hams,1994-03-11,1994,0,0,0,1.638374
10451,Eat Drink Man Woman,1994-08-03,1994,0,7294403,7294403,4.860016
10452,Queen Margot,1994-05-13,1994,0,0,0,4.405405
10458,Soundless,2004-04-22,2004,0,0,0,1.423762
10461,Get Carter,2000-10-06,2000,63600000,19412993,-44187007,6.047757
10462,Don't Drink the Water,1994-12-18,1994,0,0,0,1.618751
10464,"Corrina, Corrina",1994-08-12,1994,0,0,0,6.924689
10466,The Money Pit,1986-03-15,1986,10000000,54999651,44999651,7.054864
10467,The Road to Wellville,1994-10-28,1994,0,0,0,3.416181
10468,28 Days,2000-04-06,2000,43000000,0,-43000000,4.756669
10469,"Come, Sweet Death",2000-12-22,2000,0,0,0,1.703002
10470,Werner - Gekotzt wird sp√§ter!,2003-07-17,2003,0,0,0,1.413439
10471,Next Friday,2000-01-12,2000,11000000,59827328,48827328,10.06545
10472,Down to You,2000-01-21,2000,9000000,0,-9000000,3.847088
10473,DragonHeart: A New Beginning,2000-08-08,2000,0,0,0,8.319796
10474,The Basketball Diaries,1995-04-21,1995,0,0,0,7.415144
10475,Factotum,2005-04-25,2005,0,0,0,3.021445
10476,Hustle & Flow,2005-07-22,2005,8000000,23563727,15563727,7.422267
10477,Driven,2001-04-27,2001,94000000,54744738,-39255262,5.310558
10478,Tin Cup,1996-08-16,1996,45000000,53854588,8854588,6.24966
10479,Rules of Engagement,2000-04-07,2000,60000000,71000000,11000000,10.278274
10480,Nurse Betty,2000-09-08,2000,24000000,0,-24000000,6.335925
10481,102 Dalmatians,2000-10-07,2000,85000000,183611771,98611771,7.668752
10482,Guest House Paradiso,1999-12-03,1999,0,0,0,3.150288
10483,Death Race,2008-08-22,2008,45000000,73762516,28762516,13.53003
10484,The ComDads,1983-11-23,1983,0,0,0,4.727034
10485,Ghost Dad,1990-06-29,1990,0,24707633,24707633,3.501
10486,My Father the Hero,1994-02-04,1994,0,0,0,2.459585
10488,Nim's Island,2008-04-03,2008,37000000,100076342,63076342,7.558125
10489,Cujo,1983-08-10,1983,5000000,21200000,16200000,7.065626
10490,Drop Dead Gorgeous,1999-07-23,1999,10000000,10571408,571408,6.396767
10491,Enigma,2001-01-22,2001,0,15705007,15705007,21.520641
10492,Flashback,2000-04-06,2000,0,0,0,0.334523
10493,Dead Calm,1989-04-07,1989,10000000,7825000,-2175000,13.464246
10494,Perfect Blue,1997-07-11,1997,0,0,0,6.487495
10495,"The Karate Kid, Part III",1989-06-29,1989,0,38956288,38956288,6.441664
10496,Bats,1999-10-22,1999,0,10,10,2.584025
10497,Bitter Moon,1992-09-02,1992,5000000,1862805,-3137195,11.298195
10498,Point of No Return,1993-03-19,1993,0,0,0,11.113039
10499,The Legend of Rita,2000-09-14,2000,0,0,0,1.428565
10500,No Place to Go,2000-04-20,2000,0,0,0,0.660998
10501,The Road to El Dorado,2000-03-31,2000,95000000,76432727,-18567273,8.755188
10502,The Man without a Face,1993-08-25,1993,0,24760338,24760338,5.997712
10503,Happy-Go-Lucky,2008-04-18,2008,0,18130888,18130888,11.361898
10509,Buitenspel,2005-12-21,2005,0,0,0,0.149334
10510,Miracle on 34th Street,1994-11-18,1994,0,46264384,46264384,5.831622
10511,In America,2003-10-31,2003,0,0,0,5.067308
10513,Plan 9 from Outer Space,1959-07-22,1959,60000,0,-60000,8.084953
10514,The Andromeda Strain,1971-03-12,1971,6500000,12376563,5876563,11.081253
10515,Castle in the Sky,1986-08-02,1986,0,0,0,11.061551
10516,The Gendarme and the Creatures from Outer Space,1979-01-31,1979,0,0,0,5.73912
10518,Marathon Man,1976-10-05,1976,6500000,21709020,15209020,6.006812
10520,Itty Bitty Titty Committee,2007-02-09,2007,1000000,18479,-981521,1.833892
10521,Bride Wars,2009-01-09,2009,30000000,114663461,84663461,8.33501
10523,W.,2008-10-17,2008,25100000,29506464,4406464,8.937049
10524,Trivial,2007-05-23,2007,0,0,0,2.031489
10525,Forget Paris,1995-05-19,1995,0,0,0,16.236745
10527,Madagascar: Escape 2 Africa,2008-10-30,2008,150000000,603900354,453900354,12.668733
10528,Sherlock Holmes,2009-12-23,2009,90000000,524028679,434028679,15.68604
10529,Outlander,2008-04-24,2008,50000000,7033683,-42966317,14.611182
10530,Pocahontas,1995-06-14,1995,55000000,346079773,291079773,13.280069
10531,Death and the Maiden,1994-05-04,1994,0,0,0,5.484156
10533,The Scarlet Letter,1995-10-13,1995,50000000,10382407,-39617593,6.752119
10534,White Squall,1996-02-02,1996,38000000,10300000,-27700000,9.568604
10535,Spy Hard,1996-05-24,1996,18000000,0,-18000000,8.202057
10536,The Italian Job,1969-06-02,1969,3000000,0,-3000000,9.371815
10537,The Doors,1991-03-01,1991,38000000,34416893,-3583107,7.829619
10538,Passenger 57,1992-11-05,1992,15000000,44065653,29065653,18.451321
10539,James and the Giant Peach,1996-04-12,1996,38000000,28921264,-9078736,13.217623
10540,Outland,1981-05-22,1981,16000000,17374595,1374595,6.918821
10541,Shall We Kiss?,2007-06-06,2007,0,0,0,1.220424
10542,Killer Condom,1996-08-02,1996,0,0,0,4.67538
10543,Fear,1996-04-12,1996,0,0,0,6.954926
10544,Ned Kelly,2003-03-22,2003,0,6585516,6585516,11.478361
10545,The Hunchback of Notre Dame,1996-06-21,1996,100000000,100138851,138851,13.553999
10546,The Crow: City of Angels,1996-08-29,1996,13000000,17917287,4917287,6.554679
10547,The Arrival,1996-05-31,1996,25000000,14048372,-10951628,6.497591
10548,When We Were Kings,1996-10-25,1996,0,2666118,2666118,3.60795
10549,Hamlet,1996-12-25,1996,0,0,0,9.994088
10550,Ballistic: Ecks vs. Sever,2002-09-20,2002,70000000,19924033,-50075967,9.094558
10551,Family Business,1989-12-15,1989,0,12195695,12195695,4.616517
10552,Cat's Eye,1985-04-12,1985,0,0,0,6.781815
10553,Remo Williams: The Adventure Begins...,1985-10-11,1985,0,14393902,14393902,11.106754
10555,Shark Tale,2004-09-20,2004,75000000,367275019,292275019,17.999273
10557,East Is East,1999-05-14,1999,3800000,28200000,24400000,5.138367
10559,Frequency,2000-04-28,2000,31000000,68106245,37106245,10.163266
10560,Center Stage,2000-05-12,2000,18000000,17200925,-799075,10.491734
10562,Under Suspicion,2000-09-24,2000,25000000,260562,-24739438,11.839267
10563,Three to Tango,1999-10-22,1999,20000000,0,-20000000,5.594358
10564,Where the Heart Is,2000-04-27,2000,15000000,33771174,18771174,5.833133
10565,Kanak Attack,2000-11-16,2000,0,0,0,0.154169
10567,Dinosaur,2000-05-19,2000,127500000,354248063,226748063,9.998415
10568,The Four Feathers,1939-04-20,1939,0,0,0,7.055347
10569,Small Time Crooks,2000-05-19,2000,0,0,0,9.569183
10570,Flodder,1986-12-17,1986,0,0,0,6.702844
10571,Boys and Girls,2000-06-16,2000,16000000,20627372,4627372,10.070988
10572,Michel Vaillant,2003-11-08,2003,22900000,0,-22900000,7.771781
10573,Luna Papa,1999-09-08,1999,0,0,0,1.257822
10574,Great Freedom No. 7,1944-12-15,1944,0,0,0,0.249081
10575,Heaven,2002-02-06,2002,11000000,0,-11000000,5.186944
10576,Psycho II,1983-06-03,1983,5000000,34725000,29725000,6.370495
10577,Dracula 2000,2000-12-22,2000,28000000,33000337,5000337,6.000716
10578,Dracula II: Ascension,2003-06-07,2003,0,0,0,1.903107
10579,Dracula III: Legacy,2005-01-01,2005,3500000,0,-3500000,2.591448
10580,Lemon Popsicle,1978-04-21,1978,0,0,0,1.915814
10585,Child's Play,1988-11-08,1988,9000000,44196684,35196684,19.827546
10586,The Ghost and the Darkness,1996-10-11,1996,50000000,75000000,25000000,10.789928
10587,Police Academy 4: Citizens on Patrol,1987-04-02,1987,0,28061343,28061343,5.952392
10588,The Cat in the Hat,2003-11-21,2003,0,0,0,13.706053
10589,After the Sunset,2004-11-12,2004,60000000,61347797,1347797,11.945666
10590,We Were Soldiers,2002-03-01,2002,75000000,114660784,39660784,11.34706
10591,The Girl Next Door,2004-04-09,2004,25000000,30411183,5411183,13.083718
10592,Hart's War,2002-02-15,2002,70000000,32287044,-37712956,14.116474
10594,The Skulls III,2004-03-23,2004,0,0,0,1.912726
10596,Replicant,2001-05-11,2001,17000000,0,-17000000,9.585493
10597,Kevin & Perry Go Large,2000-04-20,2000,0,0,0,3.552442
10598,Dirty,2005-11-10,2005,3000000,0,-3000000,2.30794
10599,Pinocchio,2002-12-25,2002,40000000,41323171,1323171,6.463613
10601,Peter Pan,2003-12-25,2003,100000000,121975011,21975011,8.98628
10603,George of the Jungle,1997-07-15,1997,55000000,0,-55000000,9.559685
10604,Zorba the Greek,1964-12-14,1964,783000,0,-783000,4.813635
10606,The Philadelphia Experiment,1984-08-03,1984,21000000,0,-21000000,13.378587
10607,Don't Be a Menace to South Central While Drinking Your Juice in the Hood,1996-01-12,1996,0,0,0,11.700115
10608,Bob Roberts,1992-09-04,1992,0,0,0,3.041772
10609,The Life and Death of Peter Sellers,2004-05-21,2004,0,0,0,3.701781
10610,The Medallion,2003-08-15,2003,41000000,0,-41000000,9.885859
10611,Barbershop,2002-04-01,2002,12000000,75781642,63781642,6.498789
10612,The Englishman Who Went Up a Hill But Came Down a Mountain,1995-05-12,1995,0,0,0,5.331753
10613,The King Is Alive,2000-05-11,2000,0,0,0,5.43754
10614,My Best Friend's Birthday,1987-01-01,1987,0,0,0,1.837191
10615,Pootie Tang,2001-06-29,2001,0,0,0,3.474987
10616,Contract Killer,1998-04-03,1998,0,0,0,9.571939
10617,Once Upon a Time in China,1991-08-15,1991,0,3826459,3826459,5.476134
10618,Once Upon a Time in China II,1992-09-16,1992,0,30399676,30399676,3.606688
10619,Once Upon a Time in China III,1993-01-01,1993,0,27540561,27540561,8.507688
10620,Once Upon a Time in China and America,1997-02-01,1997,12000000,0,-12000000,2.383612
10622,Mr. Nice Guy,1997-01-31,1997,12716953,18814720,6097767,6.183021
10623,Cradle 2 the Grave,2003-02-28,2003,25000000,56489558,31489558,8.364587
10625,Mean Girls,2004-04-30,2004,17000000,129042871,112042871,11.454835
10626,The Captain from K√∂penick,1956-08-15,1956,0,0,0,1.240989
10627,Taps,1981-12-20,1981,14000000,35856053,21856053,5.355452
10628,Kangaroo Jack,2003-01-17,2003,0,0,0,6.538007
10629,Veronica Guerin,2003-07-11,2003,17000000,1569918,-15430082,9.548519
10630,F√ºhrer Ex,2002-08-31,2002,6854500,0,-6854500,0.623881
10631,All of Me,1984-09-07,1984,0,0,0,9.335812
10632,The Hunted,2003-03-11,2003,55000000,34234008,-20765992,7.481524
10633,In the Heat of the Night,1967-08-02,1967,2000000,27379978,25379978,9.059617
10634,Friday,1995-04-26,1995,3500000,28215918,24715918,14.56965
10635,Threesome,1994-04-08,1994,0,0,0,10.82236
10636,Big Girls Don't Cry,2002-10-24,2002,0,0,0,0.940276
10637,Remember the Titans,2000-09-29,2000,30000000,136706683,106706683,6.587726
10639,LiebesLuder,2000-11-02,2000,0,0,0,0.113102
10640,Futureworld,1976-08-13,1976,0,0,0,6.265857
10641,Autumn in New York,2000-08-11,2000,65000000,0,-65000000,7.420422
10642,Loser,2000-07-21,2000,0,0,0,6.244901
10643,Godzilla 2000,1999-12-11,1999,1000000,10037390,9037390,2.80298
10644,The Unbearable Lightness of Being,1988-02-05,1988,17000000,10006806,-6993194,6.815147
10645,The Slurb,2001-10-17,2001,0,0,0,0.850566
10646,Tomcats,2001-03-30,2001,11000000,23430766,12430766,4.63422
10647,Pay It Forward,2000-10-12,2000,40000000,55707411,15707411,10.479723
10648,Magnum Force,1973-12-23,1973,0,39768000,39768000,10.226181
10649,The Enforcer,1976-12-20,1976,9000000,46236000,37236000,7.550133
10650,Sudden Impact,1983-12-07,1983,22000000,67642693,45642693,9.737907
10651,The Dead Pool,1988-07-12,1988,20000000,0,-20000000,7.066395
10652,Hamburger Hill,1987-08-23,1987,0,13839404,13839404,12.373613
10653,The Seven Year Itch,1955-06-01,1955,1800000,0,-1800000,6.81733
10654,Hair,1979-03-14,1979,11000000,0,-11000000,5.259089
10655,Gettysburg,1993-10-08,1993,0,25000000,25000000,6.588347
10656,Subway,1985-04-10,1985,2000000,390659,-1609341,8.066663
10657,Needful Things,1993-08-27,1993,0,0,0,10.560238
10658,Howard the Duck,1986-08-01,1986,37000000,37962774,962774,10.722672
10659,Siegfried,2005-07-28,2005,0,0,0,0.986909
10660,It Could Happen to You,1994-07-29,1994,0,0,0,11.272073
10661,You Don't Mess with the Zohan,2008-06-05,2008,90000000,201596308,111596308,13.116461
10663,The Waterboy,1998-11-06,1998,23000000,185991646,162991646,9.461823
10664,[REC]¬≤,2009-09-15,2009,5600000,18469680,12869680,8.853168
10665,The Strangers,2008-05-29,2008,9000000,82391145,73391145,8.845536
10668,Suicide Kings,1997-09-06,1997,0,0,0,9.262719
10669,Deliverance,1972-07-30,1972,2000000,46122355,44122355,8.476681
10670,Rollercoaster,1977-06-10,1977,0,0,0,3.494417
10671,Airport,1970-03-05,1970,10000000,100489151,90489151,7.873018
10673,Wall Street,1987-12-10,1987,15000000,43848069,28848069,11.672701
10674,Mulan,1998-06-18,1998,90000000,304320254,214320254,21.180857
10675,Frantic,1988-02-16,1988,20000000,17637950,-2362050,8.105859
10676,Halloween III: Season of the Witch,1982-10-22,1982,2500000,14400000,11900000,6.066618
10677,Dirty Dancing: Havana Nights,2004-02-27,2004,25000000,27685016,2685016,4.475359
10678,Bringing Down the House,2003-03-07,2003,20000000,132675402,112675402,5.762343
10679,Iron Sky,2012-03-10,2012,7500000,8135031,635031,19.561767
10680,D3: The Mighty Ducks,1996-10-04,1996,0,22955097,22955097,5.511475
10681,WALL¬∑E,2008-06-22,2008,180000000,521311860,341311860,16.088366
10683,Happiness,1998-10-16,1998,3000000,2807390,-192610,5.493697
10684,Courage Under Fire,1996-07-04,1996,46000000,100860818,54860818,11.595316
10685,The Watcher,2000-09-08,2000,33000000,0,-33000000,6.173059
10686,Samurai Fiction,1998-10-27,1998,0,0,0,3.121214
10687,Tigerland,2000-09-22,2000,10000000,0,-10000000,5.878885
10688,Hamlet,2000-05-12,2000,2000000,1568749,-431251,12.896203
10690,Space Truckers,1996-03-01,1996,25000000,1614266,-23385734,3.596317
10691,Crazy/Beautiful,2001-06-29,2001,13000000,16929123,3929123,6.236729
10692,Henry: Portrait of a Serial Killer,1986-09-24,1986,111000,0,-111000,10.072668
10693,Peter Pan,1953-02-05,1953,4000000,87404651,83404651,16.861533
10694,The Chase,1994-03-04,1994,26000000,8009329,-17990671,14.362544
10696,Glitter,2001-09-21,2001,22000000,5271666,-16728334,5.420686
10697,The Taste of Others,2000-03-01,2000,0,0,0,3.134181
10699,Hero,1992-10-02,1992,42000000,0,-42000000,5.584089
10703,Seven Swords,2005-07-25,2005,0,0,0,4.360738
10704,Universal Soldier II: Brothers in Arms,1998-09-27,1998,0,0,0,3.074653
10705,Henry V,1989-10-05,1989,9000000,0,-9000000,7.307967
10706,Mimic 2,2001-07-17,2001,10000000,0,-10000000,4.88911
10707,The Squid and the Whale,2005-10-05,2005,1500000,11098131,9598131,10.952762
10708,Daddy Day Care,2003-05-03,2003,60000000,164433867,104433867,6.504927
10710,Envy,2004-04-30,2004,40000000,0,-40000000,13.094205
10711,French Connection II,1975-05-18,1975,0,12484444,12484444,18.54199
10712,Far from Heaven,2002-09-01,2002,13500000,29027914,15527914,10.107519
10714,The Jungle Book,1994-12-23,1994,0,0,0,10.714235
10715,Looney Tunes: Back in Action,2003-11-14,2003,80000000,68514844,-11485156,13.666488
10718,Torque,2004-01-16,2004,40000000,46546197,6546197,5.574983
10719,Elf,2003-10-09,2003,32000000,173398518,141398518,8.754132
10720,Down with Love,2003-05-08,2003,35000000,20298207,-14701793,9.392508
10722,The Day of the Beast,1995-10-20,1995,0,4367497,4367497,5.759423
10723,Bulletproof,1996-09-06,1996,25000000,22611954,-2388046,7.859132
10724,Firefox,1982-06-13,1982,18000000,70687344,52687344,8.97528
10725,Wolfen,1981-07-24,1981,17000000,10626725,-6373275,2.522474
10726,American Psycho 2: All American Girl,2002-04-22,2002,10000000,0,-10000000,4.968814
10727,Darkness Falls,2003-01-24,2003,0,0,0,11.878552
10728,Faust,1926-10-13,1926,0,0,0,4.021486
10729,Quick Change,1990-07-13,1990,0,0,0,4.122959
10730,King Kong,1976-09-08,1976,23000000,90614445,67614445,5.810716
10731,The Client,1994-07-20,1994,45000000,117615211,72615211,15.263829
10733,The Alamo,2004-04-07,2004,145000000,25819961,-119180039,12.240901
10734,Escape from Alcatraz,1979-06-22,1979,8000000,43000000,35000000,11.837667
10735,What a Girl Wants,2003-03-27,2003,0,0,0,6.743151
10739,Anything Else,2003-08-27,2003,0,0,0,11.10416
10740,Birth,2004-09-08,2004,20000000,0,-20000000,6.771415
10741,Bobby,2006-09-05,2006,0,0,0,9.614816
10742,The Clearing,2004-07-02,2004,0,12520799,12520799,4.755759
10743,Confidence,2003-04-25,2003,0,0,0,6.959638
10744,The Cooler,2003-01-17,2003,32000000,0,-32000000,10.694443
10747,The Outlaw Josey Wales,1976-06-30,1976,3700000,31800000,28100000,5.849522
10748,St. Trinian's,2007-12-21,2007,0,0,0,5.381183
10749,Sophiiiie!,2003-02-28,2003,0,0,0,0.216899
10750,Toy Soldiers,1991-04-24,1991,0,15073942,15073942,12.698468
10751,Old Men in New Cars: In China They Eat Dogs II,2002-07-12,2002,0,0,0,4.003761
10753,Police Story 2,1988-08-13,1988,0,0,0,6.447628
10754,A Short Film About Killing,1989-01-26,1989,0,0,0,3.804288
10756,The Haunted Mansion,2003-11-25,2003,90000000,182290266,92290266,11.605735
10757,Kabhi Khushi Kabhie Gham,2001-12-14,2001,0,0,0,6.523888
10758,Waitress,2007-05-25,2007,2000000,22179430,20179430,11.276024
10759,The Comebacks,2007-10-19,2007,15000000,0,-15000000,3.324966
10760,Sydney White,2007-09-21,2007,16500000,13620075,-2879925,6.463883
10761,Made of Honor,2008-05-02,2008,40000000,84601681,44601681,6.417385
10762,Without a Paddle,2004-08-20,2004,19000000,69631118,50631118,6.046516
10763,Dr. T and the Women,2000-09-13,2000,12000000,0,-12000000,6.761308
10764,Quantum of Solace,2008-10-30,2008,200000000,586090727,386090727,13.67812
10765,Private Benjamin,1980-10-06,1980,0,0,0,11.431866
10766,Damien: Omen II,1978-06-09,1978,6800000,26518355,19718355,10.235373
10768,Omen III: The Final Conflict,1981-03-20,1981,0,20471382,20471382,7.798615
10770,The Sheriff and the Satellite Kid,1979-08-10,1979,0,0,0,3.812074
10771,The Tuxedo,2002-09-27,2002,0,0,0,6.023213
10772,Django,1966-04-05,1966,0,17277,17277,4.891638
10773,Mrs Henderson Presents,2005-09-09,2005,0,0,0,4.133619
10774,Network,1976-11-01,1976,3800000,23689877,19889877,13.180457
10775,Infernal Affairs,2002-12-12,2002,0,8708932,8708932,10.363082
10776,Little Shop of Horrors,1986-12-19,1986,25000000,38748395,13748395,7.409179
10778,The Man Who Wasn't There,2001-05-13,2001,0,0,0,7.204951
10779,The Frighteners,1996-07-18,1996,30000000,29359216,-640784,12.09096
10780,Overboard,1987-12-16,1987,1880006,26713187,24833181,5.549621
10781,The Texas Chainsaw Massacre: The Beginning,2006-10-06,2006,16000000,0,-16000000,10.516112
10782,Basic,2003-04-18,2003,50000000,42792561,-7207439,14.327717
10783,Lucky Numbers,2000-10-27,2000,65000000,0,-65000000,3.385585
10784,Cabaret,1972-02-13,1972,6000000,0,-6000000,10.82887
10785,The Thing from Another World,1951-04-29,1951,0,0,0,5.466036
10786,Robin and Marian,1976-03-11,1976,0,0,0,3.849626
10787,The Invisible Man,1933-11-13,1933,328000,0,-328000,5.192905
10788,Kambakkht Ishq,2009-07-03,2009,16000000,0,-16000000,2.024764
10790,The Abandoned,2006-09-11,2006,0,0,0,4.784131
10792,Hothead,1979-02-14,1979,0,0,0,1.151782
10794,The Party,1968-04-04,1968,1500000,0,-1500000,5.354787
10795,Tell No One,2006-11-01,2006,0,0,0,10.239074
10796,The One,2001-11-02,2001,49000000,72700000,23700000,9.769047
10797,Terkel in Trouble,2004-04-02,2004,0,0,0,2.213166
10798,Sky Fighters,2005-10-15,2005,19610000,0,-19610000,10.77037
10799,Empire of the Wolves,2005-04-20,2005,24000000,11875866,-12124134,9.255441
10800,Dragon Hunters,2008-03-19,2008,15000000,0,-15000000,10.938912
10801,The Superwife,1996-03-06,1996,0,0,0,0.821299
10802,Showgirls,1995-09-22,1995,45000000,20350754,-24649246,17.502375
10803,Logan's Run,1976-06-23,1976,9000000,25000000,16000000,6.842274
10804,King Ralph,1991-02-15,1991,0,0,0,5.169223
10805,Staying Alive,1983-07-11,1983,22000000,64892670,42892670,4.860672
10806,In & Out,1997-09-10,1997,35000000,0,-35000000,9.949805
10808,Dr. Dolittle 2,2001-06-22,2001,70000000,176104344,106104344,7.906683
10809,The Debutantes,2003-06-06,2003,0,0,0,0.79207
10810,Rosario Tijeras,2005-08-12,2005,0,0,0,1.909852
10817,Glue,2006-02-02,2006,0,0,0,0.823958
10818,Water Lilies,2007-05-17,2007,0,0,0,4.968813
10819,The Wedding,2004-10-13,2004,0,0,0,0.483616
10821,120,2008-02-15,2008,0,0,0,0.467022
10822,Savage Grace,2007-05-18,2007,4600000,0,-4600000,5.225054
10823,Children of the Corn,1984-03-09,1984,800000,14000000,13200000,11.84696
10824,Candyman: Farewell to the Flesh,1995-03-17,1995,0,13940383,13940383,4.983552
10829,Tremors 3: Back to Perfection,2001-10-02,2001,0,0,0,10.191148
10830,Matilda,1996-08-02,1996,36000000,33459416,-2540584,10.034915
10831,The Draughtsman's Contract,1982-10-02,1982,0,0,0,2.444637
10832,Them,2006-07-19,2006,0,0,0,4.692506
10833,Heartbreakers,2001-03-23,2001,35000000,0,-35000000,9.515602
10834,Kings of the Road,1976-03-04,1976,0,0,0,6.008315
10835,The Killer,1989-07-06,1989,0,0,0,8.019837
10836,Dagon,2001-10-12,2001,4800000,0,-4800000,5.999625
10837,DuckTales: The Movie - Treasure of the Lost Lamp,1990-08-03,1990,0,0,0,7.810813
10839,Cross of Iron,1977-01-29,1977,6000000,0,-6000000,9.103168
10840,On Your Mark,1995-07-15,1995,0,0,0,1.674261
10841,Breakthrough,1979-03-01,1979,0,0,0,0.981224
10842,Strange Circus,2005-12-24,2005,0,0,0,3.171093
10843,After Hours,1985-09-13,1985,4500000,10609321,6109321,6.583161
10844,Out of the Blue,2006-10-12,2006,0,0,0,1.020201
10845,2001 Maniacs,2005-05-12,2005,3000000,0,-3000000,4.619056
10846,The Tiger and the Snow,2005-10-14,2005,35000000,0,-35000000,5.524817
10847,Lord of the Flies,1990-03-16,1990,0,0,0,13.889303
10849,The Purple Rose of Cairo,1985-03-01,1985,15000000,10631333,-4368667,6.133697
10851,Revolver,2005-09-11,2005,0,0,0,5.654983
10852,Kung Fu Cult Master,1993-12-18,1993,0,0,0,13.263327
10854,Wicked Little Things,2006-01-01,2006,0,0,0,6.954593
10855,Naked Weapon,2002-11-15,2002,0,0,0,1.689124
10856,Intacto,2001-11-06,2001,0,0,0,3.249017
10857,When the Wind Blows,1986-10-24,1986,0,5274,5274,3.933121
10858,Nixon,1995-12-22,1995,44000000,13681765,-30318235,5.092
10859,Stakeout,1987-08-05,1987,0,0,0,8.376319
10860,Steel Magnolias,1989-11-15,1989,0,95904091,95904091,7.14561
10861,Maximum Risk,1996-09-13,1996,25000000,51702483,26702483,7.370163
10862,Bounce,2000-11-15,2000,35000000,36779296,1779296,13.349518
10863,Eye of the Needle,1981-07-24,1981,0,18000000,18000000,9.698848
10865,Atlantis: The Lost Empire,2001-06-02,2001,120000000,186053725,66053725,10.901602
10866,Joy Ride,2001-10-05,2001,23000000,36642838,13642838,10.337689
10867,Malena,2000-10-27,2000,0,0,0,9.490512
10868,The Accused,1988-10-14,1988,0,0,0,13.028922
10869,Herbie Rides Again,1974-02-14,1974,0,0,0,4.914603
10870,Lucky Luke and the Daltons,2004-12-08,2004,0,0,0,7.371876
10871,Switchback,1997-10-31,1997,37000000,6482195,-30517805,3.742824
10872,The Ref,1994-03-09,1994,11000000,11439193,439193,5.868677
10873,Shadow of the Vampire,2000-05-15,2000,8000000,8279017,279017,12.691457
10874,Muppet Treasure Island,1996-02-16,1996,0,34327391,34327391,6.902423
10875,The Fabulous Baker Boys,1989-10-13,1989,13000000,0,-13000000,4.343506
10876,Quills,2000-11-22,2000,13500000,7060876,-6439124,5.387711
10877,Exit Wounds,2001-03-13,2001,50000000,79958599,29958599,12.280827
10878,Saving Silverman,2001-02-09,2001,22000000,19351569,-2648431,8.526823
10879,I Love Trouble,1994-06-29,1994,45000000,61947267,16947267,3.570874
10880,The Noah's Ark Principle,1984-02-24,1984,600000,0,-600000,0.441841
10881,Avalon,2001-01-20,2001,8000000,8826094,826094,5.019679
10882,Sleeping Beauty,1959-01-28,1959,6000000,51000000,45000000,14.276169
10884,10 Questions for the Dalai Lama,2006-05-01,2006,0,0,0,0.721105
10885,Shutter,2008-03-21,2008,0,0,0,5.233421
10886,The Unknown Woman,2006-10-09,2006,8000000,0,-8000000,3.732055
10889,Gloria,1980-10-01,1980,0,4059673,4059673,10.0534
10890,Stripes,1981-06-25,1981,10000000,85300000,75300000,11.341505
10891,Tremors 4: The Legend Begins,2004-01-02,2004,5000000,0,-5000000,10.002295
10894,May,2002-01-13,2002,500000,150277,-349723,8.398158
10895,Pinocchio,1940-02-23,1940,2600000,84300000,81700000,14.202284
10896,Tin Men,1987-03-06,1987,0,0,0,6.477975
10897,The Little Rascals,1994-08-05,1994,0,67308282,67308282,6.707109
10898,The Little Mermaid II: Return to the Sea,2000-08-30,2000,0,0,0,1.658407
10900,Surveillance,2008-02-08,2008,3500000,1115493,-2384507,6.804406
10905,The Man with One Red Shoe,1985-07-18,1985,0,0,0,4.006022
10906,Pet Sematary II,1992-08-28,1992,8000000,17092453,9092453,6.823445
10907,The Adventures of Robin Hood,1938-05-13,1938,2033000,3981000,1948000,10.685036
10908,Inferno,1999-09-25,1999,15000000,0,-15000000,7.965505
10909,Kalifornia,1993-09-01,1993,9000000,2395231,-6604769,8.4337
10910,Moulin Rouge,1952-12-23,1952,1500000,0,-1500000,1.437803
10911,The Guns of Navarone,1961-04-27,1961,6000000,28900000,22900000,8.522673
10912,All Quiet on the Western Front,1979-11-14,1979,0,0,0,9.234545
10913,Dear Wendy,2005-01-22,2005,0,0,0,2.48575
10915,"A Genius, Two Friends, and an Idiot",1975-12-16,1975,0,0,0,3.678782
10916,Babylon 5: A Call to Arms,1999-01-03,1999,0,0,0,8.389329
10917,Too Young to Die?,1990-02-26,1990,0,0,0,9.454614
10918,Undertaking Betty,2002-10-04,2002,0,0,0,4.002724
10921,Babylon 5: The River of Souls,1998-11-08,1998,0,0,0,2.203009
10922,The Human Stain,2003-10-29,2003,30000000,0,-30000000,8.408429
10923,Agent Cody Banks,2003-03-14,2003,28000000,58795814,30795814,10.445141
10925,The Return of the Living Dead,1985-05-15,1985,4000000,14237000,10237000,6.258984
10929,Willard,2003-03-14,2003,22000000,0,-22000000,4.109477
10930,The Flower of Evil,2003-02-09,2003,0,0,0,1.528012
10934,Under the Tuscan Sun,2003-04-30,2003,18000000,58878723,40878723,8.508008
10935,Heaven's Gate,1980-11-19,1980,44000000,3484331,-40515669,4.393576
10937,Barfly,1987-09-02,1987,3000000,3221568,221568,15.170192
10938,Beautiful Thing,1996-06-21,1996,0,1500000,1500000,5.766163
10939,The Return of the Tall Blond Man with One Black Shoe,1974-11-12,1974,0,0,0,1.599224
10940,Babylon 5: In the Beginning,1998-01-04,1998,0,0,0,3.680772
10941,Babylon 5: Thirdspace,1998-07-19,1998,0,0,0,5.579911
10942,Babylon 5: The Gathering,1993-02-22,1993,0,0,0,8.232154
10943,The Gathering,2003-02-23,2003,0,0,0,3.969121
10944,In the Cut,2003-09-09,2003,12000000,23,-11999977,5.799628
10945,Jumpin' Jack Flash,1986-10-09,1986,0,0,0,4.477284
10946,Earth,2007-04-22,2007,15000000,109000000,94000000,15.30326
10947,High School Musical,2006-01-20,2006,4200000,0,-4200000,10.187478
10948,The Fox and the Hound,1981-07-10,1981,12000000,29800000,17800000,10.197106
10949,Oliver Twist,1948-06-28,1948,0,0,0,6.061655
10950,I Am Sam,2001-12-28,2001,22000000,92542418,70542418,12.935016
10951,Gorgeous,1999-02-12,1999,0,0,0,7.231256
10952,New Jack City,1991-03-08,1991,8500000,47624253,39124253,12.979446
10954,Farinelli,1994-12-07,1994,0,0,0,8.935058
10955,Ripley's Game,2002-09-02,2002,30000000,0,-30000000,7.743921
10956,Joe Dirt,2001-04-10,2001,17700000,30987695,13287695,10.442468
10957,The Black Cauldron,1985-07-24,1985,25000000,21288692,-3711308,9.806685
10958,Flight 93,2006-01-30,2006,0,0,0,2.990253
10960,Project: ALF,1996-02-17,1996,0,0,0,1.689146
10961,Behind the Mask: The Rise of Leslie Vernon,2006-10-13,2006,0,69136,69136,5.241144
10970,Silent Movie,1976-06-17,1976,0,0,0,8.636492
10971,A Night to Remember,1958-12-16,1958,1680000,0,-1680000,6.560231
10972,Session 9,2001-08-10,2001,1500000,373967,-1126033,14.242234
10973,Creature from the Black Lagoon,1954-03-05,1954,0,1300000,1300000,7.390658
10974,Armour of God,1986-08-16,1986,15000000,0,-15000000,7.278549
10975,Armour of God II: Operation Condor,1991-02-07,1991,0,0,0,12.276235
10978,The Best Man's Wedding,2000-12-22,2000,0,0,0,5.11229
10981,Nothing,2003-09-09,2003,0,0,0,7.121398
10982,Hoodwinked!,2005-12-16,2005,15000000,51053787,36053787,6.398984
10984,Valentine,2001-02-01,2001,0,0,0,5.367306
10985,The New Guy,2002-05-10,2002,13000000,0,-13000000,9.255418
10986,The Taming of the Scoundrel,1980-12-20,1980,0,0,0,8.544678
10987,Halloween: The Curse of Michael Myers,1995-09-29,1995,5000000,15116634,10116634,8.768288
10988,Diabolique,1996-03-22,1996,0,0,0,4.530079
10989,101 Reykjavik,2000-05-31,2000,0,0,0,6.565758
10990,Mulholland Falls,1996-04-26,1996,0,0,0,5.79463
10991,Pok√©mon: Spell of the Unknown,2000-07-08,2000,16000000,68411275,52411275,6.480376
10991,Pok√©mon: Spell of the Unknown,2000-07-08,2000,16000000,68411275,52411275,10.264597
10992,Cats & Dogs,2001-07-04,2001,60000000,93375151,33375151,8.142251
10994,White Oleander,2002-10-11,2002,0,0,0,13.75498
10995,The Lover,1992-02-22,1992,0,0,0,7.281965
10996,Stuart Little 2,2002-07-19,2002,120000000,169956806,49956806,9.274909
10997,Farewell My Concubine,1993-09-16,1993,0,0,0,4.875827
10998,Fatal Attraction,1987-09-11,1987,14000000,320145693,306145693,14.260779
10999,Commando,1985-10-03,1985,10000000,57500000,47500000,10.193652
11000,The Birdcage,1996-03-08,1996,31000000,185260553,154260553,6.49968
11001,Blue Streak,1999-09-17,1999,65000000,117758500,52758500,6.229424
11002,"Greystoke: The Legend of Tarzan, Lord of the Apes",1984-03-30,1984,0,45858563,45858563,4.627865
11003,The Wedding Singer,1998-02-13,1998,18000000,123306987,105306987,8.884035
11004,Wonder Boys,2000-02-22,2000,35000000,0,-35000000,5.922739
11005,Awakenings,1990-12-19,1990,0,52096475,52096475,13.201595
11006,Smokey and the Bandit,1977-05-26,1977,0,126737428,126737428,7.68372
11007,Cheaper by the Dozen,2003-12-24,2003,40000000,190212113,150212113,7.364297
11008,Major Payne,1995-03-24,1995,0,0,0,9.253362
11009,Saturday Night Fever,1977-12-16,1977,3500000,237113184,233613184,13.657204
11010,The Postman,1994-09-22,1994,0,0,0,10.168437
11011,Ri¬¢hie Ri¬¢h,1994-12-19,1994,40000000,0,-40000000,6.595255
11012,Damage,1992-12-02,1992,0,7532911,7532911,6.384589
11013,Secretary,2002-01-11,2002,4000000,9304609,5304609,10.936827
11015,The Relic,1997-01-10,1997,60000000,33956608,-26043392,7.699967
11016,Key Largo,1948-07-31,1948,0,0,0,7.588489
11017,Billy Madison,1995-02-10,1995,10000000,26488734,16488734,6.638116
11018,Year of the Dragon,1985-08-16,1985,24000000,18707466,-5292534,7.505786
11019,Deep Blue,2003-05-18,2003,0,0,0,3.485109
11020,Picnic at Hanging Rock,1975-09-02,1975,0,0,0,6.811264
11022,Narc,2002-01-14,2002,6500000,12633747,6133747,5.20644
11023,Thirteen,2003-08-20,2003,2000000,4601043,2601043,14.379879
11024,Scooby-Doo 2: Monsters Unleashed,2004-03-24,2004,0,181466833,181466833,7.65458
11025,New York Minute,2004-05-01,2004,0,0,0,5.659198
11026,Exorcist: The Beginning,2004-08-20,2004,80000000,78000586,-1999414,13.02369
11027,The Postman Always Rings Twice,1981-03-20,1981,12000000,0,-12000000,8.049042
11028,The Big Easy,1986-11-27,1986,0,0,0,13.343046
11030,Zelig,1983-07-15,1983,0,11798616,11798616,5.94179
11031,This Is Spinal Tap,1984-05-04,1984,2500000,4736202,2236202,13.981499
11033,Dressed to Kill,1980-06-25,1980,6500000,31899000,25399000,9.3806
11034,The Great Gatsby,1974-03-27,1974,6500000,26533200,20033200,5.702638
11035,Roma,1972-03-15,1972,0,0,0,2.46757
11036,The Notebook,2004-06-25,2004,29000000,115603229,86603229,15.239013
11037,Iron Eagle,1986-01-17,1986,0,0,0,4.33058
11038,Tough Guys,1986-10-03,1986,0,0,0,2.86084
11039,Why Did You Pick On Me?,1980-12-11,1980,0,0,0,3.399599
11040,Little Big Man,1970-12-14,1970,15000000,31559552,16559552,8.186994
11041,The Beverly Hillbillies,1993-10-15,1993,0,0,0,5.673735
11042,The Barbarian Invasions,2003-05-21,2003,8000000,3432342,-4567658,4.125182
11044,Arizona Dream,1993-01-06,1993,19000000,0,-19000000,5.465995
11045,Taxi,2004-10-06,2004,25000000,36609966,11609966,7.745017
11046,Where Eagles Dare,1968-12-04,1968,7700000,21000000,13300000,12.088407
11047,Asterix the Gaul,1967-12-20,1967,0,0,0,7.24597
11048,The Knock Out Cop,1973-10-25,1973,0,0,0,1.713609
11049,Interstella 5555: The 5tory of the 5ecret 5tar 5ystem,2003-05-18,2003,0,0,0,4.812815
11050,Terms of Endearment,1983-11-20,1983,8000000,0,-8000000,8.785209
11051,The Last Temptation of Christ,1988-08-12,1988,7000000,8373585,1373585,11.370288
11052,Yu-Gi-Oh! The Movie,2004-08-13,2004,20000000,29170410,9170410,5.946085
11053,Flatfoot in Hong Kong,1975-06-26,1975,0,0,0,3.477146
11054,Hairspray,1988-02-16,1988,0,0,0,6.453409
11055,Flatfoot in Africa,1978-03-22,1978,0,0,0,2.602674
11056,Darkness,2002-10-02,2002,0,0,0,5.975404
11057,Die weisse Rose,1982-09-24,1982,0,0,0,0.417127
11058,Godsend,2004-04-30,2004,25000000,30114487,5114487,11.271148
11059,House of the Dead,2003-04-11,2003,7000000,13818181,6818181,5.701278
11060,Internal Affairs,1990-01-12,1990,0,27734391,27734391,5.439942
11062,City Hall,1996-02-16,1996,0,0,0,4.807223
11064,Brewster's Millions,1985-05-22,1985,20000000,45833132,25833132,6.526379
11065,O,2001-08-31,2001,0,16017403,16017403,5.378833
11066,Boomerang,1992-06-30,1992,40000000,70100000,30100000,6.506983
11067,Major League II,1994-03-30,1994,0,30626182,30626182,7.989181
11068,Singles,1992-09-18,1992,0,18472850,18472850,10.450148
11069,Tremors 2: Aftershocks,1996-04-09,1996,4000000,0,-4000000,9.877868
11070,Moonlight Tariff,2001-10-25,2001,0,0,0,0.660938
11071,Them!,1954-06-16,1954,23000000,0,-23000000,9.222871
11072,Blazing Saddles,1974-02-07,1974,2600000,119500000,116900000,13.233262
11074,Striking Distance,1993-09-17,1993,30,0,-30,13.390917
11075,Audition,1999-10-06,1999,0,0,0,12.799287
11076,Fly Away Home,1996-09-13,1996,0,0,0,5.511155
11077,Problem Child,1990-07-27,1990,0,0,0,5.722116
11078,National Security,2003-01-17,2003,0,50097949,50097949,6.409297
11081,Taking Lives,2004-03-19,2004,45000000,65470529,20470529,7.85646
11082,The Seventh Sign,1988-04-01,1988,0,18875011,18875011,4.720395
11083,Kitchen Stories,2003-01-01,2003,0,0,0,6.164594
11084,Flodder 3,1995-06-29,1995,0,0,0,4.573115
11085,Mutiny on the Bounty,1962-11-08,1962,19000000,13680000,-5320000,5.857488
11086,The Majestic,2001-12-21,2001,72000000,37317558,-34682442,8.063684
11087,The Hand that Rocks the Cradle,1992-01-10,1992,11700000,88036683,76336683,6.672715
11088,Heist,2001-11-09,2001,35000000,0,-35000000,5.741817
11089,Black Box BRD,2001-05-24,2001,0,0,0,0.055728
11090,The Animal,2001-06-01,2001,22000000,84772742,62772742,8.473369
11091,Riding in Cars with Boys,2001-10-19,2001,48000000,35743308,-12256692,4.556123
11092,Presumed Innocent,1990-07-26,1990,22000000,221303188,199303188,7.025657
11093,House of Sand and Fog,2003-12-19,2003,16500000,16942795,442795,9.245145
11096,Hide and Seek,2005-01-27,2005,25000000,122644820,97644820,6.102059
11099,The Final Cut,2004-10-15,2004,0,548039,548039,10.606823
11101,Stalingrad,1993-01-21,1993,0,0,0,7.667284
11103,Head Above Water,1996-11-07,1996,0,0,0,2.357791
11104,Chungking Express,1994-07-14,1994,0,0,0,6.778979
11107,Eddie,1996-05-31,1996,0,0,0,3.09233
11109,Vera Drake,2004-10-22,2004,11000000,0,-11000000,4.681074
11110,Sweet Mud,2006-06-06,2006,0,0,0,0.369258
11111,King Lines,2007-03-01,2007,250000,0,-250000,0.215744
11112,The Associate,1996-10-25,1996,0,0,0,3.277612
11113,My Fair Lady,1964-10-21,1964,17000000,72070731,55070731,12.494394
11114,Pete's Dragon,1977-11-03,1977,10000000,0,-10000000,7.644722
11115,Deal,2008-01-29,2008,0,0,0,6.880365
11115,Deal,2008-01-29,2008,0,0,0,6.880365
11119,Fortress 2,1999-10-07,1999,11000000,0,-11000000,2.603049
11120,The Mosquito Coast,1986-11-26,1986,0,14302779,14302779,6.224859
11121,Tess,1979-10-06,1979,0,0,0,4.400153
11122,India,1993-10-07,1993,0,0,0,1.348347
11123,Earthquake,1974-11-15,1974,7000000,79666653,72666653,6.657792
11127,Starship Troopers 3: Marauder,2008-07-19,2008,9000000,0,-9000000,11.161339
11128,Ladder 49,2004-10-01,2004,60000000,74541707,14541707,7.650411
11129,Human Traffic,1999-06-04,1999,600000,4000000,3400000,4.988283
11130,The Princess Diaries 2: Royal Engagement,2004-08-06,2004,40000000,95149435,55149435,8.248895
11131,Nuns on the Run,1990-03-16,1990,0,0,0,2.615488
11132,Confessions of a Teenage Drama Queen,2004-02-17,2004,15000000,29331068,14331068,7.423275
11133,Poltergeist II: The Other Side,1986-05-23,1986,19000000,40996665,21996665,6.701138
11134,Police Story 3: Supercop,1992-07-04,1992,900000,20483423,19583423,6.751864
11135,The Rescuers Down Under,1990-11-16,1990,37931000,47431461,9500461,1.562471
11137,The Prince & Me,2004-03-28,2004,0,0,0,11.631511
11139,Leolo,1992-09-16,1992,0,0,0,2.142068
11141,Laws of Attraction,2004-04-04,2004,28000000,30016165,2016165,5.739139
11142,Der Clown - Tag der Vergeltung,2005-01-01,2005,0,0,0,1.225917
11143,Tai-Chi Master,1993-11-18,1993,0,0,0,3.193491
11144,They Called Him Bulldozer,1978-09-15,1978,0,0,0,2.666812
11145,The Electric Horseman,1979-12-21,1979,0,61801971,61801971,5.916187
11148,XXY,2007-06-14,2007,0,0,0,3.420817
11152,The Ruins,2008-04-02,2008,8000000,0,-8000000,7.192452
11153,National Lampoon's Vacation,1983-07-28,1983,15000000,61399552,46399552,7.747432
11155,Christmas Vacation 2: Cousin Eddie's Island Adventure,2003-01-01,2003,0,0,0,2.021284
11156,Coco Before Chanel,2009-04-22,2009,0,0,0,6.119818
11157,She-Devil,1989-12-08,1989,0,0,0,4.282807
11158,Honey I Blew Up the Kid,1992-07-16,1992,40000000,58662452,18662452,12.337898
11159,Secrets & Lies,1996-05-24,1996,4500000,13417292,8917292,11.223572
11160,Flatfoot in Egypt,1980-03-01,1980,0,0,0,2.634068
11161,Grace is Gone,2007-01-21,2007,0,0,0,4.022198
11162,The Merchant of Venice,2004-09-03,2004,0,0,0,13.220259
11163,Fellini Satyricon,1969-09-18,1969,3000000,0,-3000000,4.214637
11164,D2: The Mighty Ducks,1994-03-25,1994,0,45610410,45610410,11.117131
11165,Tora! Tora! Tora!,1970-01-26,1970,25485000,29548291,4063291,7.262326
11167,Peeping Tom,1960-04-06,1960,150000,83957,-66043,7.229587
11169,Spartan,2004-03-12,2004,19250000,8112712,-11137288,7.364519
11170,We Are Marshall,2006-12-12,2006,65000000,43545364,-21454636,5.401746
11171,Mysterious Skin,2004-05-20,2004,0,1524966,1524966,7.103951
11172,Music and Lyrics,2007-02-09,2007,40000000,145896422,105896422,7.196688
11174,Pelle the Conqueror,1987-12-25,1987,0,0,0,1.958105
11175,Lucky Luke,1991-07-04,1991,0,0,0,1.8071
11176,The Muppet Movie,1979-05-31,1979,0,76657000,76657000,6.769866
11177,Mask,1985-03-08,1985,0,42400000,42400000,6.012125
11178,My Sassy Girl,2001-07-27,2001,0,0,0,5.980499
11179,Girls on Top 2,2004-06-17,2004,0,0,0,1.626931
11181,Nonstop Trouble with the Family,1985-02-08,1985,0,0,0,0.016023
11183,French Fried Vacation,1978-11-01,1978,0,0,0,5.021867
11184,Kinsey,2004-09-04,2004,0,0,0,6.3793
11185,"See No Evil, Hear No Evil",1989-05-12,1989,18000000,46908987,28908987,17.367336
11186,Child's Play 2,1990-11-09,1990,13000000,35763605,22763605,14.310479
11187,Child's Play 3,1991-08-30,1991,13000000,20560255,7560255,24.515462
11188,Curse of the Ring,2004-11-19,2004,23000000,0,-23000000,5.127239
11190,The Return,2003-06-25,2003,0,0,0,4.507702
11191,Mystic Pizza,1988-10-13,1988,0,0,0,6.854978
11193,True,2004-02-06,2004,0,0,0,1.680105
11194,Touching the Void,2003-09-05,2003,0,13885802,13885802,7.594022
11196,Stealing Rembrandt,2003-05-17,2003,0,0,0,1.391832
11197,Evil,2003-05-16,2003,0,0,0,8.896421
11198,City Hunter,1993-01-16,1993,0,0,0,8.087053
11199,Wild Hogs,2007-03-02,2007,0,253625427,253625427,11.356011
11202,Patton,1970-01-25,1970,12000000,89800000,77800000,14.382289
11204,Dresden,2006-03-05,2006,0,0,0,3.462206
11205,Wheels on Meals,1984-08-17,1984,0,0,0,7.068829
11206,Wait Until Dark,1967-10-26,1967,4000000,11000000,7000000,6.216637
11207,S√ºperseks,2004-09-30,2004,0,0,0,0.084158
11208,Wicker Park,2004-09-03,2004,30000000,13001257,-16998743,5.605652
11209,The Alamo,1960-10-23,1960,12000000,7900000,-4100000,4.73816
11210,Robinson Crusoe,1997-06-11,1997,0,0,0,8.739166
11211,Bring It On: All or Nothing,2006-08-08,2006,0,0,0,0.316359
11212,Baby's Day Out,1994-07-01,1994,50000000,16671505,-33328495,12.508518
11214,We Feed the World,2005-09-10,2005,0,0,0,0.934533
11215,Baby Boom,1987-09-17,1987,0,0,0,6.032248
11216,Cinema Paradiso,1988-11-17,1988,0,11990401,11990401,14.177005
11217,Club Dread,2004-02-27,2004,8500000,5001655,-3498345,6.57613
11218,Rhythm is it!,2004-06-12,2004,0,0,0,0.111894
11219,The Trouble with Harry,1955-10-03,1955,1200000,7000000,5800000,6.486117
11220,Fallen Angels,1995-09-06,1995,0,0,0,5.470351
11221,Best Defense,1984-07-20,1984,18000000,19265302,1265302,1.975174
11222,The American Friend,1977-06-26,1977,0,0,0,6.710499
11223,Coma,1978-01-06,1978,0,0,0,5.617866
11224,Cinderella,1950-03-04,1950,2900000,263591415,260691415,14.436858
11225,Into Great Silence,2005-09-04,2005,0,0,0,0.460854
11226,Strip Nude for Your Killer,1975-08-24,1975,0,0,0,2.540103
11227,Angel-A,2005-12-21,2005,15000000,0,-15000000,5.512501
11228,Daylight,1996-12-06,1996,80000000,159212469,79212469,11.995799
11229,Freeway,1996-08-23,1996,3000000,0,-3000000,7.088533
11230,Drunken Master,1978-10-05,1978,0,0,0,7.404755
11231,The Next Karate Kid,1994-07-18,1994,12000000,15826984,3826984,9.9697
11232,Kate & Leopold,2001-12-25,2001,0,0,0,7.196356
11234,The Omega Man,1971-08-01,1971,0,0,0,6.445639
11235,Local Hero,1983-02-17,1983,0,0,0,10.636074
11236,The Secret Garden,1993-08-13,1993,0,0,0,6.499523
11237,Anacondas: The Hunt for the Blood Orchid,2004-08-26,2004,20000000,70992898,50992898,10.749404
11238,Aladdin and the King of Thieves,1996-05-20,1996,0,0,0,8.654244
11239,Shall We Dance?,1996-01-27,1996,0,0,0,1.963402
11240,My Beautiful Laundrette,1985-09-07,1985,860000,2451545,1591545,2.793003
11243,The Care Bears Movie,1985-03-23,1985,0,0,0,2.849672
11244,The Meteor Man,1993-08-06,1993,30,0,-30,4.869901
11246,Hellraiser: Hellseeker,2002-10-15,2002,3000000,0,-3000000,5.823097
11247,A Cinderella Story,2004-07-10,2004,19000000,70067909,51067909,8.385361
11248,Fatherland,1994-11-26,1994,0,0,0,4.001812
11249,Seed of Chucky,2004-11-11,2004,12000000,24829644,12829644,15.216315
11252,Psycho,1998-12-04,1998,60000000,37141130,-22858870,6.715898
11253,Hellboy II: The Golden Army,2008-07-11,2008,85000000,160388063,75388063,11.928661
11257,A Room with a View,1985-12-13,1985,3000000,20966644,17966644,6.175166
11258,Hard Rain,1998-01-16,1998,70000000,19870567,-50129433,6.363405
11259,Far and Away,1992-05-22,1992,60000000,137783840,77783840,7.472753
11260,Meet Dave,2008-07-08,2008,60000000,50650079,-9349921,11.542926
11281,Halloween II,1981-10-30,1981,2500000,25533818,23033818,13.501144
11282,Harold & Kumar Go to White Castle,2004-05-30,2004,9000000,23936908,14936908,8.344105
11283,Nanny McPhee,2005-10-21,2005,25000000,122489822,97489822,9.806554
11284,Freddy's Dead: The Final Nightmare,1991-09-05,1991,11000000,34872033,23872033,11.560358
11285,Cocoon: The Return,1988-09-13,1988,17500000,25024919,7524919,12.167265
11286,The Cannonball Run,1981-06-19,1981,18000000,72179579,54179579,6.693055
11287,A League of Their Own,1992-07-01,1992,40000000,107458785,67458785,10.852038
11291,The Brothers Lionheart,1977-09-23,1977,0,0,0,2.820184
11293,Paper Moon,1973-05-09,1973,0,0,0,6.471879
11296,Birdy,1984-12-14,1984,12000000,1400000,-10600000,16.243093
11297,Save the Green Planet!,2003-04-04,2003,3000000,0,-3000000,7.378946
11298,The Howling,1981-04-03,1981,1000000,17985893,16985893,6.715512
11299,Cowboy Bebop: The Movie,2001-09-01,2001,0,0,0,11.562163
11300,Something Wild,1986-11-07,1986,0,8362969,8362969,4.737529
11302,Bananas,1971-04-28,1971,2000000,11833696,9833696,4.331819
11303,Deep in the Woods,2000-06-13,2000,0,0,0,3.037224
11304,9/11,2002-03-10,2002,0,0,0,1.48066
11305,Mystery Train,1989-09-06,1989,2800000,0,-2800000,4.814921
11306,Extreme Measures,1996-09-27,1996,38000000,17380126,-20619874,4.990506
11307,The World According to Garp,1982-08-13,1982,17000000,29712172,12712172,5.036929
11308,The Hotel New Hampshire,1984-03-09,1984,7500000,0,-7500000,2.895566
11309,Hardware,1990-09-14,1990,1500000,5728953,4228953,6.026159
11310,City Slickers II: The Legend of Curly's Gold,1994-06-10,1994,0,0,0,8.605703
11313,Hearts in Atlantis,2001-09-07,2001,31000000,24185781,-6814219,6.425321
11314,Koyaanisqatsi,1982-06-06,1982,0,1723872,1723872,8.802715
11315,Dead or Alive,1999-11-27,1999,0,0,0,0.740949
11316,The Tragedy of Macbeth,1971-10-13,1971,0,0,0,4.52244
11317,My Girl 2,1994-02-11,1994,0,0,0,4.911734
11318,The Madness of King George,1994-12-28,1994,0,0,0,4.81307
11319,The Rescuers,1977-06-22,1977,1200000,71215869,70015869,11.32442
11321,Seven Pounds,2008-12-18,2008,55000000,168167691,113167691,21.708267
11322,Public Enemies,2009-07-01,2009,80000000,214104620,134104620,10.364794
11323,The Informant!,2009-09-18,2009,22000000,35424826,13424826,11.698089
11324,Shutter Island,2010-02-18,2010,80000000,294804195,214804195,15.813629
11326,Tommy,1975-03-19,1975,5000000,34251525,29251525,6.335814
11327,Midnight Express,1978-09-12,1978,2300000,35000000,32700000,7.186048
11328,Pusher II: With Blood on My Hands,2004-12-25,2004,0,0,0,5.178284
11329,Runaway Jury,2003-10-09,2003,60000000,80154140,20154140,8.810961
11330,Pusher III: I'm the Angel of Death,2005-08-22,2005,0,0,0,4.206897
11331,The Old Man and the Sea,1958-10-07,1958,0,0,0,1.728104
11332,8 ¬Ω Women,1999-05-22,1999,0,0,0,1.687388
11333,Super Fuzz,1980-09-18,1980,0,0,0,3.951404
11335,Popeye,1980-12-12,1980,20000000,0,-20000000,9.126162
11336,The Dead Zone,1983-10-21,1983,10000000,20766616,10766616,11.194448
11337,Stardust Memories,1980-09-26,1980,10000000,10389003,389003,5.720538
11338,Into the Night,1985-02-15,1985,11400000,6700000,-4700000,5.709878
11340,Banana Joe,1982-03-24,1982,0,0,0,6.100879
11342,Warlock,1989-06-01,1989,7000000,0,-7000000,11.906872
11343,Salem's Lot,1979-11-17,1979,4000000,0,-4000000,9.582814
11344,A Bittersweet Life,2005-03-31,2005,0,0,0,10.237072
11346,Kleinruppin forever,2004-02-08,2004,0,0,0,0.248318
11347,The Lair of the White Worm,1988-09-14,1988,2500000,1189315,-1310685,9.97466
11348,Fragile,2005-10-14,2005,0,0,0,4.641868
11349,Cape Fear,1962-04-12,1962,0,0,0,7.583191
11351,Jeepers Creepers 2,2003-08-08,2003,17000000,63102666,46102666,14.786032
11352,Always,1989-12-22,1989,31000000,74134790,43134790,5.443097
11353,Bowfinger,1999-08-12,1999,55000000,0,-55000000,7.169508
11354,The Upside of Anger,2005-01-23,2005,0,0,0,4.307106
11355,Never Been Kissed,1999-04-09,1999,25000000,84565230,59565230,7.257679
11356,The Odd Couple,1968-02-07,1968,0,44527234,44527234,8.3539
11357,Halloween 4: The Return of Michael Myers,1988-10-21,1988,5000000,17768757,12768757,6.199806
11358,Walking Tall,2004-04-02,2004,56000000,57223890,1223890,10.577565
11359,The Indian in the Cupboard,1995-07-14,1995,45000000,0,-45000000,10.673296
11360,Dumbo,1941-10-22,1941,812000,1600000,788000,14.655879
11361,Halloween 5: The Revenge of Michael Myers,1989-10-12,1989,5000000,11642254,6642254,6.585405
11362,The Count of Monte Cristo,2002-01-23,2002,35000000,75395048,40395048,10.765924
11363,She's the One,1996-08-26,1996,3500000,9482579,5982579,10.827266
11364,Regarding Henry,1991-07-10,1991,0,0,0,6.972737
11365,Wilde,1997-09-01,1997,0,0,0,3.895735
11366,Spiral,2000-02-11,2000,0,0,0,3.379964
11367,Odds and Evens,1978-10-28,1978,0,0,0,0.19213
11368,Blood Simple,1984-09-07,1984,1500000,0,-1500000,8.884
11370,The Musketeer,2001-09-07,2001,40000000,27053815,-12946185,4.260945
11371,The Score,2001-07-13,2001,68000000,71069884,3069884,14.741992
11372,The Eagle Has Landed,1976-12-24,1976,0,0,0,10.982385
11373,Strawberries in the Supermarket,2003-02-06,2003,0,0,0,1.099804
11374,Edtv,1999-03-26,1999,80000000,0,-80000000,7.48939
11375,Hollywood Homicide,2003-06-09,2003,75000000,51142659,-23857341,11.080439
11376,Swimming Pool,2001-10-04,2001,0,0,0,10.437479
11377,House on Haunted Hill,1999-10-29,1999,19000000,40846082,21846082,10.187278
11378,Trafic,1971-04-16,1971,0,0,0,3.037782
11379,The Adventures of Buckaroo Banzai Across the 8th Dimension,1984-08-15,1984,0,0,0,7.778445
11380,Bones,2001-10-24,2001,10000000,7316658,-2683342,6.513545
11381,Tommy Boy,1995-03-31,1995,0,32648673,32648673,11.971318
11382,Bullets Over Broadway,1994-10-14,1994,0,0,0,5.72288
11383,The Living Desert,1953-11-10,1953,0,0,0,0.553225
11384,The Hard Way,1991-03-08,1991,0,65595485,65595485,7.122938
11385,Hatari!,1962-06-19,1962,0,0,0,10.921504
11386,The Crying Game,1992-09-02,1992,3705538,62548947,58843409,7.404329
11387,Lord Jim,1965-02-15,1965,0,0,0,7.1802
11388,Stay Cool,2009-04-23,2009,4500000,0,-4500000,1.672529
11389,The Olsen Gang,1968-10-11,1968,0,0,0,2.393462
11390,The Olsen Gang in Jutland,1971-10-08,1971,0,0,0,0.730663
11391,The Olsen Gang on the Track,1975-09-26,1975,0,0,0,2.056428
11392,The Olsen Gang Sees Red,1976-10-01,1976,0,0,0,1.799557
11393,The Natural,1984-05-11,1984,28000000,47951979,19951979,12.319855
11395,The Santa Clause,1994-11-10,1994,22000000,189833357,167833357,9.665424
11396,The Last Adventure,1967-04-12,1967,0,0,0,2.369561
11397,Not Another Teen Movie,2001-12-07,2001,16000000,66468332,50468332,9.101896
11398,The Art of War,2000-08-23,2000,40000000,30199105,-9800895,9.800232
11399,Look at Me,2004-11-18,2004,0,0,0,1.614455
11400,The New World,2005-12-25,2005,30000000,30536013,536013,7.694502
11401,Metallica: Some Kind of Monster,2004-01-21,2004,0,0,0,3.446751
11402,The Belles of St. Trinian's,1954-09-28,1954,0,0,0,1.176414
11403,The River Why,2010-04-09,2010,0,0,0,1.421703
11404,Driving Lessons,2006-04-30,2006,0,0,0,5.511184
11406,Goldene Zeiten,2006-06-26,2006,0,0,0,0.732605
11411,Superman IV: The Quest for Peace,1987-07-23,1987,17000000,19300000,2300000,7.990679
11412,The Long Kiss Goodnight,1996-10-11,1996,65000000,89456761,24456761,14.482345
11413,Employee of the Month,2004-01-17,2004,0,0,0,8.872053
11414,The Defiant Ones,1958-08-14,1958,0,0,0,3.666979
11415,House,1986-02-28,1986,3000000,0,-3000000,13.208902
11416,The Mission,1986-09-29,1986,24500000,17218023,-7281977,11.241995
11417,The Lift,1983-05-11,1983,350000,0,-350000,1.583504
11418,National Lampoon‚Äôs European Vacation,1985-07-25,1985,0,49364621,49364621,11.457485
11419,Vegas Vacation,1997-02-13,1997,25000000,36400360,11400360,9.304901
11420,The Corporation,2003-09-10,2003,0,4500000,4500000,4.192292
11421,CRAZY,2005-05-27,2005,0,0,0,6.844818
11422,Midway,1976-06-18,1976,0,0,0,10.836557
11423,Memories of Murder,2003-04-24,2003,2800000,0,-2800000,8.511453
11424,High Society,1956-07-17,1956,2000000,0,-2000000,4.534136
11425,"Honey, We Shrunk Ourselves",1997-03-18,1997,7000000,0,-7000000,5.744183
11426,From Here to Eternity,1953-08-28,1953,1650000,30500000,28850000,5.358582
11427,Dead End,2003-01-30,2003,0,0,0,5.327623
11428,Sleepwalkers,1992-04-10,1992,0,30524763,30524763,5.695003
11429,Beyond Re-Animator,2003-04-04,2003,3000000,0,-3000000,3.826178
11430,The Lion King 1¬Ω,2004-02-06,2004,0,0,0,8.931033
11431,Fever Pitch,2005-04-06,2005,30000000,50451307,20451307,6.734065
11439,The Ghost Writer,2010-02-12,2010,45000000,60222298,15222298,6.76482
11440,Hilde,2009-03-11,2009,0,0,0,0.449798
11441,Madly in Love,1981-12-18,1981,0,0,0,3.515801
11442,Halloween: Resurrection,2002-07-01,2002,13000000,37664855,24664855,8.502529
11443,Dead Presidents,1995-10-06,1995,10000000,0,-10000000,9.87957
11444,The Closet,2001-01-17,2001,0,0,0,6.186121
11445,Gypo,2005-08-24,2005,0,0,0,0.48529
11446,Welcome to the Dollhouse,1995-05-24,1995,0,0,0,5.14056
11447,The Son's Room,2001-03-09,2001,0,0,0,7.331867
11448,Mighty Aphrodite,1995-09-13,1995,15000000,6700000,-8300000,15.899134
11449,The Amityville Horror,1979-07-27,1979,0,86432000,86432000,14.00318
11450,Quiz Show,1994-09-16,1994,0,0,0,7.772505
11451,Herbie Fully Loaded,2005-06-22,2005,50000000,66002004,16002004,9.35239
11452,National Lampoon‚Äôs Van Wilder,2002-03-29,2002,5000000,38275483,33275483,7.668576
11453,Deuce Bigalow: European Gigolo,2005-08-06,2005,22000000,22400154,400154,5.341117
11454,Manhunter,1986-08-14,1986,15000000,8620929,-6379071,0.338943
11455,Up in Smoke,1978-01-01,1978,0,41590893,41590893,7.194364
11456,Domestic Disturbance,2001-10-30,2001,75000000,54249294,-20750706,6.353996
11457,Life as a House,2001-10-25,2001,18000000,0,-18000000,4.145598
11458,People I Know,2002-11-21,2002,20000000,0,-20000000,5.757895
11459,Sky High,2005-07-29,2005,35000000,86369815,51369815,8.061423
11460,Red Eye,2005-08-04,2005,26000000,57891803,31891803,6.336927
11462,Suspicion,1941-11-14,1941,1103000,4500000,3397000,5.660476
11463,Battle of Britain,1969-09-15,1969,12000000,0,-12000000,4.822357
11465,Great Balls of Fire!,1989-06-30,1989,0,0,0,3.602521
11466,Slim Susie,2003-10-03,2003,0,0,0,1.875525
11467,America's Sweethearts,2001-07-17,2001,0,0,0,6.468538
11468,Salton Sea,2002-01-01,2002,18000000,676698,-17323302,12.106615
11469,Black Knight,2001-11-21,2001,0,0,0,9.37044
11470,Jason X,2001-07-24,2001,11000000,16951798,5951798,7.793873
11471,A Better Tomorrow,1986-08-02,1986,0,4469460,4469460,9.488593
11472,Nine Months,1995-07-12,1995,0,69660733,69660733,8.482834
11474,The Warriors,1979-02-08,1979,4000000,22490039,18490039,11.457298
11475,Leningrad Cowboys Go America,1989-03-24,1989,0,0,0,6.590913
11476,As Far As My Feet Will Carry Me,2001-12-12,2001,0,0,0,1.893561
11477,Common Wealth,2000-09-29,2000,0,0,0,3.693966
11478,The Skulls,2000-03-31,2000,15000000,35007180,20007180,11.363754
11479,"Little Indian, Big City",1994-12-14,1994,0,0,0,4.728163
11481,Repulsion,1965-06-01,1965,300000,0,-300000,6.825852
11482,The Tenant,1976-05-26,1976,0,0,0,6.583984
11483,Pirates,1986-05-08,1986,40000000,1641825,-38358175,3.916952
11484,Rollerball,1975-06-25,1975,0,30000000,30000000,6.680938
11485,Take the Money and Run,1969-08-18,1969,1500000,0,-1500000,9.15948
11489,Rosetta,1999-05-23,1999,0,266665,266665,2.730118
11490,The Child,2005-07-10,2005,0,5507396,5507396,5.462645
11492,Blind Shaft,2003-02-12,2003,0,0,0,1.337977
11494,Wilderness,2006-08-11,2006,0,0,0,2.891777
11495,Firestarter,1984-05-11,1984,15000000,17080167,2080167,7.048087
11496,They Call Me Renegade,1987-10-30,1987,0,0,0,2.554632
11497,All Dogs Go to Heaven,1989-11-17,1989,13800000,27100027,13300027,7.068389
11498,Dead Again,1991-08-23,1991,0,38016380,38016380,9.696201
11499,Frost/Nixon,2008-10-15,2008,0,0,0,11.641771
11502,Knife in the Water,1962-03-09,1962,0,0,0,9.474616
11503,The Serpent and the Rainbow,1988-02-05,1988,7000000,19595031,12595031,7.791952
11504,Suburban Commando,1991-10-04,1991,0,0,0,4.409121
11506,The Silence,1963-09-23,1963,0,0,0,3.822314
11507,Body Double,1984-10-25,1984,10000000,8801940,-1198060,9.836894
11508,Addams Family Reunion,1998-09-22,1998,0,0,0,7.996398
11509,Silverado,1985-07-10,1985,26000000,0,-26000000,8.748084
11510,Repossessed,1990-09-14,1990,0,1382462,1382462,11.966566
11511,Kazaam,1996-07-17,1996,20000000,0,-20000000,8.962892
11512,Hunter Will Get You,1976-02-01,1976,0,0,0,1.375007
11513,Cobra Verde,1987-12-03,1987,0,0,0,6.115623
11515,Goya's Ghosts,2006-11-08,2006,50000000,9448082,-40551918,5.91265
11516,Winged Migration,2001-12-12,2001,35866397,20217080,-15649317,3.68993
11517,Money Train,1995-11-21,1995,60000000,35431113,-24568887,7.337906
11518,Love Stories,2000-10-27,2000,0,0,0,5.793932
11519,1941,1979-12-13,1979,35000000,31755742,-3244258,7.812379
11520,Grumpy Old Men,1993-12-25,1993,0,0,0,7.529482
11521,Little Man Tate,1991-09-06,1991,0,0,0,4.294078
11522,Pretty in Pink,1986-02-28,1986,0,40471663,40471663,8.568378
11523,View from the Top,2003-03-21,2003,0,15614000,15614000,5.506354
11524,Thief,1981-03-27,1981,0,4300000,4300000,10.480229
11525,Lawnmower Man 2: Beyond Cyberspace,1996-01-12,1996,0,2409225,2409225,2.49535
11526,Bandits,1997-07-02,1997,0,0,0,0.531412
11527,Excalibur,1981-04-10,1981,11000000,34967437,23967437,8.800455
11528,The Sandlot,1993-04-07,1993,0,32416586,32416586,10.392243
11529,Sweet Home Alabama,2002-09-26,2002,30000000,180622424,150622424,8.587129
11530,The Discord,1978-03-16,1978,0,0,0,3.267557
11531,Book of Shadows: Blair Witch 2,2000-10-27,2000,0,0,0,4.792013
11532,The Emerald Forest,1985-06-26,1985,0,24467000,24467000,19.520733
11533,Jason and the Argonauts,1963-06-19,1963,1000000,0,-1000000,6.222085
11534,Tropical Malady,2005-04-29,2005,0,0,0,1.42333
11535,Rollerball,2002-02-08,2002,0,0,0,9.347077
11536,The Misfits,1961-01-01,1961,4000000,8200000,4200000,5.317544
11537,Snake in the Eagle's Shadow,1978-03-01,1978,0,0,0,10.752763
11540,Adventures of Arsene Lupin,2004-09-17,2004,23000000,0,-23000000,5.665798
11541,The Year of Living Dangerously,1982-12-17,1982,6000000,1317657,-4682343,13.293569
11542,Altered States,1980-12-25,1980,15000000,19853892,4853892,10.603299
11543,Kingpin,1996-07-04,1996,27000000,25023434,-1976566,11.633347
11544,Lilo & Stitch,2002-06-21,2002,80000000,145771527,65771527,18.469238
11545,Rushmore,1998-09-17,1998,9000000,17096053,8096053,5.997054
11546,Police Academy: Mission to Moscow,1994-06-09,1994,0,126247,126247,6.168241
11547,Cabin Fever,2003-08-15,2003,1500000,30553394,29053394,6.466688
11548,Batteries not Included,1987-12-18,1987,0,65088797,65088797,11.492174
11549,Invasion of the Body Snatchers,1956-02-05,1956,417000,0,-417000,6.135431
11551,Small Soldiers,1998-07-10,1998,40000000,54682547,14682547,10.03936
11553,Millennium Mambo,2001-10-31,2001,0,0,0,3.039627
11554,Three Times,2005-05-20,2005,0,0,0,1.104479
11556,Nicotina,2003-09-08,2003,0,0,0,5.003217
11557,St. Elmo's Fire,1985-06-20,1985,0,37803872,37803872,9.116245
11558,Silver Streak,1976-12-03,1976,6500000,51079064,44579064,8.254209
11559,Tideland,2005-09-09,2005,12000000,566611,-11433389,6.796465
11560,High Crimes,2002-04-03,2002,42000000,63781810,21781810,8.371005
11561,Sleeper,1973-12-17,1973,2000000,18344729,16344729,6.048904
11562,Crimes and Misdemeanors,1989-10-13,1989,19000000,18254702,-745298,6.645295
11563,The Young Master,1980-02-09,1980,0,0,0,3.475332
11564,Class of 1984,1982-08-20,1982,4300000,0,-4300000,4.821182
11565,Big Momma's House 2,2006-01-26,2006,40000000,138259062,98259062,7.622875
11566,Dave,1993-05-07,1993,0,63000000,63000000,13.696394
11567,The Wedding Party,2005-04-21,2005,0,0,0,0.242035
11568,Blues Brothers 2000,1998-02-05,1998,28000000,14051384,-13948616,13.162168
11569,Hellraiser III: Hell on Earth,1992-09-11,1992,5000000,12534961,7534961,6.546551
11570,The Crimson Pirate,1952-09-27,1952,1850000,0,-1850000,2.255459
11571,Journey to the Center of the Earth,1959-12-14,1959,0,10000000,10000000,10.38937
11572,Kaena: The Prophecy,2003-01-02,2003,0,8500,8500,1.369728
11573,Inspector Clouseau,1968-07-19,1968,0,0,0,3.847641
11574,Support Your Local Sheriff,1969-03-26,1969,0,0,0,2.167511
11575,The Great Race,1965-07-01,1965,12000000,25333333,13333333,4.473327
11576,"It's a Mad, Mad, Mad, Mad World",1963-11-07,1963,9400000,60000000,50600000,13.266545
11577,Pat Garrett & Billy the Kid,1973-05-23,1973,4638783,11000000,6361217,5.781236
11578,The Return of Don Camillo,1953-06-05,1953,0,0,0,4.454569
11583,The First Great Train Robbery,1979-01-25,1979,6000000,0,-6000000,5.393807
11584,Roxanne,1987-06-19,1987,0,40050884,40050884,11.394307
11586,Exorcist II: The Heretic,1977-06-17,1977,14000000,30749142,16749142,8.266984
11587,The Exorcist III,1990-08-17,1990,0,39024251,39024251,5.861032
11588,The I Inside,2004-01-15,2004,8800000,0,-8800000,3.561706
11589,Kelly's Heroes,1970-06-22,1970,4000000,5200000,1200000,8.418662
11590,Slap Shot,1977-02-25,1977,0,28000000,28000000,9.282077
11591,The Man with Two Brains,1983-06-10,1983,10100000,0,-10100000,12.157229
11592,Serial Mom,1994-04-13,1994,13000000,7820688,-5179312,5.305311
11593,Nobody's Fool,1994-12-23,1994,0,0,0,2.891269
11594,The Hunchback of Notre Dame,1956-12-19,1956,0,0,0,2.646421
11595,Another 48 Hrs.,1990-06-08,1990,38000000,153518974,115518974,6.938921
11596,New Nightmare,1994-10-13,1994,14000000,18090181,4090181,9.860522
11597,Toys,1992-12-18,1992,0,23278931,23278931,5.923774
11598,The Kentucky Fried Movie,1977-08-10,1977,600000,0,-600000,9.133988
11599,Suzhou River,2000-01-29,2000,0,0,0,1.44948
11600,Redacted,2007-01-01,2007,5000000,782102,-4217898,3.494388
11601,Stir of Echoes,1999-09-10,1999,12000000,21133087,9133087,5.875606
11602,Through a Glass Darkly,1961-10-16,1961,0,0,0,4.955553
11603,Rear Window,1998-11-22,1998,0,0,0,9.625258
11604,Anthony Zimmer,2005-04-01,2005,0,0,0,4.10916
11605,The List of Adrian Messenger,1963-05-29,1963,0,0,0,2.216599
11606,Last Life in the Universe,2003-08-03,2003,0,0,0,6.700563
11607,DeepStar Six,1989-01-13,1989,0,8143225,8143225,3.842769
11609,Yellowbeard,1983-06-24,1983,0,4300000,4300000,9.290415
11610,"Play It Again, Sam",1972-05-04,1972,0,0,0,5.526401
11612,Even Angels Eat Beans,1973-03-22,1973,0,0,0,6.634884
11613,Thieves and Robbers,1983-02-11,1983,0,0,0,1.998473
11614,Bomber,1982-08-05,1982,0,0,0,3.366866
11615,The Life of David Gale,2003-02-21,2003,50000000,38955598,-11044402,9.930326
11616,Go for It,1983-01-01,1983,0,0,0,5.176725
11617,Rio Grande,1950-11-15,1950,0,0,0,8.40322
11618,The Haunting,1999-07-23,1999,80000000,91188905,11188905,8.967638
11619,Flushed Away,2006-10-22,2006,149000000,64459316,-84540684,9.922577
11620,Quo Vadis,1951-11-08,1951,8250000,30000000,21750000,11.840985
11621,Porco Rosso,1992-07-18,1992,0,0,0,8.08304
11622,Blast from the Past,1999-02-12,1999,35000000,40263020,5263020,8.355977
11624,Everything You Always Wanted to Know About Sex *But Were Afraid to Ask,1972-08-06,1972,2000000,18016290,16016290,5.378481
11625,Asterix and the Big Fight,1989-10-03,1989,0,0,0,6.706328
11626,Pippi on the Run,1970-11-13,1970,0,0,0,3.017903
11627,M√ºnchhausen,1943-03-05,1943,0,0,0,1.766023
11628,Solino,2002-09-23,2002,0,0,0,7.132709
11629,Legion of the Dead,2001-10-25,2001,0,0,0,0.752094
11630,Three Men and a Little Lady,1990-11-21,1990,0,0,0,5.062112
11631,Mamma Mia!,2008-07-03,2008,52000000,609841637,557841637,10.534437
11632,Vanity Fair,2004-09-01,2004,23000000,16123851,-6876149,6.614456
11633,Appleseed,2004-04-17,2004,10000000,1461989,-8538011,8.278525
11634,Show Me Love,1998-10-23,1998,0,0,0,10.58342
11635,Old School,2003-02-21,2003,24000000,87055349,63055349,16.195894
11636,New Police Story,2004-09-23,2004,0,0,0,14.177645
11637,Are We There Yet?,2005-01-20,2005,32000000,97918663,65918663,9.756822
11638,Guess Who,2005-03-25,2005,35000000,68915888,33915888,6.71898
11639,The Dark Crystal,1982-12-17,1982,15000000,40577001,25577001,13.524001
11643,"If It's Tuesday, This Must Be Belgium",1969-04-24,1969,0,0,0,6.315524
11644,Blow Out,1981-07-24,1981,18000000,12000000,-6000000,7.536295
11645,Ran,1985-06-01,1985,11500000,4069653,-7430347,12.250232
11646,Gallipoli,1981-08-13,1981,3000000,11740000,8740000,7.44658
11647,Infernal Affairs II,2003-10-01,2003,0,0,0,6.505146
11648,Must Love Dogs,2005-07-21,2005,30000000,58405313,28405313,9.378926
11649,Masters of the Universe,1987-08-07,1987,22000000,17336370,-4663630,7.106954
11650,Five Fingers,2006-05-01,2006,0,0,0,5.070446
11651,Hui Buh,2006-07-20,2006,10000000,0,-10000000,3.122516
11652,Invincible,2006-08-25,2006,0,57806952,57806952,9.794881
11653,The Myth,2005-05-11,2005,0,0,0,9.161849
11654,The Hunger,1983-04-29,1983,0,5979292,5979292,13.235179
11655,Cronos,1993-09-12,1993,0,0,0,5.513024
11656,The Virgin Spring,1960-02-08,1960,0,0,0,10.353794
11657,Le Cercle Rouge,1970-10-19,1970,0,0,0,6.616907
11658,Tae Guk Gi: The Brotherhood of War,2004-02-05,2004,0,15,15,9.140411
11659,The Best of Youth,2003-05-19,2003,0,0,0,6.040001
11660,Following,1998-09-12,1998,6000,48482,42482,5.283661
11661,Joyeux No√´l,2005-11-09,2005,22000000,17709155,-4290845,7.846226
11662,Casshern,2004-04-24,2004,6000000,1530216,-4469784,4.664474
11663,The Commitments,1991-08-14,1991,0,0,0,7.442056
11664,"Die Bademeister ‚Äì Weiber, saufen, Leben retten",1999-06-18,1999,0,0,0,0.59691
11665,Get Smart,2008-06-19,2008,80000000,230685453,150685453,11.35779
11667,Street Fighter,1994-12-22,1994,35000000,99423521,64423521,13.58449
11671,Elegy,2008-08-08,2008,13000000,14894347,1894347,6.829658
11673,Cyrano de Bergerac,1990-03-28,1990,0,0,0,5.0399
11674,101 Dalmatians,1996-11-17,1996,54000000,320689294,266689294,11.470748
11675,Halloween: H20,1998-08-05,1998,17000000,55041738,38041738,8.619068
11676,Nothing to Lose,1997-07-18,1997,25000000,0,-25000000,6.287242
11677,Stadtgespr√§ch,1995-10-26,1995,0,0,0,0.731105
11678,Vertical Limit,2000-12-08,2000,75000000,215663859,140663859,6.548229
11679,xXx: State of the Union,2005-04-27,2005,60000000,71073932,11073932,19.144611
11680,The Miser,1980-03-05,1980,0,0,0,4.662353
11681,Two Missionaries,1974-12-21,1974,0,0,0,3.088418
11683,Land of the Dead,2005-06-24,2005,15000000,46770602,31770602,9.478117
11684,La Cage aux folles II,1980-12-10,1980,0,6950125,6950125,1.540986
11686,Love and Death,1975-06-10,1975,3000000,20173742,17173742,5.165666
11687,The Visitors,1993-01-27,1993,0,0,0,7.326169
11688,The Emperor's New Groove,2000-12-09,2000,100000000,169327687,69327687,12.297375
11689,Crime Busters,1977-04-01,1977,0,0,0,9.351042
11690,Bloodsport,1988-02-26,1988,1500000,11806119,10306119,8.822276
11692,The Adventures of Pluto Nash,2002-08-15,2002,100000000,7103973,-92896027,8.903754
11693,Big Man Japan,2007-05-19,2007,0,0,0,1.411851
11694,Cat Ballou,1965-06-24,1965,0,20666667,20666667,5.45812
11697,The Man Who Shot Liberty Valance,1962-04-22,1962,3200000,8000000,4800000,6.641827
11698,Stroszek,1977-01-12,1977,0,0,0,3.511224
11699,The Bad Lieutenant: Port of Call - New Orleans,2009-09-11,2009,25000000,10589102,-14410898,8.405395
11700,Smiles of a Summer Night,1955-12-26,1955,0,0,0,4.354106
11702,The Replacement Killers,1998-02-06,1998,30000000,19204929,-10795071,9.384887
11703,Kiss of the Spider Woman,1985-07-26,1985,0,0,0,3.570377
11704,The Secret of NIMH,1982-06-17,1982,7000000,14665733,7665733,10.812275
11705,Red Road,2006-05-20,2006,0,1128345,1128345,11.054764
11706,War and Peace,1956-08-21,1956,6000000,12500000,6500000,3.666277
11707,Tightrope,1984-08-17,1984,0,48143579,48143579,8.991304
11708,Chitty Chitty Bang Bang,1968-12-16,1968,10000000,0,-10000000,13.852147
11710,The Enigma of Kaspar Hauser,1974-11-01,1974,0,0,0,7.265781
11712,Sanjuro,1962-01-01,1962,0,0,0,11.293611
11713,Fist of Fury,1972-03-22,1972,100000,0,-100000,9.523138
11718,Who's Harry Crumb?,1989-02-03,1989,0,0,0,7.102963
11719,One Foot in Heaven,1991-03-15,1991,0,0,0,1.085264
11752,Cheeky Girls,2008-07-17,2008,0,0,0,1.231199
11761,Peacock,2010-04-20,2010,0,0,0,6.013545
11763,Bunty Aur Babli,2005-05-27,2005,0,0,0,1.27801
11765,The Riddle of the Sands,1979-10-02,1979,0,0,0,1.20008
11767,Cabo Blanco,1980-03-13,1980,0,0,0,1.568954
11770,Shaolin Soccer,2001-07-12,2001,0,42776760,42776760,8.461631
11772,The Haunting,1963-09-18,1963,0,0,0,10.461285
11773,Village of the Damned,1960-11-05,1960,200000,0,-200000,6.39955
11774,Lemony Snicket's A Series of Unfortunate Events,2004-12-16,2004,140000000,209073645,69073645,12.817945
11775,Intolerable Cruelty,2003-09-02,2003,60000000,119940815,59940815,13.469862
11777,I.Q.,1994-12-24,1994,25000000,0,-25000000,5.146352
11778,The Deer Hunter,1978-12-08,1978,15000000,50000000,35000000,7.729445
11779,Buena Vista Social Club,1999-02-17,1999,0,0,0,11.619416
11780,Rob Roy,1995-04-13,1995,28000000,31596911,3596911,10.193549
11782,Hard Boiled,1992-04-16,1992,4500000,0,-4500000,10.184313
11787,Harvey,1950-10-13,1950,0,0,0,5.306185
11788,Elizabeth I,2005-09-29,2005,0,0,0,2.179351
11790,Peter's Friends,1992-09-18,1992,0,0,0,2.540085
11791,The Hound of the Baskervilles,1959-05-04,1959,0,0,0,4.789131
11795,Guyver: Dark Hero,1994-04-20,1994,0,0,0,2.037617
11796,The Hairdresser's Husband,1990-10-03,1990,0,0,0,4.050762
11797,Fright Night,1985-08-02,1985,9000000,24922237,15922237,7.472509
11798,This Is England,2006-09-12,2006,2380000,8176544,5796544,2.514638
11799,Viva Maria!,1965-11-22,1965,0,0,0,4.753956
11800,Naked in New York,1993-11-10,1993,0,0,0,0.449733
11801,Angel,2007-02-17,2007,15000000,0,-15000000,3.599876
11802,Space Chimps,2008-07-17,2008,37000000,63800345,26800345,6.212702
11804,White Noise,2005-01-07,2005,10000000,91196419,81196419,6.143324
11806,Beethoven,1992-04-03,1992,0,147214049,147214049,9.322717
11807,Jab We Met,2007-10-26,2007,2300000,4600000,2300000,3.959411
11808,U.S. Marshals,1998-03-06,1998,60000000,102367405,42367405,8.462364
11811,Leprechaun,1993-01-08,1993,900000,8556940,7656940,9.096254
11812,The Sweetest Thing,2002-04-12,2002,43000000,68696770,25696770,8.889064
11813,Il soldato di ventura,1976-02-19,1976,0,0,0,0.838344
11814,Weird Science,1985-08-01,1985,0,38934048,38934048,11.104542
11815,The Fly,1958-07-16,1958,700000,3000000,2300000,8.407369
11816,On Golden Pond,1981-12-04,1981,0,19255967,19255967,12.252186
11817,Bulletproof Monk,2003-03-28,2003,52000000,0,-52000000,7.963481
11820,Mona Lisa Smile,2003-12-19,2003,65000000,0,-65000000,10.527191
11821,Doc Hollywood,1991-08-02,1991,0,0,0,10.068517
11822,Nekromantik,1987-05-27,1987,0,0,0,3.220487
11823,Wimbledon,2004-09-13,2004,31000000,41512007,10512007,14.224013
11824,Teen Wolf,1985-08-23,1985,0,0,0,10.940057
11825,Police Academy 5: Assignment Miami Beach,1988-03-17,1988,0,19510371,19510371,10.278957
11826,Sexy Beast,2000-09-13,2000,5000000,0,-5000000,5.819673
11827,Heavy Metal,1981-08-07,1981,9300000,0,-9300000,7.640073
11828,Erik the Viking,1989-09-22,1989,0,0,0,3.44427
11830,Tampopo,1985-11-23,1985,0,0,0,4.459095
11831,Amistad,1997-12-03,1997,36000000,74000000,38000000,2.263584
11832,Babette's Feast,1987-08-28,1987,0,4398938,4398938,10.139954
11834,Jabberwocky,1977-03-28,1977,0,0,0,3.308729
11835,Death Sentence,2007-08-31,2007,20000000,16974459,-3025541,6.612175
11836,The SpongeBob SquarePants Movie,2004-11-14,2004,30000000,140161792,110161792,11.213712
11837,Watership Down,1978-10-14,1978,1000000,3713768,2713768,5.602126
11838,Ju-on: The Grudge,2002-10-18,2002,3500000,0,-3500000,7.614692
11839,The Court Jester,1955-12-24,1955,4000000,0,-4000000,3.940121
11841,The 36th Chamber of Shaolin,1978-02-02,1978,0,0,0,7.261696
11842,Red Sun,1971-09-15,1971,0,0,0,5.660214
11843,The Return of the Pink Panther,1975-05-21,1975,5000000,41833347,36833347,6.501177
11844,The Van,1996-05-11,1996,0,0,0,1.13412
11845,Intimacy,2001-01-20,2001,0,0,0,4.472873
11846,Father of the Bride,1991-12-20,1991,0,89325780,89325780,5.490622
11847,The Accidental Spy,2001-01-18,2001,25697387,3849941,-21847446,3.136813
11848,Animal Farm,1954-12-29,1954,0,0,0,5.040993
11849,Dungeons & Dragons,2000-12-08,2000,35000000,15185241,-19814759,4.884311
11850,Invasion of the Body Snatchers,1978-12-19,1978,3500000,24046533,20546533,5.219641
11851,The Presidio,1988-06-10,1988,0,20324096,20324096,3.768935
11852,The Hot Chick,2002-12-13,2002,0,35081550,35081550,8.734328
11853,Bad Girls,1994-04-22,1994,0,15240435,15240435,14.644772
11854,Kuch Kuch Hota Hai,1998-10-16,1998,1530000,15306000,13776000,6.441119
11855,Pecker,1998-09-16,1998,0,0,0,2.348919
11856,Air America,1990-08-10,1990,0,33461269,33461269,10.274376
11857,Orange County,2002-01-10,2002,0,0,0,4.582365
11858,Renaissance Man,1994-06-03,1994,40000000,24332324,-15667676,4.985157
11859,Fair Game,1995-11-03,1995,50000000,11534477,-38465523,5.912223
11860,Sabrina,1995-12-15,1995,58000000,0,-58000000,6.677277
11861,How To Make An American Quilt,1995-10-06,1995,10000000,23574130,13574130,4.485958
11862,Father of the Bride Part II,1995-02-10,1995,0,76578911,76578911,8.387519
11863,Jade,1995-10-13,1995,50000000,9851610,-40148390,11.418917
11864,Enemy Mine,1985-12-12,1985,40000000,12303411,-27696589,9.802889
11866,Flight of the Phoenix,2004-12-17,2004,45000000,21009180,-23990820,15.434731
11867,Barb Wire,1996-05-02,1996,0,3793614,3793614,5.877599
11868,Horror of Dracula,1958-05-08,1958,226188,0,-226188,8.355326
11869,"Quax, der Bruchpilot",1941-12-16,1941,0,0,0,0.190565
11870,Big Fat Liar,2002-02-08,2002,15000000,52970014,37970014,4.643981
11873,The Color of Money,1986-10-07,1986,13800000,52293982,38493982,11.613655
11874,Ace High,1968-10-02,1968,0,0,0,3.785942
11876,The Horseman on the Roof,1995-09-20,1995,35000000,15000000,-20000000,1.690768
11878,Yojimbo,1961-04-25,1961,0,0,0,10.313688
11879,Near Dark,1987-10-02,1987,5000000,0,-5000000,7.906537
11880,Dog Soldiers,2002-05-10,2002,0,0,0,10.073784
11881,Miracle on 34th Street,1947-05-02,1947,0,0,0,5.114032
11884,The Last Starfighter,1984-07-13,1984,15000000,28733290,13733290,5.984133
11886,Robin Hood,1973-11-08,1973,15000000,32056467,17056467,11.179855
11887,High School Musical 3: Senior Year,2008-10-22,2008,0,0,0,7.343504
11888,Snow Dogs,2002-01-18,2002,33000000,0,-33000000,13.470227
11889,Iris,2001-12-14,2001,0,0,0,2.964908
11890,Oscar,1991-04-26,1991,35000000,23562716,-11437284,6.137796
11891,Kung Pow: Enter the Fist,2002-01-25,2002,0,0,0,5.305679
11892,Murder by Numbers,2002-04-19,2002,50000000,56714147,6714147,9.645801
11893,Runaway Train,1985-11-15,1985,9000000,7936012,-1063988,15.236541
11894,Curly Sue,1991-10-24,1991,0,0,0,8.965053
11895,Police Academy 6: City Under Siege,1989-03-09,1989,0,11567217,11567217,5.612379
11896,Throw Momma from the Train,1987-12-11,1987,14000000,57915972,43915972,6.573364
11897,How the West Was Won,1962-11-01,1962,15000000,50000000,35000000,7.281721
11898,Kind Hearts and Coronets,1949-01-01,1949,0,0,0,9.753718
11899,The Muppets Take Manhattan,1984-07-13,1984,8000000,0,-8000000,5.89335
11900,Even Dwarfs Started Small,1970-09-16,1970,200000,0,-200000,0.854963
11901,High Plains Drifter,1973-04-19,1973,5500000,15700000,10200000,9.91087
11902,Underground,1995-04-11,1995,14000000,0,-14000000,14.587894
11904,Young Sherlock Holmes,1985-12-04,1985,18000000,0,-18000000,5.203452
11905,The Company of Wolves,1984-09-15,1984,2000000,0,-2000000,3.399621
11906,Suspiria,1977-02-01,1977,0,0,0,10.050219
11907,Nobody Loves Me,1994-11-07,1994,0,0,0,1.015068
11908,Hatchet,2006-04-27,2006,0,0,0,8.956081
11909,Bullet in the Head,1990-08-17,1990,3500000,0,-3500000,3.990633
11910,Hogfather,2006-12-18,2006,9364800,0,-9364800,4.167059
11911,Mephisto,1981-04-29,1981,144,0,-144,5.663598
11912,The Tattoo,1968-08-17,1968,0,0,0,1.733315
11913,The Gendarme Takes Off,1970-10-28,1970,0,0,0,4.337562
11914,Perched on a Tree,1971-04-12,1971,0,0,0,1.219877
11915,The Gendarme and the Gendarmettes,1982-10-03,1982,0,0,0,4.724443
11916,Two Mules for Sister Sara,1970-06-14,1970,0,5050000,5050000,10.072738
11917,Saw V,2008-10-23,2008,10800000,113857533,103057533,10.165499
11918,Superhero Movie,2008-03-27,2008,35000000,25871834,-9128166,7.876483
11925,Naked,2000-12-15,2000,0,0,0,0.436643
11927,Manhunt,2008-01-04,2008,0,0,0,2.008136
11928,Tetro,2009-06-11,2009,15000000,113221,-14886779,2.90333
11929,Dolores Claiborne,1995-03-24,1995,0,0,0,5.8025
11930,A2 Racer,2004-02-19,2004,7200000,0,-7200000,2.686788
11931,In Her Shoes,2005-10-07,2005,0,83073883,83073883,8.63229
11932,Bride of Chucky,1998-10-16,1998,25000000,50671850,25671850,13.018491
11933,Nothing but Trouble,1991-02-14,1991,40000000,8479793,-31520207,10.39662
11934,The Hudsucker Proxy,1994-03-11,1994,30000000,0,-30000000,7.550545
11935,Capricorn One,1977-12-10,1977,5000000,0,-5000000,10.719499
11936,City of Women,1980-03-28,1980,0,0,0,2.146237
11937,The Gods Must Be Crazy II,1989-07-01,1989,0,0,0,4.993561
11938,Clockwise,1986-03-01,1986,0,0,0,10.12489
11939,A Day at the Races,1937-06-11,1937,0,0,0,4.815005
11940,Sinbad and the Eye of the Tiger,1977-07-15,1977,3500000,16000000,12500000,3.502655
11942,Bring Me the Head of Alfredo Garcia,1974-08-14,1974,1500000,0,-1500000,4.139461
11943,Jeremiah Johnson,1972-09-10,1972,0,0,0,4.711031
11944,Joan of Arc,1999-05-16,1999,20000000,0,-20000000,2.045494
11945,Emil in Lonneberga,1971-12-04,1971,0,0,0,3.459098
11946,New Mischief by Emil,1972-10-21,1972,0,0,0,1.31915
11948,"Merry Christmas, Mr. Lawrence",1983-05-23,1983,0,0,0,4.455913
11949,Monty Python Live at the Hollywood Bowl,1982-06-25,1982,0,0,0,4.160035
11950,Cannonball Run II,1984-06-29,1984,0,28078073,28078073,5.305197
11951,Vanishing Point,1971-01-15,1971,1300000,72266306,70966306,5.184013
11953,Kagemusha,1980-04-26,1980,0,0,0,6.206807
11954,Lifeforce,1985-06-20,1985,25000000,0,-25000000,13.561368
11955,Iron Eagle II,1988-11-11,1988,0,0,0,2.331052
11956,When the Cat's Away,1996-04-03,1996,0,0,0,0.834917
11958,"Not For, or Against (Quite the Contrary)",2003-03-05,2003,10000000,0,-10000000,2.725099
11959,UHF,1989-07-21,1989,5000000,0,-5000000,5.039273
11960,After This Our Exile,2006-10-15,2006,0,0,0,1.349667
11962,Joe's Apartment,1996-07-26,1996,13000000,4619014,-8380986,9.490858
11963,Three Days of the Condor,1975-09-24,1975,0,27476252,27476252,14.364447
11966,Short Circuit 2,1988-07-06,1988,0,21630088,21630088,7.34677
11967,Young Guns,1988-08-12,1988,13000000,44726644,31726644,9.905174
11968,Into the Blue,2005-09-30,2005,50000000,44434439,-5565561,10.022102
11969,Tombstone,1993-12-25,1993,25000000,56505065,31505065,11.338194
11970,Hercules,1997-06-26,1997,85000000,252712101,167712101,14.048694
11971,Much Ado About Nothing,1993-05-07,1993,8000000,0,-8000000,8.62724
11972,Don Camillo,1952-03-28,1952,0,0,0,2.865776
11973,Thirteen Days,2000-12-24,2000,80000000,34566746,-45433254,10.204559
11974,The 'Burbs,1989-02-17,1989,18000000,36602000,18602000,7.889227
11975,The Rainmaker,1997-11-18,1997,40000000,45916769,5916769,6.683398
11976,Legend,1985-07-19,1985,25000000,15502112,-9497888,10.932786
11977,Caddyshack,1980-07-25,1980,6000000,39846344,33846344,10.451986
11978,Men of Honor,2000-09-13,2000,32000000,48814909,16814909,7.177649
11979,Queen of the Damned,2002-02-10,2002,35000000,45479110,10479110,8.436243
11980,The Prophecy,1995-09-01,1995,8,16,8,10.187623
11982,Look Who's Talking Now!,1993-11-05,1993,0,0,0,9.016076
11983,Proof of Life,2000-12-08,2000,65000000,0,-65000000,9.508691
11985,Vive L'Amour,1994-09-02,1994,0,0,0,1.404588
11986,Betty Blue,1986-04-09,1986,0,2003822,2003822,6.493744
12076,Elsk meg i morgen,2005-09-23,2005,0,0,0,0.466995
12078,Larks on a String,1990-01-01,1990,0,0,0,0.000431
12079,Spun,2002-06-01,2002,2000000,0,-2000000,7.115355
12085,Mad Money,2008-01-17,2008,0,0,0,5.297017
12086,Machuca,2004-02-24,2004,1500000,0,-1500000,1.570908
12088,Fortress,1992-09-30,1992,8000000,6739141,-1260859,5.970749
12089,The Tall Blond Man with One Black Shoe,1972-12-06,1972,0,0,0,3.985387
12090,Just Married,2003-01-09,2003,18000000,101564935,83564935,6.001152
12092,Alice in Wonderland,1951-07-03,1951,3000000,572000000,569000000,16.488937
12093,Lilya 4-ever,2002-08-23,2002,0,0,0,5.457863
12094,Jackass Number Two,2006-09-22,2006,11000000,72778712,61778712,7.915368
12095,From Dusk Till Dawn 2: Texas Blood Money,1999-03-16,1999,5000000,0,-5000000,13.778043
12096,The Pink Panther,2006-01-18,2006,0,0,0,10.520501
12097,Pippi Longstocking,1969-05-09,1969,0,0,0,3.162375
12100,Windtalkers,2002-06-14,2002,115000000,77628265,-37371735,7.455875
12101,Soylent Green,1973-04-19,1973,0,3600000,3600000,7.630456
12102,Kramer vs. Kramer,1979-12-18,1979,8000000,106260000,98260000,9.741644
12103,Don't Say a Word,2001-09-28,2001,50000000,100020092,50020092,6.824871
12104,Pink Floyd: The Wall,1982-07-14,1982,12000000,22244207,10244207,6.773407
12105,Yellow Submarine,1968-07-17,1968,0,0,0,14.950187
12106,The Quick and the Dead,1995-02-09,1995,32000000,18552460,-13447540,7.54701
12107,Nutty Professor II: The Klumps,2000-07-27,2000,84000000,123307945,39307945,6.671316
12109,It's All Gone Pete Tong,2004-09-12,2004,2000000,120620,-1879380,2.812182
12110,Dracula: Dead and Loving It,1995-12-22,1995,0,0,0,5.430331
12112,He Loves Me... He Loves Me Not,2002-03-27,2002,0,5126264,5126264,4.421311
12113,Body of Lies,2008-10-10,2008,70000000,113280098,43280098,12.886125
12115,"Love, Money, Love",2000-08-08,2000,0,0,0,0.173764
12116,Love in the Afternoon,1972-08-21,1972,0,0,0,1.474925
12117,Instinct,1999-06-04,1999,80000000,0,-80000000,6.236116
12118,Police Academy 3: Back in Training,1986-03-20,1986,0,43579163,43579163,7.10005
12120,My Stepmother is an Alien,1988-12-09,1988,20000000,13854000,-6146000,6.493525
12121,Made in America,1993-05-27,1993,22000000,0,-22000000,5.43085
12122,Village of the Damned,1995-04-28,1995,0,0,0,6.529879
12123,Chain Reaction,1996-08-02,1996,50000000,60209334,10209334,15.874491
12124,The Journey,1992-04-30,1992,0,0,0,0.771208
12127,Pippi in the South Seas,1970-01-24,1970,0,0,0,3.723069
12128,Night of the Living Dorks,2004-11-03,2004,4410000,0,-4410000,1.480979
12129,Herbie Goes Bananas,1980-06-25,1980,0,0,0,3.13734
12130,I Don't Want to Sleep Alone,2006-12-02,2006,0,0,0,0.889404
12133,Step Brothers,2008-07-25,2008,65000000,128107642,63107642,8.579638
12135,Left Bank,2008-03-26,2008,0,0,0,1.212963
12138,3000 Miles to Graceland,2001-02-23,2001,62000000,18720175,-43279825,4.76448
12139,Dennis the Menace,1993-06-23,1993,35000000,117270765,82270765,10.378902
12140,Ghost in the Shell 2: Innocence,2004-03-06,2004,0,9789651,9789651,9.377699
12142,Alone in the Dark,2005-01-28,2005,20000000,10442808,-9557192,5.871243
12143,Bad Lieutenant,1992-09-16,1992,1000000,2019469,1019469,6.417037
12144,The Land Before Time,1988-11-18,1988,12300000,84460846,72160846,13.631352
12145,Fierce Creatures,1997-01-24,1997,0,9381260,9381260,11.036729
12146,The Missing,2003-11-26,2003,60000000,0,-60000000,8.975439
12147,Do Fish Do It?,2002-08-15,2002,0,0,0,0.174769
12149,Frailty,2001-11-17,2001,11000000,13110448,2110448,7.397953
12150,Sea of Love,1989-09-15,1989,19000000,110879513,91879513,9.801967
12151,Ruthless People,1986-06-26,1986,0,71624879,71624879,7.427491
12153,White Chicks,2004-06-23,2004,37000000,113086475,76086475,7.723341
12154,Three Men and a Baby,1987-11-27,1987,0,0,0,5.667344
12155,Alice in Wonderland,2010-03-03,2010,200000000,1025491110,825491110,17.285093
12156,Private Property,2006-09-01,2006,0,0,0,1.733661
12157,Green Card,1990-12-23,1990,0,29888235,29888235,11.169488
12158,Vampire in Brooklyn,1995-10-26,1995,14000000,19800000,5800000,9.071127
12159,What Dreams May Come,1998-10-02,1998,85000000,71485043,-13514957,11.218378
12160,Wyatt Earp,1994-06-24,1994,63000000,25052000,-37948000,9.277147
12161,Jerichow,2008-01-01,2008,0,0,0,1.242183
12162,The Hurt Locker,2008-10-10,2008,15000000,42000000,27000000,9.403724
12163,The Wrestler,2008-09-07,2008,6000000,44703995,38703995,7.903956
12165,The Burning Plain,2008-07-11,2008,20000000,0,-20000000,7.02914
12166,Achilles and the Tortoise,2008-09-20,2008,0,0,0,1.701458
12167,The Art of Negative Thinking,2006-11-03,2006,0,0,0,1.170779
12169,The First Day of the Rest of Your Life,2008-07-23,2008,0,0,0,6.173752
12171,The Deaths of Ian Stone,2007-12-05,2007,0,0,0,6.86365
12172,Encounters at the End of the World,2007-09-01,2007,0,0,0,4.875184
12177,The Love Guru,2008-06-20,2008,62000000,41819064,-20180936,6.258666
12178,Miss Pettigrew Lives for a Day,2008-03-07,2008,0,16051363,16051363,5.056926
12179,Where in the World Is Osama Bin Laden?,2008-01-21,2008,0,0,0,1.476045
12180,Star Wars: The Clone Wars,2008-08-05,2008,8500000,68282844,59782844,8.524857
12182,Nick and Norah's Infinite Playlist,2008-10-03,2008,9000000,32973937,23973937,12.992176
12183,The Wendell Baker Story,2005-08-03,2005,0,0,0,1.756489
12184,The Other Boleyn Girl,2008-02-28,2008,35000000,0,-35000000,9.778826
12185,Heaven Can Wait,1978-06-28,1978,0,0,0,5.232475
12186,Defending Your Life,1991-03-22,1991,0,0,0,3.711347
12187,Heart and Souls,1993-08-13,1993,0,16589540,16589540,8.450231
12192,Pathology,2008-04-11,2008,8000000,0,-8000000,5.33161
12193,Four Christmases,2008-11-26,2008,80000000,163733697,83733697,7.210383
12197,Reprise,2006-07-03,2006,0,0,0,1.871718
12198,Flight of the Red Balloon,2007-05-17,2007,3000000,0,-3000000,2.039973
12201,Edge of Darkness,2010-01-29,2010,80000000,74901339,-5098661,9.554067
12205,Dark Water,2002-01-19,2002,0,0,0,8.82953
12206,The Testament of Dr. Mabuse,1933-04-21,1933,0,0,0,2.474255
12207,The Legend of Drunken Master,1994-02-03,1994,0,0,0,8.6807
12208,Casino Royale,1967-04-13,1967,12000000,41744718,29744718,13.300519
12211,Highlander: Endgame,2000-09-01,2000,25000000,15843608,-9156392,11.430964
12212,Urban Legends: Final Cut,2000-09-19,2000,14000000,38574362,24574362,12.243528
12219,12 Angry Men,1997-08-17,1997,0,0,0,3.679263
12220,The Story of Us,1999-10-13,1999,50000000,58900031,8900031,5.769957
12221,Two Drifters,2005-05-18,2005,0,0,0,1.636544
12222,Horton Hears a Who!,2008-03-03,2008,85000000,297138014,212138014,8.326699
12223,The Stepford Wives,1975-02-12,1975,0,0,0,3.94547
12224,Dinotopia,2002-05-12,2002,0,0,0,6.979858
12225,Cashback,2006-09-10,2006,0,2294291,2294291,10.158533
12227,White Fang,1991-01-18,1991,14000000,34793160,20793160,12.318052
12228,Inside Deep Throat,2005-02-11,2005,2000000,653621,-1346379,3.21768
12229,The Acid House,1998-07-02,1998,0,0,0,4.222607
12230,One Hundred and One Dalmatians,1961-01-25,1961,4000000,215880014,211880014,15.727519
12232,The Thief of Bagdad,1940-12-25,1940,0,0,0,3.428166
12233,Oliver & Company,1988-11-18,1988,31000000,74151346,43151346,10.813579
12235,Jagged Edge,1985-10-04,1985,15000000,0,-15000000,3.892311
12236,Speed Zone,1989-04-21,1989,0,3077361,3077361,2.806926
12237,Faces of Death,1978-01-01,1978,0,0,0,2.97789
12238,The Night Flier,1997-04-30,1997,1000000,91549,-908451,7.146514
12239,The Osterman Weekend,1983-10-14,1983,0,6486797,6486797,9.425108
12241,Curdled,1996-09-06,1996,2300000,49620,-2250380,2.781581
12242,Mulan II,2004-11-03,2004,0,0,0,7.424487
12244,9,2009-08-19,2009,30000000,48428063,18428063,18.502877
12245,The Oxford Murders,2008-01-18,2008,14100000,0,-14100000,5.97385
12246,Mongol: The Rise of Genghis Khan,2007-09-20,2007,18000000,26527510,8527510,6.375447
12247,Shotgun Stories,2007-10-01,2007,0,0,0,4.770903
12249,Aaltra,2004-01-29,2004,0,0,0,0.692062
12251,Mo' Money,1992-07-24,1992,17000000,0,-17000000,1.755586
12253,Biker Boyz,2003-01-31,2003,24000000,23510601,-489399,11.269558
12254,Emma,1996-10-02,1996,0,0,0,7.036457
12255,Cord,2000-01-01,2000,0,0,0,1.229626
12257,Home Fries,1998-11-25,1998,15000000,10443316,-4556684,2.312844
12259,Sholay,1975-08-15,1975,0,0,0,3.618832
12261,Carlito's Way: Rise to Power,2005-09-27,2005,9000000,0,-9000000,13.305564
12262,The Hills Have Eyes,1977-07-22,1977,230000,25000000,24770000,4.788002
12266,Strange Affair,1981-12-23,1981,0,0,0,0.58662
12268,The Pink Panther Strikes Again,1976-12-15,1976,6000000,33833201,27833201,5.58692
12270,CSNY/D√©j√† Vu,2008-01-25,2008,0,0,0,0.005247
12271,Factory Girl,2006-12-29,2006,7000000,0,-7000000,19.651793
12273,Singh Is Kinng,2008-01-01,2008,14000000,25000000,11000000,1.369086
12276,The Road Home,1999-10-16,1999,0,0,0,2.611492
12277,Undercover Brother,2002-05-31,2002,25000000,41604473,16604473,5.00725
12278,Soul Man,1986-10-24,1986,0,0,0,3.589199
12279,Spy Kids 3-D: Game Over,2003-07-25,2003,38000000,197011982,159011982,8.025145
12280,The Paper,1994-03-18,1994,6000000,0,-6000000,4.006063
12281,Mean Creek,2004-01-15,2004,500000,603943,103943,12.428269
12289,Red Cliff,2008-07-10,2008,80341000,127814609,47473609,11.867516
12308,The Last Kiss,2001-02-01,2001,0,0,0,5.50323
12309,Bachelor Party,1984-06-29,1984,6000000,38435947,32435947,5.511756
12310,The Four Musketeers,1974-10-31,1974,0,0,0,5.512439
12311,Mutiny on the Bounty,1935-11-08,1935,1950000,4460000,2510000,7.135215
12312,Joe Somebody,2001-12-21,2001,38000000,0,-38000000,4.273193
12314,The Bridge,2008-06-20,2008,0,0,0,1.025976
12335,Bedknobs and Broomsticks,1971-10-07,1971,20000000,17900000,-2100000,10.362012
12395,Thunderheart,1992-04-03,1992,0,0,0,3.212558
12400,Redbelt,2008-04-07,2008,7000000,0,-7000000,5.130795
12403,A Perfect Getaway,2009-06-08,2009,14000000,22852638,8852638,11.017008
12404,Me and Orson Welles,2009-11-25,2009,25000000,2336172,-22663828,3.600917
12405,Slumdog Millionaire,2008-05-12,2008,15000000,377910544,362910544,11.258181
12407,Stone of Destiny,2008-12-19,2008,0,0,0,9.483659
12408,Genova,2008-01-01,2008,0,0,0,2.074352
12410,Good,2008-12-11,2008,0,0,0,1.911874
12411,Disgrace,2008-09-06,2008,0,0,0,8.32971
12412,Miracle at St. Anna,2008-09-15,2008,45000000,9323833,-35676167,11.221186
12416,The Substitute,2007-03-13,2007,0,0,0,9.952905
12422,This Night,2008-01-01,2008,0,0,0,0.771313
12424,Giovanna's Father,2008-01-01,2008,0,0,0,1.835804
12427,Teza,2008-01-01,2008,0,0,0,0.663788
12428,Paper Soldier,2008-11-13,2008,0,0,0,1.096142
12429,Ponyo,2008-07-19,2008,41677699,187479518,145801819,8.470945
12432,A Perfect Day,2008-01-01,2008,0,0,0,1.881755
12435,The Nanny Diaries,2007-08-24,2007,20000000,47738099,27738099,6.764056
12437,Underworld: Rise of the Lycans,2009-01-22,2009,35000000,91353501,56353501,11.654958
12443,Perlasca: The Courage of a Just Man,2002-01-28,2002,0,0,0,0.455013
12444,Harry Potter and the Deathly Hallows: Part 1,2010-10-17,2010,250000000,954305868,704305868,23.300362
12445,Harry Potter and the Deathly Hallows: Part 2,2011-07-07,2011,125000000,1342000000,1217000000,24.990737
12446,Angel of Mine,2008-06-13,2008,0,0,0,0.616537
12447,Driving Me Crazy,1991-05-16,1991,0,0,0,0.260015
12448,The Hunchback of Notre Dame II,2002-02-05,2002,0,0,0,7.758492
12449,Room of Death,2007-11-14,2007,0,0,0,1.599907
12450,King Solomon's Mines,2004-06-06,2004,0,0,0,2.532525
12453,Stupid Boy,2004-03-10,2004,0,0,0,0.744643
12454,All or Nothing,2002-05-17,2002,9000000,0,-9000000,3.411156
12455,The Young Lieutenant,2005-08-31,2005,0,0,0,1.316087
12456,The Five Obstructions,2003-11-07,2003,0,0,0,5.714251
12470,Sandakan No. 8,1974-11-02,1974,0,0,0,1.030092
12471,Milk,2008-09-01,2008,0,0,0,1.051593
12472,The Incredible Shrinking Woman,1981-01-30,1981,0,0,0,6.788178
12473,The Visitor,2007-09-07,2007,0,9234510,9234510,9.04083
12475,In the Army Now,1994-08-12,1994,0,28881266,28881266,6.071466
12476,The Hidden,1987-10-30,1987,0,0,0,5.467128
12477,Grave of the Fireflies,1988-04-16,1988,3700000,0,-3700000,0.010902
12478,Skin Deep,1989-03-03,1989,0,0,0,7.519229
12479,Breakfast of Champions,1999-02-13,1999,12000000,0,-12000000,2.421573
12480,Water Drops on Burning Rocks,2000-03-15,2000,0,0,0,2.696909
12481,The Big Boss,1971-10-02,1971,100000,0,-100000,10.486927
12482,Love Is Colder Than Death,1970-01-16,1970,0,0,0,3.957506
12483,Riding the Bullet,2004-10-15,2004,5000000,0,-5000000,5.225658
12484,The Forsaken,2001-04-27,2001,5000000,0,-5000000,3.169217
12485,Candyman: Day of the Dead,1999-07-09,1999,0,0,0,8.259034
12486,Farce of the Penguins,2006-12-01,2006,0,0,0,2.515565
12487,Gozu,2003-07-11,2003,0,0,0,4.995134
12488,The Gingerbread Man,1998-01-23,1998,0,0,0,7.883472
12489,Gridlock'd,1997-01-29,1997,0,0,0,10.575081
12490,Ordinary Decent Criminal,2000-01-07,2000,0,0,0,10.267029
12491,Accattone,1961-08-31,1961,0,0,0,2.557031
12493,High and Low,1963-03-01,1963,0,0,0,8.815184
12495,The Singing Ringing Tree,1957-12-13,1957,0,0,0,1.611034
12496,The Twilight Samurai,2002-11-02,2002,5000000,7338987,2338987,4.281103
12497,A Touch of Spice,2003-10-24,2003,0,0,0,1.331633
12498,Sling Blade,1996-08-30,1996,1000000,24444121,23444121,9.475693
12499,Fathers' Day,1997-05-09,1997,85000000,0,-85000000,5.295556
12500,American Ninja,1985-08-30,1985,1000000,10499694,9499694,7.314536
12501,The Big Country,1958-09-30,1958,0,0,0,4.671032
12502,Silkwood,1983-12-14,1983,0,0,0,4.873957
12503,Under Fire,1983-10-21,1983,0,0,0,2.780331
12504,The Outsider,1983-10-26,1983,0,0,0,5.896223
12505,Little Nikita,1988-03-17,1988,0,0,0,2.097317
12506,Cry Freedom,1987-11-05,1987,0,0,0,3.519881
12508,Rock Star,2001-09-04,2001,57000000,16991902,-40008098,10.076223
12509,Pollock,2000-09-06,2000,6,8,2,11.179864
12513,Marie-Jo and Her 2 Lovers,2002-06-26,2002,0,0,0,1.560053
12516,Dreams,1990-05-11,1990,0,0,0,5.845197
12517,The Ordeal,2006-08-11,2006,0,0,0,4.392346
12518,Honeymoon in Vegas,1992-08-28,1992,25000000,0,-25000000,8.573348
12519,Sirens,1993-10-01,1993,0,7770731,7770731,2.86213
12520,The Last Supper,1995-09-08,1995,0,442965,442965,4.619915
12521,Shocker,1989-10-27,1989,5000000,16554699,11554699,5.587765
12523,R√§uber Knei√ül,2008-08-21,2008,0,0,0,0.106609
12524,Titus,1999-12-25,1999,0,0,0,7.295333
12525,Critters 4,1992-08-20,1992,0,0,0,8.537871
12526,Bug,2006-05-19,2006,4000000,8059140,4059140,5.911303
12527,Strawberry and Chocolate,1993-01-01,1993,0,0,0,1.777197
12528,Southern Comfort,1981-09-25,1981,0,0,0,4.239893
12529,Boot Hill,1969-12-20,1969,0,0,0,6.074748
12530,Avanti!,1972-12-17,1972,0,0,0,10.088989
12531,The Apartment,1996-07-27,1996,0,0,0,6.228174
12535,High Anxiety,1977-12-25,1977,3400000,31063038,27663038,5.101153
12536,Home Alone 4,2002-11-02,2002,0,0,0,6.137056
12537,The French Lieutenant's Woman,1981-08-28,1981,0,2689068,2689068,3.122717
12538,Senseless,1998-02-20,1998,0,13035599,13035599,6.253164
12540,Bring It On Again,2004-01-13,2004,0,0,0,0.380586
12542,Belly of the Beast,2003-12-30,2003,14000000,0,-14000000,8.316548
12543,Breaking News,2004-06-10,2004,0,0,0,3.1055
12544,Respiro,2002-01-01,2002,0,0,0,1.498672
12545,Jesus Christ Superstar,1973-08-15,1973,0,13200000,13200000,4.980716
12547,Shadows in the Sun,2005-05-12,2005,0,0,0,1.606225
12548,I Vitelloni,1953-08-26,1953,0,0,0,9.162943
12554,Citizen X,1995-02-25,1995,0,0,0,3.538001
12555,I Served the King of England,2006-12-19,2006,0,0,0,1.739765
12556,Ghosts of Girlfriends Past,2009-05-01,2009,0,102223269,102223269,8.401493
12559,First Kid,1996-08-30,1996,0,0,0,6.510437
12560,The Big Chill,1983-09-09,1983,0,0,0,11.620392
12561,Godzilla vs. Destoroyah,1995-12-09,1995,0,0,0,2.672437
12568,Brideshead Revisited,2008-07-25,2008,20000000,13204291,-6795709,11.069679
12569,Extract,2009-09-03,2009,8000000,10848783,2848783,11.23915
12572,"New York, I Love You",2008-09-06,2008,14700000,8049666,-6650334,13.825651
12573,A Serious Man,2009-10-02,2009,7000000,31430334,24430334,7.971424
12574,Cop and ¬Ω,1993-04-02,1993,0,0,0,8.400026
12575,Long Hello and Short Goodbye,1999-07-15,1999,0,0,0,0.001378
12576,Deathwatch,2002-10-06,2002,0,2270658,2270658,4.766826
12577,Riders,2002-05-08,2002,0,0,0,9.205244
12578,Germany in Autumn,1978-03-03,1978,0,0,0,1.596736
12579,The Woman Next Door,1981-09-30,1981,0,0,0,9.373676
12580,Izo,2004-08-21,2004,0,0,0,2.482068
12582,Without a Clue,1988-10-21,1988,0,0,0,4.095908
12583,Ginger Snaps Back: The Beginning,2004-07-10,2004,0,0,0,2.522054
12584,The Shootist,1976-08-11,1976,0,8091910,8091910,8.624922
12586,Bella,2006-09-09,2006,0,0,0,1.654328
12588,My Friend from Faro,2008-01-16,2008,0,0,0,1.107327
12589,Jimmy Neutron: Boy Genius,2001-12-21,2001,25000000,80936232,55936232,7.308162
12590,Below,2002-10-11,2002,0,605562,605562,11.19785
12591,Santa's Slay,2005-10-25,2005,0,0,0,3.785156
12593,Fritz the Cat,1972-04-12,1972,850000,0,-850000,3.027994
12594,Wishmaster 2: Evil Never Dies,1999-03-12,1999,2500000,0,-2500000,2.924431
12596,Pushing Tin,1999-04-23,1999,33000000,0,-33000000,7.073467
12597,Hellraiser: Inferno,2000-10-03,2000,2000000,0,-2000000,6.984609
12598,Jo,1971-08-31,1971,0,0,0,3.39109
12599,Pok√©mon: The Movie 2000,1999-07-17,1999,30000000,133949270,103949270,7.554848
12600,Pok√©mon 4Ever: Celebi - Voice of the Forest,2001-07-06,2001,0,28023563,28023563,7.072301
12600,Pok√©mon 4Ever: Celebi - Voice of the Forest,2001-07-06,2001,0,28023563,28023563,6.080108
12601,Garden of Love,2003-03-03,2003,0,0,0,0.19186
12602,The Torture Chamber of Dr. Sadism,1967-10-05,1967,0,0,0,1.853036
12605,Katze im Sack,2005-01-20,2005,0,0,0,0.024286
12606,A Very Brady Sequel,1996-08-23,1996,0,0,0,9.898696
12607,Kamikaze 1989,1982-07-16,1982,0,0,0,1.002932
12608,Illusive Tracks,2003-12-24,2003,0,0,0,0.776818
12609,Help! I'm A Fish,2000-10-06,2000,0,0,0,10.197545
12610,Osmosis Jones,2001-08-07,2001,75000000,13596911,-61403089,6.405831
12611,The Fury,1978-03-10,1978,5500000,24000000,18500000,11.844029
12612,Freeze Frame,2004-05-01,2004,0,0,0,2.352193
12613,Street Fighter II: The Animated Movie,1994-08-06,1994,0,0,0,6.878263
12614,Victor/Victoria,1982-04-25,1982,0,28215453,28215453,5.378996
12615,Death of a Salesman,1985-08-16,1985,0,0,0,3.815502
12616,One Night Stand,1997-11-14,1997,24000000,2642983,-21357017,2.818802
12617,Midnight Lace,1960-10-13,1960,0,0,0,7.069045
12618,Random Hearts,1999-10-08,1999,64000000,74608570,10608570,4.140398
12619,Cherry Falls,2000-08-25,2000,0,0,0,4.577063
12620,The House Bunny,2008-08-22,2008,25000000,70442940,45442940,9.920106
12621,Hamlet 2,2008-01-21,2008,0,0,0,5.654268
12622,Violent Cop,1989-08-12,1989,0,1960,1960,3.469468
12623,Suspect,1987-10-23,1987,0,18782400,18782400,10.638289
12625,Guns of the Magnificent Seven,1969-07-14,1969,0,0,0,2.639721
12626,Broadcast News,1987-12-16,1987,20000000,51249404,31249404,8.627019
12627,La Belle Noiseuse,1991-09-04,1991,0,0,0,3.257378
12628,Playing God,1997-10-17,1997,12000000,4000000,-8000000,9.657642
12629,Live Wire,1992-09-03,1992,0,0,0,2.029086
12631,Drei Mann in einem Boot,1961-08-25,1961,0,0,0,0.672934
12632,Kaspar Hauser,1993-09-11,1993,0,0,0,0.000578
12633,The Star Chamber,1983-08-05,1983,0,0,0,5.838449
12634,The Big Bounce,2004-01-30,2004,50000000,6808550,-43191450,6.496271
12635,Backbeat,1994-04-01,1994,0,0,0,2.487951
12636,Godzilla Against MechaGodzilla,2002-11-02,2002,8500000,0,-8500000,1.187456
12637,"New York, New York",1977-06-21,1977,0,0,0,6.453433
12638,Kill Cruise,1990-04-05,1990,0,0,0,0.543341
12639,Return of the Seven,1966-10-19,1966,0,0,0,3.057434
12645,Inhale,2010-08-27,2010,10000000,55089,-9944911,4.163207
12646,Valhalla,1986-05-12,1986,0,0,0,1.588153
12647,Billy Bathgate,1991-11-01,1991,48000000,0,-48000000,3.846331
12649,The Mouse That Roared,1959-07-17,1959,0,0,0,2.612138
12650,Il Mare,2000-09-09,2000,0,0,0,2.816928
12651,Memphis Belle,1990-09-07,1990,23000000,0,-23000000,8.854911
12652,Nelly and Monsieur Arnaud,1996-04-12,1996,0,0,0,1.784647
12653,Romasanta,2004-05-13,2004,4500000,0,-4500000,8.64362
12655,I Went Down,1997-10-03,1997,0,0,0,0.559621
12656,Feeling Minnesota,1996-09-13,1996,0,0,0,10.298582
12657,Soul Plane,2004-05-28,2004,16000000,14822346,-1177654,8.604389
12658,Someone Like You...,2001-03-30,2001,23000000,0,-23000000,5.298111
12659,Beijing Bicycle,2001-02-17,2001,0,0,0,1.199804
12660,Charlotte Gray,2001-12-17,2001,0,741394,741394,11.34469
12661,Undercover Blues,1993-09-10,1993,0,12416686,12416686,2.614785
12662,Psycho III,1986-06-27,1986,0,14481606,14481606,6.345885
12663,Red Scorpion,1988-12-24,1988,16000000,4192440,-11807560,2.549325
12664,The Snapper,1993-08-06,1993,0,0,0,1.14168
12665,Powder,1995-10-27,1995,0,0,0,12.133094
12677,The Backwoods,2006-09-24,2006,0,0,0,7.856252
12683,Alone in the Dark 2,2008-09-01,2008,4600000,0,-4600000,8.238787
12684,Sabotage,1936-12-02,1936,0,0,0,6.514753
12685,BloodRayne: The Third Reich,2010-11-05,2010,10000000,0,-10000000,5.926797
12689,"Angus, Thongs and Perfect Snogging",2008-07-25,2008,1,0,-1,8.896155
12690,Appaloosa,2008-09-12,2008,20000000,20211394,211394,12.392754
12695,Still Smokin,1983-05-06,1983,0,15543000,15543000,3.767872
12696,Hierankl,2003-07-01,2003,0,0,0,0.002499
12697,Laura's Star,2004-09-19,2004,0,0,0,1.997269
12698,The Fog of War,2003-12-09,2003,0,0,0,4.109188
12699,Hellraiser: Hellworld,2005-09-06,2005,5000000,0,-5000000,5.168183
12700,Dominion: Prequel to the Exorcist,2005-05-20,2005,30000000,251495,-29748505,7.892677
12701,Revolution,1985-12-25,1985,28000000,358574,-27641426,2.806002
12702,Critters 3,1991-12-11,1991,0,0,0,5.163739
12703,The Brown Bunny,2004-08-27,2004,10000000,0,-10000000,4.735377
12704,Ishtar,1987-05-15,1987,55000000,14375181,-40624819,3.986985
12705,Smokey and the Bandit II,1980-08-15,1980,0,66132626,66132626,7.190986
12706,Croupier,1998-06-25,1998,0,0,0,3.986838
12707,Orca: The Killer Whale,1977-07-22,1977,6000000,14717854,8717854,5.253453
12708,That Touch of Mink,1962-06-14,1962,0,0,0,2.995169
12709,Ridicule,1996-05-09,1996,3000000,2503829,-496171,10.879283
12710,Big Business,1988-06-10,1988,0,0,0,3.940139
12713,Comedy of Power,2006-02-16,2006,0,0,0,1.133439
12714,She's Having a Baby,1988-02-05,1988,0,0,0,7.255375
12715,Firewalker,1986-11-21,1986,0,11949484,11949484,3.150899
12716,My Father's Glory,1990-08-29,1990,0,0,0,4.406499
12717,My Mother's Castle,1990-10-26,1990,0,0,0,3.111707
12718,Teenage Caveman,2002-04-03,2002,0,0,0,3.553427
12719,Flashback,1990-02-02,1990,0,6488144,6488144,2.115753
12720,Suicide Club,2001-10-29,2001,0,0,0,8.279552
12721,"No Retreat, No Surrender",1986-05-02,1986,0,4662137,4662137,8.900994
12722,War Photographer,2001-01-01,2001,0,0,0,0.937069
12723,Inventing the Abbotts,1997-04-04,1997,0,5926128,5926128,5.063701
12724,The Convent,2000-01-21,2000,0,0,0,1.351392
12758,Beyond the Law,1968-04-10,1968,0,0,0,1.062381
12759,Doll Graveyard,2005-01-01,2005,0,0,0,0.657628
12761,Autumn Sonata,1978-10-08,1978,0,0,0,4.850503
12762,Broadway Danny Rose,1984-01-27,1984,8000000,10600497,2600497,5.892277
12763,Take the Lead,2006-03-17,2006,30000000,34742066,4742066,5.364459
12764,Missing in Action 2: The Beginning,1985-03-01,1985,2410000,10755447,8345447,9.110348
12766,Vera Cruz,1954-12-25,1954,0,0,0,2.320058
12767,Cold Creek Manor,2003-09-19,2003,0,21384035,21384035,5.84474
12770,Stealing Harvard,2002-09-13,2002,0,0,0,7.272325
12771,Serving Sara,2002-08-20,2002,29000000,16930185,-12069815,10.16841
12772,Leap of Faith,1992-12-18,1992,0,0,0,5.25527
12774,Last Exit to Brooklyn,1989-10-11,1989,0,0,0,2.544973
12775,Flesh + Blood,1985-08-30,1985,6500000,0,-6500000,13.006729
12776,Johnny Stecchino,1991-10-23,1991,0,0,0,10.161042
12777,It's All About Love,2003-01-10,2003,0,0,0,2.697296
12778,Greedy,1994-03-04,1994,0,13145977,13145977,9.426784
12779,Swept Away,2002-10-11,2002,10000000,598645,-9401355,3.492576
12780,Iron Monkey,1993-09-03,1993,0,14681661,14681661,8.733961
12781,The Flying Classroom,1954-09-02,1954,0,0,0,0.633356
12783,The Duchess,2008-09-05,2008,0,0,0,9.835473
12787,Homeboy,1988-08-24,1988,0,0,0,1.603891
12790,Black Night,2005-10-03,2005,0,0,0,0.831487
12791,End of the Line,2007-10-14,2007,0,0,0,2.466547
12793,All Over Me,1997-02-15,1997,0,0,0,4.06745
12794,Amnesia: The James Brighton Enigma,2005-01-01,2005,0,0,0,0.606331
12795,Another Gay Movie,2006-04-28,2006,500000,745327,245327,5.978211
12796,Sebastian,1968-01-24,1968,0,0,0,1.236231
12797,Ghost Town,2008-09-19,2008,0,0,0,12.994773
12799,Full Speed,1996-09-25,1996,0,0,0,0.384033
12800,Gasoline,2001-11-20,2001,0,0,0,0.477258
12802,Goldfish Memory,2003-03-20,2003,1200000,0,-1200000,1.175971
12806,Nico and Dani,2000-05-18,2000,0,0,0,1.847061
12807,Looking for Cheyenne,2005-04-01,2005,0,0,0,0.825628
12808,Nina's Heavenly Delights,2006-09-28,2006,0,0,0,0.770878
12811,Birdwatchers,2008-08-31,2008,0,0,0,0.5468
12812,Wild Side,2004-02-08,2004,0,0,0,0.516347
12816,Skinhead Attitude,2003-08-08,2003,0,0,0,0.160726
12818,Everybody Wants to Be Italian,2007-09-18,2007,1100000,0,-1100000,0.5455
12819,Alpha and Omega,2010-09-17,2010,20000000,39300000,19300000,8.16645
12823,Days and Clouds,2007-09-12,2007,0,0,0,5.608847
12826,Just a Gigolo,1979-01-01,1979,0,0,0,0.617142
12828,No. 2,2006-02-16,2006,5000000,0,-5000000,0.20242
12831,Amerikana,2001-05-15,2001,0,0,0,0.039918
12832,A Woman in Berlin,2008-09-10,2008,0,0,0,1.377856
12834,Leaves of Grass,2009-09-13,2009,9000000,985117,-8014883,9.954095
12837,The Secret Life of Bees,2008-09-17,2008,11000000,38105395,27105395,6.390463
12838,One to Another,2006-07-21,2006,0,0,0,3.074279
12839,The Curiosity of Chance,2006-10-21,2006,0,0,0,1.933704
12840,The Man of My Life,2006-09-08,2006,0,0,0,1.692026
12855,Blue State,2007-04-27,2007,0,0,0,5.015328
12877,Dead Man's Shoes,2004-09-29,2004,0,0,0,12.655746
12888,Belly,1998-11-04,1998,0,0,0,3.436535
12889,Futurama: The Beast with a Billion Backs,2008-06-24,2008,0,0,0,5.494827
12890,Smart People,2008-04-11,2008,7000000,10569964,3569964,3.756539
12900,Conspiracy,2001-05-19,2001,0,0,0,4.633229
12901,No End in Sight,2007-07-27,2007,2000000,1431623,-568377,1.987795
12902,Scooby-Doo! and the Loch Ness Monster,2004-06-21,2004,0,0,0,5.244817
12903,Scooby-Doo! and the Goblin King,2008-01-01,2008,0,0,0,3.206772
12911,The Gaul,2001-01-24,2001,0,0,0,1.050541
12912,Chaos Theory,2008-03-14,2008,0,240476,240476,7.303984
12914,Stargate: Continuum,2008-07-29,2008,7000000,0,-7000000,7.627484
12919,Can't Buy Me Love,1987-08-14,1987,1800000,31623833,29823833,9.104462
12920,Dreamer: Inspired By a True Story,2005-09-10,2005,0,0,0,7.811933
12921,Strange Brew,1983-08-26,1983,0,0,0,2.954184
12924,The Place Promised in Our Early Days,2004-11-20,2004,0,0,0,6.74453
12994,The Nines,2007-01-21,2007,0,0,0,5.491963
13001,Stargate: The Ark of Truth,2008-03-11,2008,7000000,8900000,1900000,9.218164
13002,Barbie in the 12 Dancing Princesses,2006-09-19,2006,0,0,0,5.956719
13003,Gonzo: The Life and Work of Dr. Hunter S. Thompson,2008-07-04,2008,0,0,0,2.849605
13004,Barbie and the Diamond Castle,2008-01-01,2008,0,0,0,4.829474
13005,Where the Buffalo Roam,1980-04-25,1980,0,6659377,6659377,3.216608
13006,Split Second,1992-05-01,1992,7,5,-2,3.2768
13007,Religulous,2008-10-01,2008,0,0,0,9.045712
13008,An American Crime,2007-07-27,2007,2000000,0,-2000000,7.478007
13009,Zombie Strippers!,2008-04-18,2008,0,0,0,5.315824
13012,Felon,2008-07-17,2008,2900000,0,-2900000,9.094276
13013,Son of Dracula,1974-04-12,1974,0,0,0,0.415277
13014,The God Who Wasn't There,2005-05-21,2005,0,0,0,1.394269
13015,George Carlin: Life Is Worth Losing,2005-11-05,2005,0,0,0,4.806651
13016,Zeitgeist,2007-06-01,2007,7000000,0,-7000000,4.777597
13017,Unstable Fables: Tortoise vs. Hare,2008-09-12,2008,0,0,0,1.572727
13018,Deception,2008-04-24,2008,25000000,17741298,-7258702,7.720729
13019,Young People Fucking,2007-09-05,2007,1500000,0,-1500000,8.388793
13020,Enron: The Smartest Guys in the Room,2005-04-22,2005,0,0,0,3.971749
13021,Flakes,2007-01-01,2007,0,0,0,1.186546
13022,Rogue,2007-11-08,2007,0,0,0,7.173304
13023,The Devil Came on Horseback,2007-01-19,2007,0,0,0,0.431719
13025,Diary of the Dead,2007-09-08,2007,2000000,5364858,3364858,12.001324
13027,Eagle Eye,2008-09-25,2008,80000000,178066569,98066569,14.324875
13041,El Topo,1970-12-18,1970,400000,0,-400000,5.467355
13042,Presto,2008-06-18,2008,0,0,0,8.563861
13051,Max Payne,2008-10-15,2008,35000000,85416905,50416905,10.08043
13053,Bolt,2008-11-21,2008,150000000,309979994,159979994,15.580915
13054,Rise of the Footsoldier,2007-09-07,2007,4000000,0,-4000000,11.397219
13055,Chance,2002-09-22,2002,75000,0,-75000,0.542401
13056,Punisher: War Zone,2008-12-05,2008,20500000,10089373,-10410627,8.333526
13058,Adulthood,2008-06-16,2008,0,0,0,4.285194
13059,The Signal,2007-02-22,2007,50000,249905,199905,11.329733
13060,Lifted,2006-12-28,2006,0,0,0,5.767577
13061,Your Friend the Rat,2007-11-06,2007,0,0,0,7.311671
13062,Boundin',2003-11-04,2003,0,0,0,5.137422
13063,Cannibal! The Musical,1993-10-01,1993,125000,0,-125000,6.612589
13064,Airborne,1993-09-17,1993,2600000,2850263,250263,11.600224
13065,Finding Amanda,2008-09-16,2008,0,0,0,6.371674
13066,I Want Someone to Eat Cheese With,2006-01-01,2006,0,0,0,1.270102
13067,In the Land of Women,2007-04-16,2007,10000000,17500000,7500000,9.351276
13068,Rocket Science,2007-01-19,2007,0,0,0,3.563126
13070,Air Guitar Nation,2006-03-09,2006,0,0,0,0.762859
13072,Brooklyn Rules,2007-04-30,2007,8000000,458232,-7541768,2.942202
13073,Palindromes,2004-09-03,2004,0,0,0,2.754372
13074,Resurrecting the Champ,2007-06-14,2007,0,0,0,7.451281
13075,Sherrybaby,2006-09-08,2006,2000000,622806,-1377194,3.319349
13076,Starting Out in the Evening,2007-01-01,2007,0,0,0,1.161496
13078,The Babysitters,2007-09-11,2007,0,44852,44852,4.822464
13079,The Life Before Her Eyes,2007-09-08,2007,8000000,0,-8000000,12.914737
13090,Sunshine Cleaning,2008-01-18,2008,5000000,16174377,11174377,9.098119
13092,How to Lose Friends & Alienate People,2008-10-02,2008,27000000,17286299,-9713701,11.981531
13094,Dance of the Dead,2008-10-14,2008,0,0,0,3.915682
13098,Paid in Full,2002-10-25,2002,0,3090862,3090862,3.928278
13099,Gen-X Cops,1999-06-18,1999,0,0,0,2.647643
13105,Mr. Mom,1983-07-22,1983,0,64783827,64783827,10.693092
13107,Henry Poole Is Here,2008-08-15,2008,0,1829917,1829917,5.923904
13119,Hank and Mike,2008-01-01,2008,0,0,0,0.680742
13120,In Search of a Midnight Kiss,2007-04-27,2007,25000,0,-25000,1.573576
13121,Teeth,2007-01-19,2007,0,0,0,6.523545
13122,The People Under the Stairs,1991-11-01,1991,6000000,0,-6000000,12.709349
13123,Aamir,2008-06-06,2008,364000,0,-364000,0.765555
13127,SPL: Kill Zone,2005-11-18,2005,0,0,0,8.416631
13128,Sweet Rain: Accuracy of Death,2008-04-22,2008,0,0,0,1.345224
13132,All the Real Girls,2003-08-01,2003,0,0,0,5.289742
13137,A Very British Gangster,2007-07-17,2007,0,0,0,0.652756
13140,Kenny,2006-08-17,2006,0,7778177,7778177,1.489294
13141,Strangers with Candy,2006-07-28,2006,0,0,0,3.786971
13150,Pride and Glory,2008-09-09,2008,30000000,31148328,1148328,5.844016
13151,Scooby-Doo on Zombie Island,1998-09-22,1998,0,0,0,5.15634
13153,Rapid Fire,1992-07-24,1992,10000000,14356479,4356479,3.073113
13154,Showdown in Little Tokyo,1991-08-23,1991,8000000,2275557,-5724443,11.521011
13155,Return to Oz,1985-06-21,1985,25000000,11137801,-13862199,6.523262
13156,Secondhand Lions,2003-09-19,2003,0,0,0,8.636608
13158,Aqua Teen Hunger Force Colon Movie Film for Theaters,2007-04-13,2007,0,0,0,2.813335
13159,Georgia Rule,2007-05-11,2007,20000000,0,-20000000,7.281643
13160,Over Her Dead Body,2008-02-01,2008,10000000,0,-10000000,5.478127
13161,Big Stan,2007-06-06,2007,0,0,0,9.338858
13162,Blind Dating,2006-07-28,2006,0,834457,834457,3.691443
13163,Buying the Cow,2002-01-14,2002,0,0,0,7.922964
13166,Freddy Got Fingered,2001-04-18,2001,0,0,0,7.187919
13167,Mama's Boy,2007-12-14,2007,0,0,0,1.750448
13168,Smiley Face,2007-01-21,2007,0,8768,8768,3.799281
13169,The Baxter,2005-04-24,2005,0,0,0,2.896563
13170,The Boys & Girls Guide to Getting Down,2007-03-23,2007,0,0,0,0.412775
13171,The Ex,2006-12-01,2006,0,3091922,3091922,5.976385
13172,The Promotion,2008-06-06,2008,0,0,0,5.916489
13173,The Ten,2007-08-03,2007,0,0,0,3.902162
13177,Battle in Seattle,2007-09-07,2007,8000000,908847,-7091153,4.518646
13179,Tinker Bell,2008-10-27,2008,48000000,0,-48000000,9.066971
13180,Zeitgeist: Addendum,2008-10-02,2008,0,0,0,3.808933
13183,Watchmen,2009-03-05,2009,130000000,185258983,55258983,16.551503
13184,Bangkok Dangerous,2008-08-21,2008,45000000,42487390,-2512610,6.576009
13185,Kidulthood,2006-03-03,2006,994000,165000,-829000,5.230003
13186,Wrong Turn 2: Dead End,2007-08-25,2007,4000000,0,-4000000,16.34615
13187,A Charlie Brown Christmas,1965-12-09,1965,0,0,0,5.23652
13188,Scrooge,1951-10-31,1951,0,0,0,13.294639
13189,A Christmas Carol,1984-12-17,1984,0,0,0,7.199078
13190,Dead Space: Downfall,2008-10-27,2008,0,0,0,8.474973
13191,"War, Inc.",2008-04-28,2008,5000000,1296184,-3703816,4.800426
13192,Moonwalker,1988-10-29,1988,22000000,0,-22000000,15.276746
13193,Saved!,2004-01-21,2004,0,0,0,5.084509
13194,Highlander: The Search for Vengeance,2007-06-05,2007,0,0,0,3.137847
13195,Flawless,2007-09-01,2007,20000000,6819587,-13180413,6.496913
13196,Then She Found Me,2007-09-07,2007,0,0,0,4.536658
13197,10th & Wolf,2006-02-19,2006,8000000,143451,-7856549,3.034823
13198,Wristcutters: A Love Story,2006-01-24,2006,0,0,0,5.213094
13199,American Me,1992-03-13,1992,0,0,0,3.160917
13200,Red,2008-10-07,2008,2500000,0,-2500000,3.520622
13201,Deuces Wild,2002-05-03,2002,0,0,0,2.050252
13203,Son in Law,1993-07-02,1993,0,36448200,36448200,9.122718
13204,Hellboy Animated: Blood and Iron,2007-03-10,2007,0,0,0,6.942203
13205,Bambi II,2006-01-26,2006,0,0,0,7.79084
13206,A Complete History of My Sexual Failures,2008-01-19,2008,0,0,0,1.262727
13207,Friday the 13th,2009-02-11,2009,19000000,91379051,72379051,14.20229
13209,Offside,2006-05-26,2006,2500,0,-2500,1.52896
13209,Offside,2006-05-26,2006,2500,0,-2500,1.529879
13210,The Dam Busters,1955-05-16,1955,0,0,0,2.744345
13220,Splinter,2008-10-31,2008,0,124191,124191,7.498032
13221,The Kautokeino Rebellion,2008-01-18,2008,7300000,0,-7300000,0.920414
13222,The Devil and Daniel Johnston,2005-01-23,2005,0,0,0,1.584846
13223,Gran Torino,2008-12-09,2008,33000000,269958228,236958228,14.794228
13225,FernGully: The Last Rainforest,1992-04-10,1992,0,32710894,32710894,7.477944
13241,My Winnipeg,2007-09-07,2007,0,0,0,2.353003
13243,Meet Bill,2007-09-07,2007,5000000,346592,-4653408,6.226054
13245,Atanarjuat: The Fast Runner,2002-02-01,2002,1934000,3786801,1852801,1.135061
13246,A Garfield Christmas Special,1987-12-21,1987,0,0,0,1.630379
13247,A Muppet Family Christmas,1987-12-16,1987,0,0,0,1.176662
13249,Seraphim Falls,2006-09-13,2006,18000000,1196307,-16803693,5.034585
13250,Butterfly on a Wheel,2007-07-27,2007,20000000,0,-20000000,8.809053
13251,The Walker,2007-02-13,2007,10000000,0,-10000000,12.717598
13252,Cleaner,2007-09-11,2007,25000000,0,-25000000,8.351152
13253,Futurama: Bender's Game,2008-11-03,2008,0,0,0,5.829662
13254,The Living and the Dead,2006-09-23,2006,0,0,0,2.006734
13255,Conspiracy,2008-02-15,2008,0,0,0,1.282721
13256,Mutant Chronicles,2008-08-07,2008,8000000,2033165,-5966835,6.603748
13257,Mr. Woodcock,2007-09-14,2007,22000000,0,-22000000,9.461012
13258,Son of Rambow,2007-01-22,2007,4000000,6870249,2870249,7.391932
13259,American Teen,2008-07-25,2008,5000000,0,-5000000,1.106762
13260,Semi-Pro,2008-02-28,2008,0,33472850,33472850,6.733237
13274,Last Order: Final Fantasy VII,2005-09-13,2005,0,0,0,2.545247
13275,Annapolis,2006-01-27,2006,26000000,17496992,-8503008,5.450751
13277,Contract Killers,2008-03-13,2008,0,0,0,0.478268
13279,Lakeview Terrace,2008-09-19,2008,20000000,27640028,7640028,13.857624
13280,Kickin' It Old Skool,2007-04-27,2007,0,0,0,7.364206
13282,Death Race 2000,1975-04-27,1975,300000,8000000,7700000,6.064898
13283,Barbie as the Island Princess,2007-09-18,2007,0,0,0,8.935419
13284,Barbie: Fairytopia,2005-03-08,2005,0,0,0,7.097884
13285,Barbie Fairytopia: Mermaidia,2006-03-14,2006,0,0,0,10.464151
13291,Traitor,2008-08-23,2008,22000000,23530831,1530831,7.859606
13293,China O'Brien,1990-01-01,1990,0,0,0,0.774983
13296,Hokkabaz,2006-10-20,2006,0,0,0,1.366833
13299,Train Man,2005-06-04,2005,0,0,0,0.703244
13300,Hell Ride,2008-08-08,2008,0,194287,194287,5.208993
13305,Snow-White and Rose-Red,1979-07-05,1979,0,0,0,1.086508
13310,Let the Right One In,2008-01-26,2008,4000000,10785801,6785801,7.274237
13311,Holiday,2006-01-19,2006,0,0,0,1.030625
13312,Inside,2007-06-13,2007,3000000,0,-3000000,8.159445
13313,Beauty and the Beast: The Enchanted Christmas,1997-11-11,1997,0,0,0,8.169404
13315,"Big Bang Love, Juvenile A",2006-08-26,2006,0,0,0,1.521943
13317,The Aerial,2007-04-17,2007,0,0,0,1.59064
13318,The Bothersome Man,2006-05-26,2006,0,0,0,3.422864
13319,Frost Bite,2006-02-24,2006,0,0,0,2.068292
13320,Funny Face,1957-02-13,1957,0,0,0,5.461487
13321,Lifeboat,1944-01-11,1944,1590000,0,-1590000,7.773354
13333,Game of Death,1978-03-22,1978,0,0,0,9.592019
13335,Harold & Kumar Escape from Guantanamo Bay,2008-04-25,2008,12000000,43493123,31493123,13.065315
13336,Chrysalis,2007-06-25,2007,12000000,0,-12000000,2.022178
13337,Broken English,2007-01-01,2007,2000000,0,-2000000,1.798357
13338,Sione's Wedding,2006-03-29,2006,0,0,0,0.658538
13339,Three O'Clock High,1987-10-09,1987,0,3685862,3685862,3.552005
13341,Bad News Bears,2005-07-22,2005,30000000,34252847,4252847,4.469459
13342,Fast Times at Ridgemont High,1982-08-13,1982,4500000,27092880,22592880,14.658885
13343,The Ghost & Mr. Chicken,1966-01-20,1966,700000,0,-700000,1.907872
13346,Lucas,1986-03-28,1986,6000000,8200000,2200000,4.57535
13348,Helvetica,2007-09-12,2007,0,0,0,4.776619
13350,Scooby-Doo and the Ghoul School,1988-01-01,1988,0,0,0,2.852579
13351,Scooby-Doo in Arabian Nights,1994-09-03,1994,0,0,0,1.239774
13352,It's a Very Merry Muppet Christmas Movie,2002-11-29,2002,0,0,0,1.991539
13353,"It's the Great Pumpkin, Charlie Brown",1966-10-27,1966,0,0,0,6.588367
13354,"Chill Out, Scooby-Doo!",2007-09-04,2007,0,0,0,8.785888
13355,Scooby-Doo! Pirates Ahoy!,2006-01-01,2006,0,0,0,4.882939
13358,A Dennis the Menace Christmas,2007-11-10,2007,2000000,0,-2000000,1.215778
13359,Expelled: No Intelligence Allowed,2008-04-18,2008,3500000,7700000,4200000,1.787297
13360,Highlander V: The Source,2007-02-06,2007,13000000,0,-13000000,6.06417
13362,Taxi to the Dark Side,2007-04-30,2007,1000000,274661,-725339,6.415898
13363,The Man from Earth,2007-06-10,2007,0,0,0,9.29906
13364,Deliver Us from Evil,2006-06-24,2006,0,201275,201275,2.583226
13365,49 Up,2005-09-15,2005,0,238073,238073,0.769595
13368,White Christmas,1954-10-13,1954,0,0,0,6.723456
13369,Empire,2002-12-06,2002,4000000,18591272,14591272,2.148655
13370,A Mighty Wind,2003-04-16,2003,6000000,18750246,12750246,4.672036
13371,Sex Lives of the Potato Men,2004-02-20,2004,0,0,0,1.42169
13372,Outfoxed: Rupert Murdoch's War on Journalism,2004-07-14,2004,0,0,0,2.782194
13373,Millions,2005-04-08,2005,0,6584159,6584159,4.66886
13374,Ice Princess,2005-03-17,2005,25000000,27645491,2645491,9.313354
13376,Eight Crazy Nights,2002-11-27,2002,0,23833131,23833131,11.788185
13377,How the Grinch Stole Christmas!,1966-12-18,1966,315000,0,-315000,6.353239
13378,Mickey's Twice Upon a Christmas,2004-01-01,2004,0,0,0,5.512528
13380,One Magic Christmas,1985-11-22,1985,0,0,0,11.890036
13382,"Rudolph, the Red-Nosed Reindeer",1964-12-06,1964,0,0,0,7.129761
13383,Santa Claus,1959-11-26,1959,0,0,0,1.248299
13384,Kes,1969-11-18,1969,0,0,0,4.418373
13385,Brighton Rock,1947-12-12,1947,0,0,0,2.353181
13386,Ricomincio da tre,1981-03-05,1981,0,0,0,0.738954
13387,Transporter 3,2008-11-26,2008,30000000,108979549,78979549,9.296824
13389,Righteous Kill,2008-09-11,2008,60000000,73174566,13174566,7.094624
13390,Tortured,2008-09-10,2008,0,0,0,5.555685
13391,Vexille,2007-08-18,2007,0,0,0,9.797201
13393,My Father and My Son,2005-11-18,2005,0,0,0,1.712815
13394,Shrek the Halls,2007-11-28,2007,60000000,0,-60000000,7.081997
13396,The Snowman,1982-12-26,1982,0,0,0,7.373338
13397,The Year Without a Santa Claus,1974-12-10,1974,0,0,0,1.58382
13398,Tokyo Godfathers,2003-12-29,2003,0,0,0,6.288949
13400,Santa Claus Is Comin' to Town,1970-12-14,1970,0,0,0,2.503251
13401,The Accidental Husband,2008-02-29,2008,0,22707064,22707064,8.761268
13402,Re-cycle,2006-01-01,2006,0,0,0,3.062052
13403,Hedwig and the Angry Inch,2001-07-20,2001,0,0,0,4.446806
13405,The Children of Huang Shi,2008-07-03,2008,40000000,7400000,-32600000,14.622493
13406,Trainwreck: My Life as an Idiot,2007-06-14,2007,0,0,0,2.544958
13408,The Wash,2001-11-16,2001,7000000,10229331,3229331,2.483032
13409,State Property 2,2005-04-13,2005,0,1691706,1691706,0.318108
13411,Malibu's Most Wanted,2003-04-10,2003,0,0,0,4.025079
13412,Walk All Over Me,2007-01-01,2007,0,0,0,2.469353
13413,BURN¬∑E,2008-11-17,2008,0,0,0,8.003898
13414,Fifty Pills,2006-04-26,2006,0,0,0,5.796823
13415,Rikki-Tikki-Tavi,1975-01-09,1975,0,0,0,0.772841
13416,Friday Night Lights,2004-10-08,2004,30000000,61255921,31255921,13.041943
13417,Kronk's New Groove,2005-12-05,2005,0,0,0,7.680092
13428,Two Hands,1999-07-29,1999,0,0,0,9.289588
13429,Donkey Punch,2008-07-18,2008,0,0,0,2.804154
13430,Always - Sunset on Third Street,2005-11-11,2005,0,33053559,33053559,0.418197
13432,Since Otar Left,2003-09-17,2003,0,0,0,0.512099
13433,Japanese Story,2003-09-25,2003,0,0,0,5.17434
13434,Noam Chomsky: Distorted Morality,2003-01-01,2003,0,0,0,0.157048
13435,Antwone Fisher,2002-12-19,2002,12500000,23367586,10867586,10.944654
13436,13 Beloved,2006-10-04,2006,0,0,0,2.934419
13437,Avenging Angelo,2002-08-30,2002,0,0,0,4.802734
13438,Marooned in Iraq,2002-05-22,2002,0,0,0,0.073685
13439,The Tracker,2002-08-08,2002,0,0,0,1.236585
13440,The Truth About Charlie,2002-10-25,2002,0,0,0,2.372928
13441,Roger Dodger,2002-05-09,2002,0,1260761,1260761,3.529256
13442,Zig Zag,2002-03-10,2002,0,0,0,1.131639
13446,Withnail & I,1987-01-01,1987,0,0,0,14.316459
13448,Angels & Demons,2009-05-13,2009,150000000,356613439,206613439,22.211558
13455,Push,2009-02-06,2009,38000000,45465299,7465299,11.596222
13457,Magnificent Obsession,1954-08-07,1954,0,0,0,5.133906
13459,Barbie in 'A Christmas Carol',2008-07-01,2008,0,4496912,4496912,4.822398
13460,Doomsday,2008-03-14,2008,30000000,22211426,-7788574,13.436536
13461,Melissa P.,2005-11-18,2005,0,5151936,5151936,5.257142
13465,The Adventures of Ichabod and Mr. Toad,1949-10-05,1949,0,0,0,7.554977
13466,October Sky,1999-02-19,1999,0,0,0,6.652528
13468,Keane,2004-09-03,2004,0,0,0,1.936078
13470,Bury My Heart At Wounded Knee,2007-05-27,2007,0,0,0,2.633626
13471,Skate Or Die,2008-06-11,2008,0,0,0,1.084334
13474,P2,2007-11-09,2007,8000000,7766240,-233760,9.276709
13475,Star Trek,2009-05-06,2009,150000000,385680446,235680446,15.362632
13476,Win a Date with Tad Hamilton!,2004-01-23,2004,17000000,16980098,-19902,5.924226
13477,When in Rome,2010-01-29,2010,0,36699403,36699403,10.118113
13480,Ricky Gervais: Out of England - The Stand-Up Special,2008-11-15,2008,0,0,0,1.045271
13481,The Five Venoms,1978-08-12,1978,0,0,0,2.502956
13482,The Milagro Beanfield War,1988-03-18,1988,0,0,0,5.56568
13483,Awake,2007-11-28,2007,86000000,14373825,-71626175,7.076062
13484,The Foot Fist Way,2006-06-24,2006,79000,245000,166000,2.066141
13485,Holiday Inn,1942-08-04,1942,0,0,0,8.258968
13486,The Scorpion King: Rise of a Warrior,2008-07-19,2008,0,0,0,18.691187
13488,Katt Williams: It's Pimpin Pimpin,2008-11-11,2008,0,0,0,0.513891
13489,Lost Boys: The Tribe,2008-07-29,2008,0,0,0,4.560963
13490,Welcome Home Roscoe Jenkins,2008-02-08,2008,35000000,43650785,8650785,4.386145
13491,Arn: The Knight Templar,2007-12-17,2007,25000000,0,-25000000,7.294411
13492,Frontier(s),2007-07-01,2007,3000000,0,-3000000,8.602956
13493,College Road Trip,2008-03-07,2008,0,68397662,68397662,6.640014
13495,Alatriste,2006-09-01,2006,24000000,23321954,-678046,5.035414
13496,American Outlaws,2001-08-17,2001,35000000,13678913,-21321087,10.855383
13497,Drumline,2002-12-13,2002,20000000,57588485,37588485,5.270187
13498,Man of the House,2005-02-25,2005,40000000,0,-40000000,5.834626
13499,"Yours, Mine & Ours",2005-11-23,2005,45000000,72028752,27028752,10.238422
13501,The Good Night,2007-01-25,2007,15000000,20380,-14979620,8.031164
13503,Texas Rangers,2001-11-30,2001,0,0,0,4.090903
13505,The Perfect Score,2004-01-30,2004,0,0,0,6.2425
13506,Admiral,2008-06-06,2008,2000000,38135878,36135878,3.462653
13507,Intimate Enemies,2007-01-01,2007,9780000,0,-9780000,5.526637
13508,Who Killed the Electric Car?,2006-08-04,2006,1000000,1678874,678874,8.570312
13509,The Monster Squad,1987-08-14,1987,12000000,3769990,-8230010,7.075534
13510,Eden Lake,2008-09-12,2008,0,3983997,3983997,12.515435
13511,Rawhead Rex,1986-10-01,1986,0,0,0,3.497943
13514,Last Hurrah for Chivalry,1979-11-22,1979,0,0,0,0.549026
13515,Mirrors,2008-08-15,2008,35000000,72436439,37436439,8.612618
13516,Slacker Uprising,2007-09-27,2007,0,0,0,1.202312
13517,The Ugly Duckling and Me!,2006-09-10,2006,0,0,0,4.407038
13519,The Stand,1994-01-01,1994,28000000,0,-28000000,10.374919
13520,Festival At The Poolroom,1975-01-05,1975,0,0,0,0.833597
13521,Charlie And A Half,1974-01-01,1974,0,0,0,0.497614
13522,Arn: The Kingdom at Road's End,2008-08-22,2008,0,0,0,3.861969
13523,Sex Drive,2008-10-16,2008,19000000,18755936,-244064,9.106146
13524,Battle of the Bulge,1965-04-02,1965,0,0,0,4.612568
13526,The Weight of Water,2000-09-25,2000,16000000,109130,-15890870,2.488424
13528,Gaslight,1944-05-04,1944,2068000,0,-2068000,14.545058
13529,Daft Punk's Electroma,2006-03-24,2006,0,0,0,2.129522
13531,Empire Records,1995-09-22,1995,0,0,0,7.188728
13532,Fanboys,2009-02-06,2009,0,948753,948753,5.785775
13533,Free Enterprise,1998-06-04,1998,0,0,0,0.898365
13534,How to Rob a Bank,2007-01-25,2007,0,0,0,3.210918
13535,Rubber Johnny,2005-06-20,2005,0,0,0,1.707514
13536,City By The Sea,2002-09-06,2002,40000000,22433915,-17566085,3.903016
13537,Shattered Glass,2003-11-14,2003,6000000,2944752,-3055248,6.0872
13538,Straightheads,2007-04-27,2007,0,0,0,5.112618
13539,Here On Earth,2000-03-23,2000,0,0,0,3.199357
13541,The Colour of Magic,2008-03-23,2008,0,0,0,9.762587
13542,Red Dust,2004-01-01,2004,0,0,0,1.757911
13544,FB: Fighting Beat,2007-01-01,2007,0,0,0,0.66926
13548,Borderland,2007-11-09,2007,0,0,0,4.275536
13549,Burnt Offerings,1976-10-18,1976,0,0,0,2.877095
13550,The Changeling,1980-03-27,1980,0,12000000,12000000,5.821597
13551,The Dead Girl,2006-11-07,2006,0,0,0,4.028773
13552,The Doom Generation,1995-10-27,1995,0,0,0,7.120806
13553,The Driller Killer,1979-06-15,1979,0,0,0,2.773173
13554,Eight Men Out,1988-09-02,1988,0,0,0,4.861698
13555,The Funhouse,1981-03-13,1981,0,0,0,3.99005
13557,The Gravedancers,2005-11-03,2005,0,0,0,3.137916
13558,H.H. Holmes: America's First Serial Killer,2004-01-01,2004,0,0,0,0.703207
13559,The Mangler,1995-03-03,1995,0,0,0,4.299199
13560,Max,2002-09-10,2002,11000000,0,-11000000,5.740474
13561,Murder Party,2007-01-01,2007,190000,0,-190000,2.72115
13562,My Man Godfrey,1936-09-17,1936,0,0,0,5.480098
13563,Puddle Cruiser,1996-01-01,1996,0,0,0,1.09859
13564,Return to House on Haunted Hill,2007-10-03,2007,0,0,0,14.820751
13567,Sleepaway Camp,1983-11-18,1983,350000,0,-350000,6.224311
13569,Thr3e,2006-12-01,2006,0,0,0,1.724012
13570,Tourist Trap,1979-01-25,1979,0,0,0,3.414839
13571,True Colors,1991-03-15,1991,0,0,0,1.514134
13572,Twisted,2004-02-27,2004,50000000,25195000,-24805000,5.376246
13573,The United States of Leland,2003-01-18,2003,0,343816,343816,10.087404
13574,Year of the Dog,2007-04-13,2007,0,0,0,2.187418
13576,This Is It,2009-10-28,2009,60000000,0,-60000000,7.015456
13577,Lower Learning,2008-10-10,2008,0,0,0,1.401827
13579,The Longshots,2008-08-22,2008,0,0,0,5.48672
13580,The Spy Who Came in from the Cold,1965-12-16,1965,0,0,0,6.279114
13581,Dead of Night,1945-09-04,1945,0,0,0,6.954993
13584,Bill Bailey: Part Troll,2004-11-22,2004,0,0,0,0.908328
13585,Bill Bailey: Tinselworm,2008-11-10,2008,0,0,0,0.177686
13586,"Dylan Moran: Like, Totally...",2006-11-13,2006,0,0,0,0.688381
13587,Eddie Izzard: Circle,2002-11-18,2002,0,0,0,1.743017
13589,Eddie Izzard: Dress to Kill,1999-06-14,1999,0,0,0,1.07289
13590,Eddie Izzard: Glorious,1997-11-17,1997,0,0,0,8.2978
13591,Eddie Izzard: Unrepeatable,1994-10-03,1994,0,0,0,0.438574
13592,Eddie Izzard: Sexie,2003-11-26,2003,0,0,0,0.37221
13595,Airheads,1994-08-05,1994,0,0,0,7.09232
13596,My Best Friend's Girl,2008-09-19,2008,20000000,36620508,16620508,14.114136
13597,Labyrinth,1986-06-27,1986,25000000,12729917,-12270083,13.009688
13600,City of Ember,2008-10-07,2008,55000000,17869048,-37130952,8.061467
13610,Christmas Cottage,2008-01-01,2008,0,0,0,1.696366
13611,Heckler,2007-01-01,2007,250000,0,-250000,1.463205
13612,Cheech & Chong's Next Movie,1980-07-18,1980,0,41675194,41675194,6.194478
13613,Day of the Dead,2008-04-08,2008,18000000,0,-18000000,6.477482
13614,Katyn,2007-09-21,2007,5200000,14723313,9523313,4.230046
13616,Children of Glory,2006-10-23,2006,0,0,0,1.221554
13617,The Man Who Loved Yngve,2008-02-15,2008,2200000,0,-2200000,0.976916
13618,Who's Your Daddy?,2004-01-07,2004,0,0,0,12.241881
13621,Switch,2007-10-26,2007,2400000,0,-2400000,0.990967
13626,Island of Lost Souls,2007-02-09,2007,0,0,0,2.918721
13630,United,2003-08-22,2003,0,0,0,0.246165
13632,MacGyver: Trail to Doomsday,1994-11-24,1994,0,0,0,3.370861
13633,Bad Boys,1983-03-25,1983,0,9190819,9190819,3.313524
13634,One Way Passage,1932-10-22,1932,0,0,0,1.777029
13635,Mesrine: Killer Instinct,2008-10-22,2008,0,31055440,31055440,4.675264
13636,Bigger Stronger Faster*,2008-05-30,2008,0,307811,307811,6.108182
13637,Sukiyaki Western Django,2007-09-15,2007,3800000,2725258,-1074742,9.239882
13639,The Letter for the King,2008-07-16,2008,0,0,0,1.586223
13640,Superman: Doomsday,2007-09-18,2007,3500000,0,-3500000,7.879229
13641,The Air I Breathe,2007-02-07,2007,0,0,0,8.876157
13643,George Carlin: It's Bad for Ya!,2008-03-01,2008,0,0,0,2.31176
13644,All I Want For Christmas,1991-11-08,1991,0,14812000,14812000,2.015641
13646,"Moscow, Belgium",2008-01-30,2008,560000,1500000,940000,1.572904
13647,The Invincible Iron Man,2007-01-23,2007,0,5300000,5300000,3.478962
13648,Resident Evil: Degeneration,2008-02-13,2008,0,0,0,8.156555
13649,High School Musical 2,2007-08-17,2007,0,7000000,7000000,6.529094
13650,Delirious,2006-09-26,2006,0,0,0,4.297666
13651,Waiting for the Hearse,1985-05-06,1985,0,0,0,1.224559
13652,Ca$h,2008-04-23,2008,0,0,0,4.743279
13653,The Aura,2005-09-15,2005,0,0,0,3.240132
13654,101 Dalmatians II: Patch's London Adventure,2003-01-21,2003,0,0,0,10.398905
13655,Camp Rock,2008-06-20,2008,0,0,0,5.840379
13665,Arthur,1981-07-17,1981,7000000,95461682,88461682,14.911301
13666,The Wolf Man,1941-12-12,1941,0,0,0,5.386984
13667,Better Off Dead...,1985-10-11,1985,0,10297601,10297601,8.994189
13668,Catch and Release,2006-10-20,2006,25000000,16158487,-8841513,5.953413
13669,Christmas in Connecticut,1945-12-17,1945,0,0,0,8.568803
13671,The Music Man,1962-06-19,1962,0,8000000,8000000,3.391161
13672,JCVD,2008-06-04,2008,6000000,276891,-5723109,6.670933
13673,Christmas with the Kranks,2004-11-24,2004,60000000,0,-60000000,7.584918
13675,Frosty the Snowman,1969-12-07,1969,0,0,0,4.305337
13676,The Little Mermaid: Ariel's Beginning,2008-08-26,2008,0,0,0,0.415606
13678,The Last Trapper,2004-12-12,2004,8000000,0,-8000000,1.614918
13679,Kirikou and the Wild Beasts,2005-12-07,2005,0,0,0,4.040988
13680,The Game Plan,2007-09-28,2007,22000000,147880543,125880543,9.627676
13681,Places in the Heart,1984-09-11,1984,0,0,0,3.712567
13682,Pooh's Heffalump Movie,2005-02-11,2005,0,0,0,10.096263
13683,Tarzan & Jane,2002-06-24,2002,0,0,0,6.237055
13685,Bottle Rocket,1996-02-21,1996,7000000,560069,-6439931,6.904831
13687,I Want Candy,2007-03-23,2007,0,0,0,7.727661
13688,CJ7,2008-01-30,2008,0,47301471,47301471,5.917685
13689,Peaceful Warrior,2006-03-30,2006,0,0,0,10.398351
13690,Open Season 2,2008-09-24,2008,0,0,0,9.031276
13691,Piglet's Big Movie,2003-03-16,2003,0,0,0,8.516475
13692,August,2008-05-16,2008,0,0,0,1.504504
13696,Angels with Dirty Faces,1938-11-26,1938,0,0,0,9.937706
13697,Grand Canyon,1991-12-25,1991,0,0,0,4.422985
13698,Gung Ho,1986-03-13,1986,0,36611610,36611610,6.853782
13699,The Happy Elf,2005-12-02,2005,53000000,0,-53000000,1.807233
13700,Home on the Range,2004-04-02,2004,110000000,103951461,-6048539,8.555544
13701,Immortal Beloved,1994-12-16,1994,120,0,-120,7.983666
13702,A Dirty Shame,2004-09-12,2004,15000000,1914166,-13085834,7.665431
13703,Less Than Zero,1987-11-06,1987,1,12396383,12396382,4.028679
13704,License to Drive,1988-07-06,1988,8000000,22433275,14433275,9.631158
13707,The Vagabond,1916-07-10,1916,0,0,0,4.023393
13710,The Merry Widow,2007-11-01,2007,0,0,0,5.188641
13713,Jean-Philippe,2006-04-05,2006,0,0,0,2.872268
13715,At Close Range,1986-04-18,1986,6500000,2347000,-4153000,10.092348
13721,Half Past Dead 2,2007-05-11,2007,1500000,0,-1500000,7.297259
13722,Mercenary for Justice,2006-04-25,2006,15000000,0,-15000000,2.998537
13723,Missionary Man,2007-11-29,2007,2000000,0,-2000000,1.367062
13726,A Secret,2007-10-03,2007,0,0,0,2.546955
13728,Locked Out,2006-04-05,2006,0,0,0,2.653756
13730,Black Box,2005-11-02,2005,0,0,0,3.45318
13732,The Red Inn,2007-12-05,2007,0,0,0,2.691581
13733,Le Cactus,2005-12-14,2005,0,0,0,1.439169
13734,Frenchmen 2,2007-10-24,2007,0,0,0,1.440118
13739,Quatre √©toiles,2005-01-01,2005,0,0,0,0.934409
13741,2 Alone in Paris,2008-06-25,2008,0,0,0,4.620808
13742,Satan,2006-02-01,2006,0,0,0,3.620977
13746,Thirty-Five Something,2005-03-23,2005,0,0,0,1.992752
13748,A Ticket to Space,2006-01-16,2006,0,2,2,3.668405
13751,Akeelah and the Bee,2006-04-28,2006,8000000,18948425,10948425,5.052049
13752,Max Manus: Man of War,2008-12-18,2008,8,0,-8,4.75876
13754,Tekkonkinkreet,2006-12-11,2006,0,0,0,7.020628
13755,A Town Without Christmas,2001-12-16,2001,0,0,0,1.233926
13757,Melody Time,1948-05-27,1948,2000000,0,-2000000,6.771815
13759,The Nutcracker Prince,1990-01-01,1990,0,0,0,2.185471
13761,Pocahontas II: Journey to a New World,1998-08-04,1998,0,0,0,8.763892
13762,The Private Eyes,1980-04-17,1980,0,0,0,1.626485
13763,Purple Rain,1984-07-27,1984,7200000,68392977,61192977,9.190328
13764,Santa Claus: The Movie,1985-10-29,1985,50000000,23717291,-26282709,11.690532
13765,Scrooge,1970-11-05,1970,0,0,0,10.012358
13766,SpaceCamp,1986-06-06,1986,18000000,9697739,-8302261,6.41742
13767,The Santa Clause 3: The Escape Clause,2006-11-01,2006,12000000,84500122,72500122,6.829528
13768,Tuck Everlasting,2002-10-11,2002,15000000,19158074,4158074,5.951492
13770,Backroads,1977-06-27,1977,0,0,0,0.627366
13771,Venus,2006-09-02,2006,0,0,0,3.740068
13774,The Last Joint Venture,2008-08-29,2008,0,0,0,0.465658
13775,Macbeth,2006-09-21,2006,0,0,0,1.833699
13776,Diner,1982-04-02,1982,0,0,0,5.077092
13777,He Died with a Felafel in His Hand,2001-08-30,2001,0,0,0,1.312959
13778,Dickie Roberts: Former Child Star,2003-09-05,2003,0,0,0,6.957601
13783,Breaker Morant,1980-05-15,1980,107,0,-107,6.313297
13784,Black Friday,1940-04-12,1940,0,0,0,1.1357
13785,Best in Show,2000-09-19,2000,0,0,0,6.256848
13787,Holy Smoke!,1999-09-04,1999,0,0,0,3.176804
13788,The Unborn,2009-01-09,2009,16000000,76514050,60514050,7.108555
13791,How to Kill Your Neighbor's Dog,2002-02-22,2002,0,0,0,6.38471
13792,Last Train to Freo,2006-09-14,2006,0,0,0,0.105567
13793,Flashbacks of a Fool,2008-10-17,2008,0,1107542,1107542,3.936673
13794,Africa: The Serengeti,1994-03-31,1994,0,0,0,1.649097
13795,Alaska: Spirit of the Wild,1998-09-03,1998,0,0,0,1.246035
13797,Feast II: Sloppy Seconds,2008-10-07,2008,2000000,0,-2000000,8.008971
13798,Thunderclump,1974-09-26,1974,0,0,0,0.524508
13802,Colour Me Kubrick,2005-01-01,2005,0,0,0,2.555216
13803,Amusement,2008-10-09,2008,6000000,0,-6000000,4.076001
13804,Fast & Furious,2009-04-02,2009,85000000,363164265,278164265,1.498902
13805,Disaster Movie,2008-08-29,2008,25000000,14109284,-10890716,11.634132
13807,Exiled,2006-09-06,2006,4500000,0,-4500000,8.311721
13808,Strictly Sexual,2008-01-01,2008,0,0,0,1.496824
13809,RockNRolla,2008-09-04,2008,18000000,25739015,7739015,7.263988
13811,Knowing,2009-03-19,2009,50000000,155446362,105446362,9.806904
13812,Quarantine,2008-10-10,2008,12000000,40855419,28855419,6.140116
13813,Defiance,2008-12-31,2008,32000000,51155219,19155219,13.990891
13815,Fresh,1994-08-24,1994,0,0,0,3.970215
13816,Idlewild,2006-08-25,2006,0,0,0,1.747683
13817,Head On,1998-08-13,1998,0,378667,378667,3.466204
13818,Heartburn,1986-07-25,1986,0,0,0,16.071191
13819,Laurel Canyon,2002-05-18,2002,0,0,0,3.672246
13820,Repo Man,1984-02-20,1984,1500000,2300000,800000,6.357559
13821,The Boys,1998-05-07,1998,0,0,0,1.239074
13823,The Power of One,1992-09-17,1992,0,0,0,14.14735
13824,Superstar,1999-10-08,1999,0,0,0,4.155147
13825,The Lazarus Project,2008-10-21,2008,9750000,558000,-9192000,11.387338
13827,"Surfer, Dude",2008-09-05,2008,6000000,69497,-5930503,2.023166
13830,Shottas,2002-02-27,2002,200000,0,-200000,2.014035
13834,Missing in America,2005-01-01,2005,0,0,0,1.337769
13835,Real Time,2008-11-07,2008,0,0,0,0.546307
13836,Race to Witch Mountain,2009-03-12,2009,50000000,106303988,56303988,8.176147
13841,Rad,1986-03-21,1986,0,2015882,2015882,5.624953
13842,Broken Bridges,2006-09-08,2006,0,251775,251775,1.120498
13847,Alibi,1929-04-20,1929,0,0,0,0.976106
13848,Stuck,2007-05-21,2007,5000000,0,-5000000,4.964839
13849,The Cottage,2008-02-07,2008,0,0,0,9.459594
13850,Song of the South,1946-11-12,1946,0,0,0,4.045635
13851,Batman: Gotham Knight,2008-07-03,2008,3500000,0,-3500000,10.178874
13852,The Castle,1997-04-10,1997,786675,861789,75114,4.337545
13853,The Clan of the Cave Bear,1986-01-17,1986,15000000,0,-15000000,10.750748
13855,The Chaser,2008-02-14,2008,0,0,0,7.062323
13856,Special,2006-01-30,2006,1000000,7202,-992798,2.003309
13861,Road to Singapore,1940-03-22,1940,0,0,0,1.226779
13885,Sweeney Todd: The Demon Barber of Fleet Street,2007-12-20,2007,50000000,152000000,102000000,10.038401
13888,Return to the Blue Lagoon,1991-08-02,1991,11000000,2807854,-8192146,8.929393
13889,Madadayo,1993-04-17,1993,0,0,0,2.012228
13891,Citizen Ruth,1996-12-13,1996,3000000,153155,-2846845,2.225234
13892,Scarfies,1999-08-05,1999,0,0,0,0.83615
13894,Sharkwater,2006-09-11,2006,0,0,0,2.814765
13898,The Circle,2000-09-08,2000,0,0,0,1.629075
13899,Dead or Alive 2: Birds,2000-12-02,2000,0,0,0,1.147692
13903,The Wizard of Gore,2007-06-22,2007,0,0,0,6.731577
13905,Farscape: The Peacekeeper Wars,2004-01-01,2004,0,0,0,5.715534
13907,Kurt & Courtney,1998-02-27,1998,0,0,0,1.362407
13908,The Master of Disguise,2002-08-02,2002,0,0,0,4.659087
13909,She Wore a Yellow Ribbon,1949-10-22,1949,1600000,5400000,3800000,7.715087
13910,Death Defying Acts,2007-09-13,2007,20000000,8380329,-11619671,4.522772
13911,Monkey Business,1931-09-19,1931,0,0,0,2.513358
13912,Horse Feathers,1932-08-19,1932,0,0,0,5.17213
13913,Animal Crackers,1930-08-28,1930,0,0,0,4.750686
13914,Heavyweights,2007-01-18,2007,0,0,0,0.874698
13915,Waydowntown,2000-01-01,2000,555000,0,-555000,0.506962
13916,Shooting Gallery,2005-12-26,2005,0,0,0,3.346751
13919,The Chumscrubber,2005-06-08,2005,0,0,0,4.465962
13920,Radio,2003-10-24,2003,32000000,52277485,20277485,5.81647
13922,The Great Raid,2005-08-12,2005,80000000,10166502,-69833498,14.987902
13923,A Bright Shining Lie,1998-01-01,1998,0,0,0,1.66849
13924,The Adventures of Andr√© and Wally B.,1984-12-17,1984,0,0,0,3.466912
13925,Luxo Jr.,1986-08-17,1986,0,0,0,7.160378
13926,Red's Dream,1987-08-17,1987,0,0,0,3.907112
13927,Tin Toy,1988-08-01,1988,0,0,0,6.058028
13928,Knick Knack,1989-01-01,1989,0,0,0,5.509405
13929,Geri's Game,1997-11-24,1997,0,0,0,4.768849
13930,For the Birds,2000-11-01,2000,0,0,0,11.209398
13931,Mike's New Car,2002-05-24,2002,0,0,0,6.816147
13932,Jack-Jack Attack,2004-12-31,2004,0,0,0,5.588364
13933,One Man Band,2005-06-21,2005,0,0,0,4.410709
13934,Mater and the Ghostlight,2006-07-27,2006,0,0,0,7.111223
13935,When Trumpets Fade,1998-06-27,1998,0,0,0,3.923738
13936,Oklahoma!,1955-10-10,1955,0,0,0,8.455348
13937,Raising Cain,1992-08-07,1992,12000000,37170057,25170057,8.816951
13938,The Last Dragon,1985-03-22,1985,10000000,25754284,15754284,6.830599
13939,Death Wish,1974-07-24,1974,3000000,22000000,19000000,12.968011
13942,The Alphabet Killer,2008-11-07,2008,0,0,0,3.076072
13943,Suburban Mayhem,2006-10-26,2006,0,0,0,1.385838
13944,Passengers,2008-09-26,2008,25000000,2000000,-23000000,6.274736
13945,The Sword and the Sorcerer,1982-04-01,1982,4000000,39103425,35103425,3.523637
13946,The Rage,2007-12-01,2007,0,0,0,1.299664
13948,An American Carol,2008-10-03,2008,20000000,7000000,-13000000,2.151159
13949,Persuasion,2007-04-01,2007,0,0,0,6.955841
13950,All About the Benjamins,2002-03-08,2002,14000000,25482931,11482931,3.909079
13954,Alien Raiders,2008-09-21,2008,0,0,0,8.091476
13955,Beethoven's Big Break,2008-12-26,2008,0,0,0,12.818481
13956,Fly Me to the Moon,2008-08-15,2008,25000000,0,-25000000,4.729184
13957,Closing the Ring,2007-09-14,2007,23000000,0,-23000000,10.320049
13958,The King of Kong,2007-08-17,2007,0,0,0,5.376821
13960,ATL,2006-03-31,2006,20000000,21170563,1170563,2.582818
13962,Blank Check,1994-02-11,1994,13000000,0,-13000000,12.960346
13963,The Last Waltz,1978-05-01,1978,0,321952,321952,2.969857
13964,The Machine Girl,2008-02-07,2008,0,0,0,2.952202
13965,Return to Snowy River,1988-03-24,1988,0,0,0,0.652283
13966,Maybe Baby,2000-06-02,2000,0,0,0,2.213463
13967,Miss Potter,2006-12-03,2006,30000000,35078241,5078241,8.599342
13968,Jump In!,2007-04-27,2007,0,0,0,8.283776
13969,First Daughter,2004-09-24,2004,30000000,0,-30000000,7.712415
13971,Wild Child,2008-01-01,2008,20000000,21972336,1972336,10.420849
13972,The Women,2008-09-12,2008,16000000,50007546,34007546,6.62363
13973,Choke,2008-09-26,2008,3000000,3830137,830137,7.589546
13975,In the Electric Mist,2009-04-15,2009,0,0,0,6.666455
13976,Dylan Moran: Monster,2004-11-15,2004,0,0,0,0.786409
13979,Day Night Day Night,2006-05-25,2006,0,0,0,0.278551
13980,Sword of the Stranger,2007-09-29,2007,0,0,0,5.648328
13981,Appleseed: Ex Machina,2007-10-19,2007,0,0,0,5.889896
13982,8 Heads in a Duffel Bag,1997-04-18,1997,0,0,0,5.666701
13984,Fubar,2002-05-24,2002,350000,0,-350000,1.308643
13986,Dil To Pagal Hai,1997-10-30,1997,1300000,11000000,9700000,2.161941
13988,The Art of War II: Betrayal,2008-08-12,2008,0,0,0,2.67815
13989,24: Redemption,2008-11-23,2008,0,0,0,5.982091
13990,The Wackness,2008-07-03,2008,6000000,2899975,-3100025,5.598338
13991,College,2008-08-28,2008,7000000,6230276,-769724,10.36168
13993,Turn the River,2008-05-09,2008,0,0,0,4.035308
13994,Romance & Cigarettes,2005-09-13,2005,0,2945242,2945242,2.36594
13995,Captain America,1990-12-14,1990,10000000,0,-10000000,11.228156
13996,Bottle Shock,2008-08-06,2008,5000000,4040588,-959412,3.334353
13997,Black Sheep,1996-02-01,1996,0,32,32,8.963037
13998,Margot at the Wedding,2007-08-31,2007,10000000,0,-10000000,9.374829
14000,Anamorph,2007-09-21,2007,0,0,0,6.410775
14001,Dead Silence,2007-03-16,2007,20000000,22217407,2217407,10.763622
14002,Baraka,1992-09-15,1992,4000000,0,-4000000,9.925348
14003,Fullmetal Alchemist the Movie: Conqueror of Shamballa,2005-07-21,2005,0,0,0,9.515415
14005,Terror Firmer,1999-10-29,1999,0,0,0,3.456735
14008,Cadet Kelly,2002-03-07,2002,0,0,0,4.392389
14011,Justice League: The New Frontier,2008-02-26,2008,3500000,5231128,1731128,7.031719
14012,Flicka,2006-10-20,2006,15000000,21000000,6000000,3.94159
14013,BASEketball,1998-07-28,1998,0,7027290,7027290,10.107454
14014,The Hammer,2007-04-01,2007,0,0,0,1.46346
14016,Mad Detective,2007-11-29,2007,0,0,0,2.061375
14019,Ex Drummer,2007-01-31,2007,0,0,0,3.624061
14021,One Missed Call 2,2005-02-05,2005,0,0,0,2.327253
14022,Slacker,1990-07-27,1990,0,0,0,4.520146
14024,Raise Your Voice,2004-08-10,2004,15000000,14867514,-132486,4.387004
14025,Lake Dead,2007-11-09,2007,0,0,0,1.104265
14028,Behind Enemy Lines III: Colombia,2009-01-06,2009,0,0,0,3.146901
14029,Demons,1985-10-04,1985,1800000,0,-1800000,11.477701
14030,"Hello, Dolly!",1969-12-12,1969,24000000,33208099,9208099,8.407519
14033,Soul Survivors,2001-09-06,2001,0,0,0,3.076331
14034,What's the Worst That Could Happen?,2001-05-31,2001,45000000,0,-45000000,6.739365
14035,Meatballs,1979-06-28,1979,0,0,0,6.613063
14040,American Flyers,1985-08-16,1985,0,1400000,1400000,5.50751
14041,Civic Duty,2006-04-26,2006,0,0,0,1.321251
14043,Nancy Drew,2007-06-15,2007,0,0,0,5.172308
14044,Assembly,2007-10-09,2007,16000000,34786960,18786960,7.404835
14047,The Great Debaters,2007-12-27,2007,15000000,30226144,15226144,8.735448
14048,Man on Wire,2008-07-25,2008,0,2957978,2957978,8.359021
14050,Recount,2008-05-28,2008,0,0,0,3.402014
14052,Revenge of the Nerds,1984-07-20,1984,0,0,0,5.780761
14053,Slap Shot 3: The Junior League,2008-12-17,2008,4500000,0,-4500000,1.158017
14054,Snow Angels,2008-03-07,2008,0,414404,414404,5.080935
14055,Starter for 10,2006-09-13,2006,8,21,13,5.140016
14057,Trust the Man,2005-09-01,2005,9000000,0,-9000000,10.184628
14059,Snow Buddies,2008-02-05,2008,0,0,0,5.71765
14061,The Edge of Love,2008-05-15,2008,0,0,0,6.179073
14062,.45,2006-11-30,2006,5000000,0,-5000000,9.785051
14063,Adrift in Manhattan,2007-01-10,2007,4000000,0,-4000000,1.844661
14064,Ten Canoes,2006-06-29,2006,2000000,300000,-1700000,1.372493
14066,"Romulus, My Father",2007-05-19,2007,0,0,0,1.09486
14067,Thunderstruck,2004-05-20,2004,0,0,0,0.126048
14069,The Girl Who Leapt Through Time,2006-07-15,2006,0,3800000,3800000,12.430158
14070,Ghajini,2008-12-25,2008,9100000,76000000,66900000,4.23908
14071,Dostana,2008-11-13,2008,10000000,20000000,10000000,2.532958
14072,Rab Ne Bana Di Jodi,2008-12-11,2008,0,0,0,4.001251
14073,Jodhaa Akbar,2008-02-15,2008,8376800,13000000,4623200,12.237488
14074,Wolf,2008-04-04,2008,0,0,0,0.245543
14075,The Fifth Commandment,2008-08-21,2008,0,0,0,1.679378
14076,Shoot on Sight,2008-08-22,2008,0,0,0,1.38264
14078,Morgan P√•lsson - V√§rldsreporter,2008-02-22,2008,0,0,0,0.28763
14086,Agatha and the Storm,2004-04-27,2004,0,0,0,1.159325
14087,Barefoot Gen,1983-07-21,1983,0,0,0,2.28696
14088,Barefoot Gen 2,1986-06-14,1986,0,0,0,2.276585
14089,Christmas on Mars,2008-11-11,2008,0,0,0,0.315741
14091,Code Rush,2000-04-25,2000,0,0,0,0.108611
14092,Ghost in the Shell 2.0,2008-07-12,2008,0,0,0,8.820107
14096,The Magician,2005-06-18,2005,0,0,0,0.156075
14097,9th Company,2005-09-19,2005,9500000,24000000,14500000,9.586723
14098,100 Feet,2008-07-22,2008,10000000,0,-10000000,5.325375
14103,Allan Quatermain and the Temple of Skulls,2008-04-29,2008,50000,0,-50000,0.75143
14105,Already Dead,2007-12-11,2007,0,0,0,0.883553
14108,The Weather Underground,2002-01-01,2002,0,0,0,1.464497
14111,Battle For Haditha,2007-09-11,2007,0,0,0,2.244393
14112,Auto Focus,2002-10-18,2002,7000000,2062066,-4937934,7.936578
14113,Zoom,2006-08-11,2006,35000000,12506188,-22493812,11.967444
14114,You Got Served,2004-01-30,2004,0,0,0,3.707216
14117,Calamity Jane,1953-11-04,1953,0,0,0,5.587033
14118,Dedication,2007-01-22,2007,0,0,0,2.082066
14120,End of the Spear,2005-12-02,2005,0,0,0,0.881335
14123,Bratz,2007-08-03,2007,0,0,0,9.033651
14125,Captivity,2007-03-09,2007,17000000,2626800,-14373200,8.687797
14126,Catacombs,2007-06-01,2007,0,0,0,7.095063
14127,Cherry Crush,2007-02-16,2007,0,0,0,1.935535
14128,Cinderella II: Dreams Come True,2002-02-23,2002,5000000,0,-5000000,8.002712
14134,Main Hoon Na,2004-04-30,2004,0,0,0,2.869463
14135,Bad Boy Bubby,1993-09-01,1993,750000,0,-750000,10.521204
14136,The Love Bug,1968-12-22,1968,0,0,0,10.091707
14137,Beer League,2006-09-15,2006,0,0,0,1.521008
14138,Black Water,2007-06-01,2007,700,0,-700,7.930423
14139,Timecrimes,2007-09-20,2007,2600000,553198,-2046802,8.623982
14140,Herbie Goes To Monte Carlo,1977-06-24,1977,0,0,0,4.705091
14141,Balls Out: The Gary Houseman Story,2009-01-13,2009,0,0,0,3.0558
14142,Columbus Day,2008-08-29,2008,0,0,0,4.363217
14143,The Devil's Ground,2008-05-19,2008,0,0,0,0.726935
14144,Daddy Day Camp,2007-08-08,2007,6000000,18197398,12197398,5.414213
14145,Dark Floors,2008-02-06,2008,4300000,0,-4300000,2.889932
14147,DeVour,2005-05-31,2005,0,0,0,2.475365
14148,The Flock,2007-08-04,2007,0,0,0,11.635191
14154,War Games: The Dead Code,2008-07-29,2008,0,0,0,12.629921
14157,Impulse,1984-09-28,1984,0,0,0,0.47699
14158,Jackass 2.5,2007-12-18,2007,0,0,0,8.585765
14159,Aaja Nachle,2007-11-30,2007,0,3800000,3800000,5.097788
14160,Up,2009-05-13,2009,175000000,735099082,560099082,19.330884
14161,2012,2009-10-10,2009,200000000,769653595,569653595,16.698628
14163,Chak De! India,2007-08-10,2007,0,19300000,19300000,4.842323
14164,Dragonball Evolution,2009-04-01,2009,100000000,0,-100000000,8.876305
14166,Pretty Persuasion,2005-01-22,2005,0,0,0,9.880711
14167,Standing Still,2005-01-02,2005,1700000,12762,-1687238,2.095106
14168,3:10 to Yuma,1957-08-07,1957,0,0,0,15.931069
14169,Arizona Colt,1966-08-27,1966,0,0,0,1.457101
14170,Funny Farm,1988-06-03,1988,0,0,0,11.303489
14171,Home of the Brave,2006-12-15,2006,12000000,0,-12000000,4.068478
14172,Wake of Death,2004-12-28,2004,0,0,0,9.866744
14173,Princess,2006-06-16,2006,8,0,-8,3.879014
14174,Lie with Me,2005-09-10,2005,2200000,0,-2200000,9.317941
14175,Valiant,2005-03-25,2005,35000000,19478106,-15521894,11.836827
14177,Beauty Shop,2005-06-02,2005,25000000,36351350,11351350,6.795949
14180,Submerged,2005-05-06,2005,15000000,0,-15000000,3.860361
14181,Boiler Room,2000-02-18,2000,26000000,28780255,2780255,8.518425
14190,The Black Lapp,2003-04-11,2003,0,0,0,1.095434
14191,Aquamarine,2006-03-03,2006,12000000,23006849,11006849,11.29062
14193,Tashan,2008-04-25,2008,0,0,0,0.868335
14194,Dhoom 2,2006-11-24,2006,11000000,46396427,35396427,3.81393
14195,Cecil B. Demented,2000-05-17,2000,10000000,0,-10000000,7.000983
14196,Garden Party,2008-07-11,2008,0,0,0,2.061031
14197,My Sassy Girl,2008-05-26,2008,0,0,0,6.318475
14198,Criminal,2004-10-07,2004,0,0,0,2.93151
14199,The Adventures of Sharkboy and Lavagirl,2005-06-10,2005,50000000,69425966,19425966,6.477862
14201,The U.S. vs. John Lennon,2006-09-15,2006,0,0,0,1.337104
14202,The Painted Veil,2006-12-09,2006,19400000,0,-19400000,11.370183
14204,Ping Pong Playa,2007-01-01,2007,0,0,0,0.841644
14205,Holding Trevor,2007-06-16,2007,0,0,0,1.632609
14207,The Librarian: Quest for the Spear,2004-12-05,2004,0,0,0,6.992152
14208,The Librarian: Return to King Solomon's Mines,2006-10-09,2006,0,0,0,12.49401
14210,Nightmare City 2035,2007-01-01,2007,0,0,0,0.782646
14212,Pulse 2: Afterlife,2008-09-30,2008,0,0,0,8.443812
14215,Restraint,2008-08-19,2008,0,0,0,3.978751
14217,Reincarnation,2005-10-26,2005,0,0,0,4.693567
14219,Skinwalkers,2006-03-20,2006,0,0,0,10.069946
14220,Strange Wilderness,2008-02-01,2008,0,6575282,6575282,5.024661
14223,Wind Chill,2007-04-27,2007,6000000,0,-6000000,5.944181
14224,E=mc¬≤,2002-08-23,2002,0,0,0,0.561068
14226,Riding Alone for Thousands of Miles,2005-12-22,2005,7500000,3752325,-3747675,1.883227
14228,Mortuary,2005-08-08,2005,0,0,0,8.261448
14229,Do You Like Hitchcock?,2005-03-19,2005,0,0,0,1.002443
14232,Humboldt County,2008-01-01,2008,0,0,0,4.270808
14233,Film Noir,2007-03-02,2007,0,0,0,0.752001
14234,Ploy,2007-05-21,2007,2000000,0,-2000000,1.852893
14235,Eden Log,2007-12-26,2007,0,0,0,5.825183
14236,Super High Me,2007-10-13,2007,0,0,0,11.320193
14237,Brainscan,1994-04-22,1994,0,4352094,4352094,8.096719
14239,Cool World,1992-07-10,1992,30000000,14110589,-15889411,11.781895
14240,Maniac Cop,1988-05-13,1988,1100000,0,-1100000,6.595038
14241,7 Faces of Dr. Lao,1964-03-18,1964,0,0,0,2.124202
14242,American Movie,1999-11-05,1999,0,0,0,5.964323
14243,Wild Style,1983-03-18,1983,0,0,0,1.053808
14244,Chris Rock: Kill the Messenger,2008-09-27,2008,0,0,0,1.703634
14245,Sniper 2,2002-12-28,2002,5000000,0,-5000000,3.437664
14247,Sniper 3,2004-10-18,2004,0,0,0,7.046943
14248,Igor,2008-09-19,2008,25000000,30000000,5000000,9.369432
14249,Revenge,1990-02-16,1990,0,15645616,15645616,7.429491
14251,Weirdsville,2007-10-12,2007,0,0,0,1.817658
14252,Vice,2008-01-01,2008,0,0,0,0.543548
14254,The Uninvited,2009-01-30,2009,0,41624046,41624046,10.330423
14256,Winter Passing,2006-02-07,2006,3500000,113783,-3386217,4.456904
14257,Delusions of Grandeur,1971-04-01,1971,0,0,0,5.507194
14258,Wonderful Days,2003-07-17,2003,0,0,0,3.726483
14262,Desperate Living,1977-05-27,1977,65000,0,-65000,1.335691
14263,Hip-Hop: Beyond Beats & Rhymes,2006-01-01,2006,0,0,0,0.071153
14267,Female Trouble,1974-10-04,1974,25000,0,-25000,2.229324
14268,Startup.com,2001-01-01,2001,0,0,0,0.587588
14269,Polyester,1981-05-29,1981,300000,0,-300000,5.430699
14271,Beyond the Mat,1999-10-22,1999,2053648,500000,-1553648,2.691433
14272,Chan Is Missing,1982-01-01,1982,0,0,0,0.506267
14273,Dark Days,2000-08-30,2000,0,0,0,0.689963
14274,The Heart of the Game,2005-01-01,2005,0,0,0,0.003296
14275,Hoop Dreams,1994-09-12,1994,700000,7830611,7130611,9.47666
14277,Loose Change: 2nd Edition,2006-06-01,2006,5000,0,-5000,0.651714
14278,Murderball,2005-07-22,2005,300000,1750211,1450211,1.687901
14279,My Kid Could Paint That,2007-01-01,2007,0,0,0,1.258634
14280,Never Cry Wolf,1983-10-07,1983,0,0,0,3.464922
14282,Ninja Scroll,1993-06-05,1993,0,0,0,7.634365
14283,The Red Violin,1998-09-10,1998,18000000,9495408,-8504592,7.725843
14284,In the Shadow of the Moon,2007-01-19,2007,2000000,0,-2000000,2.367893
14285,The Thin Blue Line,1988-08-28,1988,0,0,0,5.070224
14286,Why We Fight,2005-01-01,2005,0,0,0,6.908381
14287,The Year of the Yao,2004-09-16,2004,0,38585,38585,0.562054
14289,Fire Down Below,1997-09-05,1997,60000000,16000000,-44000000,7.83099
14290,Better Luck Tomorrow,2002-01-12,2002,0,0,0,5.309188
14291,Searching for Bobby Fischer,1993-08-13,1993,0,7266383,7266383,12.048587
14292,Miracle,2004-02-06,2004,28000000,64445708,36445708,8.248999
14293,Poolhall Junkies,2002-06-07,2002,0,0,0,6.670148
14295,You Can Count on Me,2000-11-17,2000,0,0,0,6.505313
14297,Root of All Evil?,2006-01-09,2006,0,0,0,1.083169
14298,Somers Town,2008-08-22,2008,0,0,0,1.532799
14299,Cadillac Records,2008-12-05,2008,12000000,0,-12000000,8.878391
14301,Dr. Horrible's Sing-Along Blog,2008-07-15,2008,200000,3,-199997,8.927994
14305,The Andromeda Strain,2008-05-10,2008,0,0,0,6.438995
14306,Marley & Me,2008-12-25,2008,60000000,244082376,184082376,9.729748
14308,I Am Trying to Break Your Heart,2002-06-21,2002,0,0,0,0.998704
14310,Infernal Affairs III,2003-12-12,2003,0,0,0,4.638465
14313,Feast of Love,2007-09-28,2007,0,5741608,5741608,5.993691
14317,The Wild Thornberrys Movie,2002-12-20,2002,35000000,0,-35000000,5.341749
14320,Great Expectations,1946-12-26,1946,0,0,0,5.344072
14324,Virgin Territory,2007-12-17,2007,38000000,5410749,-32589251,6.100498
14325,The Express,2008-10-10,2008,40000000,9793496,-30206504,4.929912
14326,Nights in Rodanthe,2008-09-26,2008,0,84375061,84375061,5.95117
14328,The Paper Chase,1973-10-16,1973,0,0,0,2.351669
14330,Trojan War,1997-09-26,1997,15000000,0,-15000000,1.156854
14334,The Secret of Roan Inish,1994-01-01,1994,0,0,0,1.750481
14336,ABBA - The Movie,1977-12-15,1977,0,0,0,1.558664
14337,Primer,2004-10-08,2004,7000,424760,417760,7.15307
14342,Almost Heroes,1998-05-29,1998,0,0,0,8.92689
14346,Blackballed: The Bobby Dukes Story,2004-01-01,2004,0,0,0,0.766839
14347,Blame It on Rio,1984-02-17,1984,0,18600000,18600000,7.643886
14348,An Evening with Kevin Smith,2002-12-17,2002,0,0,0,2.241764
14349,Sleepwalking,2008-01-14,2008,0,204660,204660,11.823889
14351,Crossover,2006-09-01,2006,5800000,7000000,1200000,0.906143
14353,Repo! The Genetic Opera,2008-07-18,2008,0,188126,188126,5.25696
14357,The King of Ping Pong,2008-01-18,2008,0,0,0,0.731907
14358,Mad Hot Ballroom,2005-05-13,2005,0,0,0,2.096
14359,Doubt,2008-11-27,2008,20000000,50907234,30907234,9.278263
14361,Captain Ron,1992-09-18,1992,24000000,22518097,-1481903,5.429614
14362,Out for Justice,1991-04-12,1991,14000000,39673161,25673161,6.892056
14365,Killing Me Softly,2002-05-10,2002,0,0,0,7.734182
14367,Adventures in Babysitting,1987-07-01,1987,0,34368475,34368475,7.230508
14369,Out Cold,2001-11-21,2001,24000000,14782676,-9217324,4.197544
14370,Real Genius,1985-08-07,1985,0,13000000,13000000,11.959887
14372,Leviathan,1989-03-17,1989,25000000,15704614,-9295386,10.653446
14373,Death Wish 2,1982-02-20,1982,2000000,45000000,43000000,7.965003
14375,Romanzo criminale,2005-09-30,2005,818418,4851244,4032826,4.387586
14384,Soldier Blue,1970-08-12,1970,0,0,0,3.391783
14387,The Great St. Trinian's Train Robbery,1966-01-01,1966,0,0,0,0.381581
14389,Danny Deckchair,2003-05-16,2003,0,0,0,6.229794
14390,Double Whammy,2001-01-20,2001,0,0,0,1.836741
14392,The Warlords,2007-12-12,2007,40000000,0,-40000000,5.854764
14394,Sarkar Raj,2008-06-06,2008,820000,0,-820000,0.853567
14395,Kabhi Alvida Naa Kehna,2006-08-11,2006,7400000,17000000,9600000,2.37252
14396,Code Name: The Cleaner,2007-01-05,2007,20000000,10337477,-9662523,11.107148
14397,Whisper,2007-11-27,2007,12000000,5285197,-6714803,10.425288
14398,Gang Related,1997-10-08,1997,0,5790448,5790448,2.592927
14400,The Heir Apparent: Largo Winch,2008-12-17,2008,25412760,0,-25412760,7.663624
14405,Beverly Hills Chihuahua,2008-10-03,2008,20000000,149281606,129281606,9.569765
14406,Mariage chez les Bodin's,2008-09-24,2008,0,0,0,1.310917
14407,Guy X,2005-06-06,2005,0,0,0,0.639513
14408,Me Two,2008-06-18,2008,0,0,0,0.810853
14410,Notorious,2009-01-16,2009,0,43051547,43051547,5.336296
14411,Sinbad: Legend of the Seven Seas,2003-07-02,2003,60000000,26288320,-33711680,8.388773
14412,Body Heat,1981-08-28,1981,0,24058838,24058838,5.991482
14414,Honeydripper,2007-09-10,2007,0,0,0,2.461063
14415,S√©raphine,2008-10-01,2008,0,0,0,1.998584
14419,"Coluche, l'histoire d'un mec",2008-10-15,2008,0,0,0,1.079873
14421,The Year My Parents Went On Vacation,2006-09-26,2006,0,0,0,1.120365
14422,Birds of America,2008-10-09,2008,0,0,0,3.87449
14423,First Sunday,2008-01-11,2008,0,38804615,38804615,7.383961
14424,Sex and Death 101,2007-06-15,2007,0,0,0,4.456694
14425,PCU,1994-04-29,1994,9000000,4350774,-4649226,8.888278
14427,Winter Break,2003-03-22,2003,0,0,0,1.622053
14429,Drive Me Crazy,1999-10-01,1999,8000000,22593409,14593409,4.606395
14430,Herod's Law,1999-11-09,1999,0,0,0,1.955107
14432,The Secret,2007-10-10,2007,0,0,0,3.276928
14433,Zulu,1964-01-22,1964,3500000,8000000,4500000,11.604242
14434,I Think I Love My Wife,2007-03-16,2007,11000000,13196245,2196245,3.966066
14435,My Bloody Valentine,2009-01-16,2009,15000000,100734718,85734718,5.245883
14438,Fireproof,2008-09-26,2008,500000,33456317,32956317,5.329195
14439,The Pentagon Wars,1998-02-28,1998,0,0,0,2.227719
14440,The Tattooist,2007-11-28,2007,3000000,0,-3000000,1.869749
14441,Clean and Sober,1988-08-10,1988,0,8674093,8674093,2.821608
14442,Ella Enchanted,2004-04-09,2004,31000000,27388767,-3611233,11.316988
14443,The Garbage Pail Kids Movie,1987-08-22,1987,0,0,0,3.47192
14444,The Rugrats Movie,1998-11-20,1998,30000000,100491683,70491683,5.154373
14447,A Matter of Loaf and Death,2008-12-03,2008,0,0,0,10.898525
14448,Love Songs,2007-05-23,2007,0,0,0,5.054967
14449,The Banquet,2006-09-14,2006,0,0,0,2.591175
14451,Dead Snow,2009-01-09,2009,800000,1984662,1184662,7.974726
14452,Kill Switch,2008-10-06,2008,10000000,0,-10000000,6.078986
14455,When the Last Sword Is Drawn,2003-01-18,2003,0,0,0,2.525713
14456,Shrooms,2007-08-16,2007,0,4910682,4910682,9.128571
14457,Reeker,2005-03-13,2005,0,0,0,10.382533
14458,Altered,2006-01-01,2006,8000000,0,-8000000,4.370963
14459,Storm Warning,2007-05-17,2007,0,0,0,4.677101
14460,Battle Beyond the Stars,1980-09-08,1980,2000000,11000000,9000000,2.921405
14462,The Manchurian Candidate,2004-07-30,2004,80000000,96105964,16105964,10.796939
14463,Alone in the Wilderness,2004-10-08,2004,0,0,0,3.005198
14464,Hot Pursuit,1987-05-08,1987,0,4215859,4215859,6.816276
14467,Jaane Tu... Ya Jaane Na,2008-07-04,2008,2300000,11100000,8800000,1.970054
14469,Bullet,1996-03-01,1996,0,0,0,7.572944
14474,The Oh in Ohio,2006-03-30,2006,5000000,0,-5000000,7.502117
14475,Used Cars,1980-07-11,1980,8000000,11715321,3715321,6.963023
14476,Clubbed,2008-10-02,2008,0,0,0,4.132844
14482,Baba Yaga,1971-06-03,1971,0,0,0,0.378382
14484,Body Shots,1999-10-07,1999,0,239894,239894,4.607583
14489,The Scarlet Flower,1978-08-25,1978,0,0,0,0.047926
14499,Mio in the Land of Faraway,1987-07-01,1987,7200000,2300000,-4900000,5.553737
14503,Bachelor Party 2: The Last Temptation,2008-03-11,2008,6000000,0,-6000000,7.109581
14505,Bachelor Party Vegas,2006-04-25,2006,0,0,0,6.262514
14506,The Adventures of Baron Munchausen,1988-12-07,1988,46630000,8083123,-38546877,7.753416
14510,From Beyond,1986-06-05,1986,4500000,1261000,-3239000,7.522655
14517,Mirrormask,2005-01-25,2005,4000000,866999,-3133001,5.354783
14518,Peter & the Wolf,2006-09-23,2006,2300000,0,-2300000,1.500002
14521,The Cup,1999-08-29,1999,0,0,0,0.588543
14522,Black Beauty,1994-07-29,1994,0,0,0,8.398845
14524,Cass,2008-01-08,2008,0,0,0,2.49521
14525,Adrift in Tokyo,2007-11-10,2007,0,0,0,0.798005
14527,Foolproof,2003-10-03,2003,8256269,460978,-7795291,7.474007
14530,American Crude,2008-06-03,2008,0,0,0,5.678168
14531,The Mark of Cain,2008-11-25,2008,0,0,0,1.102938
14533,Gia,1998-01-31,1998,0,0,0,9.632616
14534,Rudy,1993-09-17,1993,12000000,22750363,10750363,5.914833
14536,New in Town,2009-01-30,2009,8000000,29010817,21010817,12.357072
14537,Harakiri,1962-09-15,1962,0,0,0,9.286966
14538,Three Kingdoms: Resurrection of the Dragon,2008-04-03,2008,0,0,0,3.86486
14539,An Empress and the Warriors,2008-02-09,2008,0,0,0,5.561621
14540,Jeff Dunham: Spark of Insanity,2007-09-17,2007,0,0,0,3.111081
14541,Jeff Dunham: Jeff Dunham's Very Special Christmas Special,2008-11-16,2008,0,0,0,0.97378
14542,Jeff Dunham: Arguing with Myself,2006-04-11,2006,0,0,0,1.628042
14543,The Matrix Revisited,2001-11-19,2001,0,0,0,10.358824
14544,Roll Bounce,2005-09-23,2005,0,0,0,2.431197
14546,Golmaal Returns,2008-10-29,2008,0,0,0,5.674992
14547,Delta Farce,2007-05-11,2007,12,0,-12,7.472887
14549,Night Train,2009-04-15,2009,0,0,0,2.958584
14550,The Dream Team,1989-04-07,1989,0,28890240,28890240,4.205858
14551,Winchester '73,1950-07-12,1950,0,0,0,6.275958
14552,"Have Dreams, Will Travel",2007-05-21,2007,5000000,0,-5000000,7.979102
14553,Stealing Beauty,1996-03-29,1996,0,0,0,6.418805
14554,Bad Day at Black Rock,1955-01-07,1955,1271000,3788000,2517000,7.441117
14555,Sagan,2008-06-11,2008,0,0,0,0.815083
14556,Anything for Her,2008-12-03,2008,10000000,0,-10000000,4.636083
14557,Dead Man on Campus,1998-08-21,1998,0,0,0,9.183343
14558,Lejdis,2008-02-01,2008,0,0,0,0.924941
14560,Paul Blart: Mall Cop,2009-01-15,2009,26000000,183293131,157293131,13.003122
14561,Comeback Season,2006-01-01,2006,0,0,0,1.871794
14564,Rings,2017-02-01,2017,25000000,83080890,58080890,24.535733
14565,Love Lies Bleeding,2008-01-15,2008,3000000,0,-3000000,1.16919
14566,Feed,2005-05-11,2005,0,0,0,5.628521
14569,I-See-You.Com,2006-03-08,2006,6200000,0,-6200000,1.676513
14570,Gymkata,1985-05-03,1985,8500000,5730596,-2769404,1.542843
14571,Patlabor: The Movie,1989-01-01,1989,0,0,0,2.957731
14572,Patlabor 2: The Movie,1993-08-07,1993,0,0,0,1.605615
14573,Natural City,2003-05-09,2003,6000000,0,-6000000,3.885246
14574,The Boy in the Striped Pyjamas,2008-05-07,2008,12500000,20416563,7916563,8.912738
14575,The Crew,2008-10-01,2008,3600000,0,-3600000,2.444677
14576,Shade,2003-05-18,2003,6800000,0,-6800000,5.864457
14577,Dirty Work,1998-06-12,1998,0,0,0,7.061315
14578,Outside Providence,1999-08-16,1999,7000000,7292175,292175,3.10924
14579,Lake City,2008-01-01,2008,0,0,0,0.944598
14580,The Big Heat,1953-10-14,1953,0,0,0,8.48839
14582,Passchendaele,2008-10-17,2008,0,0,0,2.490144
14583,Deceiver,1997-08-31,1997,0,0,0,2.833853
14584,The Cheap Detective,1978-06-23,1978,0,0,0,3.351441
14585,In the Company of Men,1997-01-19,1997,0,0,0,3.323672
14587,Bhaji on the Beach,1994-01-21,1994,0,0,0,0.441585
14588,After the Thin Man,1936-12-25,1936,0,0,0,7.201727
14589,Another Thin Man,1939-01-01,1939,0,0,0,1.881187
14590,Shadow of the Thin Man,1941-11-21,1941,0,0,0,2.671234
14591,911 in Plane Site,2004-01-01,2004,0,0,0,1.017042
14594,The Thin Man Goes Home,1945-01-25,1945,0,0,0,5.650608
14595,Song of the Thin Man,1947-08-28,1947,0,0,0,1.148166
14597,Lassie,2005-12-16,2005,0,0,0,12.61454
14603,Kuffs,1992-01-10,1992,0,0,0,6.370387
14604,Hold That Ghost,1941-08-08,1941,0,0,0,6.201988
14605,The Ghost Breakers,1940-06-21,1940,0,0,0,3.943187
14606,The Baker,2007-02-09,2007,0,0,0,11.041444
14607,Loaded,2008-03-25,2008,0,0,0,1.645895
14609,Ultimate Avengers,2006-02-21,2006,0,6700000,6700000,6.425482
14611,Ultimate Avengers 2,2006-08-08,2006,0,7900000,7900000,11.443544
14612,Candleshoe,1977-12-16,1977,0,0,0,2.69658
14613,Next Avengers: Heroes of Tomorrow,2008-09-02,2008,0,3800000,3800000,4.467383
14614,Churchill: The Hollywood Years,2004-12-03,2004,0,0,0,0.825885
14615,Fury,1936-05-29,1936,0,0,0,2.943637
14619,Bottoms Up,2006-01-01,2006,0,0,0,2.246168
14620,The Butterfly Effect 2,2006-10-10,2006,0,0,0,5.776666
14621,Lean On Me,1989-03-03,1989,0,0,0,3.435402
14623,Thunderbirds,2004-07-23,2004,57000000,28283637,-28716363,14.363421
14624,The Ultimate Gift,2006-10-20,2006,0,0,0,5.09336
14626,Beau Travail,2000-05-03,2000,0,0,0,2.336209
14628,Fletch Lives,1989-03-17,1989,8045760,35150960,27105200,10.357224
14629,Woman on Top,2000-09-22,2000,8000000,0,-8000000,2.935127
14630,Puberty Blues,1981-12-10,1981,0,0,0,0.942918
14631,The Work and the Glory II: American Zion,2005-10-21,2005,6500000,2025032,-4474968,0.797014
14633,Ten,2002-05-20,2002,0,105656,105656,0.984515
14634,The Stone Angel,2007-09-12,2007,0,473993,473993,0.618434
14635,The Rookie,2002-03-25,2002,20000000,75597042,55597042,10.991137
14636,The Condemned,2007-04-27,2007,0,8642858,8642858,12.256231
14637,Nothing But the Truth,2008-12-19,2008,11500000,186702,-11313298,8.719145
14638,The Killers,1946-08-28,1946,0,0,0,4.297965
14639,The Order of Myths,2008-07-05,2008,0,0,0,0.086141
14642,20 Years After,2008-01-01,2008,1000000,0,-1000000,1.072945
14643,Boot Camp,2008-02-07,2008,14000000,0,-14000000,4.432452
14644,Boudu,2005-03-09,2005,0,0,0,4.792541
14645,Santa Claus Is a Stinker,1982-08-25,1982,0,0,0,5.870932
14646,Family Resemblances,1996-11-06,1996,0,0,0,2.102816
14650,Michou d'Auber,2007-02-28,2007,0,0,0,1.159742
14651,My Wife Is an Actress,2001-01-14,2001,0,0,0,1.257659
14652,Bon voyage,2003-04-16,2003,0,0,0,2.445568
14653,Happily Ever After,2004-08-25,2004,0,0,0,2.530186
14654,In Paris,2006-10-04,2006,0,0,0,1.592146
14655,Soul Men,2008-11-07,2008,0,0,0,8.826924
14660,Solstice,2008-01-01,2008,0,0,0,2.370808
14662,Slums of Beverly Hills,1998-08-14,1998,5000000,0,-5000000,5.913162
14664,Sharky's Machine,1981-12-18,1981,0,35610100,35610100,2.633399
14666,Cougar Club,2007-01-01,2007,0,0,0,5.556157
14667,Dogfight,1991-09-13,1991,0,0,0,2.625143
14669,Yonkers Joe,2008-04-01,2008,0,0,0,1.837949
14670,‚ÄôRound Midnight,1986-09-23,1986,0,0,0,2.130832
14671,Summer School,1987-07-22,1987,0,35114428,35114428,4.912295
14672,Crackerjack,2002-07-11,2002,0,0,0,0.111834
14673,Savage Streets,1984-08-30,1984,0,0,0,1.525307
14674,Man of the West,1958-09-30,1958,0,0,0,3.47428
14675,The Awful Truth,1937-01-01,1937,0,0,0,8.105442
14676,A Man Called Horse,1970-05-01,1970,0,0,0,14.35552
14677,Last Train from Gun Hill,1959-07-29,1959,0,0,0,2.597903
14681,Eating Out,2004-02-14,2004,50000,0,-50000,1.954508
14683,The Nine Lives of Fritz the Cat,1974-09-18,1974,0,0,0,1.553516
14684,School Ties,1992-09-18,1992,0,14715067,14715067,7.438381
14685,Swallows and Amazons,1974-06-01,1974,0,0,0,0.884828
14686,Midnight Movie,2008-10-24,2008,0,0,0,1.61398
14687,Eichmann,2007-09-22,2007,8000000,0,-8000000,3.336861
14688,Change of Plans,2009-02-18,2009,0,0,0,2.878098
14689,Hawaii,1966-10-10,1966,15000000,34562222,19562222,3.210693
14694,The Snow Walker,2003-01-01,2003,0,0,0,2.316254
14695,Havoc,2005-10-16,2005,9000000,0,-9000000,11.576336
14696,Ugetsu,1953-03-26,1953,0,0,0,5.525119
14698,"Suddenly, Last Summer",1959-12-22,1959,3000000,0,-3000000,7.007423
14703,The Night of the Iguana,1964-08-06,1964,3000000,12000000,9000000,2.560454
14704,Donkey X,2007-12-05,2007,0,0,0,1.782024
14705,Omkara,2006-07-28,2006,0,0,0,1.395127
14709,Varsity Blues,1999-01-15,1999,0,0,0,9.162643
14710,The Westerner,1940-09-18,1940,0,0,0,1.499865
14711,Afro Samurai: Resurrection,2009-01-25,2009,0,0,0,4.427087
14720,All About Actresses,2009-01-28,2009,0,0,0,1.18718
14726,Espion(s),2009-01-28,2009,0,0,0,2.180653
14728,The Librarian: The Curse of the Judas Chalice,2008-12-07,2008,0,0,0,9.309781
14729,The Long Riders,1980-05-12,1980,10000000,15795189,5795189,3.557608
14733,Bill Hicks: Sane Man,1989-12-01,1989,0,0,0,0.000578
14735,Boarding Gate,2007-05-18,2007,0,0,0,1.891973
14736,Love & Basketball,2000-04-21,2000,20000000,27728118,7728118,5.733227
14741,The Goodbye Girl,1977-11-30,1977,0,102000000,102000000,3.937139
14742,Night Shift,1982-07-30,1982,0,21095683,21095683,4.535207
14745,The Haunting of Molly Hartley,2008-10-31,2008,0,0,0,9.982123
14746,Streets of Fire,1984-06-01,1984,14500000,8089290,-6410710,6.958758
14748,Boy A,2007-10-28,2007,0,1200398,1200398,8.37404
14749,Space Buddies,2009-02-02,2009,0,0,0,8.167788
14750,Mischief,1985-02-08,1985,0,8692426,8692426,7.356831
14751,Dasvidaniya,2008-11-07,2008,0,0,0,0.767683
14752,Dil Chahta Hai,2001-07-24,2001,2079000,4099000,2020000,4.558793
14753,Silk,2007-09-14,2007,20000000,0,-20000000,4.193073
14755,The Deadly Affair,1966-05-13,1966,0,0,0,2.350984
14756,Ip Man,2008-12-12,2008,11715578,21888598,10173020,6.004257
14757,Osama,2003-05-20,2003,46000,0,-46000,2.066368
14758,Good Dick,2008-10-03,2008,0,0,0,3.161376
14759,Bookies,2003-01-01,2003,0,0,0,1.841633
14761,Cocaine Cowboys,2006-04-26,2006,0,163000,163000,2.941626
14765,The Last Deadly Mission,2007-01-01,2007,0,0,0,6.33835
14766,Affinity,2008-12-28,2008,0,0,0,1.648107
14770,Festival Express,2003-09-19,2003,0,0,0,0.645771
14771,The Onion Movie,2008-05-31,2008,0,0,0,5.694713
14772,The Memory Keeper's Daughter,2008-04-12,2008,0,0,0,1.578987
14773,10 MPH,2007-01-01,2007,0,0,0,0.054354
14774,Cheech & Chong's The Corsican Brothers,1984-07-27,1984,0,0,0,3.767854
14776,How to Get Ahead in Advertising,1989-05-05,1989,0,0,0,4.485466
14778,Last Orders,2001-09-10,2001,0,0,0,2.76118
14782,The Unsaid,2001-09-14,2001,0,0,0,5.526635
14784,The Fall,2008-01-03,2008,0,3669465,3669465,15.855108
14785,Bandit Queen,1994-09-09,1994,0,399,399,0.976798
14786,Gotti,1996-08-17,1996,0,0,0,1.189465
14787,Tom and Jerry: The Magic Ring,2002-03-12,2002,0,0,0,3.117737
14788,Bubble,2005-09-03,2005,1600000,0,-1600000,3.185256
14788,Bubble,2005-09-03,2005,1600000,0,-1600000,3.008299
14791,Two Worlds,2007-11-21,2007,0,0,0,1.677289
14793,Sigur R√≥s: Heima,2007-09-27,2007,0,0,0,1.646559
14794,If....,1968-12-19,1968,0,500000,500000,12.083475
14797,Warriors of Heaven and Earth,2003-09-23,2003,0,0,0,8.921366
14799,For Your Consideration,2006-11-22,2006,12000000,5542025,-6457975,12.142183
14801,Colossus: The Forbin Project,1970-04-08,1970,0,0,0,3.363154
14804,Vitus,2006-02-02,2006,0,0,0,2.233166
14805,Bait,2000-09-14,2000,35000000,0,-35000000,3.155291
14806,Impulse,2008-04-15,2008,2000000,0,-2000000,1.2747
14807,The Long Good Friday,1980-11-01,1980,0,0,0,11.693374
14808,Battle of the Warriors,2006-11-23,2006,0,0,0,4.086148
14809,Stark Raving Mad,2002-05-23,2002,5000000,0,-5000000,1.425786
14811,Fiddler on the Roof,1971-11-03,1971,9000000,83304330,74304330,9.227244
14812,"Hawaii, Oslo",2004-09-24,2004,0,0,0,1.749024
14813,Mickey's Christmas Carol,1983-10-19,1983,3000000,21000000,18000000,11.742804
14814,Chemical Wedding,2008-05-04,2008,0,0,0,1.744769
14815,The Wind and the Lion,1975-10-26,1975,0,0,0,8.627187
14817,Good Burger,1997-07-25,1997,0,0,0,10.580421
14818,Dynamite Warrior,2006-11-09,2006,0,0,0,1.416587
14819,Heavyweights,1995-02-17,1995,0,17689177,17689177,9.546707
14820,Music Within,2007-01-05,2007,0,153205,153205,5.507134
14821,Escape to Witch Mountain,1975-03-21,1975,0,20000000,20000000,7.151691
14822,Return from Witch Mountain,1978-03-10,1978,0,16393000,16393000,3.936986
14823,London to Brighton,2006-12-01,2006,0,0,0,2.216329
14829,Tenchi Forever!,1999-04-24,1999,0,0,0,0.407319
14830,Doctor Strange,2007-08-14,2007,0,0,0,10.025137
14831,Help!,1965-07-29,1965,1500000,0,-1500000,10.045007
14832,The Cement Garden,1993-02-20,1993,0,322975,322975,15.975485
14833,House,2008-11-06,2008,0,0,0,2.429703
14834,Not Easily Broken,2009-01-09,2009,0,0,0,7.256932
14836,Coraline,2009-02-05,2009,60000000,124596398,64596398,16.639915
14837,Forty Guns,1957-09-01,1957,0,0,0,2.055948
14839,Blue Collar,1978-02-10,1978,0,6521083,6521083,1.379256
14842,44 Minutes: The North Hollywood Shoot-Out,2003-01-01,2003,10000000,0,-10000000,1.302154
14843,Ten Inch Hero,2007-04-25,2007,0,0,0,3.015557
14844,Chasing Liberty,2004-01-09,2004,23000000,12,-22999988,5.950792
14845,Gray Matters,2006-10-21,2006,0,0,0,2.268351
14846,Little Black Book,2004-08-06,2004,35000000,22034832,-12965168,5.093704
14847,Miss Conception,2008-02-08,2008,6000000,0,-6000000,5.888476
14848,The Dog Problem,2006-09-11,2006,0,0,0,1.852095
14849,Dead Like Me: Life After Death,2009-02-17,2009,0,0,0,4.78341
14850,Tripping the Rift: The Movie,2008-03-25,2008,0,0,0,1.789882
14851,The Escapist,2008-06-20,2008,0,0,0,10.430028
14853,Screamers: The Hunting,2009-02-17,2009,0,0,0,4.92638
14854,Lone Wolf McQuade,1983-04-14,1983,5000000,12232628,7232628,5.839893
14857,Personal Effects,2009-02-06,2009,0,0,0,7.872865
14859,Keith,2008-09-13,2008,0,0,0,9.560911
14862,Killer Movie,2008-01-01,2008,2000000,0,-2000000,1.773237
14863,Anaconda 3: Offspring,2008-01-01,2008,0,0,0,4.208273
14864,The Hot Spot,1990-10-12,1990,0,1293976,1293976,3.985689
14866,Farm House,2008-01-01,2008,0,0,0,2.059098
14868,The Rage in Placid Lake,2003-05-17,2003,0,0,0,1.034794
14869,G.I. Joe: The Rise of Cobra,2009-08-04,2009,175000000,302469017,127469017,11.787058
14871,Make It Happen,2008-08-08,2008,0,0,0,5.496293
14872,The Cutting Edge: Going for the Gold,2006-02-07,2006,3000000,0,-3000000,6.865148
14873,The Jungle Book 2,2003-02-07,2003,20000000,135680000,115680000,10.605851
14874,Try Seventeen,2002-09-10,2002,0,0,0,2.814091
14877,September Dawn,2007-05-17,2007,11000000,0,-11000000,1.676016
14878,The Objective,2008-04-28,2008,0,0,0,8.227236
14881,Joe Kidd,1972-07-14,1972,0,6330000,6330000,5.809807
14882,Hounddog,2007-01-22,2007,0,0,0,2.356103
14883,This Girl's Life,2004-12-03,2004,0,0,0,5.192928
14885,Pooh's Heffalump Halloween Movie,2005-09-13,2005,0,0,0,2.568495
14886,The Last Detail,1973-12-11,1973,0,0,0,4.344612
14887,Bongwater,1997-01-01,1997,0,0,0,1.660609
14891,Dirty Sanchez: The Movie,2006-09-22,2006,0,0,0,0.908052
14892,The Big Empty,2003-05-16,2003,0,0,0,2.441745
14893,Shake It,2001-11-16,2001,0,0,0,0.891316
14897,Angels in Fast Motion,2005-03-04,2005,0,0,0,1.393743
14898,Just Another Love Story,2007-08-22,2007,0,0,0,7.488481
14900,The Great Muppet Caper,1981-06-26,1981,0,0,0,8.87534
14902,1776,1972-11-09,1972,0,0,0,1.558517
14903,Pooh's Grand Adventure: The Search for Christopher Robin,1997-08-05,1997,0,0,0,5.83918
14904,Proof,1991-08-15,1991,0,524668,524668,2.616309
14905,Welcome to Sarajevo,1997-05-09,1997,0,0,0,7.999793
14906,Saludos Amigos,1942-08-24,1942,0,0,0,3.92433
14907,Alien Apocalypse,2005-03-26,2005,0,0,0,2.376271
14908,McHale's Navy,1997-04-18,1997,0,4529843,4529843,2.705804
14911,Bat*21,1988-07-21,1988,0,3184348,3184348,9.179655
14912,18 Year Old Virgin,2009-01-20,2009,0,0,0,2.352048
14913,Boogeyman 2,2007-10-20,2007,4500000,0,-4500000,8.570712
14914,Flash of Genius,2008-09-07,2008,0,0,0,3.250891
14916,Moontrap,1989-04-28,1989,0,0,0,2.947234
14919,Batman: Mask of the Phantasm,1993-12-25,1993,6000000,5617391,-382609,7.29114
14921,Three and Out,2008-10-12,2008,0,0,0,5.229646
14922,Happy Endings,2005-01-20,2005,0,0,0,3.499985
14923,Run Ronnie Run,2002-09-16,2002,0,0,0,2.470705
14924,Sid & Nancy,1986-11-07,1986,4000000,2826523,-1173477,5.681582
14926,Uptown Girls,2003-08-15,2003,20000000,37095657,17095657,5.555088
14928,The Secrets,2007-06-14,2007,0,0,0,1.9306
14929,Mother's Day,1980-09-19,1980,0,0,0,2.795752
14930,Relative Strangers,2006-05-01,2006,0,0,0,2.219063
14931,Miami Blues,1990-04-20,1990,0,0,0,3.206796
14933,The Truth About Love,2005-04-21,2005,0,0,0,1.687672
14938,The Alibi,2006-01-12,2006,0,0,0,1.931397
14940,Gigantic,2008-09-09,2008,0,165888,165888,2.450192
14942,Thoughtcrimes,2003-01-01,2003,0,0,0,0.741709
14943,Crows Zero,2007-10-26,2007,0,0,0,6.110693
14945,Origin: Spirits of the Past,2006-01-07,2006,0,0,0,11.02494
14949,Crossed Tracks,2007-06-27,2007,0,0,0,1.323612
14962,Thumb Wars: The Phantom Cuticle,1999-11-02,1999,0,0,0,1.12808
14963,The Groomsmen,2006-06-09,2006,0,0,0,3.098757
14968,Welcome to Dongmakgol,2005-08-04,2005,8,33579813,33579805,4.222195
14976,Rachel Getting Married,2008-10-03,2008,0,0,0,13.44059
14977,Red Sands,2009-02-24,2009,0,0,0,3.159248
14978,Moog,2004-09-17,2004,0,0,0,1.01593
14979,Thick as Thieves,2009-01-09,2009,25000000,0,-25000000,11.923981
14980,Rose Red,2002-01-26,2002,0,0,0,6.965725
14981,Welcome To Macintosh,2008-05-06,2008,0,0,0,0.294119
14983,Carver,2008-03-04,2008,0,0,0,1.238318
15003,Chocolate,2008-02-06,2008,0,0,0,6.272128
15004,His Name Was Jason: 30 Years of Friday the 13th,2009-02-03,2009,0,0,0,6.353353
15005,One Night with the King,2006-10-13,2006,20000000,13391174,-6608826,3.660528
15006,Rails & Ties,2007-09-01,2007,0,22136,22136,7.625656
15007,Number Seventeen,1932-07-18,1932,0,0,0,1.962002
15008,The Flying Scotsman,2006-08-16,2006,0,0,0,2.228211
15011,Red Mist,2008-08-22,2008,0,0,0,9.252907
15012,Linewatch,2008-01-01,2008,5000000,0,-5000000,1.212331
15013,Wah-Wah,2005-08-17,2005,0,0,0,1.528003
15014,Bianca,1984-02-23,1984,0,0,0,2.806092
15015,Barbie as Rapunzel,2002-10-01,2002,0,0,0,6.507867
15016,Barbie of Swan Lake,2003-09-28,2003,0,0,0,6.456991
15017,Blonde Ambition,2007-12-21,2007,10000000,0,-10000000,2.546359
15018,Thriller: A Cruel Picture,1973-05-01,1973,0,0,0,3.814035
15019,I Could Never Be Your Woman,2007-05-11,2007,24000000,9576495,-14423505,11.414893
15020,Poor Boy's Game,2007-02-11,2007,0,0,0,1.694417
15021,Films to Keep You Awake: The Baby's Room,2006-07-31,2006,0,0,0,6.111961
15022,Dirty Deeds,2005-08-26,2005,0,0,0,2.850711
15024,The Mists of Avalon,2001-07-15,2001,20000000,0,-20000000,9.594656
15026,The Guyver,1991-01-01,1991,0,0,0,2.345714
15028,Clockstoppers,2002-03-17,2002,26000000,38793283,12793283,4.920175
15028,Clockstoppers,2002-03-17,2002,26000000,38793283,12793283,5.373623
15029,The Whoopee Boys,1986-08-22,1986,0,0,0,0.649646
15030,Deep Water,2006-12-15,2006,0,0,0,6.198833
15031,The Breaks,1999-02-26,1999,0,0,0,0.167229
15033,Constantine's Sword,2008-04-18,2008,0,0,0,0.206718
15035,Fire and Ice,1983-03-25,1983,1200000,760883,-439117,8.471302
15036,Eden Is West,2009-02-11,2009,0,0,0,1.782573
15037,Can't Hardly Wait,1998-06-12,1998,10000000,25605015,15605015,6.426937
15039,Against the Dark,2009-01-01,2009,9000000,0,-9000000,5.108627
15043,Brink!,1998-08-28,1998,0,0,0,3.448862
15044,Einstein and Eddington,2008-11-29,2008,0,0,0,8.639067
15045,Fat Albert,2004-12-12,2004,0,0,0,6.765443
15048,Beaufort,2007-02-02,2007,0,0,0,2.449338
15049,Bon Cop Bad Cop,2006-07-06,2006,8000000,12671300,4671300,5.397604
15050,Brainstorm,1983-09-30,1983,15000000,10219460,-4780540,9.974312
15052,The Lodger,2009-01-14,2009,0,0,0,5.995718
15053,Sex and Breakfast,2007-11-29,2007,0,0,0,0.792998
15056,The Curse of King Tut's Tomb,2006-04-11,2006,14000000,0,-14000000,2.097579
15058,Speak,2004-01-20,2004,1000000,0,-1000000,6.66323
15059,The Loss of Sexual Innocence,1999-04-29,1999,4000000,0,-4000000,3.02583
15060,Futurama: Into the Wild Green Yonder,2009-02-23,2009,0,0,0,13.284811
15066,Walking Tall: The Payback,2007-02-20,2007,0,0,0,1.025466
15067,"The Good, The Bad, The Weird",2008-07-16,2008,10000000,0,-10000000,8.218314
15068,80 Minutes,2008-09-02,2008,0,0,0,2.101557
15069,WŒîZ,2007-05-19,2007,0,0,0,10.543375
15070,Undisputed,2002-08-23,2002,20000000,12398628,-7601372,13.35278
15071,The Contractor,2007-07-10,2007,0,0,0,3.013828
15073,Cargo,2005-12-26,2005,0,0,0,1.598814
15074,Extreme Ops,2002-11-27,2002,40000000,10959475,-29040525,2.947411
15075,One Last Thing...,2005-01-01,2005,0,0,0,2.110792
15077,Election 2,2006-04-27,2006,0,0,0,3.233724
15080,Only Yesterday,1991-07-20,1991,0,0,0,10.831775
15081,The Three Lives of Thomasina,1963-12-11,1963,0,0,0,2.09685
15083,Ushpizin,2004-07-11,2004,0,0,0,0.245122
15084,Salaam Namaste,2005-09-09,2005,2500000,0,-2500000,1.557528
15086,La Patinoire,1998-11-01,1998,0,0,0,0.457317
15088,The Cutting Edge 3: Chasing the Dream,2008-03-16,2008,0,0,0,10.975587
15089,Fighter Pilot: Operation Red Flag,2004-12-02,2004,0,0,0,0.743036
15090,Icebreaker,2000-01-01,2000,0,0,0,0.609315
15092,Crank: High Voltage,2009-04-16,2009,20000000,34560577,14560577,10.044642
15096,20 Million Miles to Earth,1957-02-08,1957,0,0,0,8.875771
15097,Fear City: A Family-Style Comedy,1994-03-09,1994,0,0,0,7.985398
15098,Manic,2001-01-27,2001,0,0,0,2.544943
15102,Endgame,2009-01-18,2009,22000000,0,-22000000,1.999232
15104,Tortilla Soup,2001-08-21,2001,0,4574762,4574762,4.101369
15105,Still Waiting...,2009-02-17,2009,0,0,0,4.700631
15119,Shogun Assassin,1980-11-11,1980,0,0,0,3.364968
15120,Smokey and the Bandit Part 3,1983-08-12,1983,0,5678950,5678950,13.721966
15121,The Sound of Music,1965-03-02,1965,8200000,286214286,278014286,9.06773
15122,Love Stinks,1999-09-10,1999,0,0,0,1.097513
15124,A Little Trip to Heaven,2005-12-26,2005,12000000,0,-12000000,2.16269
15125,Dante 01,2008-01-02,2008,8000000,0,-8000000,2.351413
15126,Eldorado,2008-06-04,2008,0,0,0,1.806726
15128,Speechless,1994-12-16,1994,0,0,0,2.334226
15135,Feast III: The Happy Finish,2009-02-17,2009,0,0,0,5.644681
15136,So Close,2002-08-22,2002,0,0,0,3.905881
15137,Evangelion: 1.0: You Are (Not) Alone,2007-09-01,2007,0,223839,223839,6.592907
15138,Little Monsters,1989-08-25,1989,7000000,793775,-6206225,6.256969
15139,The Pagemaster,1994-11-23,1994,27000000,13670688,-13329312,7.436001
15142,Dream a Little Dream,1989-03-03,1989,0,0,0,13.592018
15143,Some Kind of Wonderful,1987-02-27,1987,0,18553948,18553948,10.208658
15144,Sixteen Candles,1984-05-04,1984,6500000,23686027,17186027,6.683723
15148,Man in the Chair,2007-01-27,2007,0,0,0,0.982936
15149,Take the Trash,2008-08-15,2008,1720666,0,-1720666,2.132882
15152,"OSS 117: Cairo, Nest of Spies",2006-04-05,2006,0,0,0,6.926251
15155,G,2002-05-10,2002,0,3020784,3020784,0.884526
15156,Illegal Tender,2007-08-24,2007,0,3106835,3106835,1.689926
15157,Another Cinderella Story,2008-09-16,2008,5000000,0,-5000000,7.863793
15158,Phantasm II,1988-07-08,1988,3000000,7282851,4282851,8.733192
15159,The Pink Panther 2,2009-02-06,2009,0,75871032,75871032,18.54675
15162,Alice Through the Looking Glass,1998-12-26,1998,0,0,0,1.13767
15163,Amazing Grace,2006-09-16,2006,0,0,0,20.346477
15165,Barbie as The Princess & the Pauper,2004-09-28,2004,0,0,0,6.665069
15166,The Gene Generation,2007-01-01,2007,2500000,0,-2500000,3.601497
15167,Barbie in the Nutcracker,2001-09-30,2001,0,0,0,6.879235
15170,Buddy,1997-06-06,1997,0,0,0,2.022706
15171,Charlotte's Web,1973-03-01,1973,0,0,0,7.574372
15173,Jonah: A VeggieTales Movie,2002-10-04,2002,0,0,0,1.734181
15177,Buddy,2003-08-29,2003,0,0,0,1.322188
15179,"Patrik, Age 1.5",2008-09-12,2008,0,56299,56299,3.225039
15182,Just Buried,2007-09-09,2007,0,0,0,2.118143
15184,A Good Woman,2004-01-01,2004,0,0,0,8.759151
15185,Pierrepoint: The Last Hangman,2005-12-07,2005,0,0,0,1.987406
15186,Full Frontal,2002-08-02,2002,2000000,2506446,506446,2.186683
15189,Hotel for Dogs,2009-01-16,2009,35000000,73034460,38034460,6.317992
15192,The Grey Zone,2001-09-13,2001,0,0,0,3.166163
15196,Clue,1985-12-13,1985,15000000,14643997,-356003,7.720009
15198,"Mystery, Alaska",1999-10-01,1999,28000000,8888143,-19111857,4.512767
15199,Rent: Filmed Live on Broadway,2008-09-24,2008,0,0,0,0.727741
15201,Skin,2008-03-13,2008,0,0,0,0.355246
15206,The Mother of Tears,2007-09-06,2007,3500000,54947,-3445053,34.145916
15208,Bathory: Countess of Blood,2008-07-04,2008,0,0,0,3.78669
15209,Eight Days a Week,1997-01-17,1997,0,9090,9090,4.515523
15212,Species: The Awakening,2007-10-02,2007,3800000,0,-3800000,9.6804
15213,Everyone's Hero,2006-09-15,2006,0,16627188,16627188,5.787334
15216,Midnight Clear,2006-01-01,2006,0,0,0,0.296538
15227,Galaxy Express 999,1979-08-04,1979,0,0,0,1.356131
15237,De-Lovely,2004-07-02,2004,20000000,0,-20000000,3.748162
15239,The Toxic Avenger,1984-05-01,1984,0,0,0,8.061088
15242,"Snoopy, Come Home",1972-09-08,1972,0,0,0,1.811747
15244,A Man Escaped,1956-11-11,1956,0,0,0,11.859048
15247,The Ipcress File,1965-03-18,1965,0,0,0,7.336578
15250,This Christmas,2007-11-27,2007,13000000,0,-13000000,2.501209
15251,Eddie Murphy: Delirious,1983-08-17,1983,0,0,0,5.762754
15255,Undisputed II: Last Man Standing,2006-04-11,2006,0,0,0,18.957084
15256,200 Cigarettes,1999-02-26,1999,6000000,6852450,852450,3.227046
15257,Hulk vs. Wolverine,2009-01-27,2009,0,0,0,5.539197
15258,The Aristocrats,2005-01-01,2005,0,0,0,3.898364
15259,Breakin',1984-01-10,1984,0,0,0,2.598283
15260,Joy Division,2007-09-07,2007,0,0,0,1.394174
15261,Bring It On: In It To Win It,2007-12-12,2007,0,0,0,0.252987
15262,Boogeyman 3,2008-10-17,2008,0,0,0,8.374035
15263,McLintock!,1963-11-13,1963,0,0,0,5.525
15264,Tall in the Saddle,1944-09-29,1944,0,0,0,9.444861
15265,The Red Balloon,1956-10-19,1956,0,0,0,5.322608
15267,The Beast of War,1988-09-14,1988,0,0,0,7.021336
15268,Street Fighter: The Legend of Chun-Li,2009-02-27,2009,50000000,12764201,-37235799,6.660188
15271,Bright Young Things,2003-05-16,2003,0,0,0,2.466442
15272,Up the Yangtze,2007-09-30,2007,0,783000,783000,0.655056
15276,Barely Legal,2003-05-15,2003,0,0,0,6.986182
15278,CB4,1993-03-12,1993,0,17953778,17953778,11.449373
15281,King Corn,2007-10-12,2007,0,81368,81368,0.964027
15282,The Hide,2008-01-01,2008,0,0,0,0.187025
15283,Pom Poko,1994-07-16,1994,0,0,0,9.607155
15285,Growing Op,2008-11-21,2008,0,0,0,1.325647
15286,Marine Boy,2009-02-05,2009,0,3923970,3923970,1.14807
15289,Babylon 5: The Lost Tales - Voices in the Dark,2007-07-31,2007,0,0,0,4.547604
15292,Step Into Liquid,2003-08-05,2003,0,0,0,1.436072
15300,Newsies,1992-04-10,1992,15000000,0,-15000000,4.095602
15301,Twilight Zone: The Movie,1983-06-24,1983,10000000,29450919,19450919,5.836054
15302,The Pixar Story,2007-08-28,2007,0,0,0,9.248513
15303,Frozen Stiff,2002-01-01,2002,0,0,0,1.816886
15310,The Jazz Singer,1980-12-17,1980,0,0,0,0.841574
15313,The Wrong Guy,1997-08-01,1997,0,0,0,0.664949
15314,Mini's First Time,2006-05-01,2006,0,0,0,2.389319
15316,Good Time Max,2008-10-28,2008,0,0,0,1.532597
15318,The Taste of Tea,2004-07-17,2004,0,0,0,2.853095
15319,After the Rain,1999-10-25,1999,3800000,0,-3800000,1.268049
15320,I.O.U.S.A.,2008-01-19,2008,0,0,0,0.819308
15321,Twin Town,1997-04-11,1997,0,0,0,1.651546
15323,Steal This Film II,2007-12-28,2007,0,0,0,0.438766
15324,Steal This Film,2006-08-21,2006,3000,0,-3000,1.097684
15325,God Grew Tired of Us,2007-01-12,2007,0,0,0,1.369146
15329,Tomorrow's Another Day,2000-11-15,2000,0,0,0,0.241178
15331,The Vanishing Point,2007-11-28,2007,0,0,0,0.271582
15338,Ace Ventura Jr: Pet Detective,2009-03-03,2009,7500000,0,-7500000,3.114989
15342,The Girl from Monaco,2008-08-20,2008,0,0,0,1.323715
15346,The Golden Boys,2008-12-11,2008,8000000,0,-8000000,0.545664
15347,Born Free,1966-06-22,1966,0,0,0,2.672431
15356,The Girl Next Door,2007-07-19,2007,0,0,0,4.763911
15357,District 13: Ultimatum,2009-02-18,2009,15000000,8786375,-6213625,9.133996
15359,Wonder Woman,2009-03-03,2009,0,0,0,7.306487
15360,The Night Stalker,1972-01-11,1972,0,0,0,4.496482
15361,Shanghai Kiss,2007-03-17,2007,0,0,0,6.397927
15362,Mesrine: Public Enemy #1,2008-11-19,2008,80000000,0,-80000000,8.835512
15363,Something New,2006-01-29,2006,0,11400000,11400000,8.642141
15365,Witless Protection,2008-02-22,2008,0,0,0,8.655423
15366,American Gun,2005-01-01,2005,0,0,0,5.16295
15370,The Cat Returns,2002-07-19,2002,0,522911,522911,11.639023
15371,Lupin the Third: The Castle of Cagliostro,1979-12-15,1979,0,0,0,7.932795
15372,Jimmy Carr: Comedian,2007-11-05,2007,0,0,0,0.62228
15373,Role Models,2008-02-03,2008,28000000,92380927,64380927,7.646215
15374,A Boy Named Charlie Brown,1969-12-04,1969,0,0,0,1.852328
15375,"Murder, Inc.",1960-06-28,1960,0,0,0,0.229078
15377,All the World's Memory,1956-01-01,1956,0,0,0,0.70468
15378,The Grand,2007-06-07,2007,5400000,0,-5400000,2.393158
15379,Missing in Action,1984-11-16,1984,1500000,22812411,21312411,6.241185
15382,White Mane,1953-12-19,1953,0,0,0,1.413075
15383,Army of Shadows,1969-09-10,1969,0,741766,741766,7.872569
15384,Red Cliff Part II,2009-01-07,2009,80000000,121059225,41059225,7.309903
15387,Cosy Dens,1999-04-08,1999,0,0,0,1.190201
15389,Metropolitan,1990-08-03,1990,225000,0,-225000,1.68399
15390,Les Enfants Terribles,1950-03-29,1950,0,0,0,1.466519
15391,Obsession: Radical Islam's War Against the West,2005-10-21,2005,0,0,0,0.487689
15392,Crossroads,1986-03-14,1986,0,5738952,5738952,10.852948
15393,Play Misty for Me,1971-11-03,1971,725000,10600000,9875000,5.820841
15394,Owning Mahowny,2003-05-02,2003,0,0,0,3.015314
15395,Love Liza,2002-12-30,2002,0,0,0,2.362585
15397,I Am David,2003-12-03,2003,0,0,0,2.380928
15400,Mickey's Once Upon a Christmas,1999-12-07,1999,0,0,0,6.577491
15401,Captain Kidd,1945-11-22,1945,0,0,0,1.920595
15402,The Notorious Bettie Page,2005-09-14,2005,0,1410778,1410778,3.678394
15411,Bheja Fry,2007-04-13,2007,0,0,0,0.985705
15412,Khosla Ka Ghosla!,2006-09-22,2006,0,0,0,0.795745
15413,Don't Tell Mom the Babysitter's Dead,1991-06-07,1991,10000000,25196249,15196249,5.402262
15414,Land of the Blind,2006-01-01,2006,0,0,0,1.469243
15417,Every Which Way But Loose,1978-12-19,1978,5,85,80,6.759519
15419,Kabhi Haan Kabhi Naa,1993-01-01,1993,0,0,0,0.938742
15420,The Plague,2006-09-05,2006,0,0,0,2.518433
15421,Becket,1964-03-11,1964,0,0,0,3.651821
15422,Dark Ride,2006-10-20,2006,0,0,0,1.198151
15423,Hood of Horror,2006-06-27,2006,5000000,25900,-4974100,2.06528
15425,Tooth and Nail,2007-10-16,2007,0,0,0,4.01982
15426,Unearthed,2007-01-01,2007,0,0,0,6.410024
15429,Jimmy Carr: In Concert,2008-11-03,2008,0,0,0,1.084058
15434,Seed,2007-04-27,2007,10000000,0,-10000000,1.782765
15436,Let It Rain,2008-09-17,2008,0,0,0,8.161057
15438,My Stars,2008-10-29,2008,0,0,0,1.054069
15440,Cold Prey II,2008-10-09,2008,0,0,0,6.987879
15443,Blackball,2003-05-18,2003,0,48000,48000,1.433756
15449,La Tour Montparnasse Infernale,2001-03-28,2001,0,0,0,4.743842
15450,The Family That Preys,2008-09-12,2008,0,0,0,1.197865
15451,Revanche,2008-05-16,2008,0,0,0,4.717517
15457,Paris 36,2008-09-24,2008,0,850575,850575,12.270513
15460,A French Gigolo,2008-10-08,2008,0,0,0,1.703275
15462,Car Wash,1976-10-22,1976,0,0,0,3.259637
15464,EMI: Liya Hai To Chukana Padega,2008-11-07,2008,0,0,0,0.341618
15467,Kismat Konnection,2008-07-18,2008,4180000,11000000,6820000,1.506777
15468,"Spy, Stand Up",1982-01-27,1982,0,0,0,1.952949
15469,Five Miles to Midnight,1962-12-12,1962,0,0,0,0.191724
15472,The Girl with the Dragon Tattoo,2009-02-27,2009,13000000,104345682,91345682,9.858687
15473,LD 50 Lethal Dose,2003-02-23,2003,0,0,0,0.862901
15476,7eventy 5ive,2007-05-16,2007,3000000,0,-3000000,2.365883
15477,Love and a .45,1994-11-23,1994,0,0,0,3.40523
15478,The Abdication,1974-10-03,1974,0,0,0,0.567976
15482,Return of the Killer Tomatoes!,1988-04-22,1988,0,0,0,4.176478
15483,The Card Player,2004-01-02,2004,2600000,1479042,-1120958,3.501564
15484,Shadows,1959-11-11,1959,0,0,0,2.316931
15486,The Bank,2001-09-06,2001,0,0,0,1.637955
15487,The Greatest Game Ever Played,2005-09-30,2005,25000000,15431177,-9568823,6.969342
15489,Snow Day,2000-02-11,2000,0,0,0,6.295701
15493,Star Wreck: In the Pirkinning,2005-08-20,2005,16398,0,-16398,7.759197
15494,Starflight: The Plane That Couldn't Land,1983-02-27,1983,0,0,0,0.857489
15495,The Hamiltons,2006-11-19,2006,0,0,0,6.47037
15497,Twelve O'Clock High,1949-12-21,1949,0,3225000,3225000,2.870026
15501,Dane Cook: Vicious Circle,2006-09-04,2006,0,0,0,1.864719
15503,Around the Bend,2004-10-08,2004,0,0,0,2.012395
15506,Agnes Browne,1999-11-08,1999,0,0,0,6.485631
15511,VeggieTales: The Pirates Who Don't Do Anything,2008-01-11,2008,0,0,0,2.059236
15512,Monsters vs Aliens,2009-03-19,2009,175000000,381509870,206509870,14.243634
15513,Kissing a Fool,1998-02-27,1998,0,0,0,9.275956
15514,I Love You Too,2001-02-15,2001,0,0,0,0.536339
15515,The 7th Voyage of Sinbad,1958-12-05,1958,650000,0,-650000,11.118379
15516,The Last House on the Left,1972-08-30,1972,90000,0,-90000,9.640939
15525,Godforsaken!,2003-04-24,2003,0,0,0,1.514227
15527,Otis,2008-03-07,2008,0,0,0,2.467542
15531,Get Smart's Bruce and Lloyd Out of Control,2008-07-01,2008,0,0,0,3.697948
15534,Griffin & Phoenix,2006-09-12,2006,0,0,0,13.534117
15542,Stiletto,2008-04-29,2008,4000000,0,-4000000,2.986836
15543,Penny Dreadful,2006-11-10,2006,0,0,0,2.575856
15544,Extreme Movie,2008-12-05,2008,0,0,0,9.435287
15548,Cirque du Soleil: Dralion,2001-08-04,2001,0,0,0,0.382243
15552,Cirque du Soleil: Varekai,2003-10-07,2003,0,0,0,2.312374
15554,Triumph of the Nerds: The Rise of Accidental Empires,1996-06-22,1996,0,0,0,1.242135
15555,Chop Shop,2007-05-21,2007,0,0,0,1.479651
15556,At First Sight,1999-01-15,1999,0,0,0,7.638813
15558,Journey to the End of the Night,2006-04-21,2006,0,0,0,1.352039
15559,Destiny in Space,1994-01-17,1994,0,0,0,1.578897
15560,Mission to Mir,1997-10-17,1997,0,0,0,0.227606
15564,Wolves,1999-03-01,1999,0,5471376,5471376,0.706172
15566,Surviving Christmas,2004-09-21,2004,45000000,14793624,-30206376,8.698971
15567,Stitch! The Movie,2003-08-26,2003,0,0,0,5.872797
15568,Gracie,2007-06-01,2007,9000000,2955039,-6044961,2.961621
15570,Bomb It,2007-04-27,2007,0,0,0,0.477894
15573,The Cowboys,1972-01-13,1972,6000000,7500000,1500000,3.189566
15576,Bellamy,2009-02-25,2009,0,0,0,1.340154
15577,Crossing Over,2009-02-27,2009,25000000,1037335,-23962665,6.036408
15580,The End Of America,2008-01-01,2008,0,0,0,0.372372
15581,Who's Your Caddy?,2007-07-27,2007,0,0,0,1.197217
15582,Teen Wolf Too,1987-11-20,1987,0,0,0,4.604439
15584,Dear Zachary: A Letter to a Son About His Father,2008-10-31,2008,0,0,0,5.531686
15587,Safari,2009-04-01,2009,0,0,0,10.6678
15588,OSS 117: Lost in Rio,2009-04-14,2009,31165200,0,-31165200,8.637416
15590,The Prince & Me 2: The Royal Wedding,2006-02-21,2006,0,0,0,5.326142
15592,Beaches,1988-12-21,1988,0,57041866,57041866,16.179384
15596,Back to School,1986-06-13,1986,0,91258000,91258000,6.669879
15598,Alfie,1966-03-29,1966,0,0,0,7.409319
15600,Missing,1982-02-12,1982,0,14000000,14000000,4.652888
15601,Scooby-Doo! and the Cyber Chase,2001-10-09,2001,0,0,0,3.573075
15602,Grumpier Old Men,1995-12-22,1995,0,0,0,11.7129
15603,Fat Pizza,2003-04-10,2003,400000,7888102,7488102,0.99099
15611,Do You Believe in Miracles? The Story of the 1980 U.S. Hockey Team,2002-01-08,2002,0,0,0,0.20375
15613,Fire in the Sky,1993-03-12,1993,19885552,19724334,-161218,6.118228
15614,Invasion,1997-05-04,1997,0,0,0,0.946845
15616,Private Valentine: Blonde & Dangerous,2008-11-07,2008,0,0,0,5.614419
15618,Robot Jox,1989-10-01,1989,10000000,0,-10000000,3.312779
15624,Conversations with Other Women,2006-06-07,2006,450000,973525,523525,2.333661
15638,Ultimate Heist,2009-03-03,2009,0,0,0,5.482028
15639,Larry the Cable Guy: Health Inspector,2006-03-24,2006,0,0,0,0.797046
15640,"Killing Is My Business, Honey",2009-02-26,2009,0,0,0,5.050627
15641,Vacancy 2: The First Cut,2008-10-24,2008,3000000,0,-3000000,3.307214
15642,Rascals on the Road,2006-12-28,2006,0,0,0,0.824792
15644,Paparazzi,2004-09-03,2004,20000000,16605763,-3394237,12.553403
15647,Kissing Jessica Stein,2001-04-21,2001,1000000,10013424,9013424,3.374229
15648,The Perfect Man,2005-06-17,2005,0,0,0,4.845647
15651,For the Bible Tells Me So,2007-10-05,2007,0,312751,312751,1.032566
15653,An Extremely Goofy Movie,2000-02-29,2000,0,0,0,10.368424
15654,Kabluey,2007-06-25,2007,0,83398,83398,1.773963
15655,The Tigger Movie,2000-02-11,2000,30000000,45554533,15554533,7.023414
15657,Tarzan II,2005-06-13,2005,0,0,0,6.668987
15658,Flowers in the Attic,1987-11-20,1987,0,0,0,2.967729
15659,Foul Play,1978-07-14,1978,0,0,0,4.789542
15660,Mommie Dearest,1981-09-18,1981,0,0,0,2.878266
15661,Noise,2008-05-09,2008,0,0,0,1.894402
15662,Quid Pro Quo,2008-06-13,2008,0,0,0,1.138929
15664,Right at Your Door,2006-01-23,2006,0,2043704,2043704,4.010441
15665,The Eyes of Tammy Faye,2000-01-25,2000,0,0,0,0.054431
15667,The Last Winter,2006-09-11,2006,0,0,0,4.320642
15668,Xanadu,1980-08-08,1980,20000000,22471595,2471595,3.782547
15669,The Final Season,2007-10-12,2007,0,0,0,1.053739
15670,Madea Goes to Jail,2009-02-16,2009,0,90508336,90508336,2.844534
15671,Picture This,2008-07-13,2008,0,0,0,13.415919
15673,Connie and Carla,2004-04-16,2004,20000000,11341016,-8658984,9.502332
15674,Sabrina the Teenage Witch,1996-04-07,1996,0,0,0,7.220815
15675,Neil Young: Heart of Gold,2006-02-10,2006,0,0,0,0.583897
15676,Nobel Son,2007-04-28,2007,4000000,333912,-3666088,2.420823
15677,84 Charing Cross Road,1987-02-13,1987,0,0,0,4.176526
15681,Ex,2009-02-06,2009,10000000,0,-10000000,5.048144
15689,Dead Meat,2004-10-01,2004,0,0,0,2.783147
15691,Doctor Who,1996-03-31,1996,5000000,42000000,37000000,5.147819
15696,A Canterbury Tale,1944-08-21,1944,0,0,0,1.77798
15697,Jailhouse Rock,1957-11-08,1957,0,0,0,5.684927
15698,Running Scared,1986-06-27,1986,0,0,0,4.819467
15701,The Irrefutable Truth About Demons,2000-05-01,2000,500000,0,-500000,0.47661
15702,To Paint or Make Love,2005-08-24,2005,0,0,0,1.176549
15705,Incendiary,2008-01-20,2008,10000000,0,-10000000,4.279817
15706,Another Gay Sequel: Gays Gone Wild!,2008-11-06,2008,0,0,0,2.066138
15708,Latter Days,2003-07-10,2003,850000,819939,-30061,3.334942
15709,Changing Sides,2008-01-07,2008,0,0,0,5.197678
15711,The Lost,2006-03-11,2006,0,0,0,2.017489
15712,Welcome,2009-03-11,2009,0,0,0,3.563196
15713,The First Star,2009-01-01,2009,0,0,0,2.64521
15714,Like Minds,2006-08-10,2006,0,0,0,5.343238
15716,The Pirates of Penzance,1983-02-18,1983,0,694497,694497,2.555585
15717,Rockers,1978-01-01,1978,0,0,0,0.718371
15718,Garfield's Halloween Adventure,1985-10-30,1985,0,0,0,1.636118
15719,Do Not Disturb,1999-11-04,1999,0,0,0,6.608293
15720,The Man from Elysian Fields,2001-09-13,2001,0,0,0,5.071803
15723,The Big Kahuna,2000-04-28,2000,7000000,3728888,-3271112,4.896026
15724,Encounters of the Spooky Kind,1980-12-24,1980,0,731753,731753,2.527755
15725,Chasing Ghosts: Beyond the Arcade,2007-01-19,2007,0,0,0,1.15189
15728,Boy Culture,2007-01-31,2007,500000,220151,-279849,2.317528
15730,Love & Human Remains,1993-05-20,1993,0,0,0,0.354014
15734,Girls! Girls! Girls!,1962-11-21,1962,0,0,0,1.435609
15736,The Death King,1990-01-25,1990,0,0,0,2.423177
15739,Annie,1982-06-18,1982,50000000,57059003,7059003,8.997507
15740,"Sarah, Plain and Tall",1991-02-03,1991,0,0,0,1.66074
15741,Dorothy Mills,2008-08-06,2008,500000,0,-500000,3.652912
15742,Taxidermia,2006-08-23,2006,0,0,0,5.141933
15745,Made,2001-07-13,2001,5000000,5476060,476060,3.531682
15749,While She Was Out,2008-10-27,2008,6000000,391410,-5608590,9.002146
15752,Barenaked in America,1999-01-01,1999,0,0,0,0.092135
15759,Skylark,1993-02-07,1993,0,0,0,1.013204
15761,Company,2002-04-15,2002,1500000,6000000,4500000,1.472352
15762,Night of the Creeps,1986-08-21,1986,0,0,0,5.460546
15764,Sophie's Choice,1982-12-08,1982,12000000,30036000,18036000,15.417202
15765,What's Love Got to Do with It,1993-06-09,1993,0,0,0,14.820883
15766,"Ghidorah, the Three-Headed Monster",1964-12-20,1964,0,0,0,2.07226
15767,Godzilla: Final Wars,2004-12-04,2004,19500000,0,-19500000,3.131059
15768,A Colbert Christmas: The Greatest Gift of All!,2008-11-23,2008,0,0,0,1.421005
15770,Born to Defend,1986-02-16,1986,0,0,0,1.122498
15771,Class Action,1991-03-15,1991,0,0,0,5.234298
15772,Guru,2007-01-12,2007,4700000,31000000,26300000,2.925476
15774,"Swades: We, the People",2004-12-17,2004,5000000,0,-5000000,4.971198
15775,If Only,2004-01-23,2004,0,0,0,4.99289
15776,The Art of Crying,2007-03-17,2007,0,0,0,0.584156
15785,Cherry 2000,1987-11-12,1987,10000000,14000,-9986000,2.849779
15787,The Delicate Delinquent,1957-06-06,1957,0,0,0,1.273904
15788,The Bellboy,1960-07-20,1960,900000,10000000,9100000,2.738268
15789,A Goofy Movie,1995-04-07,1995,0,35348597,35348597,10.177977
15791,Diamond Dogs,2007-01-01,2007,0,0,0,1.821627
15794,White Heat,1949-09-02,1949,0,0,0,11.300976
15797,Only the Strong,1993-08-27,1993,6000000,3283371,-2716629,7.96433
15800,Trekkies,1997-10-18,1997,0,0,0,4.79567
15801,What Doesn't Kill You,2008-12-12,2008,0,44872,44872,3.646265
15802,Tokyo Decadence,1992-01-06,1992,0,0,0,1.960567
15803,Multi-Facial,1995-01-01,1995,3000,0,-3000,1.099681
15804,A Brighter Summer Day,1991-07-27,1991,0,0,0,3.248978
15805,Batman & Mr. Freeze: SubZero,1998-03-17,1998,0,0,0,4.579735
15807,Air Force,1943-03-20,1943,0,0,0,0.955413
15809,Green Street Hooligans 2,2009-03-23,2009,8000000,0,-8000000,4.691962
15810,The Tender Hook,2008-09-18,2008,0,0,0,1.277157
15813,Dark Blue World,2001-05-17,2001,5000000,0,-5000000,2.702716
15822,Accused,2005-01-28,2005,0,0,0,4.091216
15824,The Inheritance,2003-02-21,2003,0,0,0,1.599982
15826,Restless Souls,2005-05-27,2005,0,0,0,0.767032
15830,The Bench,2000-08-26,2000,0,0,0,2.171715
15834,Fear Me Not,2008-12-19,2008,0,0,0,0.382905
15837,What No One Knows,2008-02-11,2008,0,0,0,0.874066
15838,Sunshine Barry & the Disco Worms,2008-09-07,2008,0,0,0,0.639577
15840,Manslaughter,2005-08-26,2005,0,0,0,3.704029
15842,Kira's Reason: A Love Story,2001-10-26,2001,0,0,0,0.918722
15846,The Burrowers,2008-09-09,2008,7000000,0,-7000000,5.59423
15849,The Mummy,1932-12-22,1932,196000,0,-196000,12.190044
15850,The Trip,2002-11-01,2002,0,0,0,3.120644
15854,Kung Fu Panda: Secrets of the Furious Five,2008-11-08,2008,0,0,0,6.638013
15855,Phantom of the Opera,1943-08-27,1943,1500000,0,-1500000,3.658396
15856,House on Haunted Hill,1959-02-17,1959,200000,0,-200000,5.738218
15859,A Moment to Remember,2004-11-05,2004,4200000,0,-4200000,5.216663
15860,Dragon Tiger Gate,2006-07-27,2006,0,8685526,8685526,4.154861
15864,Bachna Ae Haseeno,2008-08-14,2008,2400000,9600000,7200000,1.921026
15865,The Zone,2007-09-01,2007,0,0,0,4.10002
15866,Bait Shop,2008-09-02,2008,0,0,0,0.749604
15867,Interiors,1978-08-02,1978,0,0,0,4.515797
15873,The Bridge at Remagen,1969-06-25,1969,0,0,0,3.425892
15875,Donovan's Reef,1963-06-12,1963,2686000,6600000,3914000,1.920256
15876,The Enemy Below,1957-12-25,1957,0,0,0,3.583179
15877,The Sky Crawlers,2008-08-02,2008,0,0,0,3.58447
15888,Fishtales,2007-08-24,2007,14000000,9216,-13990784,0.964715
15895,Deathstalker,1983-09-02,1983,0,8890685,8890685,2.030024
15898,Unstable Fables: 3 Pigs & a Baby,2008-01-01,2008,0,0,0,1.798472
15900,Faces of Death II,1981-11-10,1981,0,0,0,1.166911
15901,Faces of Death III,1985-03-10,1985,0,0,0,0.867342
15902,Faces of Death IV,1990-11-28,1990,0,0,0,0.778312
15904,Faces of Death VI,1996-10-04,1996,0,0,0,0.453391
15906,Barbie and the Magic of Pegasus 3-D,2005-10-05,2005,0,0,0,6.966851
15907,Duma,2005-04-22,2005,12000000,0,-12000000,7.53788
15909,Kermit's Swamp Years,2002-09-03,2002,0,0,0,0.805929
15911,The Village Barbershop,2008-01-01,2008,0,0,0,0.657751
15912,The Square,2008-06-15,2008,0,0,0,2.634201
15915,The Pornographer,2001-09-08,2001,1500000,0,-1500000,3.08132
15916,Angel's Egg,1985-12-22,1985,0,0,0,3.069495
15917,Devdas,2002-07-12,2002,12500000,0,-12500000,4.641126
15919,Marty,1955-04-11,1955,343000,3000000,2657000,11.589081
15920,Autumn Spring,2001-09-27,2001,0,0,0,0.5724
15925,633 Squadron,1964-04-06,1964,0,0,0,1.497347
15926,Beer for My Horses,2008-08-08,2008,0,666045,666045,2.033354
15927,A Passage to India,1984-12-14,1984,8000000,27187653,19187653,11.842837
15930,Fighter,2007-12-14,2007,0,0,0,0.496686
15932,The Candidate,2008-08-29,2008,0,0,0,1.351956
15934,El cantante,2006-09-12,2006,0,0,0,1.904593
15935,Bad Eggs,2003-07-24,2003,0,0,0,1.0044
15936,Just Add Water,2008-03-18,2008,0,0,0,6.961849
15938,Room Service,1938-09-30,1938,0,0,0,1.782967
15940,Beautiful Creatures,2000-08-23,2000,0,0,0,2.269511
15942,Go Fast,2008-10-01,2008,0,0,0,6.39093
15943,The Shaggy D.A.,1976-12-17,1976,0,0,0,1.48253
15944,The Shaggy Dog,1959-03-19,1959,0,0,0,3.404213
15945,The Way of War,2009-02-20,2009,0,0,0,9.781476
15947,The Three Caballeros,1944-07-21,1944,0,0,0,8.702472
15952,Terribly Happy,2008-07-15,2008,0,179943,179943,4.472892
15953,Chef's Special,2008-04-11,2008,0,0,0,1.653025
15956,Just Like Home,2007-03-30,2007,0,0,0,0.612184
15957,White Night,2007-10-26,2007,0,0,0,1.055376
15959,How to Get Rid of the Others,2007-01-26,2007,0,0,0,1.005852
15961,King's Game,2004-08-10,2004,0,0,0,2.850939
15962,Murk,2005-10-07,2005,0,0,0,1.495971
15969,The Return of Jafar,1994-12-15,1994,0,0,0,12.099799
15973,Varg Veum - Fallen Angels,2008-04-04,2008,0,0,0,1.458094
15974,Bhoothnath,2008-05-09,2008,0,0,0,1.284459
15975,Oye Lucky! Lucky Oye!,2008-11-28,2008,0,0,0,0.698654
15977,Dev.D,2009-02-06,2009,0,0,0,2.610881
15978,Naina,2005-05-20,2005,500000,0,-500000,0.465984
15979,Phoonk,2008-08-22,2008,750000,2760000,2010000,0.686155
15981,Dead Leaves,2004-01-16,2004,0,0,0,1.254481
15982,The Legend of Billie Jean,1985-07-19,1985,0,3099497,3099497,2.727843
15983,Invasion U.S.A.,1985-09-27,1985,0,0,0,3.846849
15990,The Cathedral,2002-10-18,2002,0,0,0,0.903483
15991,Bad Biology,2008-02-08,2008,0,0,0,2.011614
15992,Abandon,2002-10-14,2002,25000000,10719357,-14280643,3.485213
15993,Gen 13,2000-10-30,2000,0,0,0,1.740472
15994,Cut Loose,2008-09-17,2008,0,0,0,0.040127
15997,The Land Before Time II: The Great Valley Adventure,1994-12-12,1994,0,0,0,8.98856
15999,Vampire Hunter D: Bloodlust,2000-08-25,2000,0,0,0,5.204291
16003,The Hunters,1996-01-31,1996,17500000,0,-17500000,2.310913
16004,Love n' Dancing,2009-01-01,2009,0,0,0,1.678404
16005,The Lucky Ones,2008-09-26,2008,0,0,0,7.444398
16007,Death Note,2006-06-17,2006,20000000,27793200,7793200,9.570657
16008,Room 205,2007-08-10,2007,0,0,0,1.43708
16010,Life Hits,2006-07-03,2006,0,0,0,0.509359
16013,Triple Dare,2006-08-11,2006,0,0,0,1.096528
16014,Clash of Egos,2006-08-25,2006,0,0,0,0.726228
16015,Worlds Apart,2008-02-22,2008,0,0,0,2.256139
16016,Journey to Saturn,2008-09-26,2008,0,0,0,2.142391
16017,Prague,2006-11-03,2006,0,0,0,2.466901
16018,American Hardcore,2006-09-22,2006,0,0,0,1.078379
16019,Lost Islands,2008-07-03,2008,0,0,0,1.735002
16022,Nine Lives,2005-01-24,2005,0,0,0,2.171333
16023,South Park: Imaginationland,2008-03-11,2008,0,0,0,7.829821
16026,S√§llskapsresan - eller finns det svenskt kaffe p√• grisfesten?,1980-08-22,1980,0,5010362,5010362,2.972928
16028,They,2002-11-01,2002,17000000,0,-17000000,4.583304
16029,Tree of Knowledge,1981-06-06,1981,0,0,0,1.753819
16031,Little Soldier,2008-11-14,2008,0,0,0,0.466342
16032,Midsummer,2003-07-18,2003,0,0,0,2.265412
16039,Zappa,1983-03-04,1983,0,0,0,1.514292
16042,a/k/a Tommy Chong,2006-06-14,2006,0,0,0,1.921223
16047,Go with Peace Jamil,2008-05-30,2008,0,0,0,0.951189
16048,All About Anna,2005-11-24,2005,0,0,0,6.614301
16049,Amazon Jack 3: Jungo Goes Bananas,2007-12-21,2007,0,0,0,0.81572
16052,Selena,1997-03-21,1997,20000000,60000000,40000000,7.390306
16056,Winged Creatures,2008-06-24,2008,0,0,0,8.911963
16058,Take Away,2003-08-14,2003,0,0,0,1.447172
16059,Oneway-Ticket to Kors√∏r,2008-09-18,2008,0,0,0,0.183421
16061,Tokyo Gore Police,2008-10-03,2008,0,0,0,4.496374
16066,Oyster Farmer,2005-06-30,2005,0,0,0,1.143836
16068,Babylon 5: The Legend of the Rangers - To Live and Die in Starlight,2002-01-19,2002,0,0,0,2.698788
16070,This Film Is Not Yet Rated,2006-01-26,2006,0,302179,302179,5.205826
16071,The Cake Eaters,2007-04-29,2007,0,0,0,4.701858
16072,Gods and Generals,2003-02-21,2003,56000000,12923936,-43076064,5.374563
16074,Mountain Patrol,2004-10-01,2004,1200000,0,-1200000,1.811939
16075,Great Expectations,1999-05-09,1999,0,0,0,2.58432
16076,Screwed in Tallinn,1999-04-22,1999,0,0,0,1.573783
16077,My Little Eye,2002-10-04,2002,3000000,0,-3000000,4.04526
16079,The Visitors,1988-04-29,1988,0,0,0,0.794247
16080,Crazy Eights,2006-10-31,2006,0,0,0,7.621915
16081,Doctor Dolittle,1967-12-19,1967,18000000,9000000,-9000000,3.896319
16082,White Nights,1985-11-22,1985,0,42160849,42160849,3.043177
16083,First Snow,2006-05-05,2006,0,382267,382267,4.782755
16084,Freaky Friday,1976-12-17,1976,0,0,0,8.977922
16085,Funny Girl,1968-09-19,1968,14000000,52223306,38223306,4.651946
16089,Love Nest,1951-10-10,1951,0,0,0,1.022568
16090,The Blue Dahlia,1946-04-19,1946,0,0,0,3.251779
16091,Aftermath: Population Zero,2008-03-09,2008,0,0,0,1.328618
16092,The Appeared,2008-12-12,2008,0,0,0,0.525407
16093,Carnival of Souls,1962-09-26,1962,30000,0,-30000,9.505439
16094,House Party,1990-03-09,1990,2500000,26386000,23886000,2.291511
16095,Troubled Water,2008-09-26,2008,0,0,0,2.180399
16096,House Party 2,1991-10-23,1991,0,0,0,7.252003
16097,House Party 3,1994-01-01,1994,0,0,0,0.996047
16103,The Loneliness of the Long Distance Runner,1962-09-20,1962,0,0,0,4.503397
16110,Thomas and the Magic Railroad,2000-07-26,2000,0,0,0,1.046659
16112,The Adventures of Elmo in Grouchland,1999-10-01,1999,0,0,0,2.86282
16113,The Delta Force,1986-02-14,1986,0,17768900,17768900,7.224683
16116,American High School,2009-04-07,2009,0,0,0,1.039427
16117,What Would Jesus Buy?,2007-03-11,2007,0,0,0,0.249382
16119,Cinderella III: A Twist in Time,2007-02-06,2007,8000000,0,-8000000,6.961912
16121,The Big Red One,1980-05-28,1980,4500000,7206220,2706220,5.395103
16122,Playing Beatie Bow,1986-08-07,1986,0,0,0,0.000396
16123,100 Million BC,2008-07-29,2008,0,0,0,2.312713
16124,Goodbye Pork Pie,1981-02-05,1981,300000,1400000,1100000,1.023164
16126,Flight of the Living Dead: Outbreak on a Plane,2007-04-06,2007,0,0,0,1.944796
16127,Forbidden Zone,1980-03-21,1980,0,0,0,2.234554
16129,Last Night,1998-10-23,1998,0,0,0,5.466969
16130,La Classe Am√©ricaine,1993-12-30,1993,0,0,0,7.278823
16131,Undertow,2004-05-14,2004,0,143597,143597,2.799447
16132,Twin Sisters,2002-12-11,2002,0,0,0,1.218377
16133,Survive Style 5+,2004-09-25,2004,0,0,0,2.336334
16135,Mister Lonely,2008-12-17,2008,0,0,0,2.411188
16136,Juice,1992-01-17,1992,5000000,20146880,15146880,5.547398
16137,Fear(s) of the Dark,2008-01-01,2008,0,0,0,4.762443
16138,R-Point,2004-08-13,2004,0,0,0,2.004405
16139,Phantasm III: Lord of the Dead,1994-05-06,1994,2500000,0,-2500000,4.401721
16140,Death Note: The Last Name,2006-10-28,2006,0,50710400,50710400,5.082787
16143,Nitro,2006-12-31,2006,0,0,0,0.944894
16146,Phantasm IV: Oblivion,1998-07-31,1998,650000,0,-650000,7.590628
16147,Aurore,2005-07-08,2005,6000000,0,-6000000,0.825096
16148,Zero Effect,1998-01-30,1998,5000000,1980338,-3019662,3.621052
16149,The Great Rock 'n' Roll Swindle,1980-09-11,1980,0,0,0,1.254364
16150,Darkon,2006-09-12,2006,0,0,0,0.31215
16151,Look Both Ways,2005-03-03,2005,0,0,0,0.617625
16153,Alice Doesn't Live Here Anymore,1974-12-09,1974,0,0,0,4.195988
16154,Let's Scare Jessica to Death,1971-08-06,1971,180000,0,-180000,4.157477
16155,Safe Men,1998-08-17,1998,0,0,0,3.383704
16156,Sarah Silverman: Jesus Is Magic,2005-02-11,2005,0,0,0,0.861427
16157,Mobile Suit Gundam: Char's Counterattack,1988-03-12,1988,0,0,0,1.639329
16158,The Wood,1999-07-16,1999,6000000,25059640,19059640,4.414077
16159,Sundown: The Vampire in Retreat,1989-05-18,1989,2800000,0,-2800000,1.578122
16161,Baby Boy,2001-06-27,2001,16000000,29381649,13381649,9.503157
16162,The Best Man,1999-10-22,1999,9000000,34573780,25573780,5.055141
16164,Killshot,2008-11-13,2008,0,2960993,2960993,4.475472
16166,Sauna,2010-06-25,2010,0,0,0,3.176768
16167,From Within,2009-03-31,2009,0,66456,66456,3.215954
16170,Jar City,2006-10-20,2006,0,0,0,1.333873
16171,The Nine Lives of Tomas Katz,2000-03-01,2000,0,0,0,1.170236
16172,Simply Irresistible,1999-02-05,1999,6000000,4398989,-1601011,6.053045
16174,Snow Queen,2002-01-04,2002,0,0,0,4.749467
16175,The Diary of Ellen Rimbauer,2003-05-12,2003,0,0,0,8.764092
16176,The Slipper and the Rose,1976-03-24,1976,0,0,0,2.306621
16177,Killer Babes,2007-12-20,2007,0,0,0,0.151252
16179,Breathing Room,2008-08-25,2008,0,0,0,1.776816
16180,The Legend of Hell House,1973-06-15,1973,0,0,0,7.784939
16182,The Woman in Black,1989-12-24,1989,0,0,0,7.551569
16184,The Happiness of the Katakuris,2001-10-31,2001,0,0,0,1.870143
16186,Diary of a Mad Black Woman,2005-02-25,2005,0,0,0,4.818507
16190,≈Ωi≈æek!,2005-11-18,2005,0,0,0,0.719799
16191,Highway to Hell,1991-11-21,1991,9000000,26055,-8973945,1.80809
16194,Not Quite Hollywood,2008-08-28,2008,0,0,0,1.661349
16197,Dating The Enemy,1996-09-19,1996,0,0,0,1.585469
16198,My Neighbors the Yamadas,1999-07-17,1999,0,0,0,5.106657
16201,Armbryterskan fr√•n Ensamheten,2004-10-01,2004,0,0,0,0.078565
16203,Space Is the Place,1974-11-01,1974,0,0,0,0.004763
16204,The Girl in the Park,2007-09-09,2007,0,0,0,5.812464
16205,Jack Brooks: Monster Slayer,2007-10-09,2007,0,0,0,3.88291
16209,Jesus Christ Vampire Hunter,2001-06-10,2001,0,0,0,0.836924
16211,The Sons of Katie Elder,1965-12-26,1965,0,0,0,5.190094
16214,Hooper,1978-07-28,1978,0,78000000,78000000,2.991742
16217,The Big Steal,1990-09-20,1990,0,0,0,1.456094
16219,Gladiator 1992,1992-03-06,1992,0,9,9,2.660772
16220,Wizards,1977-02-09,1977,1200000,9000000,7800000,2.914738
16221,Dororo,2007-03-15,2007,0,0,0,1.487834
16222,Whatever It Takes,2000-03-31,2000,15000000,9902115,-5097885,3.550711
16224,Plastic Little: The Adventures of Captain Tita,1994-03-20,1994,0,0,0,0.240688
16225,Heavy Metal 2000,2000-04-19,2000,15000000,0,-15000000,3.511503
16226,Lady Death,2004-10-05,2004,0,0,0,0.910428
16227,Dark Passage,1947-09-27,1947,0,0,0,6.287228
16229,Prozac Nation,2001-09-08,2001,0,0,0,4.865523
16231,Wild Zero,1999-08-28,1999,0,0,0,0.869181
16232,Mr. 3000,2004-06-15,2004,30000000,21800302,-8199698,4.902869
16233,Tromeo & Juliet,1996-05-13,1996,350000,0,-350000,5.704337
16234,Batman Beyond: Return of the Joker,2000-12-12,2000,0,0,0,7.872438
16235,Amityville II: The Possession,1982-09-24,1982,0,12534817,12534817,12.10181
16236,Mansfield Park,2007-03-18,2007,0,0,0,5.671228
16237,Teen Titans: Trouble in Tokyo,2006-09-15,2006,0,0,0,7.261823
16239,Will Ferrell: You're Welcome America - A Final Night with George W. Bush,2009-03-14,2009,0,0,0,1.84991
16240,Breakfast with Scot,2007-11-16,2007,0,0,0,2.214344
16241,The Boys from Brazil,1978-10-05,1978,0,0,0,5.923299
16242,Les patriotes,1994-06-01,1994,0,0,0,0.635069
16246,Gone in 60 Seconds,1974-07-28,1974,0,0,0,3.560274
16247,Festival,1967-10-22,1967,0,0,0,0.694321
16248,D.A.R.Y.L.,1985-06-14,1985,0,7840873,7840873,5.385862
16249,Blackbeard's Ghost,1968-02-08,1968,0,0,0,2.895685
16250,Love Comes Softly,2003-04-13,2003,0,0,0,1.807464
16257,Street Fighter IV: The Ties That Bind,2009-02-17,2009,0,0,0,0.745348
16258,The Butterfly Effect 3: Revelations,2009-01-09,2009,0,0,0,7.228413
16261,Repli-Kate,2002-01-18,2002,4000000,0,-4000000,5.433616
16263,Girls Just Want to Have Fun,1985-04-12,1985,0,0,0,3.753097
16266,2012 Doomsday,2008-02-12,2008,250000,0,-250000,2.37802
16268,War of the Worlds 2: The Next Wave,2008-01-01,2008,0,0,0,6.870464
16269,God of Gamblers,1989-12-14,1989,0,4762337,4762337,2.608728
16270,Career Opportunities,1991-03-29,1991,0,0,0,11.718412
16271,Massacre at Central High,1976-09-01,1976,0,0,0,1.168074
16274,Holiday,1938-06-15,1938,0,0,0,5.272066
16276,The Tiger Brigades,2006-04-14,2006,0,0,0,2.37193
16277,Skirt Day,2008-11-09,2008,0,0,0,6.675401
16279,The Great Buck Howard,2008-01-18,2008,0,900689,900689,7.957389
16280,13 Hours in a Warehouse,2008-10-28,2008,0,0,0,0.25404
16281,Creepshow,1982-11-12,1982,8000000,21028755,13028755,10.434018
16283,Saawariya,2007-11-07,2007,0,0,0,1.859399
16284,Ice Cold in Alex,1958-06-24,1958,0,0,0,2.750367
16288,Creepshow 2,1987-05-01,1987,3500000,14000000,10500000,9.330087
16290,Jackass 3D,2010-10-15,2010,20000000,117224271,97224271,10.997518
16295,Higher Learning,1995-01-11,1995,0,38290723,38290723,7.817811
16296,Killer Klowns from Outer Space,1988-05-27,1988,1800000,0,-1800000,6.906831
16297,With Honors,1994-04-29,1994,0,0,0,2.969003
16299,The Stupids,1996-08-30,1996,0,0,0,1.751457
16300,Down to Earth,2001-02-16,2001,0,0,0,9.779294
16301,End of the Century: The Story of The Ramones,2003-01-19,2003,0,0,0,1.016632
16303,The Loved One,1965-10-11,1965,0,0,0,1.05989
16304,Creepshow 3,2007-05-15,2007,0,0,0,6.060156
16305,Sullivan's Travels,1941-11-30,1941,689665,0,-689665,8.64244
16306,Fantastic Planet,1973-05-01,1973,0,0,0,6.305008
16307,The Wicker Man,1973-12-01,1973,0,0,0,7.206941
16308,Mobile Suit Gundam F91,1991-03-16,1991,0,0,0,0.861846
16309,Monster,2008-01-18,2008,0,0,0,0.819755
16311,The Hard Word,2002-05-30,2002,0,0,0,1.129436
16313,Coming Soon,2008-10-28,2008,0,0,0,1.520749
16314,3 Ninjas,1992-08-07,1992,0,0,0,11.035859
16315,Campfire Tales,1997-05-16,1997,0,0,0,6.985328
16318,Sex Is Zero,2002-12-12,2002,0,0,0,4.389011
16320,Serenity,2005-08-25,2005,39000000,38869464,-130536,11.919995
16322,Sea Monsters: A Prehistoric Adventure,2008-03-19,2008,0,0,0,0.794251
16323,The Rose,1979-11-07,1979,9250000,29174648,19924648,2.132964
16324,Fatso,2008-10-24,2008,0,0,0,1.443854
16325,Echelon Conspiracy,2009-02-27,2009,0,500154,500154,6.624498
16328,Johnny Got His Gun,1971-08-04,1971,0,0,0,4.261661
16331,The Jack Bull,1999-04-17,1999,0,0,0,6.657247
16335,Walled In,2009-02-20,2009,10000000,0,-10000000,15.937321
16337,The Texas Chainsaw Massacre 2,1986-08-22,1986,4700000,8025872,3325872,9.501011
16340,Rugrats in Paris: The Movie,2000-09-14,2000,30,103,73,5.568359
16342,The Children,2008-12-05,2008,0,0,0,7.320166
16344,Luck By Chance,2009-03-27,2009,0,0,0,3.525211
16345,Billu,2009-02-13,2009,5750000,10000000,4250000,1.355305
16346,Center Stage : Turn It Up,2008-10-30,2008,0,0,0,8.516625
16347,Auntie Mame,1958-12-27,1958,0,0,0,1.849064
16350,Vinyan,2008-08-30,2008,0,0,0,3.147644
16351,Ararat,2002-05-20,2002,0,0,0,3.387974
16353,Ong Bak 2,2008-12-04,2008,8500000,8936663,436663,8.553506
16355,Sonic The Hedgehog: The Movie,1996-05-31,1996,0,0,0,1.719684
16356,Riverworld,2003-03-22,2003,0,0,0,2.540875
16358,Eulogy,2004-10-15,2004,0,0,0,11.886845
16359,Vox Populi,2008-10-23,2008,0,0,0,0.68544
16363,The Best Little Whorehouse in Texas,1982-07-23,1982,35000000,69701637,34701637,2.171346
16365,Futuresport,1998-01-09,1998,0,0,0,2.673038
16366,Joseph: King of Dreams,2000-11-07,2000,0,0,0,7.18782
16367,Kinky Boots,2005-08-30,2005,0,8895428,8895428,4.893525
16370,Aspen Extreme,1993-01-22,1993,0,8041049,8041049,0.796778
16371,Tell Me Something,1999-11-13,1999,0,0,0,1.320887
16372,The Innocents,1961-12-25,1961,0,0,0,7.667964
16373,The Uninvited,1944-02-18,1944,0,0,0,2.933523
16374,Sometimes in April,2005-02-17,2005,0,0,0,3.687491
16375,Schizopolis,1996-09-13,1996,0,0,0,2.438198
16378,The Rutles: All You Need Is Cash,1978-03-22,1978,0,0,0,2.703857
16379,The Mod Squad,1999-03-26,1999,50000000,13260050,-36739950,3.826503
16380,When Worlds Collide,1951-08-01,1951,0,0,0,3.18578
16382,Tear This Heart Out,2008-09-12,2008,0,0,0,0.867611
16383,Maharathi,2008-12-05,2008,0,0,0,0.582886
16384,My Blue Heaven,1990-08-17,1990,0,0,0,5.451623
16385,Pride,2007-03-23,2007,0,0,0,1.896372
16387,Daleks' Invasion Earth: 2150 A.D.,1966-01-01,1966,797681,0,-797681,2.997399
16388,The Brothers McMullen,1995-08-09,1995,0,0,0,2.039196
16390,Scooby-Doo! and the Samurai Sword,2009-01-01,2009,0,0,0,5.326104
16391,Black Narcissus,1947-01-01,1947,424000,0,-424000,8.657125
16392,Redline,2007-04-13,2007,26000000,0,-26000000,3.215155
16395,Inferno,1980-02-07,1980,3000000,0,-3000000,4.783203
16398,Dragonquest,2009-03-31,2009,0,0,0,1.207034
16399,Commandments,1997-05-02,1997,0,0,0,0.225707
16403,Tears for Sale,2008-01-30,2008,6000000,0,-6000000,1.836576
16405,Dust,2001-08-29,2001,0,0,0,1.210809
16406,Dick,1999-08-04,1999,13000000,27500000,14500000,3.960622
16407,Dragon Lord,1982-01-21,1982,0,0,0,4.068513
16409,Last Chance Harvey,2008-12-25,2008,0,14879423,14879423,4.088346
16410,Hobson's Choice,1954-04-19,1954,0,0,0,4.88449
16411,Initial D,2005-05-12,2005,1549000,7096000,5547000,4.331811
16412,Chasing Christmas,2005-12-04,2005,0,0,0,1.049631
16417,Yankee Zulu,1993-12-01,1993,0,0,0,1.558066
16418,Barbie Presents: Thumbelina,2009-02-24,2009,0,0,0,8.499902
16420,Othello,1995-12-15,1995,0,0,0,1.845899
16422,The Caller,2008-09-26,2008,0,0,0,0.648554
16423,Love and Magnets,2004-10-01,2004,0,0,0,0.44057
16425,Assassination Tango,2002-09-11,2002,0,0,0,1.21683
16427,A Day Without a Mexican,2004-08-06,2004,0,0,0,1.50758
16428,Breakin' All the Rules,2004-05-14,2004,0,0,0,5.414749
16429,Brothers of the Head,2005-01-01,2005,0,0,0,0.492083
16430,Dandelion,2004-01-01,2004,0,0,0,1.063378
16432,Day of Wrath,2006-06-27,2006,0,0,0,0.30267
16433,Grand Theft Parsons,2003-06-18,2003,0,0,0,1.635064
16435,Speaking of Sex,2001-10-18,2001,0,0,0,3.867469
16436,North Face,2008-10-23,2008,0,927704,927704,5.260798
16437,Cyborg 2,1993-11-24,1993,5000000,0,-5000000,4.456003
16439,The Country Teacher,2008-03-20,2008,0,0,0,0.834523
16440,Tales of the Black Freighter,2009-03-24,2009,0,0,0,2.882394
16441,The Beastmaster,1982-08-20,1982,0,14056528,14056528,5.577636
16442,Sergeant York,1941-07-02,1941,1400000,16361885,14961885,3.336494
16444,The First of the Few,1942-09-14,1942,0,0,0,0.901645
16447,Woman Is the Future of Man,2004-05-14,2004,0,0,0,1.345288
16448,Waiting for Guffman,1996-01-31,1996,0,0,0,8.130999
16450,Hero Wanted,2008-03-28,2008,0,0,0,3.382052
16452,The Comedians of Comedy,2005-03-01,2005,0,0,0,1.081127
16453,Zach Galifianakis: Live at the Purple Onion,2007-03-06,2007,0,0,0,4.70231
16455,The Magic Roundabout,2005-01-19,2005,20000000,0,-20000000,2.757473
16456,The Crow IV: Wicked Prayer,2005-05-13,2005,0,0,0,4.807389
16460,Garfield Gets Real,2007-09-30,2007,0,0,0,3.190551
16464,Traffic Crossing Leeds Bridge,1888-10-15,1888,0,0,0,1.49042
16465,The Infernal Caldron,1903-10-17,1903,0,0,0,0.262724
16471,Modern Problems,1981-12-25,1981,0,0,0,5.619281
16486,The Spirit of Christmas,1992-12-01,1992,0,0,0,0.130903
16487,The Spirit of Christmas,1995-01-01,1995,0,0,0,1.410367
16508,Doug's 1st Movie,1999-03-26,1999,0,0,0,2.924948
16509,Confessions of a Superhero,2007-11-02,2007,0,0,0,0.874621
16513,Loafing and Camouflage: I-4,2008-04-27,2008,0,0,0,0.684657
16514,To Hell and Back,1955-09-22,1955,0,0,0,1.715253
16515,Captains Courageous,1937-06-25,1937,1645000,0,-1645000,2.883201
16516,Clannad: The Motion Picture,2007-09-15,2007,0,0,0,1.664222
16520,The King and I,1956-06-29,1956,4550000,21300000,16750000,7.630723
16523,Where the Wild Things Are,2009-10-16,2009,100000000,100086793,86793,12.36223
16530,Pocket Ninjas,1997-03-25,1997,0,0,0,0.325189
16535,Titanic,1953-04-11,1953,1805000,4905000,3100000,12.90707
16538,"I Love You, Man",2009-03-20,2009,41000000,91636986,50636986,12.929653
16539,Zus & Zo,2001-01-01,2001,0,0,0,0.7122
16548,Ellie Parker,2005-01-21,2005,0,0,0,10.146313
16550,Storytelling,2001-11-08,2001,0,0,0,9.447478
16551,Rhinestone,1984-06-22,1984,28000000,21435321,-6564679,5.415639
16553,Little Manhattan,2005-09-30,2005,0,1117920,1117920,9.394353
16555,Daddy's Little Girls,2007-02-14,2007,10000000,31609243,21609243,6.063809
16558,Duplicity,2009-03-19,2009,78146652,60000000,-18146652,9.097953
16559,The Picture of Dorian Gray,1945-03-01,1945,0,0,0,9.080158
16560,Tap,1989-02-12,1989,0,9114702,9114702,0.879566
16561,The Sunshine Boys,1975-11-06,1975,0,0,0,2.055346
16562,The Cutting Edge,1992-03-27,1992,0,25105517,25105517,3.8143
16563,Seven Brides for Seven Brothers,1954-07-22,1954,0,5000000,5000000,5.748536
16564,Winter in Wartime,2008-11-17,2008,4000000,530048,-3469952,3.92107
16566,Ab Tak Chhappan,2004-02-27,2004,0,0,0,0.698803
16576,Cheeni Kum,2007-05-25,2007,0,0,0,1.014387
16577,Astro Boy,2009-10-15,2009,65000000,44091067,-20908933,13.293466
16605,Somersault,2004-06-19,2004,0,0,0,1.623367
16606,Attack the Gas Station!,1999-10-02,1999,0,0,0,1.776541
16608,The Proposition,2005-10-06,2005,2000000,5048693,3048693,9.387212
16612,Carmencita,1894-03-14,1894,0,0,0,1.273072
16614,Adventureland,2009-04-03,2009,9500000,17164377,7664377,6.77887
16617,Mindhunters,2004-05-07,2004,27000000,21148829,-5851171,7.600017
16618,Hans Christian Andersen,1952-12-19,1952,0,0,0,1.569565
16619,Ordinary People,1980-09-19,1980,6000000,0,-6000000,8.934661
16620,La Bamba,1987-07-24,1987,6500000,54215416,47715416,6.476534
16624,Blacksmith Scene,1893-05-08,1893,0,0,0,1.061591
16632,100 Days with Mr. Arrogant,2004-01-16,2004,3200000,0,-3200000,1.831454
16633,Somewhere in Time,1980-10-02,1980,5100000,0,-5100000,5.429213
16634,Alien Trespass,2009-04-03,2009,0,0,0,10.067125
16635,In My Country,2004-05-04,2004,12000000,163536,-11836464,1.14196
16636,Spellbound,2002-11-13,2002,0,0,0,2.445503
16638,El Cid,1961-10-24,1961,0,0,0,4.152069
16639,Deliver Us from Evil,2009-04-03,2009,0,0,0,2.041042
16640,Pirates of the Great Salt Lake,2006-01-01,2006,0,0,0,0.149519
16642,Days of Heaven,1978-09-13,1978,0,0,0,7.380825
16643,Life or Something Like It,2002-04-26,2002,40000000,16872671,-23127329,6.332398
16646,Russian Ark,2002-05-22,2002,0,6723732,6723732,8.815485
16651,The Other Side of Heaven,2001-04-12,2001,7000000,4720371,-2279629,1.782377
16652,Happily N'Ever After 2,2009-03-24,2009,0,0,0,3.340303
16657,Prot√©g√©,2007-04-13,2007,0,0,0,3.470426
16659,My Brilliant Career,1979-08-17,1979,0,0,0,0.773123
16661,The Kid Brother,1927-01-17,1927,0,0,0,1.13281
16664,All About Lily Chou-Chou,2001-09-07,2001,0,0,0,2.695993
16665,Whisky Galore!,1949-06-16,1949,0,0,0,2.010612
16666,War Dance,2007-11-09,2007,0,0,0,1.187409
16672,Woman in the Dunes,1964-02-15,1964,0,0,0,9.768832
16686,Varg Veum - Bitter Flowers,2007-09-28,2007,0,0,0,1.488763
16687,Wushu,2008-10-23,2008,4000000,0,-4000000,1.101482
16690,Return to Never Land,2002-02-14,2002,20000000,109862682,89862682,8.759774
16692,The Tale of Zat√¥ichi,1962-04-18,1962,0,0,0,2.817598
16693,The Tale of Zat√¥ichi Continues,1962-10-12,1962,0,0,0,1.263306
16700,Bonneville,2006-09-11,2006,0,0,0,2.29609
16702,Israeli Intelligence,2007-01-01,2007,0,0,0,0.148466
16703,This Gun for Hire,1942-05-13,1942,0,0,0,2.173964
16710,Meet the Browns,2008-03-21,2008,0,41939392,41939392,3.277456
16716,A Christmas Carol,1999-12-05,1999,0,0,0,2.852665
16723,Sugar & Spice,2001-01-24,2001,11000000,13276953,2276953,7.715908
16725,The Tracey Fragments,2007-02-08,2007,700000,31576,-668424,2.819298
16727,The Namesake,2006-09-02,2006,12000000,20138836,8138836,4.273271
16729,Don't Move,2004-03-12,2004,0,11837022,11837022,2.855055
16759,Five Minutes of Heaven,2009-01-19,2009,0,0,0,13.465072
16763,Joy Ride 2: Dead Ahead,2008-10-07,2008,5000000,0,-5000000,4.084162
16764,The Toolbox Murders,2004-11-12,2004,0,0,0,4.710011
16765,Bukowski - Born into This,2003-01-18,2003,0,0,0,1.205624
16766,Japan Sinks,2006-07-15,2006,0,47636016,47636016,1.187029
16767,Spriggan,1998-09-05,1998,0,0,0,2.863839
16768,An Evening with Kevin Smith 2: Evening Harder,2006-11-28,2006,0,0,0,5.270747
16769,Coal Miner's Daughter,1980-03-07,1980,15000000,67182787,52182787,2.847277
16771,Barcelona,1994-07-29,1994,3200000,0,-3200000,1.632711
16774,Hellboy Animated: Sword of Storms,2006-10-28,2006,0,0,0,2.096572
16780,Texas Chainsaw Massacre: The Next Generation,1994-01-01,1994,600000,185898,-414102,6.854576
16781,Madea's Family Reunion,2006-02-24,2006,6000000,57231524,51231524,4.304175
16783,National Lampoon Presents Electric Apricot: Quest for Festeroo,2007-11-09,2007,0,0,0,0.684825
16784,Welcome to Mooseport,2004-02-24,2004,30000000,14000000,-16000000,3.832792
16790,Bingo,1991-08-09,1991,0,0,0,2.68101
16791,Five Children and It,2004-10-15,2004,0,0,0,8.199069
16800,Roman Polanski: Wanted and Desired,2008-01-18,2008,0,0,0,0.976978
16803,Kiss Of Life,2007-11-08,2007,0,0,0,0.729341
16804,Departures,2008-09-13,2008,0,69932387,69932387,8.175019
16806,Johnny Dangerously,1984-12-21,1984,0,0,0,4.063135
16808,Pok√©mon Ranger and the Temple of the Sea,2006-07-15,2006,0,0,0,2.789398
16814,Crazy People,1990-04-13,1990,0,0,0,3.057685
16820,F/X2,1991-04-16,1991,16400000,0,-16400000,3.186817
16825,The Case of the Scorpion's Tail,1971-08-16,1971,0,0,0,5.913654
16839,G:MT Greenwich Mean Time,1999-10-01,1999,0,0,0,0.50008
16843,11:11,2004-02-01,2004,0,0,0,1.321883
16846,Gingerdead Man 2: Passion of the Crust,2008-07-04,2008,0,0,0,1.319947
16850,The Heroes of Telemark,1965-11-22,1965,0,0,0,6.178358
16851,Yo-Yo Girl Cop,2006-09-30,2006,0,0,0,1.079597
16854,Snapphanar,2006-11-22,2006,0,0,0,0.88563
16857,The Dangerous Lives of Altar Boys,2002-06-14,2002,0,0,0,3.401162
16858,All That Jazz,1979-12-20,1979,0,37823676,37823676,5.632325
16859,Kiki's Delivery Service,1989-07-29,1989,6900000,18172849,11272849,12.220581
16866,Planet 51,2009-11-19,2009,70000000,104945765,34945765,10.44244
16867,Gardens of the Night,2008-11-21,2008,0,0,0,2.683651
16869,Inglourious Basterds,2009-08-18,2009,70000000,319131050,249131050,16.89564
16871,Drag Me to Hell,2009-03-15,2009,30000000,90810892,60810892,15.809588
16873,Battle for Terra,2007-09-06,2007,4000000,6101046,2101046,6.737142
16874,The Wog Boy,2000-02-24,2000,0,0,0,0.533729
16875,Cheats,2002-10-31,2002,0,0,0,2.656003
16876,Bang Bang You're Dead,2002-06-07,2002,0,0,0,3.273855
16877,The 39 Steps,2008-12-28,2008,0,0,0,1.16964
16878,Saving God,2008-10-14,2008,0,0,0,0.965066
16882,The Guard Post,2008-04-03,2008,0,0,0,1.633884
16884,Anders Matthesen: Anden P√• Coke?,2006-11-14,2006,0,0,0,0.555064
16885,The General,1998-05-01,1998,0,1214198,1214198,2.21138
16888,The Ladies Man,2000-10-13,2000,24000000,13700000,-10300000,3.755409
16889,Revenge of the Nerds II: Nerds in Paradise,1987-07-10,1987,0,22642033,22642033,10.54375
16890,The Guitar,2008-11-07,2008,0,0,0,2.074206
16899,Easy Virtue,2008-01-01,2008,0,0,0,5.373645
16900,Truth In 24,2008-11-06,2008,0,0,0,1.142239
16902,The Private Lives of Elizabeth and Essex,1939-11-11,1939,0,0,0,4.150285
16905,Captain Blood,1935-12-19,1935,0,0,0,4.738446
16907,Naruto the Movie: Ninja Clash in the Land of Snow,2004-08-21,2004,0,0,0,4.616039
16909,Webmaster,1998-08-28,1998,0,0,0,0.47826
16911,The Inhabited Island,2008-12-18,2008,36500000,21834845,-14665155,2.047794
16912,The Colditz Story,1955-01-25,1955,0,0,0,0.746613
16914,The Cruel Sea,1953-02-24,1953,0,0,0,3.629762
16915,Gutterballs,2008-01-01,2008,0,0,0,1.505798
16916,A Boyfriend for My Wife,2008-08-14,2008,0,0,0,2.789697
16919,Global Metal,2008-06-20,2008,0,0,0,1.015014
16921,Autopsy,2008-08-24,2008,15000000,0,-15000000,4.230297
16923,Merlin and the War of the Dragons,2008-11-25,2008,0,0,0,0.919617
16925,Scourge,2008-01-31,2008,0,0,0,0.884333
16926,Prairie Fever,2008-03-29,2008,0,0,0,1.147772
16931,Into the Blue 2: The Reef,2009-04-21,2009,0,0,0,5.431335
16932,After You,2003-12-17,2003,0,0,0,2.624898
16933,They Drive by Night,1940-07-27,1940,0,0,0,2.190797
16934,The Young Poisoner's Handbook,1995-01-20,1995,0,0,0,6.178497
16938,Black Christmas,1974-10-11,1974,0,0,0,5.310614
16939,Last Holiday,1950-05-15,1950,0,0,0,0.617996
16941,Intermission,2003-08-29,2003,5000000,4856298,-143702,3.715985
16958,The Asphalt Jungle,1950-05-22,1950,0,0,0,12.86559
16962,Barbie Fairytopia: Magic of the Rainbow,2007-01-01,2007,0,0,0,5.01763
16969,City Heat,1984-12-05,1984,25000000,38348988,13348988,12.881025
16972,The Frisco Kid,1979-07-06,1979,9200000,9346177,146177,7.085212
16973,Love Object,2003-04-05,2003,0,0,0,2.61667
16976,9 Souls,2003-07-19,2003,0,0,0,2.863136
16980,The Last Days of Disco,1998-05-29,1998,8000000,0,-8000000,8.666763
16985,Legally Blondes,2009-04-28,2009,0,0,0,15.504416
16986,The Obama Deception,2009-03-15,2009,0,0,0,0.774954
16987,Kaho Naa... Pyaar Hai,2000-01-14,2000,0,0,0,1.063064
16988,How She Move,2008-01-25,2008,0,0,0,0.868266
16991,Observe and Report,2009-04-10,2009,0,24007324,24007324,5.666341
16992,The Boxer,1997-12-31,1997,0,0,0,2.997734
16993,Fat City,1972-07-26,1972,0,0,0,2.576301
16995,State of Play,2009-04-17,2009,60000000,87784194,27784194,8.905732
16996,17 Again,2009-03-11,2009,20000000,136267476,116267476,11.362762
16997,The Man Who Came Back,2008-02-08,2008,0,0,0,0.945624
16998,The Moustache,2005-05-15,2005,0,0,0,5.54542
16999,Fire and Ice: The Dragon Chronicles,2008-09-18,2008,3000000,0,-3000000,3.545694
17003,Sugar,2009-04-03,2009,0,0,0,0.731548
17005,Bitten,2008-06-29,2008,0,0,0,3.580087
17006,I'm Gonna Git You Sucka,1988-11-10,1988,0,0,0,3.71926
17007,Call Me Claus,2001-12-02,2001,0,0,0,6.262258
17008,Die Geschichte vom Brandner Kaspar,2008-10-16,2008,0,0,0,0.681968
17009,Jetsons: The Movie,1990-06-06,1990,0,0,0,9.063683
17010,The Ketchup Effect,2004-01-24,2004,2,0,-2,2.070162
17015,Persuasion,1995-09-27,1995,0,0,0,2.228434
17021,Adam & Steve,2006-03-31,2006,0,0,0,0.859022
17022,Michael Jackson: Number Ones,2003-11-18,2003,0,0,0,1.488739
17025,Look,2007-10-05,2007,0,16136,16136,1.282833
17027,Shuttle,2008-03-08,2008,0,0,0,3.702465
17028,Eating Out 2: Sloppy Seconds,2006-01-01,2006,0,0,0,2.665564
17030,The Petrified Forest,1936-02-08,1936,0,0,0,3.225088
17031,Dragonlance: Dragons Of Autumn Twilight,2008-01-15,2008,0,0,0,2.083647
17035,The Moguls,2005-02-06,2005,0,0,0,7.11869
17037,I'll Be Home for Christmas,1998-11-12,1998,30000000,0,-30000000,3.366048
17038,Lake Placid 2,2007-04-28,2007,0,0,0,4.553745
17041,Sold Out: A Threevening with Kevin Smith,2008-10-22,2008,0,0,0,2.297635
17043,The Crocodile Hunter: Collision Course,2002-07-26,2002,0,33082548,33082548,3.148745
17044,The Land Girls,1998-09-25,1998,0,0,0,1.514441
17046,Skellig,2009-04-12,2009,0,0,0,1.676894
17047,Agent Cody Banks 2: Destination London,2004-06-24,2004,26000000,28818995,2818995,12.59201
17048,Young Dragons: Kung Fu Kids,1986-02-28,1986,0,0,0,0.14692
17057,In a Lonely Place,1950-05-17,1950,0,0,0,6.331826
17058,Scarlet Street,1945-12-28,1945,1202007,2948386,1746379,6.360746
17073,American Swing,2008-01-01,2008,0,0,0,1.930418
17074,The Batman Superman Movie: World's Finest,1998-08-18,1998,0,0,0,4.030482
17077,Everlasting Moments,2008-09-24,2008,70000000,0,-70000000,2.109176
17078,The Color of Paradise,1999-02-08,1999,0,0,0,2.066253
17082,The Sniper,2009-03-24,2009,0,0,0,3.04845
17086,Chromophobia,2005-01-01,2005,10000000,0,-10000000,1.719597
17091,Docking the Boat,1965-12-26,1965,0,0,0,0.923569
17097,After Sex,2007-09-26,2007,825000,0,-825000,7.134232
17099,Hanzo the Razor: Sword of Justice,1972-12-30,1972,0,0,0,0.866779
17100,Trucks,1997-01-01,1997,0,0,0,5.765171
17101,Bleach: The DiamondDust Rebellion,2007-12-22,2007,0,0,0,2.662515
17102,Dracula: Prince of Darkness,1966-01-09,1966,280379,364937,84558,8.913793
17106,Numb,2007-04-30,2007,0,0,0,2.445362
17108,Kung Fu Dunk,2008-02-07,2008,10000000,22896728,12896728,8.406056
17110,One Point O,2004-03-19,2004,0,0,0,2.399033
17111,Shutter,2004-09-09,2004,0,0,0,7.933786
17113,The Ballad of Jack and Rose,2005-03-25,2005,1500000,712294,-787706,4.173231
17124,Wild Things: Diamonds in the Rough,2005-02-19,2005,0,0,0,9.233565
17126,Satisfaction,1988-02-12,1988,0,8,8,1.502936
17127,The Object of My Affection,1998-04-17,1998,15000000,46905889,31905889,6.715856
17128,Hanzo the Razor: The Snare,1973-08-11,1973,0,0,0,1.30962
17129,Hanzo the Razor: Who's Got the Gold?,1974-02-09,1974,0,0,0,0.916543
17130,Crossroads,2002-02-15,2002,12000000,61141030,49141030,6.631356
17131,The Glass Key,1942-10-14,1942,0,0,0,1.642878
17132,Savannah Smiles,1982-01-01,1982,0,0,0,0.732106
17133,Homegrown,1998-01-01,1998,0,271375,271375,1.840984
17134,12 Rounds,2009-03-19,2009,20000000,17280326,-2719674,13.591485
17135,Omega Doom,1996-01-01,1996,0,0,0,4.759885
17136,The Woman in the Window,1944-11-03,1944,0,0,0,6.266656
17137,What We Do Is Secret,2008-08-08,2008,0,0,0,0.634161
17139,Character,1997-04-17,1997,4500000,0,-4500000,1.221677
17143,Fast Track: No Limits,2008-02-21,2008,0,0,0,1.37416
17144,Exit Speed,2008-08-26,2008,0,0,0,1.082238
17153,Botched,2007-10-04,2007,0,0,0,6.051389
17155,Bigga Than Ben,2008-11-18,2008,0,0,0,0.167188
17156,The Anna Nicole Smith Story,2007-08-30,2007,0,0,0,0.51655
17157,Ace of Hearts,2008-05-06,2008,0,0,0,0.539413
17158,They Wait,2007-09-06,2007,0,0,0,4.952332
17159,Eddie Murphy Raw,1987-11-25,1987,0,50504655,50504655,11.266569
17165,Bleach the Movie: Fade to Black,2008-12-13,2008,0,0,0,3.611017
17166,Insanitarium,2008-07-15,2008,0,0,0,2.127656
17168,The Temp,1993-02-12,1993,15000000,0,-15000000,1.047834
17169,Any Which Way You Can,1980-12-17,1980,0,70687344,70687344,6.279562
17170,"Bright Lights, Big City",1988-04-01,1988,0,0,0,2.785705
17172,SOS,1988-12-25,1988,0,0,0,1.842412
17174,The Neighbor,2008-11-28,2008,0,0,0,2.39926
17175,The Last Word,2008-04-20,2008,0,0,0,10.341167
17180,Princess Blade,2001-12-15,2001,0,0,0,1.287847
17181,Nanking,2007-02-10,2007,0,0,0,2.00717
17182,Eye for an Eye,1996-01-12,1996,20000000,0,-20000000,4.733526
17185,Advise & Consent,1962-06-06,1962,0,0,0,2.610391
17186,Supercross,2005-08-16,2005,0,3102550,3102550,2.350811
17187,The Emperor's Club,2002-11-22,2002,0,0,0,4.84291
17189,Battle Angel,1993-01-01,1993,0,0,0,1.592364
17190,Gross Anatomy,1989-10-20,1989,0,0,0,4.506924
17198,The Mating Habits of the Earthbound Human,1999-09-03,1999,0,0,0,6.571586
17199,La Moiti√© gauche du frigo,2000-09-13,2000,0,0,0,0.036935
17200,Helter Skelter,1976-04-01,1976,0,0,0,1.860363
17202,Why Did I Get Married?,2007-10-12,2007,15000000,55184721,40184721,2.016044
17203,Blow Dry,2001-03-01,2001,0,637769,637769,3.553887
17204,Paradise Lost: The Child Murders at Robin Hood Hills,1996-12-03,1996,0,0,0,1.686358
17205,Enter the Ninja,1981-07-17,1981,0,0,0,1.213727
17207,Houseguest,1995-01-06,1995,10500000,26325256,15825256,2.688562
17208,Paradise Lost 2: Revelations,2000-07-28,2000,0,0,0,1.661741
17209,Madhouse,2004-07-30,2004,0,0,0,2.88883
17210,National Geographic: Journey to the Edge of the Universe,2008-12-06,2008,0,0,0,4.318023
17212,Patrick,1978-10-01,1978,0,0,0,3.868092
17216,Rx (Simple Lies),2005-04-21,2005,0,0,0,2.983131
17218,The Set-Up,1949-04-02,1949,0,0,0,1.989167
17221,Where the Sidewalk Ends,1950-07-07,1950,0,0,0,2.984365
17223,Two Tigers,2007-02-14,2007,0,0,0,0.228445
17229,Bill Maher: The Decider,2007-07-21,2007,0,0,0,0.633204
17234,Summer Days With Coo,2007-07-28,2007,0,0,0,2.556822
17236,Whirlygirl,2006-05-02,2006,0,0,0,4.364247
17238,The Belly of an Architect,1987-09-23,1987,0,0,0,1.91206
17240,Slaughter,2009-01-09,2009,0,0,0,1.52385
17241,The Tenth Circle,2008-06-28,2008,0,0,0,1.174468
17244,Behind the Planet of the Apes,1998-09-05,1998,0,0,0,2.172845
17245,Mulberry Street,2006-05-23,2006,0,0,0,5.571451
17247,Battle in Heaven,2005-05-15,2005,1601792,253527,-1348265,2.329513
17258,The Pick-up Artist,1987-09-18,1987,15000000,13290368,-1709632,3.799983
17263,A Murder of Crows,1999-07-06,1999,0,0,0,9.284563
17264,The Black Stallion,1979-10-17,1979,2700000,37799643,35099643,10.246132
17266,The Odyssey,1997-05-18,1997,0,0,0,4.315717
17274,American Pastime,2007-05-14,2007,0,0,0,0.612093
17275,The All Together,2007-01-01,2007,0,0,0,0.420003
17276,Carry On Up the Jungle,1970-01-03,1970,0,0,0,1.286201
17277,The Fall of the Roman Empire,1964-03-24,1964,19000000,4750000,-14250000,2.824367
17278,Mad Monster Party?,1967-03-08,1967,0,0,0,2.151835
17281,Gigi,1958-04-15,1958,0,0,0,10.36311
17282,Rage of Honor,1987-02-01,1987,0,0,0,1.062073
17285,Kill Buljo,2007-03-23,2007,160000,0,-160000,0.629188
17287,Poultrygeist: Night of the Chicken Dead,2006-12-26,2006,0,0,0,5.072909
17288,Rampage,1986-06-12,1986,0,0,0,0.412342
17295,The Battle of Algiers,1966-09-08,1966,800000,921548,121548,11.322173
17302,The Art of Football from A to Z,2007-01-01,2007,0,0,0,0.90987
17303,The Devil Dared Me To,2007-10-11,2007,859314,0,-859314,6.91842
17306,Ice Spiders,2007-01-01,2007,2000000,0,-2000000,2.286943
17314,Pistol Whipped,2008-03-04,2008,10000000,0,-10000000,3.313287
17317,Urban Justice,2007-01-01,2007,12000000,0,-12000000,4.352072
17320,The TV Set,2006-04-28,2006,2000000,265198,-1734802,4.681832
17332,The Soloist,2009-04-24,2009,60000000,31720158,-28279842,11.328316
17334,The Other End of the Line,2008-10-29,2008,14000000,0,-14000000,3.438508
17335,Obsessed,2009-04-24,2009,20000000,73830340,53830340,7.175154
17336,Fighting,2009-04-24,2009,0,32474120,32474120,7.036697
17337,The Land Before Time VI: The Secret of Saurus Rock,1998-12-01,1998,0,0,0,3.537955
17339,Force 10 from Navarone,1978-11-01,1978,5000000,7230000,2230000,5.05047
17342,Night Train,2008-01-23,2008,0,0,0,2.021356
17343,Vampyros Lesbos,1971-07-15,1971,0,0,0,3.047838
17345,Flywheel,2003-01-01,2003,0,0,0,0.830533
17346,Grey Gardens,1975-09-27,1975,0,0,0,3.019245
17347,Bride Flight,2008-10-15,2008,6400000,2556911,-3843089,2.065753
17350,The Brice Man,2005-01-01,2005,0,0,0,5.079756
17352,South Pacific,1958-03-18,1958,6000000,36800000,30800000,2.747118
17359,News from a Personal War,1999-04-14,1999,0,0,0,0.263597
17360,Escape to Victory,1981-06-17,1981,10000000,27453418,17453418,9.865257
17362,Loverboy,1989-04-28,1989,0,3960327,3960327,5.072902
17365,The Parallax View,1974-06-14,1974,0,0,0,4.43233
17367,Belle Toujours,2006-09-08,2006,0,0,0,0.673026
17375,Rolling,2007-01-01,2007,500000,0,-500000,0.064795
17376,Anna M.,2007-02-14,2007,0,0,0,0.79125
17379,Last Holiday,2006-01-13,2006,45000000,38399961,-6600039,5.53836
17381,BMX Bandits,1983-12-29,1983,980385,0,-980385,7.798806
17382,They Died with Their Boots On,1941-11-01,1941,0,0,0,2.454775
17386,Revenge of the Ninja,1983-09-07,1983,0,13168027,13168027,13.762328
17388,The Italian,2005-09-21,2005,0,0,0,1.502873
17399,Zappa Plays Zappa,2007-10-05,2007,0,0,0,0.019188
17401,"Blue Water, White Death",1971-03-01,1971,0,0,0,0.02679
17402,Miami Rhapsody,1995-01-27,1995,6,5,-1,1.137266
17403,How to Deal,2003-07-18,2003,0,0,0,3.568531
17409,The Gunfighter,1950-06-23,1950,0,0,0,3.225024
17414,Dunston Checks In,1996-01-12,1996,16000000,0,-16000000,4.814825
17417,Hallelujah!,2009-04-29,2009,0,0,0,2.165824
17421,G.I. Joe: The Movie,1987-08-01,1987,0,0,0,1.806553
17422,Summer Palace,2006-05-18,2006,0,0,0,0.945871
17431,Moon,2009-06-12,2009,5000000,9760104,4760104,13.336773
17433,Street Fighter Alpha - The Movie,1999-12-22,1999,0,0,0,0.837228
17435,El Norte,1983-10-11,1983,0,0,0,4.358487
17436,The Informers,2008-11-05,2008,18000000,382174,-17617826,6.675032
17439,Diggers,2006-01-01,2006,0,0,0,3.662818
17443,...And Justice for All,1979-10-19,1979,0,33300000,33300000,6.291512
17445,Green Lantern: First Flight,2009-07-28,2009,3500000,0,-3500000,11.040602
17447,Jeffrey,1995-08-18,1995,0,0,0,3.196456
17450,Pennies from Heaven,1981-12-11,1981,22000000,9171289,-12828711,8.031761
17455,Hellraiser: Deader,2005-06-07,2005,4000000,0,-4000000,4.550477
17456,BloodRayne: Deliverance,2007-09-18,2007,10000000,0,-10000000,4.531697
17457,The Twins Effect,2003-03-08,2003,0,0,0,9.532044
17460,Blame It on Fidel!,2006-11-29,2006,0,0,0,1.871922
17464,Breakin' 2: Electric Boogaloo,1984-12-21,1984,0,0,0,7.43009
17465,Youngblood,1986-01-31,1986,0,0,0,4.204661
17466,Death Warrant,1990-09-14,1990,4000000,16853487,12853487,13.90542
17467,Riki-Oh: The Story of Ricky,1991-10-05,1991,0,0,0,4.288435
17469,The Cradle,2007-07-31,2007,0,0,0,0.152906
17470,Arc,2006-10-20,2006,650000,0,-650000,0.473745
17473,The Room,2003-06-27,2003,0,0,0,6.490979
17474,The Man in the Moon,1991-09-30,1991,0,2853801,2853801,8.799169
17478,Dhoom,2004-08-27,2004,1500000,12000000,10500000,3.106495
17479,Alexandra,2007-09-26,2007,0,0,0,1.522872
17481,The Adventures of Sherlock Holmes,1939-09-01,1939,0,0,0,2.561651
17483,Shelter,2007-06-16,2007,0,0,0,7.72654
17485,Craig Ferguson: A Wee Bit o' Revolution,2009-03-22,2009,0,0,0,0.218775
17486,Sister Smile,2009-04-29,2009,0,0,0,0.697896
17487,Body and Soul,1947-11-09,1947,0,0,0,1.990877
17494,Unlawful Entry,1992-06-26,1992,23000000,57138719,34138719,6.477258
17495,Whatever Lola wants,2007-12-11,2007,0,0,0,0.483387
17496,Urban Cowboy,1980-06-06,1980,0,0,0,4.566587
17501,Don : The Chase Begins Again,2006-10-20,2006,7100000,0,-7100000,7.633636
17529,True Grit,1969-06-11,1969,0,14250000,14250000,12.497833
17532,S. Darko,2009-04-28,2009,4000000,4100000,100000,7.959965
17538,Rooster Cogburn,1975-10-17,1975,0,8022000,8022000,12.140407
17539,Billy's Hollywood Screen Kiss,1998-07-24,1998,0,2020700,2020700,3.993327
17566,Brave Story,2006-05-22,2006,0,0,0,1.817657
17575,Only Clouds Move the Stars,1998-08-24,1998,0,0,0,0.27034
17577,The Devil's Tomb,2009-05-26,2009,10000000,0,-10000000,3.446155
17578,The Adventures of Tintin,2011-10-25,2011,130000000,371940071,241940071,19.201504
17582,Khamsa,2008-10-08,2008,0,0,0,0.510151
17584,Blue Hill Avenue,2001-01-01,2001,0,0,0,3.98148
17585,Surviving the Game,1994-04-15,1994,7400000,7690013,290013,3.644641
17589,Mrs Brown,1997-07-18,1997,0,0,0,3.883913
17590,Deathtrap,1982-03-19,1982,0,0,0,3.814738
17591,The Battle of the River Plate,1956-10-30,1956,0,0,0,4.585964
17592,The Wild Parrots of Telegraph Hill,2003-10-09,2003,0,0,0,0.877451
17593,Rough Cut,2008-09-11,2008,0,0,0,1.948841
17595,Cowards Bend the Knee,2003-01-01,2003,0,0,0,1.350831
17599,The Hindenburg,1975-12-25,1975,15000000,0,-15000000,2.659356
17600,Spanking the Monkey,1994-01-15,1994,200000,0,-200000,2.799575
17602,Macheads,2009-01-01,2009,0,0,0,0.152437
17604,She,1965-04-10,1965,0,0,0,5.632803
17605,Stella,2008-11-12,2008,0,0,0,1.520318
17606,The Other Man,2008-12-25,2008,15000000,1143856,-13856144,4.674662
17609,Antichrist,2009-05-18,2009,11000000,791867,-10208133,7.769607
17610,Year One,2009-06-18,2009,60000000,62357900,2357900,10.087637
17612,Lost and Delirious,2001-01-21,2001,0,0,0,6.236798
17614,Yossi & Jagger,2002-08-28,2002,0,0,0,1.948701
17618,Laid to Rest,2009-04-02,2009,0,0,0,2.627695
17622,Fifty Dead Men Walking,2008-09-10,2008,0,0,0,2.935128
17628,I Am a Sex Addict,2005-10-14,2005,0,0,0,1.650461
17629,Hamilton,1998-01-30,1998,0,0,0,2.526907
17630,Ugly Melanie,2008-11-12,2008,0,0,0,3.841513
17631,Mid-August Lunch,2008-04-30,2008,0,0,0,1.288693
17632,The Hunt for Gollum,2009-05-04,2009,5000,0,-5000,3.459518
17635,Daylight Robbery,2008-08-29,2008,0,0,0,1.06057
17640,It's Always Fair Weather,1955-02-09,1955,0,0,0,1.1856
17641,National Velvet,1944-12-14,1944,0,0,0,2.307369
17642,The Leopard Son,1996-09-27,1996,0,0,0,0.002079
17644,Barney's Great Adventure,1998-01-01,1998,0,0,0,1.197711
17645,Leave Her to Heaven,1945-12-19,1945,0,0,0,8.033213
17653,The Legend I,1993-03-04,1993,0,3956913,3956913,3.782615
17654,District 9,2009-08-05,2009,30000000,210819611,180819611,11.589835
17657,Ice Station Zebra,1968-10-23,1968,0,0,0,4.03039
17658,Someone I Loved,2009-05-06,2009,0,0,0,2.231405
17660,Dodge City,1939-03-31,1939,0,0,0,2.53549
17661,Going My Way,1944-05-15,1944,0,16300000,16300000,5.682778
17663,Anne of Green Gables,1985-12-01,1985,0,0,0,7.222048
17664,The Horse Soldiers,1959-06-11,1959,0,0,0,10.313171
17665,The Shoes of the Fisherman,1968-01-01,1968,0,0,0,1.795249
17667,Beat Street,1984-06-08,1984,0,0,0,2.248921
17669,The Last Templar,2009-01-01,2009,0,0,0,2.845437
17677,The Five Pennies,1959-01-01,1959,0,0,0,1.134522
17680,The Girlfriend Experience,2009-01-20,2009,1700000,1007962,-692038,6.115299
17681,Scooby-Doo! and the Witch's Ghost,1999-11-05,1999,0,0,0,6.121407
17684,Chouchou,2003-03-19,2003,0,0,0,4.610525
17685,King of Hearts,1966-12-21,1966,0,0,0,2.202136
17687,The Public Enemy,1931-04-23,1931,0,0,0,4.841185
17689,The Gauntlet,1977-12-21,1977,5500000,26414658,20914658,6.389326
17691,4 for Texas,1963-12-25,1963,0,0,0,1.999626
17692,Jaws 3-D,1983-03-16,1983,20500000,87987055,67487055,16.603041
17695,John Pinette: I'm Starvin'!,2007-01-23,2007,0,0,0,0.822288
17696,Robin and the 7 Hoods,1964-06-24,1964,0,0,0,3.773241
17699,Coral Reef Adventure,2003-02-14,2003,0,0,0,1.766292
17700,Deep Sea 3D,2006-03-03,2006,0,0,0,2.675711
17704,The Living Sea,1995-02-01,1995,0,87600000,87600000,1.081517
17707,Brokedown Palace,1999-08-13,1999,25000000,13000000,-12000000,6.570918
17708,Corky Romano,2001-10-12,2001,11000000,23978402,12978402,4.890067
17709,Dudley Do-Right,1999-08-27,1999,70000000,0,-70000000,4.431577
17710,Hey Arnold! The Movie,2002-06-28,2002,0,0,0,4.5973
17711,The Adventures of Rocky & Bullwinkle,2000-06-30,2000,76000000,35134820,-40865180,11.880936
17712,Lisa Lampanelli: Dirty Girl,2007-01-28,2007,0,0,0,0.01049
17720,Dunkirk,1958-03-20,1958,0,0,0,11.425006
17725,Grow Your Own,2007-06-15,2007,0,0,0,0.832563
17728,Wieners,2008-06-03,2008,0,0,0,11.978788
17729,The Glenn Miller Story,1954-01-08,1954,0,0,0,5.401649
17731,The Fluffer,2001-02-11,2001,0,0,0,1.138132
17734,Thirteen Conversations About One Thing,2001-09-02,2001,0,0,0,11.283079
17736,Where the Day Takes You,1992-09-11,1992,0,0,0,1.403849
17740,Powder Blue,2009-05-08,2009,0,0,0,5.428409
17741,Stoned,2005-11-18,2005,0,0,0,7.441462
17744,The Bedford Incident,1965-10-11,1965,0,0,0,2.61096
17745,Camp Nowhere,1994-08-26,1994,0,0,0,3.872061
17761,The High and the Mighty,1954-07-03,1954,0,0,0,2.955607
17768,A Funny Thing Happened on the Way to the Forum,1966-10-16,1966,0,0,0,10.176281
17770,Trial and Error,1997-05-30,1997,0,0,0,2.683782
17771,Sunshine,1999-09-13,1999,0,0,0,2.555556
17774,Derailed,2002-05-19,2002,0,0,0,20.020975
17775,Toronto Stories,2008-01-01,2008,0,0,0,0.310111
17780,A Kind of America 2,2008-12-18,2008,1500000,0,-1500000,0.714017
17790,Zone Troopers,1985-10-01,1985,0,0,0,1.496878
17792,Omen IV: The Awakening,1991-05-19,1991,0,0,0,2.729521
17794,Quest for a Heart,2007-12-14,2007,6000000,0,-6000000,0.521899
17795,My Fellow Americans,1996-12-20,1996,0,0,0,3.863894
17796,Freaked,1993-09-11,1993,0,0,0,3.256687
17800,Into the West,2005-06-10,2005,0,0,0,0.920023
17801,The Letter,1940-11-22,1940,0,0,0,2.601278
17803,12:01,1993-07-05,1993,0,0,0,8.811327
17804,The Paleface,1948-12-24,1948,0,0,0,1.170751
17806,Forever Lulu,2000-01-01,2000,20000000,0,-20000000,1.899016
17808,Painted Skin,2008-09-25,2008,0,0,0,2.676688
17809,Fist of Legend,1994-12-22,1994,0,1907743,1907743,5.986773
17810,Lone Wolf and Cub: Baby Cart at the River Styx,1972-06-01,1972,0,0,0,2.492024
17811,The Legend II,1993-07-30,1993,0,2967668,2967668,2.649091
17813,Alex & Emma,2003-06-16,2003,30000000,15368897,-14631103,5.236854
17814,Assault on Precinct 13,1976-11-05,1976,150000,0,-150000,11.881808
17818,San Antonio,1945-11-29,1945,0,0,0,0.191612
17819,Her Alibi,1989-02-03,1989,0,0,0,3.005651
17820,Show Boat,1951-07-13,1951,2300000,11000000,8700000,2.01799
17821,Crossworlds,1996-10-30,1996,0,0,0,3.114883
17824,Private Resort,1985-05-03,1985,0,331816,331816,4.966657
17825,The 11 Commandments,2004-02-04,2004,0,0,0,4.774788
17829,A Song Is Born,1948-10-19,1948,0,0,0,1.266629
17831,A Tale of Two Cities,1935-12-25,1935,0,0,0,7.737271
17832,Kull the Conqueror,1997-08-29,1997,0,0,0,3.324195
17834,A Simple Wish,1997-07-11,1997,28000000,8345056,-19654944,3.354869
17835,Threads,1984-09-23,1984,0,0,0,4.242601
17836,Virginia City,1940-03-23,1940,0,0,0,0.833855
17845,Loft,2008-10-21,2008,4185000,0,-4185000,7.236542
17870,Chris Rock: Bigger & Blacker,1999-07-10,1999,0,0,0,1.749317
17871,Chris Rock: Never Scared,2004-04-17,2004,0,0,0,2.575809
17874,Laserblast,1978-03-01,1978,0,0,0,4.66842
17875,The Hellstrom Chronicle,1971-05-05,1971,0,0,0,0.89217
17880,Because of Winn-Dixie,2005-02-18,2005,14000000,32645546,18645546,6.067722
17885,The Amazing Dr. Clitterhouse,1938-07-30,1938,0,0,0,1.25249
17886,Mutants,2009-05-06,2009,0,0,0,2.464117
17887,Barefoot in the Park,1967-05-25,1967,0,0,0,8.380744
17889,Anchors Aweigh,1945-07-14,1945,0,0,0,4.35038
17893,Camino,2008-10-16,2008,0,0,0,3.27121
17894,The Beautician and the Beast,1997-02-07,1997,16000000,0,-16000000,7.566377
17895,Antarctica,1983-07-23,1983,0,0,0,1.574404
17897,The Golden Voyage of Sinbad,1973-12-20,1973,0,11000000,11000000,5.887367
17898,Silver Bullet,1985-10-10,1985,0,0,0,5.852908
17899,"Sex, Party and Lies",2009-03-27,2009,0,0,0,7.156341
17902,Stormforce,2006-01-01,2006,0,0,0,0.873141
17903,A Frozen Flower,2008-12-30,2008,0,0,0,2.722097
17905,Branded to Kill,1967-06-15,1967,0,0,0,3.399614
17906,Dummy,2002-09-12,2002,0,0,0,2.171254
17907,The Raven,1935-07-08,1935,0,0,0,2.114251
17908,My Dog Skip,2000-01-14,2000,7000000,0,-7000000,7.061185
17909,Who's Singin' Over There?,1980-01-01,1980,120000,0,-120000,2.419145
17911,Mega Shark vs Giant Octopus,2009-05-19,2009,0,0,0,4.566951
17912,Gypsy,1993-12-12,1993,0,0,0,1.445489
17914,Safe Sex,1999-10-22,1999,0,0,0,0.543036
17915,Dance with Me,1998-08-21,1998,0,15,15,7.894516
17917,Oliver!,1968-09-26,1968,10000000,37402877,27402877,8.630078
17918,Swamp Thing,1982-02-19,1982,3000000,0,-3000000,9.412377
17919,Human Trafficking,2005-10-24,2005,15000000,0,-15000000,2.529274
17920,I Capture the Castle,2003-05-09,2003,0,0,0,2.625315
17921,Planet of the Vampires,1965-09-15,1965,0,0,0,2.512247
17922,Golgo 13: The Professional,1983-05-07,1983,0,0,0,1.934571
17925,Disengagement,2007-09-07,2007,0,0,0,0.634579
17926,Undiscovered,2005-08-26,2005,9000000,1046166,-7953834,1.494688
17927,Fired Up!,2009-02-20,2009,20000000,18599102,-1400898,6.312206
17935,Iron & Blood: The Legend of Taras Bulba,2009-04-02,2009,25000000,16815892,-8184108,7.855489
17938,First Spaceship on Venus,1960-02-26,1960,0,0,0,1.952221
17940,Android Apocalypse,2006-06-24,2006,1000000,0,-1000000,1.179
17941,Hush,1998-03-06,1998,0,0,0,8.753233
17949,The Pest,1997-02-07,1997,17000000,0,-17000000,3.194883
17952,In The Mix,2005-11-23,2005,0,0,0,7.461749
17956,"He Said, She Said",1991-02-22,1991,0,0,0,4.150196
17960,Hell,2005-11-30,2005,0,0,0,2.142094
17961,L'Enfer,1994-02-16,1994,10000000,0,-10000000,1.948315
17962,After Life,1998-09-11,1998,11791,0,-11791,2.916805
17963,Gone Nutty,2002-10-21,2002,0,0,0,5.51214
17965,The Abominable Dr. Phibes,1971-05-18,1971,3000000,0,-3000000,9.468736
17966,Smart Money,1931-07-11,1931,0,0,0,0.924087
17971,Midnight Madness,1980-02-08,1980,0,0,0,7.922416
17974,"The Birds, the Bees and the Italians",1965-01-01,1965,0,0,0,1.27765
17978,The Great White Hope,1970-10-11,1970,0,0,0,1.653084
17979,A Christmas Carol,2009-11-04,2009,200000000,325233863,125233863,12.869273
17984,The Absent-Minded Professor,1961-03-16,1961,0,0,0,3.708247
17985,Bleeder,1999-08-06,1999,0,0,0,2.996721
17988,The Most Beautiful,1944-04-13,1944,0,0,0,1.216724
17990,Impromptu,1991-04-12,1991,0,0,0,8.733819
17991,Tetsuo II: Body Hammer,1992-01-01,1992,0,0,0,2.018292
17993,Henry & June,1990-09-28,1990,0,11567449,11567449,4.459959
17994,Witchboard,1986-12-31,1986,0,0,0,8.180575
17995,DysFunktional Family,2003-04-04,2003,0,0,0,0.726802
18002,"Love, Honour and Obey",2000-04-07,2000,0,0,0,4.886559
18009,Leprechaun 2,1994-04-07,1994,2000000,2260622,260622,3.3924
18011,Leprechaun in the Hood,2000-03-28,2000,0,0,0,3.098603
18015,Shark Attack 3: Megalodon,2002-11-26,2002,0,0,0,1.093584
18016,A Sister's Secret,2009-09-05,2009,0,0,0,0.849344
18017,Yolngu Boy,2001-03-22,2001,0,671,671,0.407732
18019,Julius Caesar,1953-06-04,1953,0,0,0,3.353767
18029,Dying Breed,2008-04-26,2008,0,0,0,1.981097
18030,Kiss Me Deadly,1955-05-18,1955,0,0,0,7.224904
18031,Dark Matter,2007-01-23,2007,0,0,0,1.948537
18032,The Secret of Moonacre,2008-09-06,2008,12000000,7070330,-4929670,12.01334
18033,Nora Roberts' Montana Sky,2007-02-05,2007,0,0,0,1.289688
18034,A Bunch of Amateurs,2008-11-17,2008,0,0,0,1.405496
18035,Moving McAllister,2007-09-13,2007,0,0,0,2.252867
18038,Holiday Reunion,2003-11-23,2003,0,0,0,0.593045
18040,Night Skies,2007-01-23,2007,0,0,0,2.426373
18041,Gossip,2000-04-21,2000,14000000,5108820,-8891180,8.25719
18043,Popcorn,2007-03-02,2007,0,0,0,0.713852
18044,Ogre,2008-03-08,2008,0,0,0,1.187773
18045,The Dark Hours,2005-03-11,2005,500000,0,-500000,2.758048
18046,Blue Gold: World Water Wars,2008-10-09,2008,100000,0,-100000,0.518603
18047,Brian's Song,1971-11-30,1971,0,0,0,2.624202
18050,The Keys of the Kingdom,1944-12-15,1944,3000000,0,-3000000,3.683435
18051,Timecop 2: The Berlin Decision,2003-09-30,2003,0,0,0,1.415674
18056,The Take,2007-01-01,2007,0,0,0,1.550464
18060,The Beast Stalker,2008-11-27,2008,0,0,0,0.94437
18061,Zulu Dawn,1979-05-14,1979,0,0,0,2.271555
18065,Next Day Air,2009-02-06,2009,0,0,0,2.459096
18068,Babar: King of the Elephants,1999-04-28,1999,0,0,0,0.294109
18069,8 Seconds,1994-02-25,1994,0,0,0,1.888534
18070,Black Dawn,2005-01-01,2005,16000000,0,-16000000,9.989719
18072,Pure,2002-09-13,2002,0,102471,102471,5.682406
18074,Duets,2000-09-09,2000,0,0,0,3.587042
18079,Nine Queens,2000-08-31,2000,1500000,0,-1500000,5.324962
18080,Out to Sea,1997-07-02,1997,0,0,0,3.722389
18082,Tired of Kissing Frogs,2006-12-20,2006,0,0,0,0.917946
18085,Roving Mars,2006-01-27,2006,0,0,0,1.540775
18086,Fright Night Part 2,1988-04-07,1988,0,2983784,2983784,5.777858
18088,Late Night Shopping,2001-06-22,2001,0,0,0,1.448927
18089,Miss Austen Regrets,2008-02-03,2008,0,0,0,5.540214
18093,Northanger Abbey,2007-03-25,2007,0,0,0,8.895086
18094,Anvil! The Story of Anvil,2008-01-14,2008,0,0,0,3.414041
18095,Dragon Ball GT: A Hero's Legacy,1997-03-26,1997,0,0,0,3.643117
18096,The Gray Man,2007-08-30,2007,0,0,0,1.668772
18098,Arabian Nights,2000-04-30,2000,0,0,0,2.266456
18111,Bride of Re-Animator,1989-10-01,1989,2000000,0,-2000000,8.244989
18112,Boogie Man: The Lee Atwater Story,2008-09-26,2008,0,0,0,0.260175
18113,National Lampoon Presents Dorm Daze,2003-09-26,2003,0,0,0,4.640429
18116,American Zombie,2007-01-18,2007,0,0,0,1.289763
18117,Dean Spanley,2008-12-12,2008,0,0,0,12.333138
18118,Mackenna's Gold,1969-03-18,1969,7000000,0,-7000000,4.137836
18120,Brain Drain,2009-01-01,2009,0,0,0,2.82459
18122,The Inhabited Island 2: Rebellion,2009-04-23,2009,0,5873871,5873871,1.763116
18125,"Rita, Sue and Bob Too",1987-05-20,1987,0,0,0,1.662354
18126,Hannah Montana: The Movie,2009-04-10,2009,35000000,155545279,120545279,6.332878
18128,Chris Rock: Bring the Pain,1996-06-01,1996,0,0,0,2.025373
18129,The Grifters,1990-09-14,1990,0,13446769,13446769,10.809693
18133,The Program,1993-09-24,1993,0,23042200,23042200,3.199976
18141,The Elementary School,1991-08-01,1991,0,0,0,0.948924
18143,She and Her Cat: Their Standing Points,1999-01-01,1999,0,0,0,2.493824
18146,Up Periscope,1959-03-04,1959,0,0,0,1.261092
18147,Unaccompanied Minors,2006-12-08,2006,26000000,0,-26000000,5.437197
18148,Tokyo Story,1953-11-03,1953,0,0,0,10.009423
18150,Planet B-Boy,2008-03-21,2008,0,0,0,0.156058
18151,Shadow Company,2006-03-01,2006,0,0,0,0.188147
18152,Occupation 101,2006-03-25,2006,0,0,0,0.995593
18153,Steal This Movie,2000-08-18,2000,0,0,0,1.391996
18158,Earth vs. the Flying Saucers,1956-07-04,1956,0,0,0,3.340532
18161,U2: Rattle and Hum,1988-11-04,1988,0,0,0,2.143483
18162,Land of the Lost,2009-06-05,2009,100000000,68688831,-31311169,7.642063
18164,Twelve and Holding,2005-09-11,2005,400000,95687,-304313,1.829593
18165,The 24th Day,2004-05-06,2004,0,0,0,4.914501
18166,3 Needles,2005-09-09,2005,0,0,0,0.587998
18167,Another 9 1/2 Weeks,1997-06-12,1997,0,0,0,1.72106
18168,About Adam,2000-01-28,2000,0,151559,151559,2.100499
18169,About Last Night...,1986-07-02,1986,0,38702310,38702310,2.769589
18172,All the Right Moves,1983-10-21,1983,0,17233166,17233166,7.108331
18174,An Inspector Calls,1954-03-16,1954,0,0,0,1.403795
18175,The Art of Travel,2008-01-08,2008,2,0,-2,1.211974
18176,Assassination of a High School President,2008-01-17,2008,11500000,69564,-11430436,6.67905
18178,Shadows,2007-06-06,2007,0,0,0,0.452753
18181,Manda Bala (Send a Bullet),2007-01-20,2007,0,0,0,0.507587
18182,An American Girl: Chrissa Stands Strong,2009-01-05,2009,0,0,0,1.379613
18183,Like Water for Chocolate,1992-04-16,1992,2000000,21665468,19665468,4.126083
18187,Flow: For Love of Water,2008-09-12,2008,0,0,0,0.365032
18188,"Digby, the Biggest Dog in the World",1973-12-01,1973,0,0,0,0.384432
18189,Dirty Love,2005-09-23,2005,0,0,0,7.125902
18190,Dream Lover,1993-10-24,1993,0,0,0,7.449907
18191,Edmond,2005-08-31,2005,10000000,0,-10000000,3.858023
18192,Focus,2001-10-19,2001,0,0,0,0.313295
18193,Head,1968-11-06,1968,0,0,0,2.214231
18196,The Sentinel,1977-01-07,1977,0,3,3,3.811799
18197,Running on Empty,1988-09-07,1988,0,2835116,2835116,4.368078
18198,Barbie Mariposa and Her Butterfly Fairy Friends,2008-02-08,2008,0,0,0,3.906829
18200,13 Rue Madeleine,1947-01-15,1947,0,0,0,1.81212
18202,Merlin's Apprentice,2006-04-14,2006,12000000,0,-12000000,3.381735
18203,Big Night,1996-09-20,1996,0,0,0,2.702973
18205,Midaq Alley,1995-05-05,1995,0,0,0,3.304718
18206,Alone With Her,2006-04-28,2006,1000000,10018,-989982,2.392367
18208,Beautiful Ohio,2006-11-10,2006,0,0,0,1.008726
18209,Bedazzled,1967-10-30,1967,0,0,0,8.491505
18212,Better Than Chocolate,1999-02-14,1999,0,0,0,5.12798
18214,Black Eagle,1988-05-01,1988,3000000,0,-3000000,7.903056
18215,Boxing Helena,1993-06-18,1993,0,1796389,1796389,4.304224
18218,The Business of Being Born,2008-01-01,2008,0,0,0,1.057283
18220,Poison Ivy II: Lily,1996-01-16,1996,0,0,0,6.448039
18221,Space Station 3D,2002-04-17,2002,0,0,0,3.071463
18222,Poison Ivy: The New Seduction,1997-01-01,1997,0,0,0,6.146452
18223,Poison Ivy: The Secret Society,2008-07-27,2008,1999000,0,-1999000,2.84929
18224,Bionicle 3: Web of Shadows,2005-01-01,2005,0,0,0,1.988845
18228,Blue Hawaii,1961-11-22,1961,0,0,0,6.656799
18229,Passage to Marseille,1944-02-16,1944,0,0,0,1.815107
18230,Supervolcano,2005-03-13,2005,0,0,0,1.937956
18231,Star Trek: Of Gods And Men,2007-12-22,2007,0,0,0,0.821734
18232,If You Are the One,2008-12-22,2008,0,0,0,3.207363
18238,Lesbian Vampire Killers,2009-03-16,2009,0,0,0,6.52808
18239,The Twilight Saga: New Moon,2009-03-15,2009,50000000,709827462,659827462,30.121292
18240,The Proposal,2009-06-01,2009,40000000,317375031,277375031,8.058337
18242,The Secret Adventures of Tom Thumb,1993-12-10,1993,0,0,0,0.381704
18248,The Foreigner,2003-06-01,2003,16700000,0,-16700000,4.266051
18250,Dr. Phibes Rises Again,1972-07-01,1972,75000,0,-75000,2.59351
18252,My Science Project,1985-08-09,1985,0,4122748,4122748,3.868014
18254,Reds,1981-12-25,1981,32000000,40382659,8382659,5.463216
18256,Castle Freak,1995-08-04,1995,0,0,0,2.26977
18257,Black Belt Jones,1974-01-29,1974,0,0,0,1.753585
18264,The Man from Laramie,1955-08-31,1955,0,0,0,5.678463
18265,Remote Control,1992-09-09,1992,0,0,0,0.1725
18269,Lady and the Tramp II: Scamp's Adventure,2001-02-18,2001,0,0,0,9.672521
18273,Downloading Nancy,2008-01-21,2008,3000000,0,-3000000,1.961313
18274,Frogs,1972-03-10,1972,0,0,0,7.706248
18276,Hoot,2006-05-05,2006,0,0,0,6.429619
18278,Perkins' 14,2009-01-09,2009,0,0,0,1.18443
18279,Frozen Land,2005-01-14,2005,2000000,0,-2000000,1.418547
18281,Side Street,1950-03-23,1950,0,0,0,1.256294
18282,One Crazy Summer,1986-08-08,1986,0,0,0,4.66789
18283,Brigadoon,1954-09-08,1954,0,0,0,12.645217
18287,Support Your Local Gunfighter,1971-05-26,1971,0,0,0,2.412247
18289,Godzilla vs. Biollante,1989-12-16,1989,5000000,0,-5000000,6.297432
18290,Arranged,2007-03-10,2007,0,0,0,1.062884
18292,George Washington,2000-10-01,2000,0,0,0,2.745074
18299,Love in the Afternoon,1957-06-30,1957,0,0,0,8.196679
18300,Jet Lag,2002-10-30,2002,0,0,0,3.490296
18302,Painted Fire,2002-05-10,2002,0,0,0,1.792884
18303,If I Were a Rich Man,2002-11-27,2002,0,0,0,1.592771
18305,A Better Tomorrow II,1987-12-17,1987,0,0,0,4.536307
18311,Days of Being Wild,1990-12-15,1990,0,141864,141864,6.242263
18312,Endgame: Blueprint for Global Enslavement,2007-11-01,2007,0,0,0,0.90203
18316,Black Dog,1998-05-01,1998,0,0,0,4.4467
18317,Truly Madly Deeply,1990-11-10,1990,0,0,0,2.066145
18320,The Young Victoria,2009-03-04,2009,35000000,27409889,-7590111,8.437587
18323,Joshua,2002-04-19,2002,0,1347988,1347988,1.109111
18329,Happy Together,1997-05-17,1997,0,0,0,5.933971
18331,The Nutty Professor,1963-06-04,1963,0,0,0,6.36551
18333,Hour of the Wolf,1968-01-01,1968,0,0,0,4.665202
18334,Guinea Pig: Devil's Experiment,1985-09-04,1985,0,0,0,1.177852
18352,The Cremator,1969-03-14,1969,0,0,0,2.58383
18355,The Assignment,1997-09-28,1997,0,0,0,4.233187
18357,The Country Bears,2002-07-26,2002,35000000,0,-35000000,7.007574
18359,To Kill a King,2003-01-01,2003,0,0,0,9.439462
18360,Night at the Museum: Battle of the Smithsonian,2009-05-20,2009,150000000,413106170,263106170,15.417181
18362,Doug Stanhope: No Refunds,2007-08-03,2007,0,0,0,0.761797
18373,The Family Way,1966-12-18,1966,0,0,0,0.945233
18374,My Girlfriend Is an Agent,2009-04-04,2009,0,0,0,3.174574
18375,A Stranger's Heart,2007-05-05,2007,0,0,0,0.599556
18377,200 Pounds Beauty,2006-12-14,2006,4000000,0,-4000000,3.088483
18380,Babine,2008-11-28,2008,0,0,0,1.048994
18381,"It's Not Me, I Swear!",2008-09-26,2008,0,0,0,1.046124
18385,Together,2002-09-10,2002,0,0,0,1.916724
18387,Big Wednesday,1978-05-26,1978,11000000,0,-11000000,11.589692
18391,Easy Money,1983-08-19,1983,0,0,0,7.963156
18392,Embrace of the Vampire,1995-05-30,1995,500000,0,-500000,4.537915
18394,Essex Boys,2000-07-14,2000,0,0,0,6.513748
18395,Exit to Eden,1994-10-14,1994,0,6841570,6841570,4.322726
18398,Suddenly,1954-10-07,1954,0,0,0,1.859033
18402,Something to Talk About,1995-08-04,1995,0,50892160,50892160,3.743212
18404,National Lampoon's Cattle Call,2006-06-01,2006,0,0,0,1.902012
18405,The Last House on the Left,2009-03-13,2009,15000000,32721635,17721635,13.634766
18406,Chained Heat,1983-05-27,1983,0,0,0,5.105447
18408,Cherish,2002-01-17,2002,0,0,0,4.259532
18410,Project X,1987-04-17,1987,18000000,18532286,532286,10.000775
18414,Kids in the Hall: Brain Candy,1996-04-02,1996,0,0,0,2.299851
18415,Gummo,1997-10-17,1997,1300000,0,-1300000,5.148375
18417,The Other Sister,1999-02-26,1999,35000000,0,-35000000,3.816491
18420,City of Industry,1997-03-14,1997,8000000,0,-8000000,1.922014
18421,Climates,2006-09-07,2006,0,0,0,2.145564
18423,B.A.P.S.,1997-03-28,1997,0,7240837,7240837,1.56098
18424,Cloud 9,2006-01-01,2006,0,0,0,2.266472
18425,Clubland,2007-08-03,2007,0,0,0,1.174855
18426,Daisy,2006-03-09,2006,0,0,0,1.885187
18428,Confess,2005-01-01,2005,0,0,0,1.315509
18434,Crazy,2008-03-02,2008,0,0,0,1.507401
18435,Crush,2001-08-19,2001,0,0,0,1.27202
18437,The Darwin Awards,2006-07-05,2006,0,0,0,4.520783
18438,Castaway on the Moon,2009-05-14,2009,0,0,0,6.266701
18440,Days of Darkness,2007-01-01,2007,0,0,0,1.436085
18440,Days of Darkness,2007-01-01,2007,0,0,0,1.436085
18441,Death of a Ghost Hunter,2007-10-28,2007,0,0,0,0.946641
18442,Decoys,2004-02-27,2004,5000000,0,-5000000,2.855757
18443,Decoys 2: Alien Seduction,2007-03-06,2007,1500000,0,-1500000,7.522408
18444,Swiss Family Robinson,1960-12-21,1960,0,0,0,4.623089
18446,Swing Shift,1984-04-13,1984,0,0,0,1.787996
18447,The Young Land,1959-05-01,1959,0,0,0,0.312988
18449,The Deadly Companions,1961-06-06,1961,0,0,0,1.939164
18450,Zorro,1975-03-06,1975,0,0,0,2.823599
18451,The Whole Wide World,1996-12-20,1996,1300000,0,-1300000,7.94599
18457,Dead Weight,2002-04-10,2002,0,0,0,5.202103
18462,Night of the Comet,1984-11-16,1984,3000000,14418922,11418922,4.947043
18467,Spiral,2007-01-01,2007,1500000,0,-1500000,2.034737
18468,Momma's Man,2008-01-18,2008,0,0,0,0.504158
18472,Driven To Kill,2009-05-01,2009,10000000,0,-10000000,4.089346
18475,The Cookout,2004-09-03,2004,16000000,12,-15999988,1.758079
18476,Horsemen,2009-02-06,2009,20000000,1017401,-18982599,7.455953
18477,The Hills Have Eyes Part II,1984-06-01,1984,700000,0,-700000,3.09433
18480,Br√ºno,2009-07-08,2009,42000000,0,-42000000,8.543888
18484,Wassup Rockers,2005-09-12,2005,0,634074,634074,1.489895
18486,My Girl,2003-10-03,2003,0,0,0,0.709985
18487,The Taking of Pelham 1 2 3,2009-06-11,2009,100000000,150166126,50166126,15.09911
18489,The Yes Men Fix the World,2009-01-18,2009,0,0,0,1.372814
18491,The End of Evangelion,1997-07-19,1997,0,20000000,20000000,6.228255
18492,Killer Tattoo,2001-04-05,2001,0,0,0,0.493947
18493,Chronos,1985-05-10,1985,0,0,0,2.141858
18495,Folks!,1992-05-01,1992,0,6132924,6132924,3.968853
18497,Exiles,2004-05-19,2004,0,0,0,1.202441
18498,Ghoulies,1984-11-08,1984,1000000,35000000,34000000,4.734765
18499,The Decline of the American Empire,1986-06-19,1986,0,0,0,2.725818
18500,The Sandlot 2,2005-05-03,2005,0,0,0,2.695495
18501,Gamer,2009-09-03,2009,50000000,40828540,-9171460,9.730681
18502,The Stuff,1985-06-14,1985,1700000,0,-1700000,7.394892
18503,Caterina in the Big City,2003-10-24,2003,0,0,0,3.162693
18506,Once Upon A Mattress,2005-12-18,2005,0,0,0,3.794071
18507,Tu¬£sday,2008-10-10,2008,0,0,0,0.609663
18508,Uno,2004-09-10,2004,0,0,0,1.220097
18509,Caddyshack II,1988-07-22,1988,0,0,0,6.349281
18510,New Tale of Zat√¥ichi,1963-03-15,1963,0,0,0,1.552542
18511,Zat√¥ichi the Fugitive,1963-08-10,1963,0,0,0,1.482114
18512,Sergeants 3,1962-02-10,1962,0,0,0,0.982778
18513,The Naked Prey,1965-06-01,1965,0,0,0,2.243937
18514,Never Forever,2007-01-18,2007,0,0,0,0.589948
18516,Adam Resurrected,2008-08-08,2008,10000000,0,-10000000,1.714132
18517,Mr. Fix It,2006-12-26,2006,0,0,0,2.476507
18519,Free Willy 3: The Rescue,1997-08-08,1997,0,0,0,6.107833
18520,Al Franken - God Spoke,2006-01-01,2006,0,0,0,0.364839
18529,Crips and Bloods: Made in America,2008-01-01,2008,0,0,0,2.0531
18530,The Cry of the Owl,2009-02-07,2009,11500000,0,-11500000,3.877603
18533,Bronson,2008-10-09,2008,230000,2260712,2030712,9.521043
18535,Loving You,1957-07-09,1957,0,0,0,2.118791
18538,Dot the I,2003-01-18,2003,0,0,0,4.641037
18539,Tobacco Road,1941-02-20,1941,0,0,0,1.072216
18543,Revenge of the Nerds III: The Next Generation,1992-06-10,1992,0,0,0,7.482477
18547,The Ferryman,2007-01-01,2007,0,0,0,1.665752
18548,Filth and Wisdom,2008-02-13,2008,0,0,0,1.250852
18549,Flannel Pajamas,2006-11-17,2006,0,0,0,0.004998
18550,Fled,1996-07-19,1996,25000000,17193231,-7806769,3.906949
18551,Flesh and Bone,1993-11-05,1993,0,9488998,9488998,1.896869
18553,Forever Mine,1999-12-09,1999,0,0,0,5.147033
18555,Foxfire,1996-08-23,1996,0,258263,258263,3.186891
18557,Acolytes,2008-09-20,2008,0,0,0,2.146064
18558,Scenes of a Sexual Nature,2006-11-03,2006,0,0,0,3.034271
18560,Soul Music,1997-05-12,1997,0,0,0,0.764764
18561,Oxygen,1999-11-12,1999,0,0,0,8.343079
18562,Gung Ho!,1943-12-20,1943,0,0,0,0.77581
18568,The Master Touch,1972-12-08,1972,0,0,0,0.701847
18569,Made for Each Other,1939-02-10,1939,0,0,0,1.240701
18570,"Food, Inc.",2008-09-07,2008,0,0,0,6.931952
18571,Phantom Punch,2009-01-01,2009,0,0,0,2.228889
18573,House of Wax,1953-04-10,1953,658000,23800000,23142000,9.072006
18575,Pigs,1992-11-20,1992,0,0,0,0.526779
18585,The Ramen Girl,2008-02-08,2008,0,0,0,4.60263
18586,The Hottest State,2006-09-02,2006,0,0,0,0.97551
18587,10 to Midnight,1983-03-11,1983,4520000,7175592,2655592,3.372304
18588,52 Pick-Up,1986-11-07,1986,0,5186646,5186646,15.921964
18589,The Abductors,1972-01-28,1972,0,0,0,0.464565
18590,The Architect,2006-12-01,2006,0,0,0,1.399056
18591,Uncovered,1995-01-04,1995,0,0,0,1.596275
18595,Garage,2007-10-05,2007,0,0,0,3.440424
18596,The Jammed,2007-01-01,2007,0,0,0,1.377544
18597,Jimmy Carr: Live,2004-11-08,2004,0,0,0,0.867197
18598,Her Best Move,2007-03-31,2007,0,0,0,0.98754
18602,Morvern Callar,2002-01-01,2002,0,0,0,2.328347
18603,Hands on a Hard Body: The Documentary,1997-06-01,1997,0,0,0,0.495079
18612,The Desperate Hours,1955-10-05,1955,0,0,0,10.160986
18613,Fugitive Pieces,2007-09-06,2007,0,0,0,1.048087
18614,Interrogation,1989-12-13,1989,0,0,0,1.785426
18615,Fur: An Imaginary Portrait of Diane Arbus,2006-08-30,2006,16800000,2281089,-14518911,5.108321
18616,No Man's Land: The Rise of Reeker,2008-05-01,2008,2000000,0,-2000000,8.618134
18618,Gettin' It,2006-01-01,2006,0,0,0,1.409533
18619,Ghetto,2006-06-08,2006,0,0,0,1.162467
18620,Go Fish,1994-06-10,1994,0,0,0,0.775898
18621,Best Laid Plans,1999-04-09,1999,0,0,0,4.374187
18624,Zat√¥ichi on the Road,1963-11-30,1963,0,0,0,0.73057
18627,Son of Godzilla,1967-12-16,1967,0,0,0,1.925084
18628,Very Happy Alexander,1968-02-09,1968,0,0,0,2.779711
18631,Beyond The Law,1992-04-22,1992,0,0,0,3.968731
18632,A Dog's Breakfast,2007-03-03,2007,120000,0,-120000,9.17962
18633,Slipstream,2007-02-10,2007,0,27769,27769,10.627974
18634,Puzzlehead,2005-04-21,2005,500000,0,-500000,0.582772
18635,One Week,2008-09-08,2008,0,0,0,5.693842
18638,Faith of My Fathers,2005-05-30,2005,0,0,0,0.628498
18639,Flaming Star,1960-12-20,1960,0,0,0,1.62482
18642,G.I. Blues,1960-11-23,1960,0,0,0,1.587357
18643,Follow That Dream,1962-01-01,1962,0,0,0,1.127826
18644,King Creole,1958-07-02,1958,0,0,0,4.746925
18646,Royal Wedding,1951-01-01,1951,0,0,0,2.275332
18647,One-Eyed Jacks,1961-03-30,1961,6000000,4300000,-1700000,6.945886
18649,My Favorite Brunette,1947-04-04,1947,0,0,0,1.196569
18650,Miss Julie,1951-06-28,1951,0,0,0,1.068448
18651,The Story of Vernon and Irene Castle,1939-03-29,1939,0,0,0,1.583306
18652,Street Thief,2006-08-07,2006,0,0,0,0.727965
18658,Clean Slate,1994-05-06,1994,0,7355425,7355425,2.724621
18660,The Apple Dumpling Gang,1975-07-01,1975,0,0,0,4.040945
18665,High Risk,1995-07-12,1995,0,0,0,5.376026
18666,New Fist of Fury,1976-07-08,1976,0,0,0,2.29062
18670,Legend of the Red Dragon,1994-02-05,1994,0,0,0,2.946935
18671,Gun Crazy,1950-01-20,1950,0,0,0,3.467871
18672,The Legend of the Swordsman,1992-06-26,1992,4439832,0,-4439832,2.872173
18673,8 X 10 Tasveer,2009-04-03,2009,0,0,0,1.099309
18674,The Defender,1994-07-28,1994,0,0,0,2.826801
18680,Fear City,1984-07-18,1984,0,0,0,7.241443
18681,Eye of the Beholder,1999-09-04,1999,15000000,0,-15000000,3.773058
18682,Girl Happy,1965-04-14,1965,0,0,0,0.824304
18683,Shirley Valentine,1989-10-27,1989,0,0,0,1.714899
18684,Kid Galahad,1962-11-29,1962,0,0,0,1.466483
18688,Charro!,1969-03-13,1969,0,0,0,1.426253
18690,Spinout,1966-12-14,1966,0,0,0,1.185832
18691,Frankie and Johnny,1966-01-01,1966,0,0,0,1.151937
18692,Fun in Acapulco,1963-01-01,1963,0,0,0,2.036182
18693,Speedway,1968-01-01,1968,0,0,0,1.353461
18694,Change of Habit,1969-02-02,1969,0,0,0,0.68564
18696,The Giant of Marathon,1959-12-03,1959,0,0,0,1.668343
18698,Jack and the Beanstalk,1952-01-01,1952,0,0,0,1.556265
18701,Being Julia,2004-09-03,2004,0,0,0,3.922314
18702,Pot o' Gold,1941-04-03,1941,0,0,0,0.941322
18703,My Dear Secretary,1949-01-12,1949,0,0,0,1.27598
18704,Failan,2001-04-28,2001,0,0,0,1.806613
18705,Mr. Moto's Last Warning,1939-01-20,1939,0,0,0,0.838547
18706,Sherlock Holmes and the Secret Weapon,1942-12-25,1942,0,0,0,2.538368
18707,"Twinkle, Twinkle, Lucky Stars",1985-08-15,1985,9023199,0,-9023199,3.575166
18710,Capone,1975-04-16,1975,970000,2000000,1030000,3.669545
18711,Silver City,2004-09-17,2004,0,0,0,1.534733
18712,Sands of Iwo Jima,1949-12-14,1949,1000000,7800000,6800000,2.828371
18713,The Jerky Boys,1995-02-03,1995,0,0,0,0.748846
18721,The Far Country,1955-02-12,1955,0,0,0,2.335287
18722,Mr. Baseball,1992-10-01,1992,0,20000000,20000000,11.950477
18724,Attack of the 50 Foot Woman,1958-05-19,1958,88000,480000,392000,3.559789
18725,The Enforcer,1995-03-02,1995,0,0,0,2.568483
18727,Heaven Can Wait,1943-08-11,1943,0,0,0,3.24049
18729,"North and South, Book I",1985-11-03,1985,0,0,0,2.238623
18731,Last Hero in China,1993-04-01,1993,0,0,0,1.567115
18734,L.I.E.,2001-01-20,2001,700000,1667192,967192,8.66635
18735,Magnificent Bodyguards,1978-04-27,1978,0,0,0,1.257122
18736,The Lizzie McGuire Movie,2003-04-25,2003,17000000,55534455,38534455,6.730857
18739,Faintheart,2008-01-01,2008,0,0,0,1.002834
18741,Fearless Hyena Part II,1983-03-04,1983,0,0,0,2.017198
18747,Election,2005-05-14,2005,0,0,0,3.222361
18755,Pigs,2007-11-05,2007,0,0,0,4.85165
18758,To Kill with Intrigue,1977-07-22,1977,0,0,0,1.174062
18759,The Cell 2,2009-02-27,2009,0,0,0,7.790201
18760,Spiritual Kung Fu,1978-11-23,1978,0,0,0,1.502234
18761,Practical Joke,2008-05-22,2008,0,0,0,0.736912
18762,Blue Juice,1995-09-15,1995,0,0,0,2.199462
18763,Heart of the Dragon,1985-09-09,1985,0,0,0,2.301717
18764,Twin Dragons,1992-01-15,1992,10000000,8359717,-1640283,10.222076
18767,Island of Fire,1990-01-01,1990,0,0,0,11.366852
18770,Thirty Seconds Over Tokyo,1944-11-15,1944,0,0,0,1.210978
18771,They Were Expendable,1945-12-20,1945,0,0,0,8.264122
18773,Doppelganger,1993-03-01,1993,0,0,0,1.166411
18774,This Sporting Life,1963-01-15,1963,0,0,0,2.190654
18775,Demon Seed,1977-04-07,1977,0,0,0,4.578201
18776,The Spirit of St. Louis,1957-04-19,1957,0,0,0,3.455477
18777,Slow Burn,2005-09-12,2005,15500000,1237615,-14262385,6.300001
18780,Sink the Bismarck!,1960-02-11,1960,0,0,0,5.472565
18781,The Haunting in Connecticut,2009-03-27,2009,0,77527732,77527732,10.80374
18783,Sahara,1943-09-02,1943,0,0,0,2.27778
18784,"Run Silent, Run Deep",1958-03-27,1958,0,0,0,2.73837
18785,The Hangover,2009-06-05,2009,35000000,459270619,424270619,23.947351
18790,Across the Pacific,1942-09-05,1942,0,0,0,2.097374
18801,Haunted,1995-10-27,1995,0,0,0,3.287359
18803,Expired,2007-01-19,2007,0,0,0,0.44864
18804,Head in the Clouds,2004-04-29,2004,0,0,0,9.073646
18809,How to Irritate People,1969-01-21,1969,0,0,0,1.95735
18815,Glowing Stars,2009-01-30,2009,0,0,0,0.315333
18816,Dragon Squad,2005-11-10,2005,0,0,0,3.590521
18817,The Bride with White Hair,1993-08-26,1993,0,0,0,3.635789
18819,The Hunt for Eagle One,2006-01-17,2006,0,0,0,2.778665
18820,I Really Hate My Job,2007-01-01,2007,0,0,0,1.840607
18823,Clash of the Titans,2010-04-01,2010,125000000,232713139,107713139,11.972347
18825,Espace d√©tente,2005-02-02,2005,0,0,0,1.63577
18826,Spring Breakdown,2009-05-22,2009,12300000,0,-12300000,2.355305
18828,Double Take,2001-01-12,2001,0,0,0,3.067916
18835,Private School,1983-07-29,1983,0,0,0,4.479689
18836,The Quickie,2001-06-04,2001,3000000,0,-3000000,1.434499
18837,Macross Plus: Movie Edition,1995-10-06,1995,0,0,0,2.676365
18839,Ghost in the Shell: Stand Alone Complex - The Laughing Man,2005-01-01,2005,0,0,0,4.099225
18840,The White Countess,2005-10-30,2005,0,0,0,5.080754
18841,The Lost Skeleton of Cadavra,2001-09-12,2001,0,0,0,2.073869
18843,Dr. Dolittle 3,2006-04-25,2006,0,0,0,6.204275
18846,The Little Drummer Boy,1968-12-19,1968,0,0,0,1.495847
18848,The Inner Life of Martin Frost,2007-10-11,2007,0,0,0,0.349782
18851,The Cat and the Canary,1939-11-10,1939,0,0,0,1.079371
18856,The Invisible Circus,2001-02-23,2001,0,0,0,4.18281
18857,Crime Story,1993-06-24,1993,0,194720,194720,6.188664
18858,Irresistible,2006-04-18,2006,0,0,0,4.094629
18862,House Arrest,1996-08-14,1996,0,0,0,12.297782
18865,Crashing,2007-01-01,2007,0,0,0,1.516288
18866,Knots,2004-04-20,2004,0,0,0,1.010064
18867,Half a Loaf of Kung Fu,1978-06-30,1978,0,0,0,1.660612
18869,Jimmy and Judy,2006-01-01,2006,0,0,0,1.9939
18871,Ride the Pink Horse,1947-10-08,1947,0,0,0,3.432425
18872,Maborosi,1995-10-01,1995,0,0,0,2.050562
18874,Ghost in the Shell: Stand Alone Complex - Solid State Society,2007-02-23,2007,3200000,0,-3200000,6.548847
18879,The Plank,1967-06-09,1967,0,0,0,0.95992
18881,Kite,1998-02-25,1998,0,0,0,1.718354
18882,Man-Thing,2005-04-21,2005,7500000,143000,-7357000,6.11959
18884,Nuremberg,2000-07-16,2000,24000000,0,-24000000,2.278704
18885,3 Ninjas Kick Back,1994-05-06,1994,0,0,0,3.775127
18886,Flight of the Intruder,1991-01-18,1991,35000000,0,-35000000,8.340023
18887,Darby O'Gill and the Little People,1959-06-29,1959,0,0,0,3.276605
18888,Meat Love,1989-01-01,1989,0,0,0,0.003013
18889,Control Room,2004-01-15,2004,0,2586511,2586511,1.949044
18890,We're Back! A Dinosaur's Story,1993-11-24,1993,0,9317021,9317021,13.58903
18892,Jawbreaker,1999-01-30,1999,3000000,3076820,76820,7.434797
18893,Joe Strummer: The Future Is Unwritten,2007-05-18,2007,0,0,0,2.388657
18894,"Paradise, Hawaiian Style",1966-06-15,1966,0,0,0,2.679902
18896,The French Kissers,2009-06-10,2009,0,0,0,5.464497
18897,Don't Look Back,2009-05-16,2009,13000000,0,-13000000,10.681024
18898,Looking for Eric,2009-05-27,2009,0,0,0,3.840482
18899,Vengeance,2009-05-20,2009,0,0,0,5.752058
18900,In Cold Blood,1967-12-14,1967,3500000,13007551,9507551,8.592792
18901,The Pinchcliffe Grand Prix,1975-08-28,1975,0,0,0,2.73578
18902,Zoo,2007-01-20,2007,0,0,0,2.168812
18904,A Summer Place,1959-11-18,1959,0,0,0,4.834431
18905,Caveman,1981-04-17,1981,0,0,0,2.5697
18906,"Mus√©e haut, mus√©e bas",2008-11-19,2008,0,0,0,1.376614
18908,The One and Only,1999-04-01,1999,0,5405313,5405313,1.907938
18910,The Ninth Configuration,1980-02-29,1980,0,0,0,3.491636
18912,Angst,1983-01-01,1983,0,0,0,4.705283
18913,Betsy's Wedding,1990-06-22,1990,0,19740070,19740070,7.772822
18916,A Pain in the Ass,2008-01-01,2008,30000000,0,-30000000,1.644817
18917,Alice,1988-08-03,1988,0,0,0,7.906525
18919,Faust,1994-09-10,1994,0,0,0,1.892008
18920,Vi hade i alla fall tur med v√§dret,1980-02-26,1980,0,0,0,1.134897
18923,A Home at the End of the World,2004-07-23,2004,6500000,1548955,-4951045,4.136105
18925,Facing the Giants,2006-09-29,2006,100000,10178331,10078331,7.485908
18926,Boomerang!,1947-02-28,1947,0,0,0,2.935164
18927,Stander,2003-01-01,2003,0,31651,31651,7.839675
18928,"Run, Man, Run",1968-08-29,1968,0,0,0,1.29166
18929,The Entertainer,1960-07-25,1960,0,0,0,2.678395
18930,Murder by Contract,1958-12-01,1958,0,0,0,1.073017
18932,Knock Knock,2008-03-14,2008,0,0,0,1.169505
18935,Ernest Goes to Camp,1987-05-22,1987,3000000,23509382,20509382,5.712291
18937,Quest for Camelot,1998-05-15,1998,40000000,38172500,-1827500,13.02535
18939,Little Otik,2001-01-25,2001,0,0,0,2.684863
18940,Secrets Of State,2008-12-10,2008,15000000,0,-15000000,8.545117
18941,Marion Bridge,2003-04-18,2003,0,0,0,0.431196
18943,Ernest Goes to Jail,1990-04-06,1990,0,0,0,2.30623
18944,The Rolling Stones Rock and Roll Circus,1996-10-16,1996,0,0,0,1.291844
18947,The Boat That Rocked,2009-04-01,2009,50000000,36348784,-13651216,8.395618
18948,FernGully 2: The Magical Rescue,1998-03-17,1998,0,0,0,1.273338
18955,Coco,2009-07-21,2009,0,0,0,5.587649
18966,Love at First Bite,1979-04-26,1979,0,43885000,43885000,2.738421
18968,Pearl Jam: Immagine in Cornice,2007-09-25,2007,0,0,0,0.413532
18969,Demon Hunter,2005-06-01,2005,0,0,0,1.42662
18971,Rosencrantz & Guildenstern Are Dead,1991-02-08,1991,0,0,0,5.088457
18972,The Undefeated,1969-10-04,1969,0,0,0,10.975431
18973,Cinderfella,1960-12-18,1960,3000000,7100000,4100000,2.395067
18974,The 3 Worlds of Gulliver,1960-11-30,1960,0,0,0,8.158266
18975,The Adventures of Pinocchio,1996-07-26,1996,0,0,0,7.523528
18976,Attila,2001-01-01,2001,0,0,0,9.563499
18977,The Boy and the Pirates,1960-04-13,1960,0,0,0,0.488608
18978,Camelot,1967-10-25,1967,0,0,0,3.30865
18979,Captain Kronos: Vampire Hunter,1974-04-07,1974,400000,0,-400000,2.980415
18983,"Godzilla, King of the Monsters!",1956-04-27,1956,650000,0,-650000,8.07532
18984,Scratch,2001-11-07,2001,0,0,0,0.655434
18987,The Hunchback of Notre Dame,1923-09-06,1923,0,0,0,1.469045
18988,The Lion in Winter,1968-01-01,1968,0,0,0,7.056355
18989,Moll Flanders,1996-06-14,1996,0,0,0,2.337263
18990,The Mummy,1959-09-29,1959,0,0,0,4.662323
18992,My Friend Flicka,1943-05-26,1943,0,0,0,0.70993
18993,Mysterious Island,1961-12-18,1961,0,0,0,3.419312
18994,Tarzan and His Mate,1934-04-20,1934,95,0,-95,12.73076
18995,D.O.A.,1950-04-30,1950,0,0,0,7.005083
18998,Darkman II: The Return of Durant,1995-07-11,1995,0,0,0,4.366222
19002,Darkman III: Die Darkman Die,1996-08-20,1996,0,0,0,2.182588
19004,The Land Before Time III: The Time of the Great Giving,1995-03-16,1995,0,0,0,6.372442
19008,The Garden,1995-06-09,1995,0,0,0,0.466638
19010,Deep Evil,2004-06-25,2004,0,0,0,1.064408
19014,Rustlers' Rhapsody,1985-05-10,1985,0,0,0,1.051569
19016,Clifford's Really Big Movie,2004-04-23,2004,0,0,0,2.182797
19017,Dirty Mary Crazy Larry,1974-05-17,1974,0,0,0,2.314337
19025,Bhool Bhulaiyaa,2007-10-12,2007,0,0,0,1.629677
19026,Azur & Asmar: The Princes' Quest,2006-10-25,2006,0,0,0,5.235633
19029,When Nietzsche Wept,2007-08-02,2007,0,0,0,1.063441
19033,The Sasquatch Gang,2006-01-01,2006,0,0,0,1.956502
19034,The Fall of the House of Usher,1981-01-01,1981,0,0,0,0.071022
19035,Dimensions of Dialogue,1983-01-01,1983,0,0,0,1.471078
19039,The Conclave,2006-10-07,2006,4000000,0,-4000000,1.192131
19042,All Dogs Go to Heaven 2,1996-03-29,1996,0,8620678,8620678,5.028897
19049,The Yearling,1946-12-18,1946,0,0,0,2.123277
19050,The Bad News Bears in Breaking Training,1977-07-08,1977,0,19104350,19104350,1.912284
19051,The New Adventures of Pippi Longstocking,1988-07-06,1988,5000000,3569939,-1430061,3.078111
19052,Light It Up,1999-11-04,1999,0,0,0,1.252804
19053,Valley Girl,1983-04-08,1983,350000,17343596,16993596,8.438808
19054,The London Nobody Knows,1967-01-01,1967,0,0,0,0.221348
19058,Down,2001-05-11,2001,15000000,163169,-14836831,1.158196
19059,Dead Fish,2005-10-11,2005,0,0,0,7.106448
19063,Ikigami: The Ultimate Limit,2008-09-26,2008,0,0,0,1.66277
19064,Once Bitten,1985-11-15,1985,3200000,10000000,6800000,6.174699
19065,Pure Luck,1991-08-09,1991,17010000,24941969,7931969,2.07443
19066,Rest Stop: Don't Look Back,2008-09-30,2008,0,0,0,2.449903
19067,The Duellists,1977-08-31,1977,900000,0,-900000,5.82556
19072,Blithe Spirit,1945-05-14,1945,0,0,0,3.219717
19075,A Midsummer Night's Dream,1935-10-09,1935,0,0,0,2.110653
19076,The Affair of the Necklace,2001-11-20,2001,0,0,0,5.429441
19079,Phoebe in Wonderland,2008-02-07,2008,0,0,0,7.898326
19082,No Direction Home: Bob Dylan,2005-07-21,2005,2000000,0,-2000000,2.8026
19083,Strays,1997-01-18,1997,0,0,0,3.013494
19084,Johnson Family Vacation,2004-04-07,2004,12000000,31179516,19179516,3.223039
19085,Vulgar,2000-09-13,2000,120000,14904,-105096,1.62632
19086,Delta Force 2: The Colombian Connection,1990-08-24,1990,0,6698361,6698361,7.007739
19087,LadyBugs,1992-03-27,1992,0,0,0,2.386817
19092,Above the Rim,1994-03-23,1994,0,0,0,4.38154
19094,Sordid Lives,2001-05-11,2001,0,1079726,1079726,1.650666
19095,A Virgin Among the Living Dead,1973-11-15,1973,0,0,0,1.988945
19096,Back to Bataan,1945-05-30,1945,0,0,0,2.68989
19099,Frenchmen,2003-04-02,2003,0,0,0,2.360498
19100,Those Happy Days,2006-06-28,2006,0,0,0,6.414934
19101,A Little Princess,1995-05-10,1995,17000000,0,-17000000,7.731725
19103,As You Like It,2006-01-01,2006,0,0,0,2.918684
19105,Iron Maiden: Flight 666,2009-04-21,2009,0,0,0,2.123844
19106,Lascars,2009-06-17,2009,12500000,0,-12500000,4.892394
19108,Breaker! Breaker!,1977-04-01,1977,0,0,0,2.637637
19109,The Long Weekend,2005-08-05,2005,0,0,0,6.038144
19112,The End of Suburbia: Oil Depletion and the Collapse of the American Dream,2004-05-05,2004,0,0,0,0.319883
19114,Endless Love,1981-07-17,1981,0,32492674,32492674,5.786435
19116,Asylum,2008-03-20,2008,22000000,0,-22000000,2.07055
19118,Let It Ride,1989-08-18,1989,0,0,0,6.657723
19119,Night and the City,1950-04-01,1950,0,0,0,11.80556
19120,Juliet of the Spirits,1965-10-22,1965,0,0,0,5.348359
19123,Knock on Wood,1981-03-01,1981,0,0,0,5.568624
19124,Blind Fury,1989-08-17,1989,0,2692037,2692037,6.617717
19126,Even Money,2006-03-01,2006,0,0,0,7.032075
19127,Water,1985-01-01,1985,0,0,0,7.324076
19128,"The 1,000 Eyes of Dr. Mabuse",1960-09-13,1960,0,0,0,1.685889
19133,The Big Bus,1976-06-23,1976,0,0,0,7.524202
19136,Hellzapoppin',1941-12-26,1941,0,0,0,0.888554
19137,After the Fox,1966-01-01,1966,0,0,0,1.273061
19139,Goal! III : Taking On The World,2009-01-01,2009,0,0,0,3.128836
19140,The Pride of the Yankees,1942-07-14,1942,0,0,0,2.40977
19142,The Return of Swamp Thing,1989-05-11,1989,0,192816,192816,2.876656
19143,Diggstown,1992-08-14,1992,17000000,4836637,-12163363,3.622179
19147,The Man Who Challenged the Devil,2007-09-28,2007,0,0,0,0.842214
19150,The Crew,2000-08-21,2000,0,0,0,2.086952
19152,Zift,2008-06-27,2008,796442,0,-796442,1.169328
19153,The Real Cancun,2003-04-23,2003,0,0,0,1.096057
19154,The Second Arrival,1998-11-06,1998,0,0,0,2.305426
19155,Before the Rain,1994-06-09,1994,0,763847,763847,3.525649
19156,Legendary Weapons of China,1982-01-21,1982,0,0,0,0.995774
19157,Going Overboard,1989-05-11,1989,0,0,0,7.468225
19158,Graveyard Shift,1990-10-26,1990,10500000,11582891,1082891,4.668541
19159,Dancehall Queen,1997-10-10,1997,0,0,0,0.395636
19164,The Land Before Time IV: Journey Through the Mists,1996-12-10,1996,0,0,0,4.541551
19165,The Land Before Time V: The Mysterious Island,1997-09-12,1997,0,0,0,4.745231
19166,House Of 9,2005-01-01,2005,6000000,0,-6000000,5.499612
19167,Second In Command,2006-05-02,2006,0,0,0,2.423015
19169,Nightmare Alley,1947-10-09,1947,0,0,0,5.529394
19170,Mystery Street,1950-07-28,1950,0,0,0,0.784985
19171,Sudden Fear,1952-08-01,1952,0,0,0,1.184996
19173,Diary of a Nymphomaniac,2008-10-14,2008,0,0,0,5.28626
19174,Dolemite,1975-04-26,1975,0,0,0,1.631512
19176,The Cowboy Way,1994-06-03,1994,0,0,0,4.286279
19178,Four Bags Full,1956-10-26,1956,0,0,0,2.989587
19181,S√§llskapsresan II - Snowroller,1985-10-03,1985,0,8646157,8646157,2.003868
19183,The Derby Stallion,2005-07-04,2005,750000,4000000,3250000,1.500013
19184,The Last Battle,1983-04-06,1983,0,0,0,2.524734
19185,Night of the Living Dead,1990-10-18,1990,4200000,5835247,1635247,10.644165
19186,The Parent Trap,1961-06-12,1961,0,0,0,5.807074
19187,The Hebrew Hammer,2003-01-01,2003,1000000,0,-1000000,2.369273
19197,Mum & Dad,2008-08-22,2008,170000,0,-170000,2.947919
19199,Rampage at Apache Wells,1965-08-25,1965,0,0,0,2.117193
19200,Shadows and Fog,1991-12-05,1991,14000000,2735731,-11264269,8.678022
19203,Graduation,2007-04-24,2007,0,0,0,1.798215
19204,The Beyond,1981-04-22,1981,0,0,0,7.471402
19205,Cthulhu,2007-03-31,2007,0,0,0,0.925387
19209,White Water Summer,1987-07-10,1987,0,300859,300859,7.74579
19212,A Simple Promise,2008-05-27,2008,0,0,0,0.01023
19213,Pledge This!,2006-12-01,2006,8300000,0,-8300000,9.867616
19214,Passion of Mind,2000-01-07,2000,0,0,0,2.224117
19215,After Innocence,2005-10-23,2005,0,0,0,0.327041
19221,The Prisoner of Second Avenue,1975-03-14,1975,0,0,0,2.089535
19222,Parasomnia,2008-10-17,2008,0,0,0,10.459653
19223,A Pure Formality,1994-05-15,1994,0,0,0,4.619677
19235,Dog Tags,2008-01-01,2008,0,0,0,1.429466
19236,Santa Sangre,1989-05-01,1989,787000,0,-787000,6.813784
19237,Kill Theory,2008-05-14,2008,0,0,0,4.137441
19238,Table for Three,2009-01-01,2009,0,0,0,1.90424
19241,Backwoods,2008-01-03,2008,0,0,0,5.513341
19244,Mr. Untouchable,2007-10-25,2007,0,0,0,1.102543
19247,Animalympics,1980-02-01,1980,0,0,0,1.16106
19252,Carry On Abroad,1972-12-01,1972,0,0,0,2.102139
19254,Carry On Cabby,1963-06-01,1963,0,0,0,4.639023
19255,Away We Go,2009-06-05,2009,17000000,14899417,-2100583,6.590093
19258,Stroker Ace,1983-07-01,1983,0,0,0,6.98584
19259,Volunteers,1985-08-16,1985,0,0,0,7.511384
19265,Whatever Works,2009-06-19,2009,15000000,35097815,20097815,8.930341
19267,The Big Brawl,1980-09-10,1980,0,0,0,3.298877
19273,Dr. Dolittle: Million Dollar Mutts,2009-04-08,2009,0,0,0,1.879745
19274,Fearless Hyena,1979-02-17,1979,0,0,0,3.346997
19275,Future by Design,2006-06-10,2006,250000,0,-250000,0.259383
19276,Dhoondte Reh Jaoge,2009-03-06,2009,0,0,0,0.102219
19277,In Hell,2003-11-24,2003,0,0,0,5.255138
19286,Leprechaun 3,1995-07-04,1995,0,0,0,8.21698
19287,Leprechaun 4: In Space,1996-12-25,1996,0,0,0,3.301279
19288,Leprechaun: Back 2 tha Hood,2003-12-30,2003,0,0,0,2.551286
19293,Carry On Again Doctor,1969-12-05,1969,0,0,0,2.730509
19294,30 Days Until I'm Famous,2004-05-07,2004,0,0,0,0.661324
19297,Carry On at Your Convenience,1971-12-10,1971,0,0,0,1.571221
19300,Carry On Behind,1975-12-01,1975,0,0,0,3.463556
19305,Applause,2009-09-24,2009,0,0,0,1.031663
19306,At World's End,2009-10-09,2009,0,0,0,1.96444
19307,Carry On Camping,1969-05-29,1969,0,0,0,4.103723
19311,$9.99,2008-09-04,2008,0,0,0,3.350555
19312,The Black Hole,2006-06-10,2006,3500000,0,-3500000,1.992289
19316,Saving Face,2004-09-12,2004,0,0,0,3.08291
19317,"Zorro, The Gay Blade",1981-07-17,1981,0,0,0,2.852149
19318,Mr. Troop Mom,2009-06-19,2009,0,0,0,0.760281
19322,Who Dares Wins,1982-08-26,1982,0,0,0,1.680597
19323,Superman: Brainiac Attacks,2006-06-20,2006,0,0,0,1.679756
19324,Born in East L.A.,1987-08-21,1987,0,0,0,2.118964
19325,Bionicle: Mask of Light,2003-09-15,2003,0,0,0,6.897756
19326,Jury Duty,1995-04-12,1995,0,17014653,17014653,3.676921
19333,Terror of Mechagodzilla,1975-03-15,1975,0,0,0,2.168262
19335,Johnny O'Clock,1947-01-23,1947,0,0,0,1.632656
19336,Godzilla vs. Gigan,1972-03-12,1972,0,0,0,1.880834
19338,Out of the Ashes,2003-04-13,2003,0,0,0,0.996542
19342,All in,2006-03-14,2006,0,0,0,1.098447
19344,Loving Annabelle,2006-03-08,2006,900000,0,-900000,7.528482
19345,Black Widow,1987-02-06,1987,0,25205460,25205460,3.245911
19348,Girlfight,2000-05-01,2000,0,0,0,4.152211
19349,The Up in Smoke Tour,2000-12-02,2000,0,0,0,1.312333
19350,Knights of Bloodsteel,2009-09-07,2009,0,0,0,2.327569
19354,The Adventures of Prince Achmed,1926-09-03,1926,0,0,0,1.902271
19357,Summer Rental,1985-08-09,1985,0,24689703,24689703,12.372036
19361,Sleep with Me,1994-01-01,1994,0,161410,161410,6.398905
19362,Meeting People Is Easy,1998-01-01,1998,0,0,0,2.033336
19365,Foreign Exchange,2008-09-09,2008,1000000,0,-1000000,1.698566
19366,Josie and the Pussycats,2001-04-06,2001,22000000,0,-22000000,9.423041
19369,3-Day Weekend,2008-06-03,2008,0,0,0,1.14896
19371,Mr. Nanny,1993-10-08,1993,0,0,0,3.91475
19373,The Executioner's Song,1982-09-10,1982,0,0,0,2.610352
19375,Were The World Mine,2008-06-24,2008,0,119563,119563,1.882446
19378,The Cat from Outer Space,1978-06-09,1978,0,0,0,2.889806
19379,Condorman,1981-07-02,1981,0,0,0,3.327697
19380,White Sands,1992-04-24,1992,0,0,0,3.181492
19381,All I Wanna Do,1998-08-21,1998,0,0,0,1.983933
19382,Biloxi Blues,1988-03-25,1988,20000000,51684798,31684798,4.619593
19383,Targets,1968-05-15,1968,0,0,0,1.738863
19384,Dark Angel,1990-01-26,1990,7000000,9229401,2229401,7.958502
19386,He-Man and She-Ra: The Secret of the Sword,1985-01-01,1985,0,7,7,2.087446
19392,Dark Streets,2008-12-12,2008,0,0,0,0.920018
19398,Simon,2004-09-30,2004,0,0,0,1.854733
19400,Gwendoline,1984-02-07,1984,0,1337274,1337274,2.520484
19401,The Case for Christ,2007-01-01,2007,0,0,0,0.090474
19403,The Mechanic,1972-10-06,1972,0,0,0,5.266983
19404,Dilwale Dulhania Le Jayenge,1995-10-20,1995,13200000,100000000,86800000,34.457024
19405,Recess: School's Out,2001-01-27,2001,10000000,44460850,34460850,4.195694
19413,"Ugly, Dirty and Bad",1976-09-23,1976,0,0,0,3.364908
19414,Please Don't Eat the Daisies,1960-03-31,1960,0,0,0,1.014931
19415,Summer Lovers,1982-07-16,1982,0,0,0,3.531531
19416,Double Dare,2004-03-13,2004,0,0,0,0.777902
19418,Dhol,2007-09-14,2007,0,0,0,0.877038
19419,Screwed,2000-05-12,2000,0,0,0,5.166155
19422,Lost in Austen,2008-01-01,2008,0,0,0,2.30886
19423,Going the Distance,2004-08-19,2004,0,0,0,2.554238
19425,The Peanut Butter Solution,1985-12-05,1985,0,0,0,0.797308
19426,Nights of Cabiria,1957-10-03,1957,0,752045,752045,6.587353
19429,Absence of Malice,1981-12-18,1981,12000000,40716963,28716963,3.21594
19430,08/15,1954-09-30,1954,0,0,0,0.628127
19433,Revolution OS,2001-01-01,2001,0,0,0,3.14531
19434,Murder in Coweta County,1983-02-15,1983,0,0,0,0.670724
19444,Bad Karma,1991-01-01,1991,0,0,0,0.00068
19445,Placebo: Soulmates Never Die: Live in Paris 2003,2003-10-18,2003,0,0,0,0.403918
19446,One Six Right,2005-11-25,2005,0,0,0,0.663193
19448,The Laramie Project,2002-01-10,2002,0,0,0,2.261527
19457,The Yards,2000-04-27,2000,0,0,0,11.162383
19458,Princess Protection Program,2009-06-18,2009,0,0,0,5.626141
19459,Tribulation 99: Alien Anomalies Under America,1992-04-27,1992,0,0,0,0.107164
19460,Son of the Bride,2001-08-16,2001,0,0,0,3.319598
19463,The Canterville Ghost,1944-07-28,1944,0,0,0,1.300589
19482,My Dear Enemy,2008-09-24,2008,0,0,0,1.595804
19483,It Came from Outer Space,1953-05-26,1953,0,0,0,7.749114
19486,Cyborg She,2008-05-31,2008,8500000,0,-8500000,2.781309
19489,Held Up,1999-10-08,1999,0,0,0,2.387117
19490,The Bishop's Wife,1947-12-09,1947,0,0,0,4.645121
19492,Captain EO,1986-01-01,1986,0,0,0,3.716093
19493,Hornblower: The Even Chance,1998-10-07,1998,0,0,0,2.023147
19494,Nine to Five,1980-12-18,1980,0,0,0,15.458258
19495,Nomad: The Warrior,2005-07-17,2005,25000000,0,-25000000,8.762777
19496,Salem Witch Trials,2002-01-01,2002,0,0,0,1.029574
19499,Jimmy Carr: Stand Up,2005-01-01,2005,0,0,0,0.638918
19501,April Showers,2009-04-18,2009,0,0,0,0.687802
19505,Hendrix,2000-09-17,2000,0,0,0,0.923745
19506,ICHI,2008-10-25,2008,0,0,0,4.404908
19507,Neighbors,1981-12-18,1981,8500000,29916207,21416207,3.950775
19508,Garfield's Pet Force,2009-08-05,2009,0,0,0,4.816294
19509,All The Days Before Tomorrow,2007-04-01,2007,0,0,0,0.348432
19513,Series 7: The Contenders,2001-01-20,2001,0,0,0,1.63465
19525,It Happened in Brooklyn,1947-04-07,1947,0,0,0,0.765129
19528,Invisible Target,2007-01-01,2007,0,0,0,2.497472
19542,The Red Shoes,1948-07-20,1948,500000,0,-500000,10.44551
19543,Anacondas: Trail of Blood,2009-02-27,2009,0,0,0,3.167031
19545,Invasion of Astro-Monster,1965-12-19,1965,0,0,0,2.816293
19548,Le Grand Restaurant,1966-01-01,1966,0,0,0,4.271086
19551,Shadow Puppets,2007-04-16,2007,2000000,0,-2000000,1.443434
19552,The Scent of Green Papaya,1993-06-08,1993,0,0,0,3.481652
19553,Lifepod,1993-06-28,1993,0,0,0,1.672776
19554,Elvis and Anabelle,2007-03-10,2007,0,0,0,2.644962
19555,9 Dead Gay Guys,2003-09-19,2003,0,0,0,1.055872
19556,Miss March,2009-03-13,2009,0,0,0,8.397892
19560,Taken in Broad Daylight,2009-02-15,2009,0,0,0,1.789607
19562,The Magnificent One,1973-11-23,1973,0,0,0,3.206246
19566,Autism: The Musical,2007-01-01,2007,0,0,0,0.366348
19568,Airspeed,1998-08-18,1998,0,0,0,0.506837
19575,Bob Funk,2009-03-20,2009,0,0,0,1.886755
19580,The Dukes of Hazzard: The Beginning,2007-03-04,2007,0,0,0,3.479526
19582,Sherman's Way,2008-02-29,2008,0,0,0,0.901498
19583,Fierce People,2005-01-01,2005,0,0,0,8.695263
19585,G-Force,2009-07-21,2009,150000000,292817841,142817841,9.163791
19587,The Education of Charlie Banks,2007-01-01,2007,0,0,0,2.340454
19590,By the Light of the Silvery Moon,1953-03-26,1953,0,0,0,0.239039
19592,Dead Birds,2004-01-01,2004,1500000,0,-1500000,7.774208
19593,The Death of the Incredible Hulk,1990-02-18,1990,0,0,0,4.541138
19594,Bartok the Magnificent,1999-11-15,1999,0,0,0,4.28423
19596,Electric Dreams,1984-07-20,1984,0,0,0,4.094509
19597,The Hedgehog,2009-07-03,2009,0,0,0,7.943677
19598,Leaving Barstow,2008-04-29,2008,0,0,0,0.134579
19599,Book of Blood,2009-03-07,2009,0,0,0,6.152506
19600,Bossa Nova,2000-01-01,2000,0,0,0,0.577044
19601,Bent,1997-11-26,1997,0,0,0,3.546605
19604,Decampitated,1998-01-01,1998,0,0,0,0.340446
19606,High Road to China,1983-03-18,1983,0,28400000,28400000,2.738
19610,A Star Is Born,1976-12-16,1976,6000000,161000000,155000000,2.447359
19611,Connected,2008-09-25,2008,5750000,0,-5750000,2.989962
19614,Fade to Black,2004-11-05,2004,0,0,0,1.186847
19616,New York,2009-06-26,2009,0,0,0,2.431428
19618,Crime Wave,1954-01-12,1954,0,0,0,3.2125
19620,Bluffmaster!,2005-01-01,2005,1823152,7133082,5309930,1.12908
19621,The Hit,1984-09-12,1984,0,0,0,3.729553
19623,Drona,2008-10-02,2008,15000000,3250000,-11750000,0.758985
19624,Fashion,2008-10-29,2008,5000000,0,-5000000,1.671997
19625,Munna Bhai M.B.B.S.,2003-12-19,2003,0,0,0,2.794501
19629,Red Doors,2005-04-22,2005,0,0,0,1.38669
19636,Garam Masala,2005-11-03,2005,0,0,0,1.133285
19637,Chup Chup Ke,2006-06-09,2006,0,0,0,1.129278
19644,Silmido,2003-12-24,2003,8000000,0,-8000000,1.746498
19654,The Man I Love,1997-12-05,1997,0,0,0,0.322959
19657,Baazigar,1993-11-12,1993,0,0,0,3.064874
19658,Race,2008-03-20,2008,0,0,0,2.337689
19661,Mirage,1965-10-29,1965,0,0,0,7.259158
19662,The World of Henry Orient,1964-03-19,1964,0,0,0,1.762156
19664,The Sea Wolves,1980-07-03,1980,0,0,0,3.244148
19665,The Arrow,1997-01-12,1997,7800000,0,-7800000,0.573198
19666,Lagaan: Once Upon a Time in India,2001-06-15,2001,5200000,8100000,2900000,4.97451
19670,Golmaal,2006-07-14,2006,0,0,0,2.091276
19672,Rock On!!,2008-08-29,2008,0,0,0,1.250624
19673,Sexmission,1984-05-13,1984,0,0,0,3.603836
19675,Pretty Cool Too,2007-06-12,2007,0,0,0,0.88213
19676,These Girls,2005-09-10,2005,0,0,0,1.042863
19688,Middle of Nowhere,2008-09-06,2008,0,0,0,11.295267
19698,Porky's II: The Next Day,1983-06-24,1983,6500000,33759266,27259266,5.269838
19703,A Wednesday!,2008-09-05,2008,1400000,3500000,2100000,3.143929
19713,How to Be,2008-01-17,2008,500000,0,-500000,1.478869
19715,Donald in Mathmagic Land,1959-06-26,1959,0,0,0,1.525186
19719,LolliLove,2004-11-21,2004,2000,0,-2000,1.677933
19723,The League of Gentlemen's Apocalypse,2005-06-03,2005,4,0,-4,2.010946
19724,Imagine That,2009-06-19,2009,55000000,0,-55000000,6.308773
19725,Carry On Columbus,1992-10-02,1992,0,0,0,2.59193
19727,Streets of Blood,2009-07-13,2009,0,0,0,2.644888
19728,The Blue Max,1966-06-21,1966,5000000,0,-5000000,4.361613
19731,Grand Theft Auto,1977-06-16,1977,0,0,0,1.974792
19736,Baby: Secret of the Lost Legend,1985-03-22,1985,0,0,0,1.697935
19738,Revolutionary Girl Utena: The Movie,1999-08-14,1999,998000,0,-998000,2.701511
19740,The Great Waldo Pepper,1975-03-13,1975,0,20642922,20642922,5.279919
19742,Rodan,1956-12-26,1956,0,0,0,1.624159
19753,Start the Revolution Without Me,1970-08-14,1970,0,0,0,2.406178
19754,The Amy Fisher Story,1993-01-03,1993,0,0,0,1.997741
19757,Icarus XB 1,1963-07-26,1963,0,0,0,1.408341
19759,The Fabulous World of Jules Verne,1958-08-21,1958,0,0,0,1.53134
19760,Two If by Sea,1996-01-12,1996,0,0,0,2.174487
19761,Saturn 3,1980-02-15,1980,0,0,0,4.542917
19762,Son of Flubber,1963-01-16,1963,0,0,0,2.545544
19765,≈Ωelary,2003-09-04,2003,0,0,0,2.059599
19766,Inspector Gadget 2,2003-03-11,2003,12000000,0,-12000000,10.923985
19792,Firestarter 2: Rekindled,2002-03-10,2002,10000000,0,-10000000,2.581486
19794,Labor Pains,2009-07-19,2009,0,0,0,9.892713
19797,I Think I Do,1998-04-10,1998,0,344,344,1.231723
19803,Underclassman,2005-09-02,2005,0,0,0,3.902766
19809,Copper Mountain,1983-01-01,1983,0,0,0,2.089464
19812,Father of Four: Never Gives Up!,2005-01-10,2005,0,0,0,0.447242
19819,Blue Chips,1994-02-18,1994,0,0,0,6.131056
19823,Dolan's Cadillac,2009-10-23,2009,10000000,0,-10000000,3.481648
19824,Van Wilder: Freshman Year,2009-06-02,2009,0,0,0,8.30643
19827,The In-Laws,1979-06-15,1979,9000000,38200000,29200000,3.336115
19828,10 Attitudes,2001-01-01,2001,0,0,0,0.659927
19829,Ninja Cheerleaders,2008-05-10,2008,0,0,0,1.919746
19833,In the Loop,2009-01-22,2009,0,6149791,6149791,6.341259
19837,Beer Wars,2009-04-16,2009,0,0,0,0.876713
19840,"I Love You, Beth Cooper",2009-07-10,2009,18000000,15345201,-2654799,9.434281
19844,Kiss the Bride,2007-01-01,2007,0,0,0,1.78277
19846,The Interview,1998-03-03,1998,0,0,0,2.882197
19848,The Players Club,1998-04-08,1998,0,0,0,5.519679
19850,Breast Men,1997-12-13,1997,0,0,0,8.190952
19851,Grey Gardens,2009-04-18,2009,12000000,0,-12000000,2.947074
19855,The War,1994-11-04,1994,0,0,0,3.908596
19874,What Goes Up,2009-05-29,2009,0,0,0,2.471224
19877,Fist of the North Star,1986-03-08,1986,0,18000000,18000000,2.832555
19884,The Sword of Doom,1966-02-25,1966,0,0,0,2.398983
19887,Disco Dancer,1982-12-10,1982,0,0,0,1.051608
19893,Flipper,1963-08-14,1963,0,0,0,2.439867
19898,Pandorum,2009-09-08,2009,33000000,20645327,-12354673,10.391425
19899,Couples Retreat,2009-09-19,2009,70000000,171844840,101844840,15.152577
19900,Weather Girl,2009-07-10,2009,0,0,0,2.58326
19901,Daybreakers,2009-01-06,2009,20000000,51416464,31416464,10.038613
19904,The Stepfather,2009-10-16,2009,0,0,0,6.164529
19905,"The Goods: Live Hard, Sell Hard",2009-08-14,2009,10000000,0,-10000000,4.603801
19908,Zombieland,2009-10-07,2009,23600000,102391382,78791382,11.063029
19912,The Final Destination,2009-08-26,2009,40000000,186167139,146167139,8.805723
19913,(500) Days of Summer,2009-07-17,2009,7500000,60722734,53222734,16.376657
19918,Spread,2009-01-16,2009,0,12032983,12032983,11.219086
19929,9to5: Days in Porn,2008-08-24,2008,0,0,0,1.552852
19931,The Joy Luck Club,1993-09-08,1993,11000000,32861136,21861136,3.01386
19933,The Brave Little Toaster,1987-07-09,1987,2000000,0,-2000000,6.649391
19936,Hipnos,2004-10-08,2004,0,0,0,2.064359
19939,Cape No. 7,2008-08-22,2008,16000000,0,-16000000,1.461326
19946,A Man Called Blade,1977-08-13,1977,0,0,0,2.114454
19947,The Adventures of Mark Twain,1985-03-01,1985,0,849915,849915,2.03644
19950,13B: Fear Has a New Address,2009-03-06,2009,0,0,0,1.39827
19951,1920,2008-09-12,2008,0,0,0,1.183047
19952,Best Men,1997-01-01,1997,1000000,0,-1000000,6.610419
19953,The Incredible Mr. Limpet,1964-03-28,1964,0,0,0,3.37816
19955,I Do,2006-11-01,2006,0,0,0,4.314822
19957,Knights of the Round Table,1953-12-22,1953,0,0,0,4.861517
19958,The Year My Voice Broke,1987-01-01,1987,0,0,0,1.334529
19959,Surrogates,2009-09-24,2009,80000000,122444772,42444772,16.211937
19961,Stormy Night,2005-12-10,2005,0,0,0,1.938963
19962,Mike Bassett: England Manager,2001-09-28,2001,0,0,0,1.659274
19963,Bernie,1996-11-27,1996,0,0,0,3.144046
19965,Loggerheads,2005-10-14,2005,0,0,0,1.92853
19968,No Time For Sergeants,1958-01-01,1958,0,0,0,1.306304
19969,Skeleton Crew,2009-01-01,2009,0,0,0,0.980721
19971,The Little Girl Who Lives Down the Lane,1976-12-25,1976,0,0,0,7.717337
19972,The 300 Spartans,1962-08-01,1962,0,0,0,6.734287
19973,Comedian,2002-10-25,2002,0,2744253,2744253,7.938629
19974,The Big Clock,1948-04-09,1948,0,0,0,2.583556
19975,Care Bears Movie II: A New Generation,1986-03-21,1986,0,0,0,2.508783
19976,The Exterminating Angels,2006-09-13,2006,0,0,0,2.771957
19978,Anniyan,2005-06-17,2005,0,8500000,8500000,1.532894
19980,99,2009-05-15,2009,3000000,6600000,3600000,0.328668
19989,Aces 'N' Eights,2008-03-15,2008,0,0,0,1.61646
19993,George Lopez: America's Mexican,2007-02-24,2007,0,0,0,0.534723
19994,Jennifer's Body,2009-09-18,2009,16000000,31556061,15556061,13.483131
19995,Avatar,2009-12-10,2009,237000000,2787965087,2550965087,185.070892
19996,Brother's War,2009-05-26,2009,0,0,0,0.741591
19997,Niagara,1953-01-26,1953,1250000,8500000,7250000,14.605464
19998,The Big Steal,1949-07-09,1949,0,0,0,2.703354
19999,Forgiving Dr. Mengele,2006-02-24,2006,0,0,0,0.090293
20000,Somewhere in the Night,1946-06-12,1946,0,0,0,1.194854
20002,Chandni Chowk To China,2009-01-16,2009,10500000,9400000,-1100000,1.970481
20003,House of Strangers,1949-07-01,1949,0,0,0,1.58585
20004,Epoch,2001-11-24,2001,0,0,0,6.421741
20006,Pink Cadillac,1989-05-26,1989,0,0,0,5.794189
20007,The Bugs Bunny/Road Runner Movie,1979-09-30,1979,0,0,0,2.684017
20009,Slackers,2002-02-01,2002,14000000,6413915,-7586085,8.559189
20012,The Void,2001-01-01,2001,0,0,0,2.421893
20015,KM 31: Kilometer 31,2006-10-19,2006,0,0,0,1.701171
20016,Trailer Park of Terror,2008-10-21,2008,0,0,0,1.728538
20017,Wrong Move,1975-01-01,1975,0,0,0,1.588197
20021,The King,2005-01-01,2005,0,0,0,1.233312
20024,The End of the Affair,1999-12-03,1999,23000000,10827816,-12172184,6.200344
20025,Thieves' Highway,1949-10-10,1949,0,0,0,5.44131
20027,Delhi-6,2009-02-20,2009,0,8250000,8250000,1.44792
20028,Decoy,1946-09-14,1946,0,0,0,0.281682
20032,Robot Stories,2003-01-01,2003,0,0,0,1.097132
20033,Mulligans,2008-01-01,2008,0,0,0,1.631885
20034,Hush,2008-08-13,2008,0,0,0,2.847024
20036,The Prince & Me: A Royal Honeymoon,2008-10-28,2008,0,0,0,5.541859
20043,Royal Space Force - The Wings Of Honneamise,1987-03-14,1987,8000000,0,-8000000,2.988405
20044,"Hard Revenge, Milly",2008-08-09,2008,0,0,0,0.71776
20047,The Steam Experiment,2009-03-01,2009,0,0,0,1.779516
20048,Confessions of a Shopaholic,2009-02-05,2009,40000000,108332743,68332743,8.198789
20049,Ayan,2009-04-03,2009,3230939,18000000,14769061,1.937874
20051,Dad's Army,1971-03-12,1971,0,0,0,4.14241
20053,Dead Heat,2002-07-23,2002,0,0,0,1.377516
20055,The Betrayed,2008-09-27,2008,3500000,0,-3500000,1.668857
20064,Little Boy Blue,1997-06-01,1997,0,0,0,1.40335
20065,Purple Violets,2007-04-30,2007,4000000,0,-4000000,2.266369
20066,Senior Skip Day,2008-05-06,2008,0,0,0,3.280158
20067,Things You Can Tell Just by Looking at Her,1999-10-28,1999,0,0,0,4.166882
20069,Manual of Love 2,2007-01-01,2007,0,0,0,8.663872
20071,Pagafantas,2009-07-02,2009,0,2012927,2012927,0.82522
20072,Agathe Cl√©ry,2008-11-11,2008,0,0,0,3.074809
20075,Nice Dreams,1981-07-24,1981,0,0,0,11.389252
20077,Batman vs Dracula,2005-10-18,2005,0,0,0,8.393194
20083,Shinjuku Incident,2009-03-22,2009,15000000,0,-15000000,4.382125
20088,Kon-Tiki,1950-01-12,1950,0,0,0,1.006239
20089,Twilight of the Dark Master,1998-01-21,1998,0,0,0,0.29325
20092,Corporate,2006-07-07,2006,0,0,0,0.737303
20096,The Butcher's Wife,1991-10-25,1991,0,0,0,6.825983
20105,The Story of the Kelly Gang,1906-12-26,1906,0,0,0,0.290549
20106,Mais qui a tu√© Pamela Rose ?,2003-06-04,2003,0,0,0,3.065777
20107,Bart Got a Room,2008-04-25,2008,2000000,0,-2000000,11.561666
20108,Au Hasard Balthazar,1966-05-25,1966,0,39388,39388,4.530601
20110,Ashes and Snow,2005-03-05,2005,0,0,0,0.744671
20115,Opera,1987-12-19,1987,8000000,0,-8000000,7.448046
20120,Bill Cosby: Himself,1983-05-20,1983,0,0,0,1.039767
20121,Killdozer,1974-02-02,1974,0,0,0,1.642658
20122,Damnation,1988-10-20,1988,0,0,0,1.489647
20123,Time of the Gypsies,1988-12-21,1988,0,0,0,5.443964
20126,Deep Red,1975-03-07,1975,0,0,0,8.543908
20127,It Should Happen to You,1954-01-18,1954,0,0,0,3.883222
20128,Life Is a Miracle,2004-05-14,2004,8000000,0,-8000000,2.287296
20132,Kaal,2005-04-29,2005,0,0,0,0.695019
20139,The Children's Hour,1961-01-01,1961,0,0,0,7.591269
20145,36 China Town,2006-05-05,2006,0,0,0,1.029823
20147,Dave Chappelle: For What it's Worth,2004-09-04,2004,0,0,0,1.930293
20148,Cowboys & Angels,2003-05-14,2003,2000000,33700,-1966300,1.188935
20152,Angels of the Universe,2000-01-01,2000,0,0,0,1.687025
20153,Where Danger Lives,1950-07-14,1950,0,0,0,1.624031
20156,Exotica,1994-09-24,1994,0,0,0,5.378467
20158,Ganes,2007-09-28,2007,0,0,0,0.671229
20160,Restless,2000-01-28,2000,0,0,0,1.744298
20162,Addiction - When Nothing Is Enough,2004-01-16,2004,0,0,0,3.103836
20163,Man's Job,2007-02-23,2007,0,0,0,0.845714
20164,Bad Boys,2003-01-17,2003,0,0,0,2.72426
20171,Paraiso Travel,2009-07-10,2009,0,0,0,1.070242
20173,The Barefoot Executive,1971-03-17,1971,0,0,0,0.914294
20174,The Fast and the Furious,1955-02-15,1955,66000,250000,184000,1.114697
20177,Super Capers,2009-01-01,2009,0,30955,30955,1.221836
20178,World's Greatest Dad,2009-08-20,2009,10000000,295750,-9704250,5.431657
20181,Tunnel Rats,2008-05-31,2008,8000000,0,-8000000,3.092242
20182,Alien Abduction: Incident in Lake County,1998-01-20,1998,0,0,0,3.726699
20183,"Puff, the Magic Dragon",1978-10-30,1978,0,0,0,0.635137
20186,Better Things,2008-05-17,2008,0,0,0,0.839591
20187,The Eiger Sanction,1975-05-21,1975,0,14200000,14200000,5.47591
20196,Mac and Me,1988-08-12,1988,0,5935269,5935269,4.433298
20197,Things Are Tough All Over,1982-08-04,1982,0,21134374,21134374,9.442756
20200,Narco,2004-12-01,2004,823258,823258,0,4.584117
20205,Transmorphers Fall of Man,2009-06-30,2009,0,0,0,1.716174
20210,Grind,2003-08-15,2003,0,0,0,2.638079
20211,Robin Williams: Live on Broadway,2002-07-14,2002,0,0,0,5.372191
20213,The Manxman,1929-01-21,1929,0,0,0,1.680545
20216,Cookers,2001-04-23,2001,0,0,0,0.92956
20220,1001 Nights,1990-04-11,1990,0,0,0,1.22292
20221,El rey de los huevones,2006-08-31,2006,0,0,0,0.041184
20223,Bad Girls,2007-03-09,2007,0,0,0,2.016527
20224,Remember the Daze,2007-06-10,2007,0,0,0,1.448735
20226,Love Belongs to Everyone,2006-02-08,2006,0,0,0,0.139111
20227,Michael Jackson Dangerous Tour - Bucharest - 1992,1992-10-01,1992,0,0,0,0.646327
20236,Direct Contact,2009-04-16,2009,6000000,0,-6000000,6.078318
20238,The Shakiest Gun in the West,1968-07-10,1968,0,0,0,1.053244
20239,Fear of a Black Hat,1994-10-28,1994,0,0,0,0.985441
20242,Outrageous Fortune,1987-01-30,1987,0,0,0,2.362974
20246,The Stranger,1946-05-25,1946,0,0,0,6.749799
20263,An American Affair,2008-11-27,2008,0,0,0,2.307534
20268,Last Stop 174,2008-10-24,2008,4700000,0,-4700000,2.813715
20270,The Prodigy,2005-01-01,2005,0,0,0,0.626723
20271,Divorce Italian Style,1961-12-20,1961,0,0,0,3.279671
20277,The Ugly Dachshund,1966-02-16,1966,0,0,0,2.159291
20278,Africa Screams,1949-05-04,1949,0,0,0,5.021009
20283,Breaking Away,1979-05-24,1979,2300000,20000000,17700000,4.806374
20287,Extreme Prejudice,1987-04-24,1987,0,0,0,6.407061
20289,Rush,1991-12-22,1991,0,0,0,10.584954
20294,Welcome,2007-12-21,2007,0,36500000,36500000,1.520963
20296,Chocolate: Deep Dark Secrets,2005-09-16,2005,0,0,0,0.992054
20298,Black Angel,1946-08-02,1946,0,0,0,7.74492
20301,Daisy Kenyon,1947-12-25,1947,0,0,0,0.910004
20302,A Life Apart: Hasidism in America,1998-08-25,1998,0,0,0,0.496541
20303,Life and Debt,2003-02-28,2003,0,0,0,0.250317
20304,Never Die Alone,2004-03-26,2004,3000000,5923000,2923000,6.212433
20305,Nukes in Space,1999-01-01,1999,0,0,0,0.336895
20306,Swimming with Sharks,1994-09-10,1994,0,0,0,5.869261
20307,Renegades,1989-06-02,1989,0,0,0,1.806334
20308,Stephanie Daley,2006-01-21,2006,0,0,0,6.196999
20309,Say It Isn't So,2001-03-12,2001,25000000,0,-25000000,3.65507
20310,Time Share,2000-01-01,2000,0,0,0,0.883355
20311,Love the Beast,2009-03-12,2009,0,0,0,1.12405
20312,Interstate 60,2002-04-13,2002,7000000,0,-7000000,7.335241
20316,The City of No Limits,2002-03-01,2002,0,0,0,2.268551
20318,Mother Night,1996-11-01,1996,0,0,0,6.038784
20321,Close Your Eyes,2002-02-01,2002,0,0,0,6.327386
20322,The Brothers,2001-03-23,2001,0,0,0,5.028944
20323,Long Weekend,2009-08-14,2009,0,0,0,4.267304
20324,The Importance of Being Earnest,1952-06-02,1952,0,0,0,2.328043
20325,Swing Time,1936-08-27,1936,886000,2600000,1714000,6.507597
20329,L: Change the World,2008-01-31,2008,0,30231200,30231200,8.271179
20330,Beyond a Reasonable Doubt,1956-09-05,1956,0,0,0,1.609677
20332,"Russell Peters: Red, White and Brown",2008-10-07,2008,0,0,0,1.274233
20333,The Last Outlaw,1993-10-30,1993,0,0,0,2.645295
20334,The Shop Around the Corner,1940-01-11,1940,0,0,0,7.144236
20337,Martin Lawrence Live: Runteldat,2002-08-01,2002,3000000,19184015,16184015,0.527297
20339,Splitting Heirs,1993-04-02,1993,0,3200000,3200000,3.27076
20342,Secret,2007-07-27,2007,0,0,0,4.235841
20343,Make Mine Music,1946-04-26,1946,68,0,-68,5.788405
20345,The Bird with the Crystal Plumage,1970-02-19,1970,500000,0,-500000,5.078021
20347,Takeshis',2005-09-02,2005,0,0,0,6.535144
20348,Fandango,1985-01-25,1985,0,0,0,11.350645
20352,Despicable Me,2010-07-08,2010,69000000,543513985,474513985,22.274502
20357,Trauma,2004-09-17,2004,0,0,0,5.221661
20359,Phir Hera Pheri,2006-06-09,2006,0,0,0,1.371231
20360,Namastey London,2007-03-27,2007,0,0,0,1.703963
20361,Cemetery Without Crosses,1969-01-25,1969,0,0,0,1.230823
20362,Cry of the City,1948-09-29,1948,0,0,0,1.548359
20363,The Pee-wee Herman Show,1981-01-01,1981,0,0,0,0.90922
20364,Hulchul,2004-11-26,2004,0,0,0,0.969653
20367,Detour,1945-11-30,1945,30,0,-30,3.392467
20372,Nine Lives,1957-11-11,1957,0,0,0,1.252216
20375,Raid,2003-01-31,2003,2000000,0,-2000000,0.366841
20377,The Brave Little Toaster Goes to Mars,1998-05-19,1998,0,0,0,1.614156
20378,The Brave Little Toaster to the Rescue,1997-11-01,1997,0,0,0,2.799264
20379,Grand Prix,1966-12-21,1966,0,0,0,10.75236
20381,The Hitcher II: I've Been Waiting,2003-07-15,2003,0,0,0,3.617635
20382,Visioneers,2008-06-12,2008,0,0,0,1.623658
20388,De Indringer,2005-03-16,2005,0,0,0,0.748143
20389,The Escape,2009-01-09,2009,0,0,0,0.734874
20390,No Entry,2005-08-26,2005,0,0,0,1.382637
20391,Paint Your Wagon,1969-10-15,1969,20000000,31678778,11678778,10.648872
20405,Puccini for Beginners,2006-01-01,2006,0,89417,89417,1.610123
20406,Rockaway,2007-07-07,2007,0,0,0,0.098675
20407,The Answer Man,2009-01-18,2009,0,0,0,6.39166
20408,Terror by Night,1946-02-01,1946,0,0,0,4.660762
20410,Scooby-Doo and the Alien Invaders,2000-01-01,2000,0,0,0,2.702528
20411,Until Death,2007-01-19,2007,10000000,0,-10000000,8.628157
20413,Dhamaal,2007-09-07,2007,0,0,0,1.342057
20414,"Grande, grosso e Verdone",2008-03-07,2008,0,0,0,4.309426
20416,The Deep,1977-06-17,1977,0,0,0,10.507151
20417,Dressed to Kill,1946-06-07,1946,0,0,0,5.995438
20421,Rock-A-Doodle,1991-08-02,1991,18000000,11657385,-6342615,3.602031
20423,For All Mankind,1989-01-01,1989,0,770132,770132,3.216292
20424,Invaders from Mars,1953-04-22,1953,0,0,0,3.262443
20430,Meet Market,2004-01-29,2004,0,0,0,0.082397
20431,Sakuran,2007-02-24,2007,0,0,0,1.349005
20432,The Forgotten Ones,2008-11-08,2008,0,0,0,2.282379
20435,Death Train,1993-04-14,1993,0,0,0,12.895711
20436,First Descent,2005-12-02,2005,0,739690,739690,0.226138
20438,The Tao of Steve,2000-08-04,2000,0,0,0,2.272983
20439,The Anarchist Cookbook,2002-06-06,2002,0,0,0,1.02291
20441,The Messengers 2: The Scarecrow,2009-07-21,2009,0,0,0,4.171674
20442,The Naked Spur,1953-02-06,1953,0,0,0,3.184967
20443,Johnny Be Good,1988-03-22,1988,0,0,0,3.007873
20444,The Out of Towners,1970-05-28,1970,0,0,0,1.945528
20449,The Ghost,2008-11-13,2008,3000000,0,-3000000,1.716775
20453,3 Idiots,2009-12-23,2009,9000000,70000000,61000000,7.675621
20454,Dil Dosti Etc,2007-09-28,2007,0,0,0,0.074111
20455,Digimon: The Movie,2000-03-17,2000,5500000,0,-5500000,5.300501
20457,The Matchmaker,1997-10-03,1997,0,0,0,3.742915
20458,Headhunter,2009-08-28,2009,0,0,0,0.973991
20465,StageFright: Aquarius,1987-02-08,1987,1000000,0,-1000000,2.776386
20468,The Big Tease,1999-01-01,1999,0,0,0,1.116821
20471,The Mysteries of Pittsburgh,2008-01-20,2008,0,0,0,5.910208
20472,Saturday the 14th,1981-10-30,1981,0,0,0,0.85835
20473,Not Quite Human,1987-06-19,1987,0,0,0,0.880956
20478,Normal Adolescent Behavior,2007-04-27,2007,0,0,0,1.173129
20481,Nightbreed,1990-02-16,1990,11000000,8862354,-2137646,6.372135
20482,The Naked City,1948-03-04,1948,0,0,0,3.826672
20483,Catch That Kid,2004-02-06,2004,18000000,16702864,-1297136,5.226389
20493,Love Story 2050,2008-07-04,2008,20000000,5000000,-15000000,0.304988
20494,Malamaal Weekly,2006-03-10,2006,0,204,204,1.479018
20495,Mujhse Shaadi Karogi,2004-07-30,2004,0,0,0,1.898123
20497,Ballet Shoes,2008-08-26,2008,0,0,0,5.828623
20499,The Cutter,2005-11-21,2005,6000000,0,-6000000,4.421468
20502,The Life,2004-04-16,2004,0,0,0,2.011938
20504,The Book of Eli,2010-01-14,2010,80000000,157107755,77107755,14.39853
20506,The Eel,1997-05-12,1997,0,0,0,1.094509
20507,Agyaat,2009-08-07,2009,0,0,0,0.118962
20511,Chronicles,2004-05-16,2004,0,299261,299261,7.490741
20513,Dakota Skye,2008-01-01,2008,0,0,0,0.985408
20520,The Motel,2005-01-01,2005,0,0,0,0.275344
20521,Reefer Madness: The Movie Musical,2005-04-16,2005,0,0,0,6.004782
20525,Hana,2006-06-02,2006,0,0,0,1.51898
20526,TRON: Legacy,2010-12-10,2010,170000000,400062763,230062763,21.259
20527,Love and Honor,2006-12-01,2006,0,0,0,2.187385
20528,The Ambush: Incident at Blood Pass,1970-12-18,1970,0,0,0,1.424191
20529,Sita Sings the Blues,2008-02-11,2008,0,0,0,1.711226
20530,Late Spring,1949-09-13,1949,0,0,0,5.306325
20531,Early Spring,1956-01-29,1956,0,0,0,1.096517
20532,Sansho the Bailiff,1954-03-31,1954,0,0,0,5.104286
20533,Jonah Hex,2010-06-18,2010,47000000,10539000,-36461000,9.482806
20534,Murder,2004-04-02,2004,0,0,0,0.387378
20536,61*,2001-04-28,2001,0,0,0,2.07709
20537,Caravaggio,1986-08-29,1986,0,0,0,2.88364
20539,The Crucible,1996-11-27,1996,25000000,0,-25000000,9.412825
20540,The Pawnbroker,1965-04-20,1965,500000,0,-500000,2.58471
20542,Delgo,2008-12-12,2008,40000000,0,-40000000,2.915814
20543,Steven Wright: When the Leaves Blow Away,2006-10-21,2006,0,0,0,0.423153
20544,Something the Lord Made,2004-05-30,2004,0,0,0,3.260102
20545,Deal of the Century,1983-11-04,1983,0,0,0,2.403016
20546,Goodnight Mister Tom,1998-10-24,1998,0,0,0,1.379679
20548,The Home of Dark Butterflies,2008-01-10,2008,0,0,0,0.350875
20551,Ernest Goes to School,1994-12-14,1994,0,0,0,1.229301
20553,21 Up,1977-01-01,1977,0,0,0,1.554186
20556,Let It Be,1970-05-13,1970,0,0,0,2.494236
20558,Scooby-Doo! in Where's My Mummy?,2005-11-24,2005,0,0,0,4.774371
20561,28 Up,1984-11-20,1984,0,0,0,0.018017
20562,35 Up,1991-08-29,1991,0,0,0,0.930397
20564,Nearing Grace,2005-06-18,2005,0,0,0,1.106661
20565,42 Up,1998-07-28,1998,0,0,0,0.697268
20567,Sex and Fury,1973-02-17,1973,0,0,0,2.647596
20583,Love's Long Journey,2005-12-03,2005,0,0,0,1.287226
20591,Cradle of Fear,2001-07-04,2001,0,0,0,1.44886
20595,The Last Days,1998-10-23,1998,0,0,0,1.380947
20604,Metal: A Headbanger's Journey,2005-09-14,2005,0,0,0,1.905009
20605,The City of Violence,2006-05-25,2006,2700000,0,-2700000,8.907871
20606,Doghouse,2009-06-11,2009,0,0,0,6.715813
20607,"Dawn Breaks, Which Is No Small Thing",1989-01-17,1989,0,0,0,1.197692
20616,Swimfan,2002-09-06,2002,8500000,34411240,25911240,8.421411
20618,Road Trip: Beer Pong,2009-08-11,2009,0,0,0,4.004323
20620,Seconds,1966-10-05,1966,0,0,0,6.097929
20622,Padosan,1968-11-29,1968,0,0,0,0.236517
20623,Page 3,2005-01-21,2005,0,0,0,0.684585
20625,The Cocoanuts,1929-08-03,1929,0,0,0,1.242836
20626,Special Correspondents,2009-01-21,2009,0,0,0,2.375541
20628,Skin Game,1971-09-30,1971,0,0,0,1.811978
20629,Lemonade Joe,1964-10-16,1964,0,0,0,1.112431
20637,Panic,2000-12-01,2000,1000000,779137,-220863,7.554807
20638,Yellow Sky,1948-12-24,1948,0,0,0,2.874471
20639,Gus,1976-07-07,1976,0,0,0,1.095507
20640,Woman of the Year,1942-01-19,1942,3000000,0,-3000000,2.83303
20641,Love's Enduring Promise,2004-11-20,2004,0,0,0,1.934935
20642,Double Wedding,1937-10-15,1937,0,0,0,0.233653
20643,I Love You Again,1940-08-09,1940,0,0,0,1.46809
20644,Love Crazy,1941-05-23,1941,0,0,0,1.175665
20645,Rhapsody in August,1991-05-25,1991,0,0,0,3.659999
20646,Graveyard of Honor,2002-06-22,2002,0,0,0,1.955441
20648,100 Women,2002-10-18,2002,0,0,0,1.020766
20649,Clockers,1995-09-15,1995,25000000,13071518,-11928482,4.558992
20650,The Sealed Room,1909-09-02,1909,0,0,0,0.22511
20651,Parineeta,2005-06-10,2005,6250000,0,-6250000,1.361436
20656,Saathiya,2002-12-20,2002,0,0,0,1.492941
20661,Twist and Shout,1984-12-26,1984,0,0,0,1.491174
20662,Robin Hood,2010-05-12,2010,200000000,310669540,110669540,10.56812
20663,Dead Reckoning,1947-01-16,1947,0,0,0,6.848208
20668,Daltry Calhoun,2005-09-25,2005,3000000,0,-3000000,1.571192
20674,By Dawn's Early Light,1990-05-19,1990,0,0,0,6.6716
20675,The Beast of the City,1932-02-13,1932,0,0,0,0.7958
20676,Deep Cover,1992-04-15,1992,0,0,0,3.573392
20678,Blankman,1994-08-19,1994,0,0,0,2.057471
20679,George Carlin: Complaints & Grievances,2001-11-17,2001,0,0,0,1.03164
20681,The Dogs of War,1980-12-17,1980,0,0,0,3.99897
20682,Chain of Fools,2000-09-22,2000,20000000,0,-20000000,2.241861
20683,Pale Cocoon,2006-01-18,2006,0,0,0,1.437723
20684,Preaching to the Perverted,1997-07-04,1997,0,0,0,1.25361
20688,Kaminey,2009-08-14,2009,9000000,18130000,9130000,2.089842
20689,The Dancer Upstairs,2002-09-20,2002,0,0,0,1.303136
20693,Santos,2008-10-10,2008,0,0,0,0.153135
20694,Rugrats Go Wild,2003-06-13,2003,0,0,0,9.599034
20695,Blessed,2004-05-16,2004,0,0,0,2.369185
20697,Ready to Rumble,2000-04-07,2000,24000000,12372410,-11627590,3.69298
20700,A Day In The Life,2009-07-07,2009,0,0,0,0.659084
20701,Tales from the Darkside: The Movie,1990-05-03,1990,3500000,16324573,12824573,5.732016
20704,Necessary Roughness,1991-09-27,1991,0,0,0,9.626033
20712,Whore,1991-06-21,1991,0,1008404,1008404,6.404093
20713,Farewell to the King,1989-03-03,1989,16000000,2420917,-13579083,1.629224
20714,12,2007-06-06,2007,4000000,7537453,3537453,6.975759
20715,Immigrants (L.A. Dolce Vita),2008-10-30,2008,0,0,0,1.019084
20718,I'm with Lucy,2002-09-04,2002,0,0,0,7.270805
20719,Day of the Wacko,2002-07-07,2002,0,0,0,2.699622
20720,Gabriel Iglesias: Hot and Fluffy,2007-08-04,2007,0,0,0,3.394396
20721,Code of Silence,1985-05-03,1985,0,20345361,20345361,5.132151
20722,The House of Small Cubes,2008-07-08,2008,0,0,0,4.560544
20723,That Darn Cat!,1965-12-02,1965,0,0,0,2.803679
20726,Little Giants,1994-10-14,1994,0,0,0,5.045874
20731,Raaz,2002-02-01,2002,0,0,0,0.521858
20735,That Darn Cat,1997-02-14,1997,0,0,0,1.496999
20737,Air Bud,1997-08-01,1997,3000000,23144499,20144499,9.407128
20742,Shootout at Lokhandwala,2007-05-25,2007,11000000,12000000,1000000,1.3666
20755,Air Bud 3: World Pup,2001-06-29,2001,0,0,0,7.584444
20756,The Secret of NIMH 2: Timmy to the Rescue,1998-12-22,1998,0,0,0,2.34262
20758,Father of the Bride,1950-06-16,1950,0,0,0,2.469167
20759,The Great White Hype,1996-05-03,1996,0,0,0,3.321765
20760,Lilo & Stitch 2: Stitch has a Glitch,2005-01-29,2005,0,0,0,10.971661
20761,Play It to the Bone,1999-12-25,1999,24000000,8434146,-15565854,4.347609
20762,The Substitute,1996-04-19,1996,0,0,0,10.68537
20763,Radio Flyer,1992-02-21,1992,35000000,4651977,-30348023,5.618237
20764,Sleep Dealer,2008-12-10,2008,2500000,107559,-2392441,3.750365
20766,The Road,2009-11-25,2009,32000000,27635305,-4364695,14.958098
20769,Chandni Bar,2001-09-28,2001,0,0,0,0.377007
20770,But I'm a Cheerleader,1999-09-12,1999,1200000,2600000,1400000,4.928139
20776,Return to the Batcave: The Misadventures of Adam and Burt,2003-03-09,2003,0,0,0,1.348822
20777,The Killing Room,2009-01-16,2009,0,0,0,6.358789
20778,Le Doulos,1963-01-18,1963,0,0,0,2.401164
20781,Angel of Death,2009-07-07,2009,0,0,0,1.938244
20782,Road of No Return,2008-11-10,2008,0,0,0,1.473572
20784,Charles Darwin and the Tree of Life,2009-02-01,2009,0,0,0,0.662785
20785,Emmet Otter's Jug-Band Christmas,1977-12-17,1977,0,0,0,1.359057
20787,The Man Who Saves The World,1982-11-04,1982,0,0,0,1.125238
20789,The Flyboys,2008-08-15,2008,0,0,0,1.668128
20794,Novocaine,2001-11-23,2001,6000000,2025238,-3974762,3.916221
20802,Freebie and the Bean,1974-12-25,1974,0,0,0,2.254126
20803,Ivan Vasilyevich Changes His Profession,1973-09-17,1973,0,0,0,4.700685
20806,Yield to the Night,1956-06-19,1956,0,0,0,1.038506
20811,The Master,1992-05-29,1992,0,8096542,8096542,13.313825
20813,A Little Romance,1979-04-27,1979,0,0,0,3.568628
20815,The Handmaid's Tale,1990-03-09,1990,0,0,0,3.163613
20825,I Hate Valentine's Day,2009-06-27,2009,0,0,0,4.241465
20829,Funny People,2009-07-31,2009,75000000,61458982,-13541018,9.900376
20832,Krazzy 4,2008-04-11,2008,0,8000000,8000000,1.37762
20837,Jim Gaffigan: King Baby,2009-03-29,2009,0,0,0,1.019955
20842,Children Shouldn't Play with Dead Things,1973-02-28,1973,70000,0,-70000,1.796065
20846,Dim Sum Funeral,2008-11-01,2008,0,0,0,1.063296
20847,The Needle,1988-09-16,1988,0,0,0,0.667468
20848,The White Sun of the Desert,1970-03-30,1970,0,0,0,3.501433
20849,Possessed,1947-07-26,1947,0,0,0,3.122447
20850,Ilsa: She Wolf of the SS,1975-10-01,1975,0,0,0,4.40553
20853,Detective Story,1951-11-01,1951,0,0,0,2.475492
20856,Aliens in the Attic,2009-07-31,2009,45000000,57881056,12881056,11.618472
20857,Hardball,2001-09-14,2001,32000000,40222729,8222729,7.674549
20858,8 Million Ways to Die,1986-04-25,1986,18000000,0,-18000000,9.328747
20859,Blown Away,1993-04-01,1993,0,0,0,2.260891
20860,The Stoned Age,1994-12-05,1994,0,0,0,2.207065
20861,Tully,2000-01-01,2000,0,0,0,1.076999
20862,Smoke Signals,1998-01-16,1998,0,0,0,2.270828
20863,King of the Gypsies,1978-12-20,1978,0,0,0,3.750643
20870,Afonya,1975-10-13,1975,0,0,0,6.532578
20871,Gentlemen of Fortune,1971-12-13,1971,0,0,0,3.142233
20873,The Diamond Arm,1968-04-27,1968,0,0,0,3.212524
20874,Kin-dza-dza!,1986-12-01,1986,0,0,0,5.736763
20875,Operation Y and Other Shurik's Adventures,1965-07-23,1965,0,0,0,3.311058
20876,A Shock to the System,1990-03-23,1990,0,0,0,3.011743
20878,"Kidnapping, Caucasian Style",1967-04-03,1967,0,0,0,4.100466
20879,Wedding in Malinovka,1967-06-06,1967,0,0,0,1.151644
20880,Midnight Chronicles,2008-01-01,2008,0,0,0,0.514069
20882,Peculiarities of the National Fishing,1998-01-01,1998,0,0,0,1.740314
20883,Peculiarities of the National Hunt in the Winter,2000-01-01,2000,0,0,0,0.882049
20884,Peculiarities of the National Politics,2003-01-01,2003,0,0,0,1.866982
20885,The Republic of ShKID,1966-01-01,1966,0,0,0,0.336644
20886,"Welcome, or No Trespassing",1964-10-07,1964,0,0,0,1.609025
20891,Kingdom of Crooked Mirrors,1963-05-05,1963,0,0,0,1.22313
20893,Shadowheart,2009-08-04,2009,10000000,0,-10000000,0.819109
20894,Guest from the Future,1984-06-06,1984,0,0,0,1.717845
20898,Aladdin and His Magic Lamp,1967-12-30,1967,0,0,0,1.202725
20899,The Adventures of Buratino,1975-12-20,1975,0,0,0,1.00512
20907,Opium: Diary of a Madwoman,2007-01-01,2007,0,0,0,0.721084
20912,She Hate Me,2004-07-30,2004,8000000,365134,-7634866,5.126696
20914,My Friends,1975-06-06,1975,0,0,0,4.876771
20916,Style,2001-12-28,2001,0,0,0,0.295599
20919,The Devil's Chair,2007-09-12,2007,0,0,0,2.420788
20921,Cutie Honey,2004-05-29,2004,0,0,0,1.131061
20927,Bed of Roses,1996-01-26,1996,0,19030691,19030691,10.412194
20929,Taal,1999-08-13,1999,0,0,0,1.375513
20931,Taxi No. 9 2 11: Nau Do Gyarah,2006-02-24,2006,0,0,0,1.082981
20932,Father Frost,1964-05-05,1964,0,0,0,2.23013
20934,Barbara the Fair with the Silken Hair,1969-01-01,1969,0,0,0,0.559277
20941,Innocent Voices,2004-11-05,2004,0,837000,837000,7.559298
20942,House of Bamboo,1955-07-01,1955,0,0,0,2.839764
20943,The Ugly Truth,2009-07-24,2009,38000000,205298907,167298907,8.450799
20945,The Seventh Victim,1943-08-21,1943,0,0,0,2.411819
20946,A Tale of Lost Times,1964-01-01,1964,0,0,0,1.032041
20947,Moscow-Cassiopeia,1973-09-23,1973,0,0,0,0.446074
20949,Teens in the Universe,1975-03-25,1975,0,0,0,1.443911
20963,Elections Day,2007-01-01,2007,0,0,0,0.896702
20967,Thirty Two Short Films About Glenn Gould,1993-11-26,1993,0,0,0,0.873068
20968,Sarkar,2005-07-01,2005,1900000,5900000,4000000,2.004745
20969,The Art of Seduction,2005-12-21,2005,0,0,0,2.449703
20975,The Girls,1961-01-01,1961,0,0,0,2.499512
20977,Gas Station Queen,1962-12-09,1962,0,0,0,1.645067
20978,My Father the Hero,1991-10-23,1991,0,0,0,2.498723
20980,Liquid Sky,1982-08-01,1982,0,0,0,1.076213
20981,The Call of Cthulhu,2005-01-01,2005,50000,0,-50000,3.324295
20983,Hooking Up,2009-01-01,2009,0,0,0,1.517949
20986,Gurren Lagann The Movie: Childhood's End,2008-09-06,2008,0,0,0,3.512528
20989,18 Fingers of Death!,2006-04-11,2006,0,0,0,0.142365
20992,Brother,1997-01-01,1997,0,0,0,3.911557
20993,Brother 2,2000-01-01,2000,1500000,0,-1500000,2.131384
20994,Blind Man's Bluff,2005-05-26,2005,0,0,0,1.76146
20995,The Swimsuit Issue,2008-12-25,2008,0,0,0,0.98955
20996,Smashing Pumpkins: If All Goes Wrong,2008-11-11,2008,0,0,0,0.023065
21001,Like It Is,1998-04-17,1998,0,0,0,0.683513
21013,Kenny Begins,2009-03-25,2009,0,0,0,1.278297
21014,Keeping Up with the Steins,2006-05-12,2006,0,0,0,8.433369
21024,Roadie,1980-06-13,1980,0,0,0,1.136027
21026,The Belgrade Phantom,2009-03-27,2009,1000000,0,-1000000,0.484569
21027,Shenandoah,1965-06-03,1965,0,0,0,3.265501
21028,Moscow Does Not Believe in Tears,1980-02-11,1980,0,0,0,3.494578
21029,Revenge of the Nerds IV: Nerds In Love,1994-05-09,1994,0,0,0,2.707017
21030,Daddy's Dyin'... Who's Got the Will?,1990-05-04,1990,0,1373728,1373728,0.284911
21032,Balto,1995-12-22,1995,0,11348324,11348324,12.140733
21033,Beautiful,2009-04-27,2009,1500000,56000,-1444000,2.713961
21035,Turkish Delight,1973-02-22,1973,0,0,0,3.971566
21036,Panda! Go Panda!,1972-12-17,1972,0,0,0,2.213026
21038,Andersonville,1996-03-03,1996,0,0,0,1.911592
21039,Rogue Trader,1999-01-01,1999,0,0,0,3.280984
21040,Executive Protection,2001-08-10,2001,0,0,0,1.723103
21041,The Third Wave,2003-10-15,2003,4667404,0,-4667404,1.7972
21042,When Father Was Away on Business,1985-05-01,1985,0,0,0,2.945585
21043,The Method,2005-09-22,2005,0,0,0,3.049732
21044,Surviving Sid,2008-10-20,2008,0,0,0,6.855234
21052,Levity,2003-03-16,2003,7500000,209151,-7290849,2.400607
21055,All Over the Guy,2001-03-07,2001,0,1051948,1051948,7.332279
21056,Big Eden,2000-04-18,2000,0,512451,512451,1.629476
21057,Ocean Waves,1993-01-01,1993,0,0,0,5.114861
21058,Spring in a Small Town,1948-02-01,1948,0,0,0,0.976409
21059,Girls Will Be Girls,2003-07-05,2003,0,0,0,0.450419
21060,It's in the Water,1997-01-30,1997,0,0,0,0.666315
21062,"Ready, Steady, Charlie!",2003-09-18,2003,0,0,0,1.430701
21070,The Seventh Juror,1962-04-16,1962,0,0,0,1.632324
21072,Zero Tolerance,1999-10-29,1999,0,0,0,1.698838
21073,The Goebbels Experiment,2005-04-13,2005,0,0,0,0.752885
21074,Brick Lane,2007-11-16,2007,0,0,0,0.834664
21115,Fighter In The Wind,2004-08-12,2004,6000000,0,-6000000,2.145287
21118,Waking Up in Reno,2002-12-13,2002,0,261603,261603,3.093697
21128,One False Move,1992-05-08,1992,0,1543112,1543112,3.14325
21131,Harvie Krumpet,2003-10-23,2003,0,0,0,5.558811
21132,Monument Ave.,1998-09-25,1998,0,0,0,2.258288
21135,L'eclisse,1962-04-12,1962,0,0,0,5.6567
21136,Funky Forest: The First Contact,2005-10-25,2005,0,0,0,1.49222
21137,The Decline of Western Civilization,1981-07-01,1981,100000,0,-100000,1.54682
21138,The Sandlot: Heading Home,2007-05-01,2007,0,0,0,4.19422
21141,Simon Says,2006-01-01,2006,0,0,0,6.624127
21142,Billy Jack,1971-08-02,1971,0,0,0,2.157316
21143,The Day of the Triffids,1962-07-01,1962,750000,0,-750000,7.351703
21145,Louise-Michel,2008-09-23,2008,0,0,0,2.999862
21147,"No Deposit, No Return",1976-02-05,1976,0,0,0,1.696311
21148,Spring Break,1983-03-25,1983,0,0,0,2.031593
21153,Flock of Dodos: The Evolution-Intelligent Design Circus,2006-01-01,2006,0,0,0,0.672521
21156,Lunacy,2005-11-17,2005,0,0,0,2.365427
21159,The Last Man on Earth,1964-03-08,1964,0,0,0,4.471808
21167,S&M Judge,2009-03-11,2009,0,0,0,1.244851
21168,The Reflecting Skin,1990-08-28,1990,0,0,0,3.918167
21173,Death of a President,2006-10-27,2006,2000000,167000,-1833000,4.028906
21175,Lakshya,2004-06-18,2004,483719,0,-483719,1.608795
21176,Final,2001-06-08,2001,0,0,0,1.117728
21179,American Violet,2008-01-01,2008,0,0,0,2.030129
21181,Lucky Miles,2007-07-19,2007,0,0,0,0.214606
21182,Young @ Heart,2008-10-02,2008,0,0,0,1.582832
21183,Fluke,1995-06-02,1995,0,0,0,4.953936
21185,Vibes,1988-08-05,1988,1884000,1883811,-189,7.368928
21189,Lost in La Mancha,2002-02-11,2002,0,0,0,4.128414
21191,Sin Nombre,2009-03-20,2009,0,5101756,5101756,5.435993
21193,Carmen,1984-03-14,1984,0,0,0,1.490737
21194,Casi Divas,2008-08-21,2008,0,0,0,0.536386
21198,House of Voices,2004-06-23,2004,0,0,0,2.373442
21200,Intimate Strangers,2004-02-05,2004,0,0,0,6.91026
21202,Madame Butterfly,1995-11-22,1995,0,0,0,0.1489
21208,Orphan,2009-07-24,2009,20000000,41596251,21596251,8.730934
21210,Dil Se..,1998-08-22,1998,5200000,13000000,7800000,1.891138
21214,"One, Two, Many",2008-04-10,2008,0,0,0,0.616565
21219,Mobsters,1991-07-26,1991,23000000,20246790,-2753210,12.511561
21220,"Frank McKlusky, C.I.",2002-04-26,2002,0,0,0,0.628159
21231,Katt Williams: American Hustle,2007-01-01,2007,0,0,0,0.248574
21236,Lonely Street,2009-01-01,2009,0,0,0,1.126681
21240,Carry On Constable,1960-02-22,1960,0,0,0,4.118721
21241,Cannonball,1976-07-06,1976,780000,1500000,720000,2.096666
21242,Valdez Is Coming,1971-04-09,1971,0,0,0,3.189948
21244,Cyclomania,2001-01-01,2001,1353676,0,-1353676,0.341369
21245,Lovers & Leavers,2002-02-01,2002,0,0,0,0.152494
21246,Kids in America,2005-10-21,2005,0,0,0,2.524746
21250,Charlotte's Web 2: Wilbur's Great Adventure,2003-03-18,2003,0,0,0,1.094403
21251,Carry On England,1976-10-01,1976,0,0,0,0.846154
21252,Nil by Mouth,1997-05-08,1997,9000000,0,-9000000,3.035339
21253,Four Days in September,1997-05-01,1997,0,310724,310724,1.791965
21256,Born to Win,1971-12-01,1971,0,0,0,2.554758
21259,Testament,1983-11-04,1983,1500000,2044892,544892,8.923953
21265,Maqbool,2003-01-01,2003,0,0,0,0.714608
21266,Reptilicus,1961-02-20,1961,0,0,0,1.262936
21282,Otto er et n√¶sehorn,1983-01-01,1983,0,0,0,0.692467
21290,Strings,2004-10-24,2004,0,0,0,2.580159
21291,Dad,1989-10-27,1989,19000000,19738015,738015,2.727017
21293,Gooby,2009-04-17,2009,0,0,0,1.643226
21294,The Amateur,1981-12-11,1981,10000000,6892098,-3107902,1.701134
21295,The Honeymooners,2005-06-10,2005,27000000,0,-27000000,4.57478
21296,Kansas City Confidential,1952-11-11,1952,0,0,0,1.7951
21297,Wake Up Sid,2009-10-02,2009,3000000,11000000,8000000,1.710257
21299,Benji the Hunted,1987-06-17,1987,0,0,0,2.30019
21301,Barbershop 2:  Back in Business,2004-01-20,2004,18000000,65070412,47070412,8.353739
21309,River's Edge,1986-08-27,1986,19000000,0,-19000000,4.482439
21311,I Dreamed of Africa,2000-05-05,2000,34000000,0,-34000000,2.767134
21316,Leroy & Stitch,2006-06-23,2006,0,0,0,11.193451
21317,Paramore: The Final Riot!,2008-10-25,2008,0,0,0,0.059843
21323,More,1969-06-06,1969,0,0,0,1.340205
21325,Onmyoji: The Yin Yang Master,2001-10-06,2001,0,0,0,0.450855
21332,Quicksilver,1986-02-14,1986,0,0,0,2.732817
21334,Children of Heaven,1997-08-01,1997,180000,900000,720000,7.523517
21335,Oh! What a Lovely War,1969-03-10,1969,0,0,0,0.981738
21336,The Dark Corner,1946-04-09,1946,0,0,0,1.272285
21338,Stone Cold,1991-05-17,1991,0,0,0,4.173455
21343,Reverb,2007-02-10,2007,0,0,0,0.728179
21344,The Krays,1990-04-27,1990,0,0,0,2.545697
21345,City of Life and Death,2009-04-22,2009,12000000,10652498,-1347502,7.216103
21348,Kirikou and the Sorceress,1998-12-09,1998,0,0,0,5.635856
21349,Anywhere But Here,1999-11-12,1999,23000000,18653615,-4346385,12.593734
21352,Andre,1994-08-17,1994,0,0,0,3.139316
21355,All the Pretty Horses,2000-12-11,2000,57000000,0,-57000000,7.345133
21356,Rock & Rule,1983-04-15,1983,8000000,0,-8000000,2.066433
21362,High Spirits,1988-11-18,1988,0,7399763,7399763,5.007836
21366,Journey Into Fear,1943-02-11,1943,0,0,0,2.131714
21370,Bootmen,2000-10-05,2000,0,0,0,1.40065
21371,Goodbye Solo,2008-08-09,2008,0,0,0,1.714522
21372,Life Is Hot in Cracktown,2009-01-01,2009,0,0,0,0.862541
21373,Descent,2007-01-01,2007,0,0,0,2.703952
21375,Dexter the Dragon & Bumble the Bear,1983-02-03,1983,0,0,0,0.559828
21376,A Force of One,1979-06-01,1979,0,20200000,20200000,2.272676
21379,Bionicle 2: Legends of Metru Nui,2004-01-01,2004,0,0,0,1.53998
21380,Hell of the Living Dead,1980-11-17,1980,0,0,0,2.442874
21381,Rabid Grannies,1988-01-01,1988,0,0,0,0.003553
21383,The Butterfly Tattoo,2009-04-17,2009,0,0,0,0.016439
21385,"Mickey, Donald, Goofy: The Three Musketeers",2004-08-04,2004,0,0,0,7.673021
21386,Will Vinton's Claymation Christmas Celebration,1987-12-21,1987,0,0,0,0.26361
21393,Rasmus and the Vagabond,1981-12-12,1981,0,0,0,2.337524
21394,The Children of Noisy Village,1986-12-05,1986,0,0,0,3.020044
21398,Grace,2009-08-14,2009,5000000,0,-5000000,4.037911
21407,The Collector,2009-07-09,2009,3400000,114000000,110600000,6.727804
21409,The Window,2008-09-07,2008,0,0,0,0.924596
21410,Zat√¥ichi's Vengeance,1966-05-03,1966,0,0,0,1.133042
21413,The Battle of Shaker Heights,2003-08-22,2003,1000000,0,-1000000,10.536668
21427,The Valet,2006-03-29,2006,0,29326868,29326868,7.696023
21430,New Rose Hotel,1998-09-05,1998,0,0,0,10.255215
21431,Big Game,2008-01-01,2008,0,0,0,0.346654
21433,Don't Tell Her It's Me,1990-09-21,1990,0,0,0,1.924879
21435,French Fried Vacation 3,2006-01-01,2006,0,0,0,7.733817
21442,Everybody Has Secrets,2004-07-30,2004,0,0,0,2.005229
21447,The Nautical Chart,2007-08-31,2007,0,0,0,0.33911
21449,"What's Up, Tiger Lily?",1966-11-02,1966,0,0,0,2.916982
21450,Naked,1993-09-14,1993,0,0,0,8.665198
21451,Ministry of Fear,1944-10-15,1944,0,0,0,2.475938
21452,Detective Conan: The Fourteenth Target,1998-04-19,1998,0,0,0,3.834063
21453,Wicked City,1987-04-19,1987,0,0,0,2.684329
21454,Kiss of Death,1947-08-27,1947,0,0,0,2.824732
21459,Chupke Chupke,1975-01-01,1975,0,0,0,0.005568
21461,Lage Raho Munna Bhai,2006-01-01,2006,0,0,0,3.540755
21462,Masoom,1983-01-10,1983,0,0,0,0.693724
21463,Roja,1992-08-15,1992,0,0,0,0.589798
21466,Mera Naam Joker,1970-12-18,1970,0,0,0,0.621181
21467,The Bone Man,2009-02-09,2009,0,0,0,2.13223
21468,There's No Business Like Show Business,1954-12-16,1954,0,0,0,4.110337
21469,Across the Hall,2009-08-27,2009,0,0,0,3.791141
21474,Bring It On: Fight to the Finish,2009-07-31,2009,0,0,0,0.391552
21481,Twitches,2005-10-14,2005,0,0,0,4.232318
21484,Possession,1981-05-27,1981,0,0,0,10.505671
21488,Funny Felix,2000-04-19,2000,0,0,0,1.309157
21489,The Odessa File,1974-10-17,1974,0,0,0,3.883002
21490,I Live in Fear,1955-11-22,1955,0,0,0,1.645971
21494,Moliere,2007-01-31,2007,0,0,0,4.821828
21500,Class,1983-07-22,1983,0,0,0,3.169554
21501,Christmas Story,2007-11-16,2007,0,0,0,2.573902
21506,Noroi: The Curse,2005-08-20,2005,2000000,0,-2000000,2.800654
21508,Stranded: I've Come from a Plane That Crashed on the Mountains,2007-11-23,2007,0,0,0,0.283513
21509,The Cook,2008-04-01,2008,210000,0,-210000,0.618331
21512,The Blood of Heroes,1989-10-19,1989,0,882290,882290,10.3371
21513,Moon Child,2003-04-19,2003,0,0,0,0.571698
21515,Student Bodies,1981-08-07,1981,0,0,0,2.142083
21518,Air Bud: Seventh Inning Fetch,2002-06-18,2002,0,0,0,1.757138
21519,Project A,1983-12-22,1983,0,0,0,5.693875
21521,Project A II,1987-08-19,1987,0,0,0,6.7196
21522,Enter the Phoenix,2004-04-08,2004,0,0,0,1.245443
21525,Tupac: Resurrection,2003-01-23,2003,300000,7808524,7508524,2.409278
21531,Barking Dogs Never Bite,2000-02-19,2000,0,0,0,1.409127
21533,Voyage of the Unicorn,2001-01-01,2001,0,0,0,3.043915
21534,Iblard Jikan,2007-07-04,2007,0,0,0,1.528257
21535,Orps: The Movie,2009-03-06,2009,0,0,0,0.988834
21537,Not Scared to Die,1973-01-12,1973,0,0,0,1.05692
21538,The American Astronaut,2001-01-20,2001,0,0,0,1.090137
21539,The Preacher's Wife,1996-12-13,1996,40000000,48093211,8093211,4.182641
21542,Love Don't Cost a Thing,2003-12-12,2003,0,0,0,3.812555
21544,Hope Springs,2003-05-09,2003,0,0,0,10.284616
21554,Sparkle,1976-04-07,1976,0,0,0,0.765831
21555,Socha Na tha,2005-03-04,2005,0,0,0,0.43779
21564,Human Desire,1954-08-05,1954,0,0,0,6.481002
21566,Raja Hindustani,1996-11-15,1996,0,0,0,1.412622
21567,Iqbal,2005-08-26,2005,0,0,0,0.641487
21570,Rangeela,1995-01-01,1995,2800000,14000000,11200000,0.709452
21571,Mithya,2008-01-27,2008,0,0,0,0.766631
21575,A Prophet,2009-08-26,2009,13000000,0,-13000000,6.892315
21576,Bill Maher: Be More Cynical,2000-06-10,2000,0,0,0,0.215474
21578,Bill Maher: I'm Swiss,2005-07-30,2005,0,0,0,0.256005
21580,Bill Maher: Victory Begins at Home,2003-01-01,2003,0,0,0,0.691764
21581,Through the Mist,2009-03-13,2009,0,0,0,0.981474
21583,Management,2009-02-08,2009,0,2434658,2434658,12.459106
21585,Robin Williams: An Evening with Robin Williams,1982-01-01,1982,0,0,0,1.086516
21586,Robin Williams: A Night at the Met,1986-08-09,1986,0,0,0,1.196539
21587,Jon Stewart: Unleavened,1996-01-01,1996,0,0,0,0.370562
21588,Cemetery Man,1994-03-25,1994,4000000,0,-4000000,6.247819
21589,Hard Core Logo,1996-10-25,1996,0,0,0,0.88051
21594,The Blue Gardenia,1953-03-23,1953,0,0,0,1.946802
21596,Thomas in Love,2000-09-03,2000,0,0,0,0.369046
21600,I Wake Up Screaming,1941-10-31,1941,0,0,0,1.64311
21605,Thunderpants,2002-05-24,2002,0,0,0,1.452692
21610,Nighthawks,1981-03-17,1981,5000000,19905359,14905359,5.830675
21612,The Funeral,1996-01-26,1996,12500000,1227324,-11272676,2.772039
21613,Street Mobster,1972-05-06,1972,0,0,0,0.865934
21614,Hera Pheri,2000-03-31,2000,0,0,0,2.467498
21616,Captive,2004-03-20,2004,0,0,0,0.783709
21619,King of the Ants,2003-07-28,2003,0,0,0,1.578598
21620,The Price of Milk,2000-10-13,2000,0,0,0,0.971453
21622,Cover Girl,1944-03-30,1944,0,0,0,1.735279
21625,Gulaal,2009-03-13,2009,0,0,0,2.053626
21626,Kissed,1996-09-07,1996,0,0,0,2.056754
21627,Crimewave,1985-09-19,1985,3000000,0,-3000000,3.718284
21629,Stir Crazy,1980-12-12,1980,0,101300000,101300000,6.481464
21631,The Fallen Idol,1948-09-30,1948,0,0,0,1.982942
21634,Prayers for Bobby,2009-02-27,2009,0,0,0,9.598968
21635,"Sorry, Wrong Number",1948-09-01,1948,0,0,0,8.433119
21636,Love Takes Wing,2009-04-04,2009,0,0,0,1.570009
21641,The Damned United,2009-03-27,2009,10000000,0,-10000000,11.545627
21644,Molokai: The Story of Father Damien,2002-06-20,2002,0,0,0,0.213976
21657,Northern Lights,2009-03-21,2009,0,0,0,1.739262
21661,Air Bud: Golden Receiver,1998-08-14,1998,0,10224116,10224116,3.576604
21665,Khakee,2004-01-23,2004,0,0,0,1.393286
21666,Yanks,1979-09-01,1979,0,0,0,1.669958
21671,The Comedians of Comedy: Live at The Troubadour,2007-09-18,2007,0,0,0,0.963557
21683,Batman: Mystery of the Batwoman,2003-10-21,2003,0,0,0,8.26786
21700,Airbag,1997-06-20,1997,0,0,0,1.879667
21705,Barbie Diaries,2005-12-31,2005,0,0,0,7.589921
21707,My Wife Is a Gangster,2001-09-28,2001,0,0,0,1.787893
21708,My Wife Is a Gangster 2,2003-09-05,2003,0,0,0,1.464944
21710,Fuck,2005-11-07,2005,0,19791,19791,2.048857
21711,The Candidate,1972-08-23,1972,0,0,0,11.862375
21712,Mind Game,2004-08-07,2004,0,0,0,3.586257
21714,Coven,2000-03-31,2000,0,0,0,0.435088
21717,Big Jake,1971-05-26,1971,0,0,0,4.175526
21719,The Minus Man,1999-02-25,1999,0,370668,370668,2.255032
21721,Eddie and the Cruisers,1983-09-23,1983,0,4786789,4786789,3.756026
21724,Dance Flick,2009-05-22,2009,0,0,0,9.389891
21733,Dragons Forever,1988-02-11,1988,0,0,0,4.105262
21734,Shadow of a Doubt,1943-01-16,1943,0,0,0,8.007141
21735,49th Parallel,1941-11-24,1941,0,0,0,1.855274
21736,Everest,1998-03-06,1998,0,76447420,76447420,2.096835
21741,Hail Columbia!,1982-01-01,1982,0,0,0,0.00551
21742,Into the Deep,1994-11-02,1994,0,0,0,0.696311
21751,Spoon,2005-02-02,2005,0,1589109,1589109,0.309836
21752,If I Were You 2,2009-02-01,2009,0,0,0,2.361097
21753,Everything You Want,2005-01-01,2005,0,0,0,1.464393
21754,Fahrenhype 9/11,2004-10-05,2004,0,0,0,0.204169
21755,The Brothers Bloom,2008-09-09,2008,20000000,5530764,-14469236,7.973126
21764,Gregory's Girl,1981-04-23,1981,0,0,0,3.018382
21765,Good Boy!,2003-10-10,2003,17000000,0,-17000000,6.575505
21769,Armitage: Dual Matrix,2002-03-22,2002,0,0,0,3.125124
21775,The Stone Council,2006-11-15,2006,22000000,0,-22000000,2.006506
21776,Cash Truck,2004-04-14,2004,0,0,0,2.461442
21778,RRRrrrr!!!,2004-01-28,2004,17820000,14054361,-3765639,9.482248
21779,The Silencers,1966-02-18,1966,0,16318124,16318124,2.311461
21780,Annie: A Royal Adventure,1995-11-18,1995,0,0,0,1.442372
21781,Spider Forest,2004-09-03,2004,0,0,0,1.833655
21784,Exte: Hair Extensions,2007-02-17,2007,0,0,0,1.341795
21786,Cold Prey,2006-10-13,2006,0,0,0,5.319439
21788,Trouble at Timpetill,2008-12-17,2008,0,0,0,7.607153
21791,Drop Dead Sexy,2005-03-12,2005,0,0,0,5.960148
21792,The Ghost,2004-06-17,2004,0,0,0,1.954925
21793,The Chipmunk Adventure,1987-05-22,1987,0,0,0,3.624446
21794,In a Dark Place,2006-07-21,2006,0,0,0,1.525381
21795,Voices,2007-08-22,2007,0,0,0,1.239318
21798,Belly 2: Millionaire Boyz Club,2008-08-12,2008,0,0,0,1.108885
21799,Cutting Class,1989-07-01,1989,0,0,0,5.379013
21801,The Slaughter Rule,2002-01-01,2002,0,0,0,3.406102
21810,Adam & Paul,2004-08-27,2004,0,0,0,3.311706
21811,Ski School,1990-01-01,1990,0,0,0,1.574897
21822,Y.M.I. - Yeh Mera India,2009-08-28,2009,0,0,0,0.751366
21828,Flirting,1991-03-20,1991,0,2415396,2415396,2.076971
21832,Neon Genesis Evangelion: Death and Rebirth,1997-03-15,1997,0,0,0,2.545437
21836,Humanity's End,2009-01-01,2009,0,0,0,0.986736
21837,Cop Dog,2008-01-01,2008,0,0,0,0.295476
21838,Dead & Breakfast,2004-03-16,2004,0,0,0,2.436203
21840,The Misfit Brigade,1987-07-02,1987,0,0,0,1.250511
21841,June 9,2008-06-09,2008,0,0,0,0.545307
21842,Once in a Lifetime,2000-11-10,2000,0,0,0,1.433017
21843,Riot On!,2004-11-12,2004,0,0,0,0.816183
21845,Rookie of the Year,1993-07-07,1993,0,53579269,53579269,6.961256
21846,Trinity And Beyond: The Atomic Bomb Movie,1995-09-29,1995,0,0,0,2.305626
21847,10.5: Apocalypse,2006-03-18,2006,0,0,0,2.80335
21849,A Face in the Crowd,1957-10-17,1957,0,0,0,6.656685
21851,The Lost,2009-01-01,2009,0,0,0,0.546265
21861,LOL (Laughing Out Loud),2008-06-06,2008,0,0,0,6.011605
21862,Deep in the Valley,2009-08-28,2009,0,0,0,4.181466
21864,Wyvern,2009-01-31,2009,0,0,0,1.486371
21866,Bronco Billy,1980-06-11,1980,0,0,0,3.900543
21867,Lady Jane,1986-02-07,1986,8500000,0,-8500000,1.991634
21868,Evelyn,2002-12-13,2002,0,0,0,7.724715
21871,Tank,1984-03-16,1984,0,14134877,14134877,1.833948
21873,My Bodyguard,1980-07-11,1980,0,22482952,22482952,2.48642
21874,Looker,1981-10-30,1981,0,0,0,1.457778
21876,Von Ryan's Express,1965-06-23,1965,5760000,0,-5760000,9.891678
21878,The Line,2008-11-04,2008,7500000,0,-7500000,11.630025
21879,The Hollywood Knights,1980-05-30,1980,2500000,10000000,7500000,2.599219
21882,Gator,1976-08-25,1976,0,0,0,3.078583
21886,No Blade of Grass,1970-10-23,1970,0,0,0,0.798969
21887,The Great Santini,1979-10-26,1979,0,0,0,3.919041
21891,Confessions of a Sociopathic Social Climber,2005-03-12,2005,0,0,0,1.744858
21893,The Abduction Club,2002-07-19,2002,0,0,0,1.652233
21896,Yes Nurse! No Nurse!,2002-09-06,2002,0,0,0,0.28309
21900,Shifty,2009-04-24,2009,0,0,0,1.747367
21905,Shabd,2005-02-04,2005,2500000,3100000,600000,0.922522
21906,Gupt: The Hidden Truth,1997-07-04,1997,0,0,0,0.21663
21910,I Sell The Dead,2008-08-07,2008,0,0,0,3.568522
21915,Booty Call,1997-02-26,1997,0,20060051,20060051,2.543626
21921,Richard Pryor: Here and Now,1983-10-28,1983,0,0,0,0.353046
21923,Richard Pryor: Live on the Sunset Strip,1982-03-12,1982,0,0,0,1.475823
21925,Naqoyqatsi,2002-09-02,2002,3000000,13308,-2986692,2.850011
21927,Dark Corners,2006-05-10,2006,0,0,0,6.636622
21930,Gamera,1965-11-27,1965,0,0,0,2.718759
21935,The Haunting Hour: Don't Think About It,2007-09-04,2007,3000000,0,-3000000,1.935899
21946,Counter Investigation,2007-03-07,2007,0,0,0,4.787284
21947,A.P.E.X.,1994-02-01,1994,0,49601,49601,1.160832
21948,Rolling Thunder,1977-10-14,1977,5000000,0,-5000000,4.721308
21950,Jackson County Jail,1976-03-31,1976,445000,2300000,1855000,2.482536
21954,Sex Pot,2009-08-18,2009,0,0,0,1.79103
21955,The Pom Pom Girls,1976-05-01,1976,0,17883410,17883410,1.318752
21956,Scooby-Doo! and the Monster of Mexico,2003-01-01,2003,0,0,0,3.448629
21959,Mushi-Shi: The Movie,2006-01-01,2006,0,0,0,1.445941
21964,Five Fingers of Death,1972-05-26,1972,0,0,0,1.590512
21966,Blood and Bones,2004-11-06,2004,0,0,0,1.727334
21967,Late Autumn,1960-11-13,1960,0,0,0,1.457156
21968,Super Fly,1972-08-04,1972,0,0,0,1.222538
21970,The Watcher in the Woods,1980-04-17,1980,0,5000000,5000000,9.003838
21972,Like Mike,2002-07-03,2002,30000000,0,-30000000,5.422624
21974,Money as Debt,2006-01-01,2006,0,0,0,0.873309
21982,Aankhen,2002-03-27,2002,0,0,0,1.139385
21988,Awaydays,2009-04-01,2009,0,0,0,1.173881
21989,Hot Dog... The Movie,1984-01-13,1984,0,0,0,2.029222
21990,The Man from Hong Kong,1975-07-31,1975,0,0,0,1.547134
21991,State and Main,2000-08-26,2000,0,0,0,2.864682
21997,In the Time of the Butterflies,2001-10-21,2001,0,0,0,4.072273
22004,Trespass,1992-12-25,1992,14000000,0,-14000000,9.879725
22007,Train,2008-10-16,2008,0,0,0,3.874811
22010,Grass,1999-09-15,1999,0,0,0,2.601702
22013,Elmer Gantry,1960-06-19,1960,3000000,10400000,7400000,6.409512
22014,Our Father,2002-11-22,2002,0,0,0,0.472956
22016,Man on the Train,2002-09-02,2002,0,0,0,1.560336
22020,Black Shampoo,1976-03-05,1976,0,0,0,0.276763
22021,Coffy,1973-06-13,1973,500000,0,-500000,3.029275
22023,The Border,1982-01-29,1982,22000000,0,-22000000,2.686525
22025,Detroit Metal City,2008-08-22,2008,0,0,0,1.679952
22029,Black Caesar,1973-02-07,1973,0,0,0,2.707671
22033,Cry of the Banshee,1970-07-22,1970,500000,0,-500000,1.848123
22034,De Hel Van Tanger,2006-03-15,2006,0,0,0,1.109493
22043,The Profit,2001-04-01,2001,0,0,0,0.597295
22048,Foxy Brown,1974-04-05,1974,500000,0,-500000,8.094683
22049,Starcrash,1978-12-21,1978,0,0,0,1.986584
22051,Adam,2009-07-29,2009,0,2277396,2277396,7.003724
22058,That Man Bolt,1973-12-01,1973,0,0,0,0.047005
22059,The Fantastic Four,1994-01-01,1994,1500000,0,-1500000,6.114738
22060,Spirit Trap,2005-08-12,2005,4500000,0,-4500000,1.099967
22066,The Marsh,2006-05-18,2006,0,0,0,2.827337
22067,Jason's Lyric,1994-09-28,1994,7000000,20851521,13851521,0.912909
22072,The Chair,2007-01-01,2007,0,0,0,1.068661
22073,Hoodlum,1997-08-27,1997,30000000,0,-30000000,2.384882
22074,Capitalism: A Love Story,2009-09-06,2009,20000000,17436509,-2563491,6.032166
22075,Angelus,2001-11-02,2001,0,0,0,0.3313
22076,Alien Hunter,2003-07-19,2003,7000000,0,-7000000,3.081045
22084,Dadnapped,2009-01-01,2009,0,0,0,6.60929
22085,The Last Casino,2004-06-26,2004,0,0,0,1.872955
22090,Telefon,1977-12-16,1977,0,0,0,3.610412
22093,Broken Sky,2006-02-14,2006,0,0,0,1.58991
22094,Hard Times,1975-09-04,1975,2700000,5000000,2300000,3.427039
22099,Rammstein: Live aus Berlin,1999-08-31,1999,0,0,0,0.989113
22100,Watching the Detectives,2007-05-01,2007,2000000,0,-2000000,3.155603
22102,Troop Beverly Hills,1989-03-22,1989,0,0,0,3.196522
22105,Danika,2006-01-01,2006,0,0,0,10.488933
22112,Criss Cross,1949-01-12,1949,0,0,0,5.693534
22114,Solo,1980-01-01,1980,0,0,0,0.001655
22121,Truck Turner,1974-04-19,1974,0,0,0,2.009635
22124,Executioners from Shaolin,1977-01-01,1977,0,0,0,1.344123
22130,Zombie Lake,1981-05-13,1981,0,0,0,1.385791
22135,Not Forgotten,2009-09-11,2009,0,0,0,3.035571
22136,Ricky,2009-02-11,2009,0,0,0,3.282278
22137,The Kingdom,1994-11-23,1994,0,0,0,5.230666
22140,The Kingdom II,1997-11-01,1997,0,0,0,0.553169
22152,Lymelife,2008-09-08,2008,1500000,0,-1500000,9.813825
22154,Stan Lee Presents: Mosiac,2007-01-09,2007,0,0,0,1.47122
22156,The Nest,2002-01-01,2002,0,0,0,2.463214
22160,Against All Odds,1984-03-02,1984,0,0,0,3.027195
22162,A Kid in Aladdin's Palace,1998-01-01,1998,0,0,0,0.814318
22164,Blood and Bone,2009-02-07,2009,3700000,0,-3700000,12.673118
22165,The Bridge to Nowhere,2009-08-17,2009,0,0,0,0.993108
22166,Fast Lane,2010-02-03,2010,0,0,0,0.268346
22167,Knightriders,1981-04-10,1981,3000000,0,-3000000,1.088614
22171,Ms .45,1981-04-24,1981,62000,0,-62000,8.201117
22172,Street Trash,1987-05-09,1987,0,0,0,3.68961
22175,The Shortcut,2009-02-07,2009,0,0,0,14.596309
22176,The Heart Is a Lonely Hunter,1968-07-31,1968,0,0,0,3.601834
22177,Autumn,2009-01-01,2009,0,0,0,1.641025
22178,Hangmen Also Die!,1943-04-15,1943,0,0,0,2.54637
22182,Lezioni di cioccolato,2007-11-23,2007,0,0,0,2.064569
22189,Havana,1990-12-11,1990,40000000,9243140,-30756860,10.10753
22192,J√∂nssonligan dyker upp igen,1986-10-24,1986,0,0,0,1.24269
22194,Possessed,1999-06-25,1999,0,0,0,0.529774
22200,Once Upon a Time in the Midlands,2002-09-06,2002,0,0,0,1.32996
22201,Gunfight at the O.K. Corral,1957-05-30,1957,0,11750000,11750000,10.460298
22211,Hercules,2005-04-01,2005,0,0,0,1.841647
22213,Boiling Point,1993-04-16,1993,0,0,0,2.124785
22215,Cheri,2009-02-10,2009,23000000,9366227,-13633773,4.164362
22230,Happy Accidents,2000-01-25,2000,0,688510,688510,9.916094
22233,The Thrill of It All,1963-07-17,1963,0,0,0,4.207464
22238,The Syrian Bride,2004-11-11,2004,0,0,0,1.225592
22240,My New Partner II,1990-02-07,1990,0,0,0,1.468369
22241,Firaaq,2009-01-01,2009,0,0,0,0.320519
22242,Dirty Deeds,2002-07-18,2002,0,0,0,0.954226
22244,Society,1989-05-13,1989,0,0,0,4.454846
22256,Without Limits,1998-09-11,1998,25000000,777423,-24222577,3.643468
22257,Vabank,1981-01-01,1981,0,0,0,0.726743
22259,Bionicle: The Legend Reborn,2009-08-24,2009,0,0,0,2.698356
22264,America,2009-01-01,2009,0,0,0,0.387065
22267,Ride with the Devil,1999-11-24,1999,38000000,635096,-37364904,7.059308
22274,Quiet Chaos,2008-02-01,2008,0,0,0,3.03607
22279,An Awfully Big Adventure,1995-07-21,1995,4000000,851545,-3148455,0.922958
22285,Good Copy Bad Copy,2007-01-01,2007,0,0,0,0.400687
22288,Honeysuckle Rose,1980-07-18,1980,0,0,0,0.89977
22289,My Flesh and Blood,2003-01-17,2003,0,0,0,0.178846
22292,The Ghost and Mrs. Muir,1947-06-26,1947,0,0,0,3.008607
22293,Manos: The Hands of Fate,1966-11-15,1966,19000,0,-19000,2.560257
22301,Hell's Angels,1930-11-15,1930,3950000,8000000,4050000,5.276546
22302,Polytechnique,2009-01-24,2009,0,0,0,5.170568
22305,Depeche Mode: The Videos 86-98,1998-01-01,1998,0,0,0,0.83297
22307,Sisters,1973-03-27,1973,500000,0,-500000,9.296883
22309,The Fighting Temptations,2003-09-17,2003,15000000,30238577,15238577,2.18689
22311,The Inglorious Bastards,1978-02-08,1978,0,0,0,9.461686
22314,In Too Deep,1999-08-25,1999,7000000,14011454,7011454,1.615319
22315,Aitraaz,2004-11-12,2004,3500000,9250000,5750000,1.280578
22316,Ajnabee,2001-09-21,2001,0,0,0,1.742685
22317,Lightning Jack,1994-03-11,1994,0,0,0,2.913584
22318,Permanent Midnight,1998-09-12,1998,0,0,0,3.357962
22319,Trouble the Water,2008-01-20,2008,0,0,0,1.438503
22323,The Boys Next Door,1985-10-01,1985,0,0,0,1.381945
22326,Forbidden Fruit,2009-02-13,2009,0,0,0,0.631264
22327,Youth in Revolt,2009-09-11,2009,18000000,0,-18000000,5.433934
22328,The Apple Dumpling Gang Rides Again,1979-06-27,1979,0,0,0,1.036492
22334,Chase a Crooked Shadow,1958-01-21,1958,0,0,0,1.357415
22335,Smash Cut,2009-07-18,2009,0,0,0,1.871453
22342,The Big Combo,1955-02-15,1955,0,0,0,1.787278
22345,Baby Geniuses,1999-03-12,1999,12000000,36450736,24450736,7.707344
22356,Angel and the Badman,1947-02-15,1947,0,0,0,8.08426
22358,The Island,2006-11-23,2006,0,0,0,2.242361
22359,Any Gun Can Play,1967-09-26,1967,0,0,0,0.94847
22365,Apache Blood,1975-01-06,1975,0,0,0,0.005082
22371,Minutemen,2008-01-25,2008,0,0,0,7.9865
22373,Saturn in Opposition,2007-02-23,2007,0,0,0,3.549715
22376,Treasure Island,1972-10-01,1972,0,0,0,1.671169
22377,The Green Berets,1968-07-04,1968,7000000,11000000,4000000,9.391981
22379,Slipstream,1989-06-22,1989,0,0,0,1.697976
22383,The Professionals,1966-11-01,1966,0,0,0,5.032092
22386,Come September,1961-01-01,1961,0,0,0,0.905633
22387,Random Harvest,1942-12-17,1942,0,0,0,5.148718
22390,Pardners,1956-08-01,1956,0,0,0,2.265234
22396,"China 9, Liberty 37",1978-08-04,1978,0,0,0,0.935395
22398,Tenderness,2009-01-15,2009,0,0,0,3.35167
22404,Man Hunt,1941-06-13,1941,0,0,0,6.924131
22408,Rage at Dawn,1955-03-26,1955,0,0,0,0.398755
22414,Postcards from the Edge,1990-09-12,1990,22000000,39071603,17071603,2.523655
22419,Camille,2008-04-13,2008,6000000,0,-6000000,8.776971
22423,Guilty by Suspicion,1991-03-15,1991,0,0,0,2.458952
22429,Kyaa Kool Hai Hum,2005-05-06,2005,0,0,0,1.136152
22434,If Looks Could Kill,1991-03-15,1991,0,7788597,7788597,3.894815
22435,Who Pulled the Plug?,1981-12-18,1981,0,0,0,0.804917
22440,Dracula's Daughter,1936-05-11,1936,0,0,0,2.076008
22447,Is Anybody There?,2009-04-17,2009,0,0,0,3.579347
22448,Awarapan,2007-06-29,2007,6000000,0,-6000000,1.28015
22449,I Just Didn't Do It,2007-01-20,2007,0,0,0,0.705809
22450,Red Water,2003-08-17,2003,0,0,0,1.012234
22451,The Bone Snatcher,2003-12-23,2003,0,0,0,6.123475
22452,The War on Democracy,2007-06-15,2007,0,0,0,1.039916
22454,Dirty Mind,2009-01-28,2009,0,0,0,0.510883
22455,Body Melt,1994-10-28,1994,0,0,0,2.617006
22460,The Wall,1975-07-01,1975,0,0,0,1.233987
22466,Rover Dangerfield,1991-08-02,1991,0,0,0,1.407655
22471,Yrrol,1994-10-28,1994,0,0,0,1.103116
22473,Neverwas,2005-09-09,2005,0,0,0,8.557727
22476,Infestation,2009-02-05,2009,0,0,0,5.877186
22477,September,1987-01-01,1987,0,0,0,2.724242
22478,Another Woman,1988-10-13,1988,0,0,0,3.333264
22479,Kansas City,1996-08-16,1996,18000000,0,-18000000,5.130136
22484,Tongan Ninja,2002-11-08,2002,50000,0,-50000,1.018876
22485,loudQUIETloud: A Film About the Pixies,2006-04-21,2006,0,0,0,0.95225
22488,Love's Abiding Joy,2006-10-06,2006,0,0,0,1.148336
22489,Last Flight Out,2004-05-06,2004,0,0,0,0.005923
22490,The Women,1939-01-01,1939,1688000,2270000,582000,5.076649
22492,It Might Get Loud,2009-08-14,2009,0,1896244,1896244,4.857726
22494,Frequently Asked Questions About Time Travel,2009-04-24,2009,0,0,0,7.916957
22495,"Chelovek, kotoryy znal vsyo",2009-06-11,2009,0,160829,160829,0.746165
22498,Patti Smith: Dream of Life,2008-01-01,2008,0,0,0,1.4236
22500,Gandahar,1987-12-11,1987,0,0,0,1.258514
22501,Time Masters,1982-03-24,1982,0,0,0,8.717863
22502,The Rain Children,2003-06-25,2003,0,0,0,2.462786
22504,The King and the Mockingbird,1980-03-19,1980,0,0,0,3.005302
22515,Death Racers,2008-09-28,2008,0,0,0,0.984599
22519,The Two Worlds of Jennie Logan,1979-10-31,1979,0,0,0,0.789792
22520,Aachi and Ssipak,2006-06-28,2006,3500000,0,-3500000,0.53886
22521,Terror's Advocate,2007-06-06,2007,0,0,0,1.33924
22522,Anne of the Thousand Days,1969-12-18,1969,0,0,0,3.163027
22527,The Wrong Man,1956-12-22,1956,1200000,2000000,800000,8.56081
22536,Thirst,2009-04-30,2009,5000000,0,-5000000,5.213648
22537,Inuyasha the Movie 2: The Castle Beyond the Looking Glass,2002-12-22,2002,0,0,0,1.243744
22538,Scott Pilgrim vs. the World,2010-07-27,2010,60000000,47664559,-12335441,13.793301
22543,Dead Ringer,1964-02-19,1964,0,0,0,1.621641
22549,Ulysses' Gaze,1995-05-24,1995,0,0,0,1.605995
22551,Believers,2007-06-11,2007,0,0,0,2.209294
22553,At the Circus,1939-10-20,1939,0,0,0,1.149676
22554,The Subtenant,2008-09-12,2008,1300000,0,-1300000,1.063304
22555,Jesse Stone: Thin Ice,2009-03-01,2009,0,0,0,3.30642
22556,The Yellow Handkerchief,2008-12-17,2008,15000000,317000,-14683000,3.919317
22559,Aliens of the Deep,2005-01-21,2005,0,0,0,1.924682
22561,Allegro non troppo,1976-03-12,1976,0,0,0,1.115905
22572,Hell Comes to Frogtown,1988-01-01,1988,0,0,0,6.004236
22573,Last of the Living,2009-05-03,2009,0,0,0,1.790302
22575,Go West,1940-12-06,1940,0,0,0,4.217156
22578,Labyrinth,2003-09-09,2003,0,0,0,1.743593
22579,My Bestfriend's Girlfriend,2008-02-13,2008,0,0,0,0.010755
22582,Tom and Jerry: The Movie,1992-10-01,1992,0,0,0,10.978036
22584,To Have and Have Not,1944-10-11,1944,0,3650000,3650000,10.003167
22585,Ski Patrol,1990-01-12,1990,0,8533973,8533973,2.345336
22586,The Swan Princess,1994-11-18,1994,35000000,9771658,-25228342,8.910462
22588,Radioland Murders,1994-10-21,1994,0,0,0,8.506727
22590,Sidekicks,1992-12-17,1992,0,0,0,2.489661
22592,Grandma's Boy,1922-09-03,1922,0,0,0,0.35722
22595,Speedy,1928-04-07,1928,0,0,0,1.160323
22596,Safety Last!,1923-04-01,1923,0,623,623,4.394823
22597,The Broken Hearts Club: A Romantic Comedy,2000-02-01,2000,1000000,1744858,744858,1.795849
22599,The Hire: Star,2001-06-01,2001,0,0,0,2.678121
22600,Gangster's Paradise: Jerusalema,2008-02-11,2008,0,0,0,2.738852
22602,Randy Rides Alone,1934-06-05,1934,0,0,0,1.158542
22606,Texas Terror,1935-10-17,1935,0,0,0,1.464799
22609,Dil Bole Hadippa!,2009-09-18,2009,0,0,0,2.029765
22611,Little Nemo: Adventures In Slumberland,1989-07-15,1989,0,0,0,2.770568
22612,The Lucky Texan,1934-01-22,1934,0,0,0,1.373484
22613,The Outlaw,1943-02-05,1943,0,0,0,1.450989
22614,The Scarlet Pimpernel,1934-12-23,1934,0,0,0,2.942979
22615,Kiss Kiss (Bang Bang),2001-11-07,2001,0,0,0,1.048992
22616,Night of the Day of the Dawn of the Son of the Bride Part 2: In Shocking 2-D,1991-01-01,1991,0,0,0,0.022568
22617,Dinner Rush,2000-09-01,2000,0,0,0,1.578282
22618,Far Side of the Moon,2003-09-09,2003,0,0,0,0.90175
22620,Scooby-Doo! The Mystery Begins,2009-09-12,2009,0,0,0,9.754483
22621,Heavy,1995-01-20,1995,0,0,0,0.889498
22623,Ripoux 3,2003-12-10,2003,0,0,0,2.800132
22625,Circle of Friends,1995-03-16,1995,0,0,0,2.605521
22627,Pure Country,1992-10-23,1992,0,0,0,2.803846
22638,Henry V,1944-11-24,1944,0,0,0,1.200979
22640,Shrink,2009-06-08,2009,5100000,0,-5100000,3.81571
22642,A Bucket of Blood,1959-10-21,1959,50000,0,-50000,2.728651
22643,Mickey's House of Villains,2001-11-15,2001,0,0,0,4.920174
22649,A Farewell to Arms,1932-12-08,1932,4,25,21,1.914697
22649,A Farewell to Arms,1932-12-08,1932,4,25,21,2.411191
22650,Any Number Can Win,1963-03-19,1963,0,0,0,1.771915
22657,Algiers,1938-06-28,1938,0,0,0,0.348765
22660,Old Yeller,1957-12-25,1957,0,0,0,12.887829
22672,Sharpshooter,2007-10-11,2007,0,0,0,9.401708
22681,Homecoming,2009-07-17,2009,1500000,0,-1500000,6.650064
22682,How to Succeed in Business Without Really Trying,1967-01-01,1967,0,0,0,3.014635
22683,Gifted Hands: The Ben Carson Story,2009-02-07,2009,0,0,0,4.291857
22688,Angel on My Shoulder,1946-09-20,1946,0,0,0,0.594433
22689,A Shriek in the Night,1933-07-22,1933,0,0,0,1.677515
22692,A Star Is Born,1937-04-27,1937,0,0,0,2.537508
22694,The Trip,1967-08-23,1967,0,0,0,1.338485
22701,Attack from Space,1965-01-01,1965,0,0,0,0.237749
22705,Cheeky,2000-01-28,2000,0,0,0,6.377611
22707,Amandla! A Revolution in Four-Part Harmony,2002-09-21,2002,0,405331,405331,0.173464
22711,Blaze,1989-12-15,1989,0,19131000,19131000,3.444266
22717,Wanted,2009-09-18,2009,75,134,59,4.450762
22718,Attack of the Giant Leeches,1959-10-01,1959,0,0,0,1.386687
22726,Battle of the Worlds,1961-03-01,1961,0,0,0,1.306155
22727,The Beast of Yucca Flats,1961-06-02,1961,0,0,0,0.93079
22728,Love Is Eternal While It Lasts,2004-02-20,2004,0,0,0,2.031126
22731,Pig Hunt,2008-07-31,2008,0,0,0,1.568169
22733,Beat the Devil,1953-11-24,1953,1000000,0,-1000000,2.001733
22734,Beneath the 12-Mile Reef,1953-12-02,1953,0,0,0,0.830214
22741,Black Dragons,1942-03-06,1942,0,0,0,0.640341
22744,Jane Eyre,1943-12-24,1943,0,0,0,2.188029
22745,The Seamstress,2009-09-24,2009,2500000,0,-2500000,1.800496
22747,Bob the Butler,2005-03-10,2005,0,0,0,1.836802
22749,Bloodlust!,1961-09-13,1961,0,0,0,0.731527
22750,The Blood of Jesus,1941-04-26,1941,5000,0,-5000,0.039707
22752,The Reluctant Dragon,1941-06-19,1941,0,0,0,8.095106
22758,Bloody Pit of Horror,1965-11-28,1965,0,0,0,0.909563
22765,The Shadow Riders,1982-09-28,1982,0,0,0,3.108433
22774,Valentino: The Last Emperor,2009-01-01,2009,0,0,0,2.079739
22777,The Million Dollar Duck,1971-06-30,1971,0,0,0,0.808654
22779,Victory Through Air Power,1943-07-17,1943,0,0,0,0.914238
22784,Boxcar Bertha,1972-06-14,1972,600000,0,-600000,5.070135
22787,Whiteout,2009-09-09,2009,40000000,12206028,-27793972,7.759722
22792,High Strung,1991-01-01,1991,300000,0,-300000,3.019717
22794,Cloudy with a Chance of Meatballs,2009-09-17,2009,100000000,242988466,142988466,11.665693
22795,Doing Time on Maple Drive,1992-03-16,1992,0,0,0,0.678176
22796,Simon Birch,1998-09-11,1998,20000000,18253415,-1746585,2.651408
22797,The Butcher Boy,1997-07-13,1997,0,0,0,7.801199
22798,Whip It,2009-09-13,2009,15000000,16633035,1633035,14.511442
22800,Good Hair,2009-10-09,2009,0,0,0,12.569979
22803,Law Abiding Citizen,2009-10-15,2009,53000000,126690726,73690726,16.639047
22804,Saw VI,2009-10-22,2009,11000000,68233629,57233629,17.360894
22805,Motherhood,2009-01-21,2009,0,0,0,8.42093
22812,Unnatural & Accidental,2006-07-07,2006,0,0,0,0.087226
22817,Disaster!,2006-07-20,2006,2980000,0,-2980000,2.594115
22819,American Son,2008-01-01,2008,0,0,0,1.439634
22820,Gentlemen Broncos,2009-09-30,2009,10000000,0,-10000000,3.67036
22821,The Boondock Saints II: All Saints Day,2009-11-24,2009,8000000,10629321,2629321,8.051448
22824,The Fourth Kind,2009-11-06,2009,10000000,42333295,32333295,13.751992
22825,The Box,2009-09-17,2009,30000000,33333531,3333531,10.424946
22826,The Monster,1994-10-22,1994,0,0,0,4.700084
22828,Homicide,1991-05-28,1991,0,0,0,7.571853
22829,Paris When It Sizzles,1964-03-01,1964,0,0,0,2.952978
22832,Ninja Assassin,2009-09-29,2009,40000000,60462347,20462347,9.163897
22842,Black Cloud,2004-01-01,2004,0,0,0,0.563074
22843,Evangelion: 2.0 You Can (Not) Advance,2009-06-26,2009,0,41162041,41162041,6.518028
22855,Superman/Batman: Public Enemies,2009-09-29,2009,0,0,0,8.572867
22857,The Classic,2001-01-16,2001,0,0,0,0.964849
22871,Destination Tokyo,1943-12-31,1943,0,0,0,2.762671
22874,Indiscreet,1958-06-26,1958,0,0,0,1.407538
22881,The Blind Side,2009-11-20,2009,29000000,309208309,280208309,12.753109
22882,Van Diemen's Land,2009-09-24,2009,0,0,0,2.11211
22892,Laughing Gas,1914-07-09,1914,0,0,0,0.647234
22894,Legion,2010-01-21,2010,26000000,67918658,41918658,13.795875
22897,It's Complicated,2009-12-23,2009,85000000,219103655,134103655,9.083133
22899,Gamera vs. Barugon,1966-04-17,1966,0,0,0,0.635468
22901,I Know You Know,2009-02-05,2009,0,0,0,2.133283
22905,The Rape of Europa,2006-01-01,2006,0,0,0,1.275477
22907,Takers,2010-08-26,2010,32000000,69055695,37055695,7.000421
22908,A Room for Romeo Brass,1999-08-23,1999,0,0,0,0.808056
22910,The Big Bird Cage,1972-07-01,1972,0,0,0,2.077256
22911,War Made Easy: How Presidents & Pundits Keep Spinning Us to Death,2007-08-23,2007,0,0,0,0.30516
22913,24 7: Twenty Four Seven,1997-08-31,1997,0,0,0,0.477356
22915,North Shore,1987-08-14,1987,0,3832228,3832228,1.047417
22924,Armored Car Robbery,1950-06-08,1950,0,0,0,2.393434
22937,Carry On... Up the Khyber,1968-11-28,1968,0,0,0,4.799837
22939,Spider-Plant Man,2005-03-11,2005,0,0,0,1.659001
22943,Tillie's Punctured Romance,1914-11-14,1914,0,0,0,0.621999
22947,Up in the Air,2009-09-05,2009,25000000,163670000,138670000,8.338562
22949,Old Dogs,2009-11-24,2009,35000000,92219310,57219310,9.52295
22954,Invictus,2009-12-10,2009,60000000,122233971,62233971,9.109838
22958,The Shape of Things,2003-01-01,2003,0,0,0,2.897666
22965,Doomed to Die,1940-08-12,1940,0,0,0,0.456508
22968,Father's Little Dividend,1951-04-12,1951,0,0,0,1.325032
22969,Fire Over England,1937-02-25,1937,0,0,0,1.722841
22970,The Cabin in the Woods,2012-04-12,2012,30000000,66486080,36486080,14.811958
22971,Dear John,2010-02-04,2010,25000000,114977104,89977104,8.371479
22972,Green Zone,2010-03-11,2010,100000000,94882889,-5117111,11.174041
22974,√úvegtigris,2001-10-18,2001,0,0,0,0.808418
22975,Richard Pryor: Live in Concert,1979-01-26,1979,0,0,0,1.716494
22976,Biggles,1986-05-30,1986,0,112132,112132,1.058656
22984,The Kids Are Alright,1979-06-24,1979,2000000,0,-2000000,1.653741
22985,The Prowler,1951-05-25,1951,0,0,0,3.250812
22994,The Fighting Seabees,1944-01-27,1944,0,0,0,1.577427
22998,To Be or Not to Be,1983-12-16,1983,0,13030214,13030214,8.378174
22999,The Flying Deuces,1939-10-28,1939,0,0,0,3.60402
23001,The Sin of Harold Diddlebock,1947-04-04,1947,0,0,0,0.557728
23014,Invisible Ghost,1941-04-25,1941,0,0,0,1.289375
23019,Chinaman,2005-04-01,2005,0,0,0,1.009415
23020,Jail Bait,1954-01-01,1954,0,0,0,0.514993
23022,Jigsaw,1949-05-28,1949,0,0,0,1.049591
23023,Tooth Fairy,2010-01-14,2010,48000000,112462508,64462508,6.74468
23024,Judge Priest,1934-09-28,1934,0,0,0,0.380048
23030,Arabesque,1966-05-04,1966,4800000,0,-4800000,4.953729
23033,Jungle Book,1942-04-03,1942,0,0,0,2.467773
23044,The September Issue,2009-08-28,2009,0,0,0,2.496887
23045,Killers from Space,1954-01-23,1954,0,0,0,1.135331
23047,Season of the Witch,2011-01-07,2011,40000000,88100000,48100000,13.471159
23048,Hot Tub Time Machine,2010-03-26,2010,36000000,64572262,28572262,11.967652
23049,My Life in Ruins,2009-02-06,2009,17000000,20455276,3455276,7.19669
23050,Scavenger Hunt,1979-12-21,1979,0,0,0,1.200851
23051,Action in the North Atlantic,1943-06-12,1943,0,0,0,0.454126
23069,Benji,1974-10-17,1974,0,0,0,1.54283
23076,"Texas, Adios",1966-08-28,1966,0,0,0,0.819728
23077,Russell Peters: Outsourced,2006-08-01,2006,0,0,0,1.631019
23082,The Invention of Lying,2009-09-13,2009,18500000,31912793,13412793,7.087161
23096,Doctor Detroit,1983-05-06,1983,0,0,0,8.591768
23097,Hell and High Water,1954-02-06,1954,0,0,0,0.338405
23101,Topper,1937-07-16,1937,500000,0,-500000,3.1574
23102,The Pride and the Passion,1957-07-10,1957,0,0,0,3.033852
23104,King of the Zombies,1941-05-14,1941,0,0,0,1.387826
23107,Lady Gangster,1942-04-01,1942,0,0,0,0.635338
23108,The Last of the Mohicans,1936-07-02,1936,0,0,0,1.344557
23111,Moscow on the Hudson,1984-06-04,1984,0,25100000,25100000,4.021828
23112,Bliss,2007-03-16,2007,0,0,0,0.844469
23114,Little Lord Fauntleroy,1936-03-06,1936,0,0,0,4.709847
23115,Long John Silver,1954-12-16,1954,0,0,0,1.562051
23116,Loose Change 9/11: An American Coup,2009-09-22,2009,0,0,0,2.286217
23122,Maniac,1934-09-11,1934,0,0,0,0.489892
23126,Midnight Manhunt,1945-07-27,1945,0,0,0,0.382124
23127,The Haunted World of El Superbeasto,2009-09-12,2009,0,0,0,3.517689
23128,The Cove,2009-07-31,2009,0,1162422,1162422,12.492389
23132,2009: Lost Memories,2002-02-01,2002,0,0,0,2.111875
23134,Totally Awesome,2006-11-07,2006,0,0,0,0.492677
23142,Attack of the 60 Foot Centerfold,1995-01-01,1995,0,0,0,1.069668
23148,Lady Sings the Blues,1972-10-12,1972,0,0,0,7.565468
23150,The Garden of Sinners - Chapter 1: Overlooking View,2007-12-01,2007,0,0,0,1.044894
23151,The Garden of Sinners - Chapter 2: A Study in Murder (Part 1),2007-12-29,2007,0,0,0,2.079812
23152,People Will Talk,1951-08-29,1951,0,0,0,1.276632
23153,The Garden of Sinners - Chapter 3: Remaining Sense of Pain,2008-02-09,2008,0,0,0,2.222614
23154,The Garden of Sinners - Chapter 4: The Hollow Shrine,2008-05-24,2008,0,0,0,1.383098
23155,The Garden of Sinners - Chapter 5: Paradox Spiral,2008-08-16,2008,0,0,0,1.702333
23159,The Talk of the Town,1942-08-20,1942,0,0,0,7.293819
23160,Werckmeister Harmonies,2000-07-12,2000,0,25461,25461,7.970312
23166,The Garden of Sinners - Chapter 6: Oblivion Recording,2008-12-20,2008,0,0,0,1.590718
23167,The Garden of Sinners - Chapter 7: A Study in Murder (Part 2),2009-08-08,2009,0,0,0,0.894116
23168,The Town,2010-09-15,2010,37000000,154026136,117026136,13.081203
23169,Remember Me,2010-03-12,2010,16000000,56032889,40032889,8.307719
23172,The Spy Next Door,2010-01-15,2010,28000000,45236543,17236543,6.663422
23173,Tormented,2009-05-22,2009,0,0,0,7.481106
23174,It's Alive,2008-08-15,2008,11000000,15500000,4500000,0.868804
23178,Elvis and Me,1988-02-07,1988,8000000,0,-8000000,0.908671
23189,The Undercover Man,1949-03-21,1949,0,0,0,0.390205
23190,Life After People,2008-01-21,2008,0,0,0,2.005717
23194,The Hallelujah Trail,1965-06-23,1965,0,0,0,9.576045
23196,South Central,1992-09-18,1992,4000000,0,-4000000,2.99945
23200,Silent Partner,2005-05-26,2005,3600000,0,-3600000,1.640142
23202,Trick 'r Treat,2007-10-05,2007,12000000,0,-12000000,10.304654
23205,Second Skin,2009-03-07,2009,0,0,0,0.214747
23207,Crossing the Line,2006-10-16,2006,0,0,0,0.475083
23210,Six Degrees of Separation,1993-12-08,1993,0,0,0,8.730025
23220,The Brides of Dracula,1960-01-01,1960,0,0,0,2.966154
23223,Normal Life,1996-01-26,1996,0,0,0,0.881187
23239,Idiot Box,1996-01-01,1996,0,0,0,0.690785
23253,Mr. Robinson Crusoe,1932-08-19,1932,0,0,0,0.176884
23269,Portraits of Women,1970-02-06,1970,0,0,0,0.114894
23270,Russell Howard: Live,2008-11-17,2008,0,0,0,0.524643
23273,Great!,1986-01-01,1986,0,0,0,1.682762
23280,Nancy Drew... Reporter,1939-02-18,1939,0,0,0,0.811435
23281,One Body Too Many,1944-11-24,1944,0,0,0,0.521866
23282,One Week,1920-09-01,1920,0,0,0,3.121673
23283,Our Town,1940-05-24,1940,0,0,0,1.268804
23286,Paradise Canyon,1935-07-19,1935,0,0,0,1.334437
23289,Love at First Hiccough,1999-10-15,1999,0,0,0,1.375491
23303,Another You,1991-07-26,1991,17000000,0,-17000000,7.327229
23305,The Warrior,2001-09-23,2001,0,0,0,1.967992
23305,The Warrior,2001-09-23,2001,0,0,0,1.967992
23312,Which Way Is Up?,1977-01-01,1977,0,0,0,1.802461
23319,Jerry Seinfeld: I'm Telling You for the Last Time,1998-01-01,1998,0,0,0,4.02254
23325,At War with the Army,1950-04-14,1950,0,0,0,3.355457
23330,The Ballad of Cable Hogue,1970-05-13,1970,3716946,5000000,1283054,2.537955
23331,Planet Outlaws,1953-01-01,1953,0,0,0,1.110623
23333,Mrs. Parker and the Vicious Circle,1994-09-07,1994,0,0,0,4.739054
23334,Port of New York,1949-11-28,1949,0,0,0,0.698314
23336,Why We Fight: Prelude to War,1942-05-27,1942,0,0,0,0.476623
23338,Pride of the Bowery,1940-12-15,1940,0,0,0,0.11681
23340,Queen of the Amazons,1947-01-15,1947,0,0,0,0.415906
23356,Purgatory,1999-01-10,1999,0,0,0,0.683658
23367,Bandslam,2009-08-06,2009,20000000,5210988,-14789012,5.757056
23368,Let's Make Money,2008-10-30,2008,0,0,0,1.980374
23377,Pablo Francisco: Bits and Pieces,2004-07-27,2004,0,0,0,0.748818
23378,Into the Woods,1991-03-15,1991,0,0,0,0.708742
23381,Pokiri,2006-04-27,2006,0,0,0,0.631275
23382,Dark Country,2009-10-05,2009,0,0,0,4.839781
23383,Hamlet,1948-03-25,1948,750000,0,-750000,3.188067
23385,New Town Killers,2008-10-28,2008,0,0,0,1.701395
23388,Report from the Aleutians,1943-07-30,1943,0,0,0,0.62555
23389,Revolt of the Zombies,1936-06-04,1936,0,0,0,0.482454
23391,Riders of Destiny,1933-10-10,1933,0,0,0,0.604248
23395,The Red Pony,1949-03-28,1949,0,0,0,0.843101
23397,Straight Time,1978-03-18,1978,0,0,0,2.352594
23398,Alvin and the Chipmunks: The Squeakquel,2009-12-21,2009,75000000,443140005,368140005,9.909961
23404,Command Performance,2009-01-01,2009,0,0,0,2.762953
23410,The Thaw,2009-01-01,2009,0,0,0,6.487576
23423,Friends and Family,2001-06-17,2001,0,0,0,0.592235
23427,29th and Gay,2005-01-01,2005,25000,0,-25000,0.266907
23431,An Angel Named Billy,2007-01-11,2007,0,0,0,0.187181
23437,A Nightmare on Elm Street,2010-04-30,2010,35000000,115664037,80664037,10.40191
23438,Wild Hearts Can't Be Broken,1991-05-24,1991,0,0,0,6.254895
23439,House of Usher,1960-06-21,1960,270000,1450000,1180000,3.481988
23449,Celtic Pride,1996-04-19,1996,0,0,0,1.940747
23451,Videocracy,2009-09-04,2009,700000,1179676,479676,0.712844
23452,Gurren Lagann The Movie: The Lights in the Sky Are Stars,2009-04-25,2009,0,0,0,2.328925
23470,Surf Ninjas,1993-09-20,1993,0,4916135,4916135,2.556077
23476,Without Evidence,1995-10-12,1995,0,0,0,2.083168
23478,Mozart and the Whale,2005-09-10,2005,12000000,84967,-11915033,8.334487
23479,The Bad News Bears,1976-04-07,1976,35000000,35323292,323292,8.399441
23483,Kick-Ass,2010-03-22,2010,28000000,96188903,68188903,17.26045
23488,Dorian Gray,2009-09-09,2009,0,4706919,4706919,11.069608
23495,The War Tapes,2006-10-22,2006,0,254190,254190,0.273694
23504,Robotech: The Movie,1986-07-25,1986,0,0,0,0.002001
23506,The Wizard of Gore,1970-10-23,1970,60000,0,-60000,2.526194
23508,Embodiment of Evil,2008-08-08,2008,0,0,0,0.962933
23509,Italians,2009-01-01,2009,0,0,0,2.8077
23512,The Boys Are Back,2009-09-15,2009,0,0,0,4.098714
23514,The Rum Diary,2011-10-13,2011,45000000,24000000,-21000000,10.110504
23515,Sick Girl,2007-10-01,2007,30000,0,-30000,1.002036
23516,Frownland,2007-03-09,2007,0,0,0,0.039692
23518,Seven Days in May,1964-02-12,1964,0,0,0,2.623786
23520,Unstoppable,2004-10-20,2004,0,0,0,2.331514
23521,Daffy Duck's Quackbusters,1988-09-24,1988,0,0,0,0.870327
23522,The Book of Life,1998-08-22,1998,0,0,0,0.684968
23523,McLibel,2005-05-20,2005,0,0,0,0.803616
23524,Steep,2007-04-28,2007,0,0,0,0.948353
23525,The D.I.,1957-05-30,1957,0,0,0,0.765507
23527,First Squad: The Moment of Truth,2009-05-13,2009,0,0,0,1.803186
23529,Cosas insignificantes,2008-09-23,2008,0,0,0,1.195679
23531,Whipped,2000-09-01,2000,3000000,0,-3000000,0.752852
23532,How to Be a Serial Killer,2008-10-12,2008,0,0,0,1.523889
23535,Class of 1999,1990-05-11,1990,5200000,2459895,-2740105,6.700173
23538,A Dirty Carnival,2006-06-15,2006,4700000,0,-4700000,5.604096
23544,The Point!,1971-02-02,1971,0,0,0,0.766972
23550,His Secret Life,2001-03-16,2001,0,215339,215339,3.83196
23566,Barbie and the Three Musketeers,2009-09-15,2009,0,0,0,6.670165
23567,I Was a Male War Bride,1949-08-19,1949,0,0,0,1.853079
23568,American Virgin,2009-10-03,2009,4000000,0,-4000000,3.102284
23570,The Pallbearer,1996-05-03,1996,8000000,0,-8000000,8.174116
23574,What a Way to Go!,1964-05-12,1964,20000000,0,-20000000,1.706828
23587,Vigilante,1983-01-04,1983,0,5091888,5091888,2.620456
23590,Sagebrush Trail,1933-12-15,1933,0,0,0,1.064154
23592,In Enemy Hands,2005-04-15,2005,5400000,0,-5400000,3.401596
23594,Wild Roomies,2004-01-01,2004,400000,0,-400000,0.897354
23599,Wanted: Dead or Alive,1987-01-16,1987,0,0,0,4.917167
23601,We Don't Live Here Anymore,2004-01-20,2004,3000000,2037545,-962455,2.127661
23604,Two Days,2003-05-01,2003,0,0,0,1.111066
23606,A Scene at the Sea,1991-10-19,1991,0,0,0,1.619846
23609,Guns & Talks,2001-10-12,2001,0,0,0,2.785681
23614,The Heavenly Kid,1985-07-26,1985,0,0,0,4.293628
23615,The Scarlet Pimpernel,1982-11-09,1982,0,0,0,1.636045
23618,The Original Kings of Comedy,2000-08-18,2000,0,0,0,0.621406
23619,We Can Do That,2008-10-31,2008,0,0,0,2.767783
23620,Salt of the Earth,1954-03-14,1954,0,0,0,0.979701
23626,Blue Collar Comedy Tour: The Movie,2003-03-28,2003,0,604856,604856,1.578537
23627,Second Chorus,1940-12-09,1940,0,0,0,3.874151
23628,Road to Victory,2007-01-01,2007,0,0,0,0.015715
23629,Sucker Punch,2011-03-24,2011,82000000,89792502,7792502,13.779527
23631,Machete,2010-09-01,2010,20000000,31327899,11327899,7.120403
23637,"Ciao, Professore!",1992-10-01,1992,0,0,0,3.456868
23638,Dust to Glory,2005-04-01,2005,0,0,0,0.508833
23654,J√∂nssonligan och den svarta diamanten,1992-10-30,1992,0,0,0,0.937939
23655,Groove,2000-06-08,2000,0,0,0,0.607562
23668,"Fort Apache, the Bronx",1981-02-06,1981,0,0,0,1.433116
23676,Ten Minutes Older: The Trumpet,2002-05-18,2002,0,0,0,1.134635
23683,The Poker Club,2008-10-16,2008,0,0,0,0.545768
23685,Monkeybone,2001-02-23,2001,75000000,5409517,-69590483,8.893957
23691,The Initiation of Sarah,2006-01-01,2006,0,0,0,1.766511
23692,The Initiation of Sarah,1978-02-06,1978,0,0,0,1.213598
23703,The Thing About My Folks,2005-01-01,2005,0,0,0,2.390913
23704,The Rocket Post,2004-05-13,2004,0,0,0,0.124832
23705,A Better Way to Die,2000-01-01,2000,0,0,0,1.164735
23706,All About Steve,2009-09-04,2009,15000000,40105542,25105542,9.288013
23717,In the Name of God,2007-07-29,2007,0,0,0,1.088775
23719,Trapped in Paradise,1994-12-02,1994,0,5777916,5777916,4.720595
23720,Humpday,2009-09-16,2009,0,0,0,4.368154
23724,BUtterfield 8,1960-11-04,1960,0,0,0,4.605205
23728,Our Man Flint,1966-01-16,1966,0,0,0,11.714305
23729,The Invicible Cell,2009-03-20,2009,1520000,0,-1520000,0.749969
23730,C.H.U.D.,1984-08-31,1984,1250000,3412497,2162497,4.412794
23736,Lies & Illusions,2009-08-26,2009,0,0,0,4.41396
23739,Circle of Iron,1978-07-25,1978,0,0,0,1.022584
23742,Cop Out,2010-02-26,2010,30000000,55583804,25583804,14.313079
23750,Revengers Tragedy,2002-08-06,2002,0,0,0,0.118968
23752,The Couch Trip,1988-01-15,1988,0,0,0,1.264947
23759,Centurion,2010-02-15,2010,12000000,6814789,-5185211,13.00941
23761,Alice Sweet Alice,1976-11-13,1976,340000,0,-340000,3.274172
23764,Toyland,2007-08-29,2007,0,0,0,2.549898
23767,Billa,2007-12-14,2007,0,0,0,1.430582
23776,Parugu,2008-05-01,2008,0,0,0,0.976507
23790,Magadheera,2009-08-09,2009,0,0,0,1.630422
23802,Bill Hicks: Totally Bill Hicks,1994-01-01,1994,0,0,0,0.69609
23805,The Toy,1982-12-10,1982,0,0,0,6.269867
23807,2019: After the Fall of New York,1983-07-22,1983,0,0,0,1.323491
23808,Sniper: Weapons of Retaliation,2009-05-09,2009,0,0,0,1.504633
23816,Sands Of Oblivion,2007-07-28,2007,0,0,0,4.084078
23817,The Big Bad Swim,2006-01-01,2006,0,0,0,1.231994
23823,Wrong Turn 3: Left for Dead,2009-01-01,2009,0,0,0,12.257121
23825,Rock School,2005-02-27,2005,0,0,0,1.594478
23827,Paranormal Activity,2007-09-14,2007,15000,193355800,193340800,12.706424
23830,Last Night,2010-05-11,2010,7000000,7644937,644937,15.280219
23832,For Love and Gold,1966-04-07,1966,0,1314230,1314230,1.851923
23834,Volcano High,2001-12-08,2001,0,0,0,1.941389
23843,The Listening,2006-04-28,2006,0,0,0,1.461427
23847,Across 110th Street,1972-12-19,1972,0,0,0,5.920786
23848,Halla Bol,2008-01-11,2008,0,0,0,2.561425
23853,Wish You Were Dead,2002-05-21,2002,0,0,0,0.938943
23854,The Assailant,2009-10-30,2009,5000000,0,-5000000,0.658448
23855,The First $20 Million Is Always the Hardest,2002-06-28,2002,0,0,0,6.725887
23857,White Skin,2004-09-17,2004,0,0,0,0.559559
23861,Command Decision,1948-12-23,1948,0,0,0,0.803021
23898,The Stroll,2003-01-01,2003,0,0,0,0.653556
23903,Curious George 2: Follow That Monkey!,2009-10-27,2009,0,0,0,2.24177
23908,A Midnight Clear,1992-04-24,1992,0,0,0,7.210452
23916,Paradise Alley,1978-09-22,1978,0,7185518,7185518,5.634675
23919,Porky's 3: Revenge,1985-03-22,1985,9000000,20518905,11518905,3.208108
23924,Went the Day Well?,1942-12-07,1942,0,0,0,1.923558
23928,Captain Horatio Hornblower R.N.,1951-04-10,1951,0,0,0,1.577618
23939,Stay Tuned,1992-08-14,1992,25000000,10736401,-14263599,13.72021
23941,Dancing at the Blue Iguana,2000-09-14,2000,0,0,0,1.900076
23942,Paradise,1982-03-25,1982,0,5588800,5588800,1.895489
23943,Zapped!,1982-07-23,1982,0,0,0,3.435989
23945,Carpool,1996-08-23,1996,17000000,0,-17000000,3.714049
23947,Nasty Old People,2009-10-10,2009,15000,5300,-9700,0.993784
23949,Tape,2001-01-26,2001,100000,490475,390475,3.580063
23951,Objectified,2009-03-14,2009,0,0,0,2.400134
23954,Atlantic City,1980-09-02,1980,7200000,12729678,5529678,3.835188
23957,Over the Edge,1979-11-02,1979,0,0,0,1.861082
23963,Pontypool,2009-03-06,2009,1500000,32000,-1468000,6.407207
23964,Slap Shot 2: Breaking the Ice,2002-01-01,2002,0,0,0,1.294066
23965,The White Diamond,2004-11-13,2004,0,0,0,1.107223
23966,Deadgirl,2008-09-06,2008,0,0,0,10.698928
23967,Slap Her... She's French,2002-06-13,2002,0,0,0,2.245356
23976,Nursery University,2009-04-24,2009,0,26042,26042,0.307601
23981,Iron And Silk,1991-02-15,1991,0,0,0,0.00022
23985,Cremaster 2,1999-01-01,1999,0,0,0,0.695043
23986,Cremaster 3,2002-05-15,2002,0,0,0,0.806208
23988,Stan Helsing,2009-10-27,2009,108,0,-108,5.280974
23990,Scarlet Diva,2000-05-26,2000,0,0,0,2.065757
23995,Billabong Odyssey,2003-11-07,2003,0,0,0,0.003916
23996,RiP!: A Remix Manifesto,2009-04-01,2009,0,0,0,1.22207
23997,Every Little Step,2009-04-17,2009,0,0,0,0.36752
23998,"It's Christmastime Again, Charlie Brown",1992-11-27,1992,0,0,0,1.425983
23999,Abigail's Party,1977-11-01,1977,0,0,0,0.704172
24001,The Hills Run Red,2009-06-12,2009,0,0,0,5.87477
24002,Let's Make It Legal,1951-10-31,1951,0,0,0,1.506729
24003,Clash by Night,1952-06-16,1952,0,0,0,1.019696
24004,We're Not Married!,1952-07-11,1952,0,0,0,1.241513
24005,Don't Bother to Knock,1952-07-18,1952,0,0,0,2.38281
24006,O. Henry's Full House,1952-08-07,1952,0,0,0,1.14904
24007,More Things That Happened,2007-08-14,2007,0,0,0,0.76115
24008,Monkey Business,1952-09-02,1952,0,2000000,2000000,2.853852
24010,Bus Stop,1956-08-31,1956,0,0,0,3.899327
24012,The Prince and the Showgirl,1957-06-13,1957,0,0,0,3.424195
24014,Let's Make Love,1960-10-07,1960,0,0,0,3.273251
24016,The Sheltering Sky,1990-10-24,1990,25000000,2075084,-22924916,13.798247
24018,Glen or Glenda,1953-01-01,1953,0,0,0,1.750815
24019,Angels in America,2003-12-07,2003,60000000,0,-60000000,6.386873
24020,Johnny Tsunami,1999-07-24,1999,0,0,0,2.780335
24021,The Twilight Saga: Eclipse,2010-06-23,2010,68000000,698491347,630491347,34.047399
24023,Johan Falk: GSI - Gruppen f√∂r s√§rskilda insatser,2009-06-25,2009,0,0,0,1.650679
24024,Johan Falk: Leo Gaut,2009-10-07,2009,0,0,0,2.295717
24025,Johan Falk: National Target,2009-10-06,2009,0,0,0,0.88647
24026,Johan Falk: Vapenbr√∂der,2009-09-22,2009,0,0,0,1.286971
24032,"Oh, God!",1977-10-07,1977,0,41687243,41687243,2.660367
24034,Teacher's Pet,2004-01-16,2004,10000000,0,-10000000,0.491334
24037,Open City,2008-01-10,2008,0,11095236,11095236,2.111669
24038,976-EVIL,1988-12-09,1988,0,2955917,2955917,15.360682
24041,El Cortez,2006-10-05,2006,0,0,0,2.21521
24043,States of Grace,2005-11-04,2005,0,0,0,0.73253
24047,Alien Nation: Dark Horizon,1994-10-25,1994,0,0,0,3.834165
24048,The Front Line,2006-07-16,2006,0,0,0,0.449847
24049,Sivaji: The Boss,2007-06-14,2007,12000000,19000000,7000000,1.323587
24050,The Good Life,2007-01-18,2007,0,0,0,0.889589
24051,Hardwired,2009-11-03,2009,5000000,0,-5000000,4.913101
24053,The Merry Gentleman,2008-04-16,2008,0,0,0,5.378154
24055,The Puffy Chair,2005-01-17,2005,0,0,0,0.709745
24056,The Tournament,2009-05-01,2009,8000000,0,-8000000,8.904174
24057,Wyrd Sisters,1997-05-18,1997,0,0,0,1.099806
24059,When a Man Falls,2007-02-12,2007,0,0,0,0.643454
24060,Darfur Now,2007-09-09,2007,0,0,0,0.894568
24062,The Patsy,1964-08-12,1964,0,0,0,1.149817
24065,Guncrazy,1992-09-11,1992,800000,0,-800000,4.797893
24066,"Happy, Texas",1999-12-03,1999,1700000,1943649,243649,2.939685
24068,Lucky Girl,2001-04-08,2001,0,0,0,1.426418
24070,Mixed Nuts,1994-12-21,1994,15000000,0,-15000000,2.899608
24071,Mumford,1999-09-24,1999,0,0,0,8.102656
24073,Opportunity Knocks,1990-03-30,1990,0,11359129,11359129,1.200053
24077,The Tall Guy,1989-02-01,1989,0,0,0,3.969987
24078,Off the Map,2003-01-22,2003,0,0,0,6.866857
24079,Triggermen,2002-01-01,2002,500000,0,-500000,0.447803
24081,From the Hip,1987-02-06,1987,0,9518342,9518342,0.619481
24084,The Adventures of Barry McKenzie,1972-01-01,1972,0,0,0,0.505579
24085,Barry McKenzie Holds His Own,1974-12-12,1974,0,0,0,0.670659
24086,The Boy Who Could Fly,1986-08-15,1986,0,7177431,7177431,3.791972
24090,It Waits,2005-01-01,2005,0,0,0,0.952627
24091,Crush,2009-04-01,2009,0,0,0,1.682406
24092,2LDK,2003-10-04,2003,0,0,0,0.723046
24094,Necessary Evil,2008-01-01,2008,950000,0,-950000,1.618261
24097,Don't Look in the Basement,1973-09-01,1973,0,0,0,0.689278
24099,Dreamscape,1984-08-15,1984,0,12145169,12145169,3.559119
24100,The Little Vampire,2000-10-27,2000,22000000,13555988,-8444012,9.41834
24101,The Easter Bunny Is Comin' to Town,1977-04-06,1977,0,0,0,0.90236
24102,The Land Before Time VII: The Stone of Cold Fire,2000-12-05,2000,0,0,0,3.993298
24103,Haunted Honeymoon,1986-07-25,1986,0,8033397,8033397,2.858879
24105,The Music Man,2003-02-16,2003,0,0,0,1.62656
24106,The Black Cat,1934-05-07,1934,0,0,0,8.053913
24109,Fun with Dick and Jane,1977-03-18,1977,3000000,0,-3000000,1.224832
24111,Bedlam,1946-05-10,1946,0,0,0,1.856537
24113,Town & Country,2001-04-27,2001,90000000,10372291,-79627709,1.901065
24115,How to Eat Fried Worms,2006-01-01,2006,0,13022756,13022756,4.691574
24116,The Skeptic,2009-05-01,2009,0,0,0,3.6797
24122,The Rebound,2009-09-16,2009,0,0,0,8.323775
24123,Cake,2005-05-12,2005,0,0,0,14.571699
24124,The Burning,1981-05-08,1981,1500000,0,-1500000,8.942517
24126,Warlock: The Armageddon,1993-05-01,1993,0,0,0,3.905507
24128,Stop Making Sense,1984-11-16,1984,1200000,4978922,3778922,2.359569
24129,The Simple-Minded Murderer,1982-02-12,1982,0,0,0,1.263494
24130,In Like Flint,1967-03-15,1967,0,0,0,2.433339
24133,One-Eyed Monster,2008-11-11,2008,0,0,0,2.410649
24134,Darling,1965-08-03,1965,0,0,0,1.79142
24137,An Ideal Husband,1999-04-15,1999,14000000,18535191,4535191,3.873796
24140,Bockerer,1981-11-13,1981,0,0,0,0.355935
24149,305,2008-07-08,2008,0,0,0,0.540693
24150,Halloween II,2009-08-28,2009,15000000,39421467,24421467,7.490807
24152,The Magic Christian,1969-12-12,1969,0,0,0,0.892883
24153,The Buddy Holly Story,1978-05-18,1978,1200000,14363400,13163400,2.017413
24154,Miyori's Forest,2007-08-25,2007,0,0,0,0.73615
24159,12:08 East of Bucharest,2006-06-02,2006,0,0,0,1.764346
24161,My Friends Act III,1985-01-01,1985,0,0,0,2.96348
24163,As Tears Go By,1988-06-09,1988,0,0,0,7.497042
24164,"Good Morning, Night",2003-01-01,2003,0,0,0,1.611098
24166,What Time Is It There?,2001-05-15,2001,0,0,0,1.363895
24167,Two Women,1960-12-23,1960,0,0,0,4.371898
24168,Come Dio comanda,2008-01-01,2008,0,0,0,2.016859
24169,Il cosmo sul com√≤,2008-12-19,2008,0,0,0,3.935385
24170,Private Fears in Public Places,2006-11-22,2006,0,0,0,0.977421
24171,Dry Season,2006-09-01,2006,0,0,0,0.582349
24177,Holy Tongue,2000-09-14,2000,0,0,0,0.155198
24179,Momo,2001-12-21,2001,0,0,0,0.986673
24182,"Dearest Relatives, Poisonous Relations",1992-07-30,1992,0,0,0,0.000844
24185,The Wedding Director,2006-04-21,2006,0,0,0,0.906035
24186,The Safety of Objects,2002-10-25,2002,0,0,0,1.460923
24188,Il Sorpasso,1962-12-04,1962,0,0,0,4.577991
24189,The Missing Star,2006-09-08,2006,0,0,0,1.116154
24190,Time of the Wolf,2003-08-28,2003,0,0,0,2.379551
24192,The Gospel According to Matthew,1964-09-04,1964,0,0,0,2.534184
24194,TerrorVision,1986-02-14,1986,0,0,0,4.188751
24195,Dirty Linen,1999-01-25,1999,0,0,0,0.451399
24197,Mr. & Mrs. Smith,1941-01-30,1941,0,0,0,2.761605
24198,AVH: Alien vs. Hunter,2007-12-18,2007,0,0,0,0.619336
24199,Ellis in Glamourland,2004-09-24,2004,0,0,0,1.108206
24200,Fay Grim,2006-09-11,2006,0,0,0,5.052905
24202,Blind Date,2007-05-16,2007,0,0,0,1.236072
24203,Desk Set,1957-08-02,1957,0,0,0,2.007373
24206,Silent Trigger,1996-06-26,1996,15000000,76382,-14923618,1.672406
24212,Devil Girl from Mars,1954-05-01,1954,0,0,0,1.173332
24214,The President's Analyst,1967-12-21,1967,0,0,0,0.631907
24220,California Dreamin',2007-06-01,2007,1600000,0,-1600000,1.709218
24221,The Rebel,2007-04-27,2007,1500000,0,-1500000,1.775833
24223,Brides,2004-01-01,2004,0,0,0,1.194912
24225,Afghan Star,2009-06-26,2009,0,101543,101543,0.476791
24226,The Verdict,1982-12-08,1982,16000000,53977250,37977250,9.596883
24229,The Killers,1964-07-07,1964,0,0,0,4.202642
24230,Nemesis,1992-12-26,1992,0,0,0,11.48313
24232,Is It College Yet?,2002-01-01,2002,0,0,0,0.782377
24235,Champion,2005-03-12,2005,0,0,0,1.969006
24236,"Now You See Him, Now You Don't",1972-07-12,1972,0,0,0,1.215839
24238,Mary and Max,2009-02-09,2009,590235,1725381,1135146,8.888393
24241,And Starring Pancho Villa as Himself,2003-09-07,2003,0,0,0,1.125806
24243,As Melhores Coisas do Mundo,2010-05-22,2010,0,0,0,0.686956
24248,Barabbas,1961-12-23,1961,0,0,0,1.846624
24249,Bad Influence,1990-03-09,1990,0,0,0,2.301922
24251,"I Want a Dog for Christmas, Charlie Brown",2003-12-09,2003,0,0,0,1.132124
24253,The Girl Who Played with Fire,2009-09-18,2009,0,66995253,66995253,14.38601
24254,Rude Awakening,1989-08-16,1989,0,3169719,3169719,0.453698
24257,The Endless Summer 2,1994-06-03,1994,0,0,0,0.408159
24258,We Have Only One Life,1958-01-01,1958,0,0,0,0.264598
24259,On the Run,2002-09-11,2002,0,0,0,0.103334
24260,Inspector Blunder,1980-12-03,1980,0,0,0,1.603415
24264,Sheena,1984-08-17,1984,25000000,5778353,-19221647,4.11214
24266,The Man from Snowy River,1982-03-02,1982,3500000,20659423,17159423,3.382894
24269,The Temptations,1998-11-01,1998,8000000,0,-8000000,1.607355
24271,The Maiden Heist,2009-05-09,2009,20000000,0,-20000000,6.776165
24272,Joseph and the Amazing Technicolor Dreamcoat,1999-11-07,1999,0,0,0,2.972002
24273,Happy Campers,2001-01-21,2001,15000000,0,-15000000,1.903358
24274,Dead & Buried,1981-05-29,1981,3000000,216166,-2783834,3.891243
24276,Matewan,1987-08-28,1987,4000000,1680358,-2319642,3.350126
24285,Phileine Says Sorry,2003-10-09,2003,4170000,0,-4170000,0.970785
24293,Goemon,2009-03-17,2009,9000000,16000000,7000000,5.074153
24330,Seventh Moon,2008-09-20,2008,0,0,0,7.961566
24331,Scanners II: The New Order,1991-06-28,1991,0,14225876,14225876,2.201123
24341,Dolls,1987-03-01,1987,0,0,0,4.545885
24348,Powaqqatsi,1988-04-29,1988,2500000,589244,-1910756,2.726061
24349,Minnie and Moskowitz,1971-12-22,1971,0,0,0,2.096508
24351,Flight of Fury,2007-02-20,2007,12000000,0,-12000000,5.448576
24356,Masked and Anonymous,2003-08-08,2003,0,0,0,2.524264
24357,Final Flight of the Osiris,2003-03-21,2003,0,0,0,2.679319
24363,House of D,2005-04-15,2005,0,0,0,4.587746
24365,The Final Inquiry,2006-12-13,2006,0,0,0,2.187464
24381,The Titfield Thunderbolt,1953-03-04,1953,0,0,0,2.069436
24382,Big Deal on Madonna Street,1958-06-06,1958,0,0,0,6.035008
24385,Splinterheads,2009-11-06,2009,0,0,0,0.579509
24388,Bag Boy,2007-09-14,2007,0,0,0,0.996333
24392,The Dark Lurking,2010-01-01,2010,1000000,0,-1000000,1.484663
24395,The Hill,1965-06-22,1965,0,0,0,3.467376
24397,Kiss Me Again,2006-04-28,2006,0,0,0,1.649473
24398,Bodysong,2003-12-05,2003,0,0,0,0.520126
24402,Emmanuelle,1974-06-25,1974,500000,0,-500000,12.855473
24403,Away with Words,1999-08-07,1999,0,0,0,1.022589
24405,Chasers,1994-04-22,1994,0,1596687,1596687,9.85327
24408,C.S.A.: The Confederate States of America,2004-01-01,2004,0,0,0,2.106051
24409,Nightmare Man,2006-06-13,2006,0,0,0,1.364969
24410,K-20: The Fiend with Twenty Faces,2008-12-20,2008,0,0,0,6.242159
24411,The Shepherd: Border Patrol,2008-03-04,2008,0,0,0,3.330171
24417,Apartment 1303,2007-10-23,2007,0,0,0,1.746599
24418,Cirque du Freak: The Vampire's Assistant,2009-10-23,2009,40000000,28169671,-11830329,10.829432
24420,The Time Traveler's Wife,2009-08-14,2009,39000000,101229792,62229792,13.682598
24421,Stag Night,2008-06-26,2008,0,0,0,1.504671
24424,Ajami,2009-09-17,2009,0,0,0,3.892393
24426,A.R.O.G.,2008-12-03,2008,0,0,0,1.507568
24428,The Avengers,2012-04-25,2012,220000000,1519557910,1299557910,89.887648
24429,The Brink's Job,1978-12-08,1978,0,0,0,7.196137
24432,Doogal,2006-02-24,2006,0,0,0,2.524859
24436,A Diva's Christmas Carol,2000-12-13,2000,0,0,0,1.046687
24438,Did You Hear About the Morgans?,2009-12-17,2009,58000000,85280250,27280250,7.323405
24439,Joe Rogan: Live,2006-09-19,2006,0,0,0,0.314084
24440,Robert Newman's History of Oil,2006-10-02,2006,0,0,0,0.106485
24442,The Black Shield Of Falworth,1954-09-02,1954,0,0,0,1.862466
24444,Zat√¥ichi Meets the One-Armed Swordsman,1971-01-13,1971,0,0,0,2.657711
24446,Holiday in Handcuffs,2007-12-09,2007,0,0,0,9.267314
24447,Louis C.K.: Shameless,2007-01-12,2007,0,0,0,2.654295
24448,7/G Rainbow Colony,2004-10-15,2004,0,0,0,0.637825
24450,Pretty Ugly People,2009-09-18,2009,0,0,0,1.079616
24452,The Little Shop of Horrors,1960-09-14,1960,30000,0,-30000,4.327466
24453,The Razor's Edge,1984-10-19,1984,0,0,0,1.697455
24458,The Age of Stupid,2009-09-21,2009,0,0,0,1.101593
24461,Asylum,2005-09-09,2005,0,0,0,2.721316
24469,Fish Tank,2009-05-14,2009,3000000,2357852,-642148,6.070216
24470,"South of Heaven, West of Hell",2000-01-01,2000,0,0,0,0.701694
24475,Coco Chanel,2008-09-13,2008,0,0,0,2.090843
24476,Beethoven's 3rd,2000-07-25,2000,0,0,0,4.637328
24477,Beethoven's 5th,2003-12-02,2003,0,0,0,3.973595
24479,"Look, Up in the Sky: The Amazing Story of Superman",2006-06-12,2006,0,0,0,1.110539
24480,Partly Cloudy,2009-05-28,2009,0,0,0,12.916643
24481,Born Yesterday,1950-12-25,1950,0,0,0,6.085287
24486,Jack the Ripper,1988-10-21,1988,0,0,0,2.102138
24487,Passing Strange,2009-08-21,2009,0,0,0,0.321534
24488,Demonlover,2002-05-19,2002,0,0,0,5.821242
24499,Scar,2007-05-19,2007,0,0,0,6.615604
24506,The Enemies of Reason,2007-01-01,2007,0,0,0,0.7156
24508,The Lineup,1958-06-11,1958,0,0,0,1.018844
24518,"The Long, Long Trailer",1954-02-18,1954,0,0,0,1.36565
24524,Ad Fundum,1993-01-01,1993,0,0,0,1.380589
24525,Hurlyburly,1998-12-25,1998,0,0,0,7.352493
24527,Undefeatable,1993-09-29,1993,0,0,0,1.350475
24546,Into the Sun,2005-03-08,2005,15000000,0,-15000000,3.607833
24548,Just One of the Guys,1985-04-26,1985,11500000,0,-11500000,3.922068
24553,All the Invisible Children,2005-09-01,2005,0,0,0,2.271382
24554,The Land Before Time X: The Great Longneck Migration,2003-12-02,2003,0,0,0,4.212417
24556,The Land Before Time XI: Invasion of the Tinysauruses,2005-01-11,2005,0,0,0,4.40127
24558,Loose Cannons,1990-02-09,1990,1500000,5585154,4085154,1.961208
24559,Slaughterhouse-Five,1972-03-15,1972,3200000,0,-3200000,5.250311
24560,Sour Grapes,1998-01-01,1998,0,0,0,1.684341
24561,Yatterman,2009-02-06,2009,0,0,0,1.274672
24563,Mars Needs Women,1967-01-01,1967,0,0,0,0.482867
24564,Radiant City,2007-05-30,2007,0,0,0,0.06218
24565,Our Daily Bread,2006-04-21,2006,0,0,0,0.942629
24566,Examined Life,2008-09-05,2008,0,0,0,0.624313
24567,The Narrows,2008-09-08,2008,0,0,0,2.012895
24568,Carry On Follow That Camel,1967-09-01,1967,0,0,0,1.114848
24569,Carry On Henry,1971-01-01,1971,0,0,0,1.572535
24570,Carry On Loving,1970-09-20,1970,0,0,0,2.393864
24571,Carry On Matron,1972-05-05,1972,0,0,0,1.641968
24574,Steel Toes,2006-01-01,2006,0,0,0,0.426806
24575,Raise the Titanic,1980-01-01,1980,0,0,0,2.132843
24578,The Waiting Room,2007-08-18,2007,0,0,0,1.244581
24580,The Creeping Unknown,1955-08-26,1955,0,0,0,11.455239
24582,Manufactured Landscapes,2006-09-09,2006,0,240239,240239,1.170876
24584,Get Real,1998-08-16,1998,0,0,0,2.196587
24585,Fraternity Vacation,1985-12-04,1985,0,3333306,3333306,3.90299
24587,American Pimp,1999-01-01,1999,0,0,0,1.152591
24589,Dug's Special Mission,2009-11-09,2009,0,0,0,10.998646
24590,Conversations with God,2006-01-25,2006,0,0,0,1.198126
24603,All The Best,2009-10-16,2009,7500000,0,-7500000,1.071906
24615,Aloha Scooby-Doo!,2005-01-01,2005,0,0,0,10.584972
24617,Atomic Twister,2002-06-09,2002,0,0,0,2.285591
24618,Bee Season,2005-09-03,2005,14000000,6856989,-7143011,2.308846
24619,Blind Horizon,2003-12-14,2003,5000000,0,-5000000,6.041539
24621,Chasing Papi,2003-04-16,2003,0,6126237,6126237,1.251134
24624,The Detonator,2006-04-25,2006,15000000,0,-15000000,2.306707
24625,Dinner with Friends,2001-01-01,2001,0,0,0,5.77754
24626,Dance 'Til Dawn,1988-10-23,1988,0,0,0,0.973018
24631,"Maria, ihm schmeckt's nicht!",2009-08-05,2009,0,0,0,1.907941
24632,The Mad,2007-05-22,2007,0,0,0,1.464656
24633,Phantom Pain,2009-04-30,2009,0,0,0,1.161097
24634,Ghost Story,1981-12-18,1981,0,0,0,7.878735
24645,The Turning,1992-01-01,1992,0,0,0,0.129847
24646,Den ofrivillige golfaren,1991-12-25,1991,0,0,0,2.059092
24647,H√§lsoresan,1999-12-25,1999,0,0,0,1.84439
24649,Wishcraft,2002-09-25,2002,0,0,0,0.623175
24650,The Fountainhead,1949-07-02,1949,0,0,0,4.866997
24653,The Consequences of Love,2004-09-24,2004,0,0,0,5.298931
24654,What the Bleep! Down the Rabbit Hole,2006-02-03,2006,0,138913,138913,1.655202
24655,The Car,1977-05-12,1977,0,0,0,3.526676
24657,The Sacrifice,1986-05-14,1986,0,300653,300653,5.001997
24660,A Detective Story,2003-04-01,2003,0,0,0,1.798465
24662,Cats Don't Dance,1997-03-26,1997,32000000,3566637,-28433363,3.406836
24663,The Open Road,2009-02-07,2009,0,0,0,1.807794
24664,Bamboozled,2000-10-06,2000,0,0,0,4.380258
24665,Jim Carrey: Unnatural Act,1991-01-01,1991,0,0,0,1.128902
24671,River Queen,2005-09-12,2005,0,0,0,1.20343
24674,The Eye 2,2004-03-18,2004,0,0,0,4.496225
24675,Beyond,2003-06-03,2003,0,0,0,1.521274
24676,Fatal Contact: Bird Flu in America,2006-05-09,2006,0,0,0,1.267276
24678,Disney's American Legends,2001-02-12,2001,0,0,0,1.256023
24679,Bird,1988-07-01,1988,0,0,0,4.942377
24681,White Wedding,2009-01-01,2009,0,0,0,0.35292
24683,Razortooth,2007-01-01,2007,0,0,0,3.398983
24684,An Education,2009-10-29,2009,7500000,26096852,18596852,8.593196
24685,Viper In The Fist,2004-10-06,2004,0,0,0,1.818566
24686,Love and the City,2009-03-05,2009,3500000,9112193,5612193,1.03513
24696,Tom and Jerry: A Nutcracker Tale,2007-10-02,2007,0,0,0,2.270361
24701,"Puff, Puff, Pass",2006-05-09,2006,0,0,0,5.419965
24703,Trekkies 2,2004-04-20,2004,0,0,0,0.65191
24707,Addicted to Plastic,2008-10-04,2008,0,0,0,0.530203
24709,Lost in the Barrens,1990-01-01,1990,0,0,0,0.7
24711,Above Suspicion,1995-01-01,1995,0,0,0,3.397781
24712,Johan Falk: The Outlaws,2009-11-04,2009,0,0,0,2.334434
24713,Johan Falk: Operation N√§ktergal,2009-11-03,2009,0,0,0,1.546782
24729,The Toughest Man in the World,1984-11-07,1984,0,0,0,0.617749
24731,Short Time,1990-05-04,1990,0,0,0,1.302083
24732,Harrison Bergeron,1995-08-13,1995,0,0,0,1.42682
24734,K2,1991-10-09,1991,0,3106559,3106559,2.995373
24735,Agnes of God,1985-08-21,1985,0,0,0,3.941689
24736,A Far Off Place,1993-03-12,1993,0,12890752,12890752,9.040158
24739,Miracle Mile,1989-05-19,1989,3000000,1145404,-1854596,10.018693
24740,The Entity,1982-09-30,1982,0,13277558,13277558,6.302682
24742,Secret Admirer,1985-06-14,1985,0,8622757,8622757,4.44326
24745,Sweeney Todd: The Demon Barber of Fleet Street,1982-09-12,1982,0,0,0,0.314668
24746,Six-String Samurai,1998-09-18,1998,2000000,124494,-1875506,2.740989
24747,Bobby Jones: Stroke of Genius,2004-04-30,2004,0,0,0,4.052084
24748,Hud,1963-05-29,1963,2500000,10000000,7500000,4.526285
24749,Iceman,1984-04-13,1984,0,0,0,2.491724
24750,Time After Time,1979-08-31,1979,0,0,0,5.65127
24751,The Conqueror,1956-03-28,1956,0,0,0,2.050561
24752,Dragon Ball Z: Cooler's Revenge,1991-07-20,1991,0,0,0,5.425533
24756,The Art of War III: Retribution,2009-01-01,2009,0,0,0,1.986279
24757,Stoic,2009-01-01,2009,2000000,0,-2000000,2.584212
24767,Iron Will,1994-01-14,1994,0,0,0,9.074631
24768,Nothing Funny,1996-02-02,1996,0,0,0,0.483034
24769,Psy II: Ostatnia krew,1994-04-05,1994,0,0,0,0.778906
24772,Going Berserk,1983-09-30,1983,0,0,0,0.846545
24774,The Idiot,1951-05-23,1951,0,0,0,2.147226
24775,Blast,2004-01-01,2004,20000000,0,-20000000,1.52455
24777,Private Parts,1972-09-01,1972,0,0,0,0.578458
24782,Buster,1988-09-16,1988,0,0,0,1.645134
24784,Jimmy Carr: Telling Jokes,2009-11-02,2009,0,0,0,0.414557
24786,In Tranzit,2007-05-16,2007,0,0,0,5.005837
24787,Scooby-Doo Meets the Boo Brothers,1987-11-01,1987,0,0,0,2.248518
24789,Subspecies,1991-08-08,1991,0,0,0,2.159789
24791,A,1998-01-01,1998,0,0,0,0.001715
24792,Between the Folds,2008-01-01,2008,0,0,0,1.19675
24793,A Knight in Camelot,1998-11-08,1998,0,0,0,9.062226
24794,Air Bud: Spikes Back,2003-07-01,2003,5000000,0,-5000000,1.757851
24795,Angels in the Outfield,1994-07-15,1994,0,50236831,50236831,10.892812
24797,Magic Man,2009-11-04,2009,0,0,0,1.613703
24798,True Stories,1986-10-10,1986,0,0,0,3.09897
24799,Wolvesbayne,2009-10-12,2009,0,0,0,3.584192
24801,Cow Belles,2006-03-24,2006,0,0,0,3.760464
24803,Julie & Julia,2009-08-06,2009,40000000,129540499,89540499,8.142089
24804,Black Dynamite,2009-10-16,2009,2900000,296557,-2603443,10.92143
24805,The Ten Commandments,1923-11-23,1923,0,0,0,1.725825
24807,Mr. Deeds Goes to Town,1936-04-12,1936,0,0,0,3.85412
24808,Something Wicked This Way Comes,1983-04-29,1983,19000000,5656087,-13343913,3.985819
24810,Nora Roberts' Carolina Moon,2007-02-19,2007,0,0,0,1.992832
24816,The Gnome-Mobile,1967-07-17,1967,0,0,0,1.479408
24821,Hidden,2009-03-04,2009,2215773,0,-2215773,1.602258
24822,Seven Days,2007-11-14,2007,0,0,0,1.726038
24825,The Octagon,1980-08-14,1980,0,18971000,18971000,8.79061
24826,Disorderlies,1987-07-14,1987,0,10348437,10348437,1.416498
24827,Ajab Prem Ki Ghazab Kahani,2009-11-05,2009,0,26000000,26000000,2.383191
24828,Leonard Part 6,1987-12-18,1987,0,4916871,4916871,3.47537
24830,They Call Me Bruce?,1982-11-10,1982,0,16894678,16894678,1.223424
24831,Piranha,1978-08-03,1978,660000,0,-660000,16.038604
24833,Santa Buddies,2009-11-19,2009,0,0,0,4.688709
24837,August Underground's Mordum,2003-01-01,2003,300,0,-300,1.340559
24858,Eternity and a Day,1998-01-01,1998,0,0,0,1.266908
24860,The Memory Of A Killer,2003-10-15,2003,0,0,0,4.368257
24862,Crash and Burn,1990-01-01,1990,0,0,0,1.637273
24863,Holiday Affair,1949-12-24,1949,0,0,0,1.993116
24868,Offspring,2009-02-05,2009,0,0,0,4.009138
24869,Ink,2009-01-23,2009,250000,0,-250000,5.124589
24870,Viva,2007-01-01,2007,0,0,0,0.950301
24873,Death Wish 3,1985-11-01,1985,9000000,16945171,7945171,12.829904
24874,Dark Mirror,2007-01-01,2007,0,0,0,2.123997
24881,Love Hurts,2009-11-13,2009,0,0,0,1.994467
24883,The Black Stallion Returns,1983-03-25,1983,0,9800000,9800000,1.258022
24885,Medicine for Melancholy,2008-03-07,2008,13000,0,-13000,0.464837
24886,Minor Details,2009-02-05,2009,0,0,0,0.169039
24889,Overheard,2009-07-23,2009,0,0,0,6.596168
24908,Happenstance,2000-06-12,2000,0,0,0,1.705466
24909,The Young Americans,1993-10-08,1993,0,0,0,1.51734
24913,April Fool's Day,1986-03-27,1986,5000000,0,-5000000,10.301342
24914,Kid's Story,2003-06-02,2003,0,0,0,3.253814
24916,Bio Zombie,1998-06-11,1998,0,0,0,0.870092
24918,The Twelve Chairs,1970-10-28,1970,0,0,0,3.869883
24919,Burial Ground,1981-01-23,1981,0,0,0,2.364193
24920,City of the Living Dead,1980-08-11,1980,0,0,0,8.54341
24921,Rise of the Gargoyles,2009-06-21,2009,0,0,0,2.410279
24922,Ebola Syndrome,1996-06-15,1996,0,0,0,2.37715
24923,Messiah of Evil,1973-01-01,1973,0,0,0,2.268896
24924,Night of the Demons,1988-10-14,1988,1200000,3109904,1909904,6.942907
24925,Night of the Demons 2,1994-05-31,1994,1300000,0,-1300000,1.939337
24926,Winnie the Pooh and a Day for Eeyore,1983-01-01,1983,0,12000000,12000000,1.235038
24927,Night Of The Living Dead 3D,2007-05-06,2007,3000000,1449945,-1550055,1.017103
24929,Return of the Living Dead Part II,1988-01-15,1988,6200000,9205924,3005924,6.606325
24935,Return of the Living Dead: Necropolis,2005-10-15,2005,0,0,0,8.195958
24936,The Deep End,2001-01-21,2001,3000000,0,-3000000,2.541051
24939,Return of the Living Dead: Rave to the Grave,2005-10-15,2005,0,0,0,8.186979
24940,Head Over Heels,2001-02-02,2001,14000000,10424470,-3575530,5.594987
24948,Zombies! Zombies! Zombies!,2008-09-09,2008,0,0,0,0.505325
24951,Prancer,1989-11-17,1989,0,0,0,1.912324
24955,The New Country,2000-11-24,2000,0,0,0,1.2757
24959,Program,2003-03-01,2003,0,0,0,1.851765
24960,World Record,2003-06-03,2003,0,0,0,2.774738
24961,The Wiz,1978-10-24,1978,24000000,21049053,-2950947,4.233081
24962,Magic in the Water,1995-08-30,1995,0,0,0,1.496718
24963,Dead Air,2009-10-27,2009,0,0,0,1.599643
24964,Bring on the Night,1985-11-08,1985,0,0,0,0.741503
24965,Gunga Din,1939-01-24,1939,0,0,0,7.425486
24971,Eagles Over London,1969-09-20,1969,0,0,0,0.444586
24973,The Egyptian,1954-08-25,1954,5000000,15000000,10000000,10.374608
24977,Michael Jordan to the Max,2000-05-05,2000,0,21268532,21268532,2.047132
24978,Paper Soldiers,2002-06-01,2002,0,0,0,1.447595
24979,"Nick Swardson: Seriously, Who Farted?",2009-05-19,2009,0,0,0,1.048636
24982,Ghosts of the Abyss,2003-04-10,2003,13000000,17040871,4040871,4.835446
24985,The Heart of Me,2002-01-01,2002,7000000,0,-7000000,1.49983
24986,Sophie's Revenge,2009-08-13,2009,0,0,0,1.199484
24993,Kickboxer 2:  The Road Back,1991-01-30,1991,0,1250712,1250712,8.500628
24998,Gates of Heaven,1978-10-01,1978,0,0,0,4.027423
24999,The Great Happiness Space: Tale of an Osaka Love Thief,2006-01-01,2006,0,0,0,1.088298
25001,Hanky Panky,1982-06-04,1982,0,0,0,8.240643
25003,Friends of God: A Road Trip with Alexandra Pelosi,2007-01-25,2007,0,0,0,0.57686
25004,Black Ice,2007-10-19,2007,0,0,0,1.238266
25005,Eddie and the Cruisers II: Eddie Lives!,1989-01-01,1989,0,0,0,1.591236
25006,State Property,2002-01-18,2002,0,2106838,2106838,0.620718
25007,Death of a Dynasty,2005-04-29,2005,0,42108,42108,0.902846
25009,Mogambo,1953-10-09,1953,0,0,0,2.994187
25010,The Flamingo Kid,1984-12-21,1984,0,0,0,4.418591
25014,Harrison's Flowers,2000-09-23,2000,0,0,0,1.447713
25016,Pygmalion,1938-10-06,1938,0,0,0,1.272174
25018,Leatherface: Texas Chainsaw Massacre III,1990-01-12,1990,0,5765562,5765562,5.79907
25019,The Beatles: The First U.S. Visit,1991-11-13,1991,0,0,0,0.303927
25021,The Alien Saga,2002-01-01,2002,0,0,0,0.145984
25028,The Dead Next Door,1989-11-10,1989,0,0,0,0.901519
25032,Alexander: The Neva Battle,2008-05-01,2008,0,0,0,1.524195
25033,The Last Horror Movie,2004-06-25,2004,0,0,0,1.49252
25037,The Life and Death of Colonel Blimp,1943-06-10,1943,0,0,0,2.982447
25038,2:22,2008-09-24,2008,0,0,0,5.543966
25041,The American Mall,2008-08-11,2008,0,0,0,3.367755
25047,Le Deuxi√®me Souffle,1966-11-01,1966,0,0,0,1.40411
25048,Le Donk & Scor-zay-zee,2009-10-09,2009,0,0,0,0.874819
25050,Still Walking,2008-06-28,2008,0,0,0,6.98658
25051,Distance,2001-05-26,2001,0,0,0,1.138694
25053,Air Doll,2009-09-26,2009,0,0,0,4.173112
25055,Transmorphers,2007-06-26,2007,0,0,0,1.874027
25058,Can Mr. Smith Get to Washington Anymore?,2006-06-16,2006,0,0,0,0.056741
25059,Homeward Bound II: Lost in San Francisco,1996-03-08,1996,0,32709423,32709423,14.657754
25060,Zombie Honeymoon,2004-01-01,2004,0,0,0,2.702334
25062,A Taste of Honey,1961-09-01,1961,0,0,0,1.829632
25066,Tales from the Hood,1995-05-24,1995,6000000,12000000,6000000,2.86007
25073,Deadline,2009-01-01,2009,0,0,0,9.71579
25074,Mr. Canton and Lady Rose,1989-06-15,1989,0,0,0,7.170685
25078,Cat Soup,2001-02-21,2001,0,0,0,0.581091
25079,Junkers Come Here,1995-03-18,1995,0,0,0,0.307422
25087,Bloodsport II,1996-03-01,1996,0,684351,684351,3.085207
25088,The Willies,1990-12-27,1990,0,0,0,1.625023
25095,Wuthering Heights,1992-10-16,1992,0,0,0,5.215985
25099,"Fast, Cheap & Out of Control",1997-10-03,1997,0,832735,832735,2.117703
25103,Night of the Demon,1957-12-17,1957,0,0,0,3.237326
25105,Flower Drum Song,1961-11-09,1961,0,0,0,0.50835
25109,Evil Roy Slade,1972-02-18,1972,0,0,0,0.944223
25110,Pauline & Paulette,2001-06-27,2001,0,0,0,0.324682
25111,Far Out Man,1990-05-11,1990,500000,0,-500000,1.522173
25112,Ballast,2008-01-19,2008,0,0,0,1.020165
25113,The Four Seasons,1981-05-22,1981,0,0,0,7.531501
25114,20th Century Boys - Chapter 2: The Last Hope,2009-01-30,2009,0,0,0,1.747031
25117,Bill Hicks: Revelations,1993-05-27,1993,0,0,0,1.069902
25119,Are You Scared?,2006-09-12,2006,0,0,0,1.487765
25121,Unnaipol Oruvan,2009-09-18,2009,0,0,0,0.902673
25124,Kung Fu Chefs,2009-02-19,2009,0,0,0,1.705604
25126,Six Shooter,2004-01-01,2004,200000,0,-200000,2.737149
25128,Love & Sex,2000-01-24,2000,0,0,0,9.684941
25132,Shorts,2009-08-21,2009,40000000,28972508,-11027492,4.021983
25133,Transylvania 6-5000,1985-11-08,1985,0,0,0,2.006718
25137,Beyond a Reasonable Doubt,2009-02-05,2009,25000000,4388563,-20611437,5.1991
25142,The Banishment,2007-06-01,2007,0,0,0,2.203486
25143,My Boy Jack,2007-11-11,2007,0,0,0,1.389902
25147,Jude,1996-02-06,1996,7000000,405000,-6595000,3.379677
25148,Charlie Chan at the Olympics,1937-05-21,1937,0,0,0,1.131624
25150,Awesome; I Fuckin' Shot That!,2006-03-31,2006,0,0,0,0.220449
25151,Mutants,2008-10-31,2008,4000000,0,-4000000,2.77735
25154,The Marc Pease Experience,2009-08-21,2009,0,0,0,6.236016
25155,The Stepfather,1987-01-22,1987,0,0,0,4.826581
25160,George Carlin: Doin' it Again,1990-03-23,1990,0,0,0,1.169166
25161,George Carlin: Jammin' in New York,1992-04-24,1992,0,0,0,1.88795
25164,Screwballs,1983-04-01,1983,0,0,0,1.551446
25166,Drowning Mona,2000-03-03,2000,16000000,15427192,-572808,4.372616
25167,Bye Bye Birdie,1963-04-04,1963,0,0,0,12.535244
25168,The Crazy Life,2008-09-20,2008,0,0,0,1.778179
25172,Komodo,1999-01-01,1999,0,0,0,2.175912
25180,Anne Of Green Gables: The Continuing Story,2000-07-23,2000,1100000,0,-1100000,2.761919
25182,Love Finds A Home,2009-04-11,2009,0,0,0,1.604676
25183,Paper Heart,2009-07-31,2009,1000000,1296971,296971,7.648005
25186,Janky Promoters,2009-10-16,2009,10000000,9069,-9990931,1.192891
25188,The Last Picture Show,1971-10-03,1971,1300000,29133000,27833000,5.961382
25189,The Mirror Has Two Faces,1996-11-15,1996,42000000,0,-42000000,4.803721
25190,The Sun Also Rises,1957-08-23,1957,0,0,0,1.368063
25195,Leap Year,2010-01-08,2010,19000000,29922472,10922472,7.432311
25196,Crazy Heart,2009-12-16,2009,7000000,39462438,32462438,9.347931
25199,Teen Witch,1989-04-28,1989,0,27843,27843,4.649104
25205,The Concert,2009-09-01,2009,0,0,0,4.318909
25208,The Caveman's Valentine,2001-01-19,2001,0,0,0,9.001823
25209,Annie Get Your Gun,1950-05-17,1950,3768785,8000000,4231215,2.090588
25212,Deterrence,2000-03-10,2000,0,0,0,3.682868
25218,Live!,2007-01-01,2007,0,0,0,12.376901
25221,For the Boys,1991-11-22,1991,40000000,23202444,-16797556,10.336913
25224,Masterminds,1997-08-22,1997,0,0,0,6.963206
25228,Darling,2007-02-09,2007,0,0,0,0.472319
25232,This Is My Father,1999-05-07,1999,0,0,0,1.704254
25234,Evil Ed,1995-11-01,1995,0,0,0,1.63905
25237,Come and See,1985-07-01,1985,0,0,0,12.643242
25239,I Spit on Your Grave,1978-11-02,1978,650000,0,-650000,12.412877
25241,Squirm,1976-07-30,1976,0,0,0,3.192931
25248,Saint Ralph,2004-09-11,2004,0,0,0,2.488542
25251,Borsalino,1970-05-19,1970,0,3,3,4.471645
25253,Crooks in Clover,1963-11-27,1963,0,0,0,4.690267
25259,Seven Minutes,2009-06-12,2009,0,0,0,0.419191
25264,I as in Icarus,1979-12-12,1979,0,0,0,14.958978
25269,Article 99,1992-03-13,1992,18000000,6375979,-11624021,2.471038
25272,Under the Salt,2008-10-17,2008,0,0,0,0.755399
25283,Four Shades of Brown,2004-01-25,2004,0,0,0,1.345651
25284,The Last Seduction,1994-05-26,1994,2500000,0,-2500000,4.187079
25290,Year of the Jellyfish,1984-11-14,1984,0,0,0,2.071165
25293,The Hound of the Baskervilles,2000-10-28,2000,0,0,0,0.937805
25296,Pushing Hands,1992-02-01,1992,400000,152322,-247678,1.638622
25297,Cannery Row,1982-02-12,1982,0,0,0,2.086954
25300,I'm Not Scared,2003-02-08,2003,0,0,0,4.422618
25305,The Gumball Rally,1976-07-28,1976,0,0,0,6.627829
25312,Yes,2005-08-05,2005,0,0,0,4.579994
25313,P.S.,2004-10-15,2004,0,0,0,2.669824
25318,Escape from Sobibor,1987-04-12,1987,0,0,0,3.515282
25319,The Masque of the Red Death,1964-06-24,1964,0,0,0,11.587199
25320,Hysteria: The Def Leppard Story,2001-07-18,2001,0,0,0,2.046809
25329,The Echo,2008-05-25,2008,0,0,0,5.003455
25330,Dutch,1991-07-19,1991,17000000,4603929,-12396071,8.237799
25334,Wondrous Oblivion,2004-04-23,2004,0,0,0,0.336644
25335,Hellsinki,2009-01-09,2009,2500000,0,-2500000,0.97247
25338,The Silent Partner,1978-09-07,1978,0,0,0,2.745838
25350,Imaginary Heroes,2004-09-14,2004,10000000,0,-10000000,2.994171
25353,The True Story of Puss 'n Boots,2009-04-01,2009,0,0,0,0.946277
25354,Gardener of Eden,2007-04-26,2007,0,0,0,1.886995
25355,Irma Vep,1996-09-06,1996,0,0,0,1.808369
25356,The Break-up Artist,2009-08-09,2009,0,0,0,1.191485
25358,Katt Williams: Live,2006-09-26,2006,0,0,0,0.306781
25360,Jack the Giant Killer,1962-05-17,1962,0,0,0,5.397223
25361,Thunderbird 6,1968-08-03,1968,0,0,0,0.922944
25364,Ace in the Hole,1951-06-29,1951,1821052,1300000,-521052,11.046411
25366,Methadonia,2005-10-06,2005,0,0,0,0.108379
25373,A Cry in the Wild,1990-06-01,1990,0,1,1,0.80227
25376,The Secret in Their Eyes,2009-08-13,2009,2000000,33965843,31965843,11.251632
25377,Paintball,2009-04-24,2009,0,0,0,3.861409
25379,The Blue Butterfly,2004-02-20,2004,0,0,0,1.660018
25381,Night Passage,1957-07-24,1957,0,0,0,1.68548
25385,Tobruk,1967-02-07,1967,0,0,0,1.483111
25386,The 39 Steps,1959-03-13,1959,0,0,0,1.451635
25388,March or Die,1977-09-08,1977,0,0,0,1.632755
25389,Matinee,1993-01-29,1993,0,9532895,9532895,7.256473
25391,Cyborg 3: The Recycler,1995-12-19,1995,0,0,0,1.103932
25392,Destination Moon,1950-06-26,1950,0,0,0,0.940976
25395,Blood Trails,2006-04-20,2006,0,0,0,0.583192
25403,Dear Diary,1993-10-12,1993,0,0,0,2.904734
25405,Taking Chance,2009-09-21,2009,0,0,0,2.804378
25407,Riff-Raff,1947-06-28,1947,0,0,0,0.436278
25413,The Suspect,1944-12-01,1944,0,0,0,0.724986
25423,Kung Fu Killer,2008-08-17,2008,0,0,0,0.942089
25425,Drunken Tai Chi,1984-05-31,1984,0,0,0,1.295722
25426,Coronado,2003-09-25,2003,0,0,0,1.029389
25428,I Love Your Work,2003-10-05,2003,0,0,0,1.224042
25430,All the King's Men,1949-11-08,1949,0,0,0,3.975372
25431,Adam's Rib,1949-11-18,1949,0,0,0,3.651233
25434,The Home Song Stories,2007-02-09,2007,0,0,0,0.567031
25435,Treed Murray,2001-09-13,2001,0,0,0,0.521044
25438,Trick or Treat,1986-10-24,1986,0,6797218,6797218,2.612214
25440,Widows' Peak,1994-05-13,1994,0,0,0,0.409427
25441,Never a Dull Moment,1968-06-26,1968,0,0,0,1.942718
25445,The Happiest Millionaire,1967-06-26,1967,0,0,0,3.395277
25447,Tapeheads,1988-10-21,1988,0,343786,343786,1.693701
25450,Ratko: The Dictator's Son,2009-06-01,2009,0,0,0,0.597435
25451,Taking Chances,2009-11-24,2009,0,0,0,2.131755
25460,Return to Sender,2004-09-17,2004,7800000,0,-7800000,2.463468
25461,Raising Victor Vargas,2002-05-16,2002,800000,2816116,2016116,1.178723
25462,Two Can Play That Game,2001-09-07,2001,6000000,0,-6000000,2.294632
25466,Mutant Action,1993-02-03,1993,0,0,0,5.951804
25467,Before I Self Destruct,2009-11-16,2009,0,0,0,1.054892
25468,My Dinner with Andr√©,1981-10-11,1981,0,0,0,3.875264
25471,The King of Masks,1997-12-20,1997,0,1,1,2.291724
25472,Merry Madagascar,2009-11-16,2009,0,0,0,4.763307
25473,Walking Tall,1973-02-22,1973,0,0,0,4.689964
25474,Accident,2009-09-24,2009,0,0,0,2.773937
25475,Tinker Bell and the Lost Treasure,2009-09-03,2009,0,0,0,10.200558
25476,Scum,1979-09-12,1979,420000,0,-420000,3.413463
25482,Lolita's Club,2007-11-30,2007,0,0,0,0.469959
25495,Our Man in Havana,1959-12-30,1959,0,0,0,6.603651
25497,Stormy Monday,1988-05-01,1988,0,1791328,1791328,5.623518
25499,"Just Let It Go, Friends",1983-08-12,1983,14000,0,-14000,1.403423
25500,Red Lights,2004-03-03,2004,0,0,0,1.24105
25501,"After Dark, My Sweet",1990-08-24,1990,0,0,0,7.349189
25502,Deception,1946-10-18,1946,0,0,0,6.611392
25503,Impact,1949-03-20,1949,0,0,0,1.551252
25504,Shock Corridor,1963-09-11,1963,0,0,0,9.52088
25506,Slightly Scarlet,1956-02-29,1956,0,0,0,0.556092
25507,The Get-Away,1941-06-13,1941,0,0,0,0.493968
25508,Cat People,1942-12-05,1942,134000,4000000,3866000,5.110716
25509,The Bribe,1949-02-03,1949,0,0,0,0.844059
25510,Jannat,2008-01-01,2008,0,0,0,0.361991
25512,Jeanne and the Perfect Guy,1998-04-22,1998,0,13936,13936,0.38359
25516,Koi... Mil Gaya,2003-08-08,2003,0,0,0,3.273286
25517,The Gospel,2005-10-07,2005,0,0,0,1.109339
25518,La Belle verte,1996-09-18,1996,0,0,0,2.010173
25519,Pardes,1997-01-01,1997,0,0,0,1.774295
25520,The House of Mirth,2000-09-23,2000,10000000,5164404,-4835596,2.492547
25525,Lensman,1984-06-07,1984,0,0,0,0.401054
25527,The Ron Clark Story,2006-08-13,2006,0,0,0,1.912009
25528,American Ninja 4: The Annihilation,1990-10-30,1990,0,0,0,2.213603
25530,First on the Moon,2005-09-25,2005,0,0,0,0.436348
25532,Chronicle of an Escape,2006-01-01,2006,0,0,0,1.392353
25536,PTU,2003-04-17,2003,0,0,0,3.461469
25538,Yi Yi,2000-09-20,2000,0,0,0,8.930431
25539,Winners & Sinners,1983-01-01,1983,0,0,0,2.272623
25541,Brotherhood,2009-10-21,2009,0,0,0,2.587911
25541,Brotherhood,2009-10-21,2009,0,0,0,2.587911
25548,Shadow on the Wall,1950-05-19,1950,0,0,0,0.976364
25549,Split Second,1953-05-02,1953,0,0,0,1.527971
25550,The Sellout,1952-05-30,1952,0,0,0,0.449885
25551,The Sniper,1952-05-09,1952,0,0,0,2.030317
25553,Dark of the Sun,1968-01-19,1968,0,0,0,2.131668
25556,The Land Before Time IX: Journey to the Big Water,2002-12-17,2002,0,0,0,3.171563
25557,The Puppet Masters,1994-10-21,1994,0,8638072,8638072,7.272296
25560,The Taming of the Shrew,1967-03-07,1967,0,0,0,2.786435
25562,Soapdish,1991-05-31,1991,0,36489888,36489888,9.904821
25563,Marked Woman,1937-04-10,1937,0,0,0,1.771875
25564,Appointment with Danger,1951-05-09,1951,0,0,0,1.12449
25566,Ragtime,1981-11-20,1981,0,0,0,6.154039
25568,The Dream Is Alive,1985-06-01,1985,0,0,0,0.344133
25571,Drive,1997-08-06,1997,3500000,0,-3500000,5.408618
25572,American Drug War: The Last White Hope,2007-01-01,2007,0,0,0,0.770685
25583,Wonderful and Loved by All,2007-08-24,2007,0,0,0,0.945098
25584,Every Other Week,2006-01-13,2006,0,0,0,0.49983
25587,The Land Before Time VIII: The Big Freeze,2001-12-04,2001,0,0,0,4.050424
25594,Wrong Turn at Tahoe,2009-11-16,2009,0,0,0,3.629657
25597,Hansel & Gretel,2007-12-27,2007,0,0,0,3.752484
25598,The Indian Runner,1991-05-19,1991,7000000,191125,-6808875,7.218957
25599,Way Out West,1937-04-16,1937,0,0,0,2.339021
25602,Ninja,2009-10-22,2009,10000000,0,-10000000,9.203341
25603,Russell Howard Live: Dingledodies,2009-11-09,2009,0,0,0,0.313534
25606,White Collar Blues,1975-03-27,1975,0,0,0,4.969226
25608,April's Shower,2003-10-15,2003,0,0,0,0.996202
25610,The Tommyknockers,1993-05-09,1993,12,0,-12,9.156782
25621,Decasia,2002-01-24,2002,0,0,0,1.156575
25623,House,1977-08-26,1977,0,0,0,4.321776
25624,Rosewood,1997-02-21,1997,30000000,13130349,-16869651,2.899809
25625,Multiple Maniacs,1970-04-10,1970,5000,0,-5000,1.33737
25626,The Founding of a Republic,2009-09-17,2009,0,0,0,1.942028
25627,The Living Dead at Manchester Morgue,1974-11-28,1974,0,0,0,2.511806
25628,Hawk the Slayer,1980-08-27,1980,0,0,0,2.699959
25630,Kurt Cobain: About a Son,2006-10-03,2006,0,0,0,0.853595
25633,Party Girl,1958-10-28,1958,0,0,0,2.027982
25636,Jesus' Son,1999-09-05,1999,0,0,0,5.954815
25638,Laaga Chunari Mein Daag - Journey of A Woman,2007-10-12,2007,0,0,0,0.618282
25641,My First Mister,2001-01-18,2001,0,0,0,1.866367
25643,Love Happens,2009-09-18,2009,18000000,36133014,18133014,10.279603
25645,Wing Chun,1994-03-24,1994,0,0,0,2.01819
25646,Death Warrior,2009-11-27,2009,0,0,0,0.461768
25647,Breath,2007-04-26,2007,0,0,0,1.494799
25648,Time,2006-06-30,2006,0,14742,14742,3.376611
25649,Bad Guy,2002-01-11,2002,0,0,0,3.001605
25650,Address Unknown,2001-06-02,2001,0,0,0,1.775879
25651,Real Fiction,2000-06-24,2000,0,0,0,1.397031
25652,Crocodile,1996-11-16,1996,0,0,0,1.337021
25653,Wild Animals,1997-10-25,1997,0,0,0,0.725231
25655,Triad Wars,2008-02-28,2008,0,0,0,1.764311
25656,Glasses,2007-09-22,2007,0,0,0,0.650104
25657,Kamome Diner,2006-06-11,2006,0,0,0,0.944834
25659,"Fine, Totally Fine",2008-01-01,2008,0,0,0,0.368102
25660,Nowhere to Hide,1999-01-01,1999,0,0,0,1.375675
25664,Throw Down,2004-07-08,2004,0,0,0,3.210913
25666,Frog Dreaming,1986-05-01,1986,0,0,0,1.371187
25667,Little Moscow,2008-11-28,2008,0,0,0,1.564191
25670,Foreign Correspondent,1940-08-16,1940,0,0,0,9.955445
25672,Hollow Triumph,1948-06-18,1948,0,0,0,0.798956
25673,A Place in the Sun,1951-06-12,1951,0,0,0,6.656993
25674,Shout,1991-10-04,1991,0,3547684,3547684,1.393986
25676,Rob-B-Hood,2006-09-28,2006,0,0,0,12.183711
25678,American Ninja 2: The Confrontation,1987-05-01,1987,0,0,0,4.237511
25680,The Friends of Eddie Coyle,1973-06-26,1973,0,0,0,8.652856
25682,American Ninja 3: Blood Hunt,1989-02-24,1989,0,0,0,2.745571
25684,American Ninja 5,1993-01-01,1993,0,0,0,1.322105
25688,Pitfall,1948-06-24,1948,0,0,0,10.163157
25690,The Blackout,1997-06-11,1997,0,0,0,1.395025
25693,Albino Farm,2009-09-09,2009,0,0,0,1.377897
25694,Alice in Wonderland,1933-12-22,1933,0,0,0,1.504355
25695,Treeless Mountain,2009-08-27,2009,0,0,0,0.78034
25697,Getting Away with Murder,1996-04-12,1996,0,0,0,0.746662
25698,In the Good Old Summertime,1949-07-29,1949,3400000,0,-3400000,0.741227
25699,The Man on the Roof,1976-09-30,1976,0,0,0,1.734909
25701,Ryan and Sean's Not So Excellent Adventure,2008-11-14,2008,0,0,0,0.146091
25704,Post Grad,2009-08-21,2009,15000000,6405245,-8594755,9.747452
25706,Brain Smasher... A Love Story,1993-11-17,1993,0,0,0,0.901866
25707,Dot.Kill,2005-03-08,2005,0,0,0,1.636055
25713,Animals,2008-11-05,2008,5500000,0,-5500000,5.27828
25716,Crows Zero II,2009-04-11,2009,0,0,0,4.668907
25719,Shooting Fish,1997-08-22,1997,3000000,302204,-2697796,1.631288
25720,The Whistle Blower,1986-11-21,1986,0,0,0,3.098412
25722,The Unholy Wife,1957-06-24,1957,0,0,0,0.190466
25723,Overnight Delivery,1998-04-07,1998,12000000,0,-12000000,2.305829
25727,The Girls Rebel Force of Competitive Swimmers,2007-12-25,2007,0,0,0,0.885609
25728,The Mob,1951-09-07,1951,0,0,0,5.462545
25735,The Gangster,1947-11-25,1947,0,0,0,0.552189
25736,The Postman Always Rings Twice,1946-05-02,1946,0,0,0,5.68705
25738,He Ran All The Way,1951-06-19,1951,0,0,0,2.024833
25739,L'associ√©,1979-08-22,1979,0,0,0,0.000308
25740,"Buy the Ticket, Take the Ride",2006-12-12,2006,0,0,0,1.348899
25741,The Flight Before Christmas,2008-09-22,2008,6100000,0,-6100000,2.481381
25744,A Slit-Mouthed Woman,2007-03-16,2007,0,0,0,1.367306
25745,The Gamers,2002-11-03,2002,0,0,0,0.510359
25746,Kabei: Our Mother,2008-01-26,2008,0,0,0,1.208795
25747,Beautiful,2008-02-14,2008,0,0,0,1.705167
25748,Children of the Corn II: The Final Sacrifice,1993-01-29,1993,900000,6980986,6080986,8.357875
25749,Children of the Corn III: Urban Harvest,1995-09-12,1995,0,0,0,4.411511
25750,Children of the Corn IV: The Gathering,1996-10-08,1996,0,0,0,7.97048
25751,Children of the Corn V: Fields of Terror,1998-06-21,1998,0,0,0,6.132346
25752,Children of the Corn 666: Isaac's Return,1999-10-19,1999,0,0,0,11.091559
25753,Children of the Corn: Revelation,2001-10-09,2001,2500000,0,-2500000,2.58429
25754,Children of the Corn,2009-09-26,2009,4500000,0,-4500000,9.895965
25755,Citizen Dog,2004-12-12,2004,1700000,0,-1700000,1.147208
25756,Clownhouse,1989-01-15,1989,0,0,0,1.820459
25757,Comic Book: The Movie,2004-01-27,2004,0,0,0,0.590192
25763,Damnation Alley,1977-09-10,1977,17000000,8720000,-8280000,2.217704
25764,Dasepo Naughty Girls,2006-08-10,2006,0,0,0,1.45696
25767,The Grass Is Greener,1960-12-23,1960,0,6000000,6000000,4.074783
25768,"Steamboat Bill, Jr.",1928-02-14,1928,0,0,0,7.518657
25769,Carriers,2009-09-04,2009,0,5802422,5802422,8.153954
25770,The Paleface,1922-01-01,1922,0,0,0,1.114303
25771,Pink Floyd: Live at Pompeii,1972-08-31,1972,0,0,0,5.855108
25772,Lethal Angels,2006-01-01,2006,0,0,0,0.115571
25773,The Chosen,1981-08-20,1981,0,0,0,0.888234
25774,Fados,2007-12-31,2007,0,0,0,0.153843
25778,Felicity: An American Girl Adventure,2005-11-29,2005,6800000,0,-6800000,0.986942
25781,A Raisin in the Sun,2008-02-25,2008,0,0,0,4.49832
25783,Comandante,2003-02-14,2003,0,0,0,1.090011
25784,Journey from the Fall,2006-02-22,2006,1300000,639000,-661000,0.044561
25786,Samantha: An American Girl Holiday,2004-11-23,2004,0,0,0,5.436026
25787,One Girl's Confession,1953-04-06,1953,0,0,0,0.41406
25789,Aftershock: Earthquake in New York,1999-11-19,1999,0,0,0,6.930899
25793,Precious,2009-11-06,2009,10000000,47536959,37536959,8.293548
25795,Thieves,2007-08-08,2007,0,0,0,0.717736
25796,That Old Feeling,1997-04-04,1997,0,0,0,1.954656
25797,Miss Minoes,2001-12-06,2001,0,0,0,3.642711
25799,Amu,2005-01-07,2005,0,0,0,0.80794
25801,Aamdani Atthanni Kharcha Rupaiya,2001-12-21,2001,0,0,0,0.274767
25803,Amal,2007-09-13,2007,0,0,0,0.635498
25807,Red Light,1949-09-30,1949,0,0,0,1.052809
25831,The Prince and the Pauper,1990-11-16,1990,0,0,0,2.312207
25832,Aria,1987-05-27,1987,0,0,0,2.267249
25833,Eating Out: All You Can Eat,2009-10-09,2009,0,0,0,2.227403
25834,Xtro,1982-12-06,1982,0,0,0,3.267125
25838,Devils on the Doorstep,2000-05-12,2000,0,0,0,2.438822
25842,A Christmas Carol,1938-12-16,1938,0,0,0,1.896952
25843,Karas: The Prophecy,2005-05-25,2005,0,0,0,1.035921
25846,Baar√¨a,2009-09-02,2009,35000000,0,-35000000,7.109369
25848,Legend of the Lost,1957-12-17,1957,1750000,2200000,450000,4.250819
25852,Nothing Like the Holidays,2008-12-12,2008,0,0,0,1.953115
25853,Dahmer,2002-06-21,2002,250000,144008,-105992,3.66229
25855,Raging Phoenix,2009-08-12,2009,0,0,0,2.07265
25858,Drunken Angel,1948-04-27,1948,0,0,0,3.12255
25862,Blues in the Night,1941-11-15,1941,0,0,0,0.393469
25866,The Sucker,1965-03-24,1965,0,0,0,4.684921
25867,De Dana Dan,2009-11-27,2009,0,0,0,1.248411
25868,Aladin,2009-10-29,2009,0,0,0,1.901261
25869,Salaam-E-Ishq,2007-01-25,2007,0,0,0,1.091632
25872,The Pirate Movie,1982-08-06,1982,0,0,0,0.840824
25874,The Illustrated Man,1969-03-26,1969,0,0,0,2.237092
25875,Silk,2006-09-28,2006,0,0,0,2.230957
25876,The Racket,1951-12-12,1951,0,0,0,1.444428
25884,Feds,1988-10-28,1988,0,3527636,3527636,3.139282
25890,Looking for Comedy in the Muslim World,2005-12-15,2005,0,0,0,1.209137
25893,The Seven Little Foys,1955-09-30,1955,0,0,0,1.557872
25894,Above Suspicion,1943-05-01,1943,0,0,0,4.741695
25896,Coming Soon,1999-06-08,1999,0,0,0,1.570062
25898,Babes in Toyland,1934-12-14,1934,0,0,0,7.768271
25900,Tension,1949-11-23,1949,0,0,0,1.301133
25902,Just Sex and Nothing Else,2005-12-08,2005,0,0,0,0.026851
25903,Marie and Bruce,2004-01-19,2004,0,0,0,1.026251
25904,Marketa Lazarov√°,1967-11-24,1967,0,0,0,2.484463
25905,The Shop on Main Street,1965-09-09,1965,0,0,0,1.615901
25908,The Valley of the Bees,1968-05-17,1968,0,0,0,1.406401
25913,Balto II: Wolf Quest,2002-02-19,2002,0,0,0,5.697362
25914,The Fastest Gun Alive,1956-07-12,1956,0,0,0,3.365966
25915,Shockproof,1949-01-25,1949,0,0,0,1.088807
25918,Champion,1949-04-09,1949,600,0,-600,4.436786
25919,Great World of Sound,2007-01-01,2007,0,0,0,0.3097
25921,Garage Days,2002-10-03,2002,0,0,0,1.002876
25922,Three Days,2008-04-25,2008,0,0,0,1.014073
25925,Who's the Man?,1993-04-23,1993,0,0,0,0.862854
25926,Mind Meld: Secrets Behind the Voyage of a Lifetime,2001-11-06,2001,0,0,0,0.728127
25927,Staten Island,2009-02-07,2009,0,0,0,10.143164
25934,"To Sir, with Love",1967-06-14,1967,640000,0,-640000,8.138554
25935,The Reckoning,2003-08-06,2003,0,0,0,3.529565
25936,Radio Day,2008-03-08,2008,4000000,0,-4000000,0.95369
25939,Passenger,1963-09-20,1963,0,0,0,0.919012
25941,Harry Brown,2009-11-11,2009,7300000,10329747,3029747,7.478206
25943,Almost an Angel,1990-12-21,1990,0,0,0,2.862209
25944,Blood for Dracula,1974-08-13,1974,0,0,0,1.825571
25950,Mysterious Island,2005-09-17,2005,0,0,0,3.228053
25951,Bullet Ballet,1998-09-12,1998,0,0,0,1.081032
25952,Conquest of Space,1955-04-20,1955,0,0,0,3.941502
25953,Radar Secret Service,1950-01-28,1950,0,0,0,0.330747
25955,Pickup on South Street,1953-05-29,1953,0,0,0,6.366499
25956,Secuestro Express,2005-01-01,2005,0,0,0,0.586761
25961,Pok√©mon: The Rise of Darkrai,2007-07-14,2007,0,42238454,42238454,3.851534
25967,Isolation,2005-09-10,2005,5000000,0,-5000000,3.727745
25968,Veronika Decides to Die,2009-05-16,2009,9000000,0,-9000000,5.553972
25969,Angus,1995-09-15,1995,0,0,0,2.25008
25970,I Married a Witch,1942-10-30,1942,0,0,0,4.02032
25973,What Love Is,2007-03-23,2007,0,0,0,0.785591
25975,My Date with Drew,2005-08-05,2005,0,0,0,1.210937
25977,Showdown at Area 51,2007-01-01,2007,0,0,0,1.399429
25983,The House of the Devil,2009-04-25,2009,0,0,0,5.706196
25985,Jump Tomorrow,2001-11-09,2001,0,0,0,1.19372
25988,The Sleeping Dictionary,2003-01-31,2003,0,0,0,8.281066
25993,Asylum,1972-11-17,1972,0,0,0,5.378622
25994,The Winter Guest,1997-12-27,1997,0,0,0,0.923637
25998,Men Behind the Sun,1988-12-01,1988,0,0,0,2.820652
26005,Made in Hong Kong,1997-10-09,1997,0,0,0,2.396191
26009,Scandal Sheet,1952-01-16,1952,0,0,0,0.601989
26010,Legendary Assassin,2008-12-05,2008,515788,0,-515788,3.407635
26011,Hard Ticket to Hawaii,1987-03-01,1987,0,0,0,1.909558
26014,Good Advice,2001-11-15,2001,0,0,0,2.695666
26015,Don't Be Afraid of the Dark,1973-10-10,1973,0,0,0,1.525986
26016,Kathy Griffin: She'll Cut a Bitch,2009-04-15,2009,0,0,0,0.177713
26018,Food Matters,2010-10-08,2010,0,0,0,3.292247
26022,My Name Is Khan,2010-02-12,2010,12000000,42345360,30345360,11.264586
26028,Jimi Plays Monterey,1986-10-23,1986,0,0,0,1.087264
26030,Bob le Flambeur,1956-08-24,1956,0,0,0,2.666065
26031,The Naked Kiss,1964-10-29,1964,0,0,0,2.883014
26032,Make the Yuletide Gay,2009-11-01,2009,0,0,0,1.297088
26035,According to Greta,2009-11-25,2009,0,0,0,9.62432
26036,Bigger Than Life,1956-08-02,1956,0,0,0,6.457462
26038,Call Northside 777,1948-02-13,1948,0,0,0,2.227907
26039,Point Blank,1967-08-30,1967,2500000,3200000,700000,5.352165
26040,Haze,2005-01-01,2005,0,0,0,1.233593
26042,Warlock III: The End of Innocence,1999-10-12,1999,2000000,0,-2000000,1.920393
26044,Arthur 2: On the Rocks,1988-07-08,1988,0,14681192,14681192,3.611453
26056,Snipes,2001-09-13,2001,0,70569,70569,2.0769
26103,Mean Guns,1997-11-21,1997,0,0,0,9.335084
26108,Stage Beauty,2004-09-03,2004,0,776691,776691,3.127483
26111,More About the Children of Noisy Village,1987-09-05,1987,0,0,0,0.98834
26113,Operation Thunderbolt,1977-06-06,1977,0,0,0,0.712359
26114,Jesse Stone: Sea Change,2007-05-22,2007,0,0,0,2.908563
26116,The Mechanik,2005-11-02,2005,0,0,0,2.895673
26118,Dylan Moran: What It Is,2009-11-23,2009,0,0,0,0.695655
26119,Chato's Land,1972-01-01,1972,0,0,0,2.075823
26121,Moon Zero Two,1969-10-20,1969,0,0,0,1.489319
26123,American Pie Presents: The Book of Love,2009-06-18,2009,0,0,0,7.432114
26124,Face,1997-09-26,1997,0,0,0,2.135508
26125,The Defender,2004-12-20,2004,0,0,0,1.001318
26126,Disco Pigs,2001-10-05,2001,0,0,0,2.421159
26127,Joshua Tree,1993-08-04,1993,9000000,0,-9000000,2.506227
26129,Storm Catcher,1999-09-10,1999,0,0,0,0.354214
26130,Summer Time Machine Blues,2005-09-03,2005,0,0,0,0.436363
26131,Straight From the Heart,2003-02-09,2003,0,0,0,0.480985
26133,Tuesdays with Morrie,1999-12-05,1999,0,0,0,1.739258
26137,Electric Shadows,2004-09-11,2004,0,0,0,0.261949
26138,Duelist,2005-09-08,2005,0,0,0,3.681251
26140,Stewart Lee: Stand-Up Comedian,2005-10-17,2005,0,0,0,0.214093
26141,Fatal Instinct,1993-10-29,1993,0,0,0,3.555139
26142,The Doctor,1991-07-24,1991,12000000,38120905,26120905,8.337242
26146,My Wrongs 8245-8249 And 117,2002-01-01,2002,0,0,0,0.869438
26147,FC Venus,2005-12-30,2005,2196531,2411594,215063,0.947509
26149,Music of the Heart,1999-10-29,1999,27000000,14859394,-12140606,3.104943
26152,Erreur de la banque en votre faveur,2009-04-08,2009,0,0,0,1.122752
26153,God Tussi Great Ho,2008-08-15,2008,0,0,0,0.789268
26155,The Invisible Boy,1957-10-01,1957,0,0,0,1.226801
26156,Hiding Out,1987-11-06,1987,0,0,0,2.026942
26158,Around the World Under the Sea,1966-06-22,1966,0,0,0,0.201091
26162,The Bat Whispers,1930-01-01,1930,0,0,0,0.670708
26165,Mad Love,2001-09-28,2001,4800000,0,-4800000,1.059641
26166,Crack-Up,1946-09-06,1946,0,0,0,0.767843
26167,Raw Deal,1948-05-26,1948,0,0,0,10.091381
26168,Slingshot,2005-03-10,2005,0,0,0,1.386615
26170,Coogan's Bluff,1968-10-02,1968,0,3110000,3110000,4.60692
26171,Everybody's Fine,2009-12-04,2009,21000000,0,-21000000,6.786855
26172,Messenger of Death,1988-09-16,1988,0,0,0,8.755119
26173,Mr. Majestyk,1974-07-17,1974,0,0,0,2.073746
26174,T-Men,1947-12-15,1947,0,0,0,4.237738
26175,Ivanhoe,1952-01-01,1952,0,0,0,5.956582
26176,"Mother, Jugs & Speed",1976-01-01,1976,0,0,0,5.016085
26177,Annie,1999-11-07,1999,0,0,0,2.17699
26178,Razorback,1984-04-19,1984,5500000,801000,-4699000,1.822979
26179,Oh Heavenly Dog,1980-07-11,1980,0,0,0,1.54645
26180,Excess Baggage,1997-08-29,1997,0,0,0,3.714997
26181,Some Girls Do,1969-01-23,1969,0,0,0,0.488385
26182,The Big Store,1941-06-21,1941,0,0,0,1.639015
26185,McQ,1974-01-04,1974,0,0,0,1.589822
26186,Hot Millions,1968-09-19,1968,0,0,0,3.359214
26189,Get a Clue,2002-01-01,2002,0,0,0,2.968976
26190,Carry On Cruising,1962-04-01,1962,0,0,0,4.866607
26191,35 Shots of Rum,2009-02-18,2009,0,0,0,1.636869
26195,The Secret Lives of Dentists,2002-09-09,2002,0,0,0,0.947554
26198,The Keep,1983-12-16,1983,6000000,3661757,-2338243,3.554491
26199,The Liquidator,1965-01-01,1965,0,0,0,1.017405
26200,The Nude Bomb,1980-05-09,1980,0,0,0,1.939255
26201,The Sea Hawk,1940-07-01,1940,0,0,0,2.477593
26203,Blink,1994-01-26,1994,0,16668552,16668552,3.00282
26204,Tony Rome,1967-10-31,1967,0,0,0,1.99092
26205,The Desert Fox: The Story of Rommel,1951-10-16,1951,0,0,0,2.118207
26215,Quicksilver Highway,1997-05-13,1997,0,0,0,2.503972
26223,The Canyon,2009-10-23,2009,0,0,0,2.179154
26225,Ash Wednesday,2002-10-11,2002,0,0,0,1.061924
26230,Class of Nuke 'Em High 2: Subhumanoid Meltdown,1991-01-01,1991,0,0,0,1.263475
26232,Viva Cuba,2005-04-20,2005,0,0,0,0.867439
26233,April Fool's Day,2008-03-25,2008,5000000,0,-5000000,1.44619
26234,10 Rillington Place,1971-02-10,1971,0,0,0,2.99988
26235,The Gamers: Dorkness Rising,2008-01-01,2008,0,0,0,0.623316
26242,Park Row,1952-08-12,1952,0,0,0,0.148056
26243,Fallen Angel,1945-11-07,1945,0,0,0,3.242793
26244,Phish: Bittersweet Motel,2000-08-25,2000,0,0,0,0.158157
26245,Dark Prince: The True Story of Dracula,2000-10-31,2000,0,0,0,1.821845
26246,Incident at Oglala,1992-05-08,1992,0,0,0,0.501794
26250,Wanda Sykes: I'ma Be Me,2009-10-10,2009,0,0,0,0.211198
26251,Wanda Sykes: Sick and Tired,2006-10-14,2006,0,0,0,0.005247
26252,P√©p√© le Moko,1937-01-28,1937,0,153936,153936,2.57335
26254,The Hunting of the President,2004-06-20,2004,0,0,0,0.842853
26255,Love Potion No. 9,1992-11-13,1992,0,754935,754935,8.358541
26258,Bushwhacked,1995-08-04,1995,0,0,0,3.287036
26259,Come Drink with Me,1966-04-07,1966,0,0,0,3.116449
26261,Cops & Robbersons,1994-04-15,1994,0,0,0,7.042878
26263,Death Wish 4: The Crackdown,1987-06-11,1987,0,0,0,4.566325
26264,George of the Jungle 2,2003-08-18,2003,0,0,0,11.885797
26266,Spymate,2006-01-24,2006,0,0,0,0.538422
26267,Now You See It...,2005-01-14,2005,0,0,0,1.448265
26268,Harper,1966-02-23,1966,3500000,12000000,8500000,8.55931
26269,Twilight,1998-03-06,1998,0,0,0,9.468224
26270,Project Moon Base,1953-09-04,1953,0,0,0,0.484406
26271,Live Nude Girls,1995-12-08,1995,0,0,0,2.138959
26275,Kamikaze Girls,2004-05-29,2004,0,0,0,4.365377
26277,Mujhse Dosti Karoge!,2002-08-08,2002,0,0,0,1.373044
26278,Quatermass II,1957-05-24,1957,0,0,0,7.029675
26280,I Killed My Mother,2009-06-05,2009,0,0,0,6.662036
26282,Macao,1952-04-30,1952,0,0,0,1.715751
26283,The Las Vegas Story,1952-01-30,1952,0,0,0,5.43144
26285,Fantozzi Still Suffers,1983-01-01,1983,0,0,0,4.434073
26286,Dragonwyck,1946-04-10,1946,0,0,0,1.058284
26290,Me Without You,2001-11-01,2001,0,0,0,7.576878
26291,Shakes the Clown,1991-03-13,1991,1400000,0,-1400000,2.714993
26293,Hurt,2009-11-10,2009,0,0,0,0.954211
26296,Un maledetto imbroglio,1959-10-24,1959,0,0,0,1.096116
26298,Here and Elsewhere,1976-09-15,1976,0,0,0,0.479079
26299,Clambake,1967-01-01,1967,0,0,0,0.81731
26300,Fist of the North Star,1995-04-22,1995,7000000,0,-7000000,1.171193
26301,The Hunt for the BTK Killer,2005-10-09,2005,0,0,0,9.789667
26302,The Color of Pomegranates,1969-10-01,1969,0,0,0,1.635298
26306,Prefontaine,1997-01-24,1997,8000000,589304,-7410696,2.93818
26314,"Job, czyli ostatnia szara kom√≥rka",2006-11-03,2006,0,0,0,0.223654
26316,Mosquito Squadron,1969-01-18,1969,0,0,0,1.433703
26317,Man with a Movie Camera,1929-01-08,1929,0,0,0,4.694378
26319,The Man Who Came to Dinner,1942-01-24,1942,0,0,0,1.097462
26320,Taking Woodstock,2009-09-03,2009,0,0,0,10.993034
26323,Bordertown,1935-01-23,1935,0,0,0,1.588639
26325,"Tarzan, the Ape Man",1981-08-07,1981,0,36565280,36565280,2.081712
26326,Rock 'n' Roll High School,1979-08-24,1979,300000,0,-300000,3.019609
26329,Carry On Girls,1973-11-09,1973,0,0,0,1.927063
26331,The Last of Sheila,1973-06-14,1973,0,0,0,1.569849
26332,Electra Glide in Blue,1973-08-18,1973,0,0,0,7.714702
26333,Untamed Heart,1993-02-12,1993,0,18899204,18899204,3.704567
26334,Run Bitch Run,2009-01-01,2009,0,0,0,1.321136
26336,Crazy Love,2007-11-22,2007,0,0,0,0.614455
26337,China Moon,1994-03-04,1994,0,0,0,7.340512
26340,Delta Force 3: The Killing Game,1991-01-01,1991,0,0,0,1.513073
26342,The Terminators,2009-04-28,2009,0,0,0,2.555861
26347,Our Music,2004-05-19,2004,0,0,0,0.512308
26350,Perestroika,2009-03-20,2009,0,0,0,0.974475
26351,Israel: Birth of a Nation,1995-09-27,1995,0,0,0,0.042281
26352,A Low Down Dirty Shame,1994-11-23,1994,10000000,29392418,19392418,3.021526
26354,Surfwise,2007-01-01,2007,0,0,0,0.400054
26355,For Keeps,1988-01-15,1988,0,17514553,17514553,5.410839
26356,Medea,1969-12-27,1969,0,0,0,2.216567
26357,To Trap a Spy,1964-01-01,1964,0,0,0,0.898135
26358,Phoenix,1995-01-01,1995,0,0,0,0.387806
26360,Depeche Mode: 101,1989-04-27,1989,0,0,0,1.088695
26366,Ellen DeGeneres: The Beginning,2000-07-23,2000,0,0,0,0.17475
26367,I Can Do Bad All By Myself,2009-09-11,2009,0,0,0,1.805018
26368,Spring and Chaos,1996-12-14,1996,0,0,0,0.037028
26369,Cannibal Women in the Avocado Jungle of Death,1989-03-15,1989,0,0,0,0.807143
26370,638 Ways to Kill Castro,2006-11-28,2006,0,0,0,0.310085
26371,Maurice,1987-09-18,1987,0,0,0,5.778465
26372,Shame,1968-09-29,1968,0,0,0,5.305396
26376,Castle on the Hudson,1940-02-17,1940,0,0,0,0.471208
26378,They Made Me a Criminal,1939-01-28,1939,0,0,0,1.758391
26379,Paa,2009-12-04,2009,3250000,0,-3250000,2.03188
26380,Out of the Fog,1941-06-14,1941,0,0,0,1.096974
26381,Christmas Town,2008-12-09,2008,0,0,0,1.176964
26385,Walk a Crooked Mile,1948-09-02,1948,0,0,0,0.959509
26386,Ernest Saves Christmas,1988-11-11,1988,6000000,28202109,22202109,3.590547
26387,Night Has a Thousand Eyes,1948-10-13,1948,0,0,0,0.878471
26388,Buried,2010-09-24,2010,1987650,19152480,17164830,7.389437
26389,From Paris with Love,2010-02-05,2010,52000000,52826594,826594,6.885593
26390,Brooklyn's Finest,2009-01-16,2009,17000000,29536299,12536299,12.50422
26391,Cabin Boy,1994-01-07,1994,0,3662459,3662459,1.679042
26393,Breaking Up,1997-10-17,1997,0,11690,11690,2.145688
26397,The Civil War,1990-09-23,1990,0,0,0,3.431403
26398,At the Earth's Core,1976-07-01,1976,0,0,0,3.277291
26405,Wake in Fright,1971-07-21,1971,0,0,0,4.249576
26408,The War Room,1993-12-05,1993,0,0,0,1.273617
26422,The Pillow Book,1996-05-12,1996,0,0,0,2.690319
26425,Just the Ticket,1999-02-26,1999,12000000,0,-12000000,1.165752
26426,A Show of Force,1990-05-11,1990,0,0,0,0.655553
26427,Hoffman,1970-01-01,1970,0,0,0,0.322493
26428,Agora,2009-05-17,2009,70000000,39041505,-30958495,8.029671
26430,The Carter,2009-01-01,2009,0,0,0,0.222757
26431,Pu-239,2006-01-01,2006,0,0,0,1.612168
26441,The Big Green,1995-09-29,1995,0,0,0,5.982764
26444,Death Hunt,1981-05-22,1981,0,0,0,5.674684
26447,3:15,1985-01-31,1985,0,0,0,0.36671
26449,Sex and the Teenage Mind,2002-01-01,2002,0,0,0,0.678391
26450,Phantom of the Megaplex,2000-11-10,2000,0,0,0,1.602574
26451,Investigation of a Citizen Above Suspicion,1970-02-09,1970,0,0,0,4.772045
26452,Hercules,1983-08-12,1983,0,10676194,10676194,1.567626
26454,Deliver Us from Eva,2003-02-07,2003,0,0,0,1.172757
26461,Trailer Park Boys: Say Goodnight to the Bad Guys,2008-12-07,2008,0,0,0,0.658229
26465,Big Pun: The Legacy,2009-09-01,2009,0,0,0,0.168673
26466,Triangle,2009-10-16,2009,12000000,0,-12000000,10.217404
26467,The Climb,2002-01-01,2002,0,0,0,0.407244
26469,Skills Like This,2007-03-10,2007,0,0,0,0.172431
26475,The Anniversary Party,2001-05-15,2001,0,0,0,2.668002
26477,Back to the Beach,1987-08-07,1987,0,0,0,1.430702
26479,Strapped,1993-08-21,1993,0,0,0,0.235063
26480,The Legend of the 7 Golden Vampires,1974-07-11,1974,0,0,0,1.845877
26483,Beach Blanket Bingo,1965-04-14,1965,0,0,0,4.119355
26484,Beach Party,1963-08-07,1963,0,0,0,0.816475
26486,The Last Shot,2004-09-24,2004,0,0,0,6.292054
26488,Torremolinos 73,2003-04-29,2003,0,1819410,1819410,8.721919
26491,Tipping the Velvet,2002-10-22,2002,0,0,0,2.433306
26497,Impy's Island,2006-08-02,2006,0,0,0,1.772896
26500,Turn Left at the End of the World,2004-06-06,2004,0,0,0,1.680423
26502,Seven Men from Now,1956-08-04,1956,0,0,0,2.511267
26503,The Black Cat,1981-04-04,1981,0,0,0,7.551234
26504,Black Belly of the Tarantula,1971-08-12,1971,0,0,0,4.726173
26505,Arthur and the Revenge of Maltazard,2009-11-26,2009,87000000,0,-87000000,9.603484
26506,Before The Rains,2007-09-07,2007,0,0,0,0.964688
26508,The War Game,1965-11-01,1965,0,0,0,1.761241
26509,The Bed-Sitting Room,1969-06-01,1969,0,0,0,1.728397
26510,School for Seduction,2004-12-03,2004,0,0,0,0.779796
26513,Punishment Park,1971-05-09,1971,0,0,0,2.304455
26514,Where the Red Fern Grows,1974-06-21,1974,0,0,0,2.31862
26515,Pumpkinhead,1988-06-09,1988,3500000,4385516,885516,11.841506
26516,Blackboard Jungle,1955-03-25,1955,0,0,0,4.582859
26517,Martin,1978-07-05,1978,0,0,0,3.965407
26518,Old Joy,2006-01-01,2006,300000,0,-300000,2.196695
26520,Bob & Carol & Ted & Alice,1969-09-17,1969,2000000,30000000,28000000,1.81433
26521,Sexy Killer: You'll Die for Her,2008-10-10,2008,0,0,0,1.17307
26522,A Soldier's Story,1984-09-14,1984,6000000,21821347,15821347,12.019262
26525,Brewster McCloud,1970-12-05,1970,0,0,0,4.433745
26530,Christmas Holiday,1944-01-01,1944,0,0,0,1.083518
26531,The Little Princess,1939-03-17,1939,0,0,0,5.640722
26533,The Fallen Sparrow,1943-08-19,1943,0,0,0,0.55343
26535,Billy Liar,1963-06-05,1963,0,0,0,3.584709
26537,"Nestor, the Long-Eared Christmas Donkey",1977-12-03,1977,0,0,0,0.448238
26538,Jack Frost,1979-12-13,1979,0,0,0,0.734387
26539,Frosty's Winter Wonderland,1976-12-02,1976,0,0,0,0.731525
26540,Bugs Bunny's Looney Christmas Tales,1979-11-27,1979,0,0,0,1.016717
26541,The Tesseract,2003-05-15,2003,0,0,0,1.205089
26547,'Twas the Night Before Christmas,1974-12-08,1974,0,0,0,1.353059
26550,Little Lips,1978-02-08,1978,0,0,0,14.555186
26554,Class of Nuke 'Em High,1986-12-12,1986,2000000,0,-2000000,4.098849
26555,Club Paradise,1986-07-11,1986,15000000,12308521,-2691479,4.079853
26556,Dara O Briain Talks Funny: Live in London,2008-11-17,2008,0,0,0,0.238029
26558,Combat Shock,1986-05-14,1986,40000,0,-40000,1.640696
26560,Continental Divide,1981-09-18,1981,0,15578237,15578237,2.931013
26561,Enchanted April,1991-11-06,1991,0,13200170,13200170,2.400185
26564,Crumb,1994-09-10,1994,0,3174695,3174695,3.620388
26566,Father and Guns,2009-07-08,2009,0,0,0,1.030775
26567,The War Within,2005-09-30,2005,0,0,0,1.005088
26569,The 7 Grandmasters,1977-03-20,1977,0,0,0,0.62682
26571,Downtown '81,1981-01-01,1981,0,0,0,0.423073
26573,Dr. Goldfoot and the Bikini Machine,1965-11-06,1965,0,0,0,10.031602
26574,Dudes,1987-08-01,1987,0,0,0,0.508078
26578,The Falcon and the Snowman,1985-01-25,1985,0,0,0,4.690847
26579,The Heart is Deceitful Above All Things,2004-09-15,2004,74050,176153,102103,2.789574
26580,4 Little Girls,1997-07-09,1997,0,0,0,0.639411
26581,Dr. Who and the Daleks,1965-08-23,1965,502318,0,-502318,2.187942
26583,The Keeper,2009-10-03,2009,10000000,0,-10000000,7.756334
26584,North,2009-02-06,2009,0,0,0,1.375209
26587,Dread,2009-07-14,2009,0,0,0,5.967679
26588,Summer's Blood,2009-11-02,2009,0,0,0,1.707129
26593,Rio Lobo,1970-12-18,1970,0,0,0,4.501917
26594,The Secret,2006-03-26,2006,0,0,0,4.457291
26596,Johnny Guitar,1954-05-26,1954,0,0,0,4.918293
26598,Cats,1998-10-05,1998,0,0,0,2.548705
26599,Duel of Hearts,1992-01-01,1992,0,0,0,1.213965
26600,Between Two Worlds,1944-05-20,1944,0,0,0,10.138589
26602,Summer Catch,2001-08-22,2001,34000000,19693891,-14306109,5.499867
26603,Vice Versa,1988-02-25,1988,0,0,0,9.39207
26606,Performance,1970-08-03,1970,0,0,0,3.3228
26610,Insomnia,1997-03-14,1997,0,0,0,3.722295
26612,Treasure Island,1990-06-08,1990,0,0,0,3.301143
26614,La Chienne,1931-11-20,1931,0,0,0,1.743615
26615,Challenge of the Masters,1976-05-07,1976,0,0,0,1.062408
26617,Five Easy Pieces,1970-09-12,1970,0,0,0,9.721297
26618,Clay Pigeons,1998-09-25,1998,0,0,0,6.108589
26621,Robin Williams: Weapons of Self Destruction,2009-12-06,2009,0,0,0,2.174557
26622,Always Outnumbered,1998-03-21,1998,0,0,0,0.86635
26623,Generation X,1996-12-20,1996,7000000,0,-7000000,1.916293
26626,Glory Daze,1995-10-01,1995,0,0,0,10.738755
26630,Shank,2009-05-01,2009,0,0,0,1.786749
26631,In the Blood,2006-01-01,2006,0,0,0,0.038824
26635,Brother Orchid,1940-06-08,1940,0,0,0,2.159924
26636,Twentynine Palms,2003-09-17,2003,0,0,0,1.516165
26638,Red Desert,1964-09-04,1964,0,0,0,7.888143
26639,Britannia Hospital,1982-05-27,1982,0,0,0,2.008448
26642,The Dark Side of the Sun,1988-12-21,1988,0,0,0,4.697126
26643,The Magic Sword,1962-04-01,1962,0,0,0,1.362469
26644,Photographing Fairies,1997-09-19,1997,0,0,0,0.910451
26648,The Night Porter,1974-04-03,1974,0,0,0,4.266305
26651,Tobruk,2008-09-04,2008,0,0,0,0.771781
26652,Play Dirty,1969-01-01,1969,0,0,0,1.89728
26654,Conflict,1945-06-15,1945,0,0,0,1.720804
26655,Like Mike 2: Streetball,2006-06-06,2006,5000000,0,-5000000,2.255781
26656,Ghost Machine,2009-02-01,2009,0,0,0,11.002218
26657,Nobody Lives Forever,1946-11-01,1946,0,0,0,0.778661
26661,Abbott and Costello Meet the Mummy,1955-06-01,1955,0,0,0,4.656016
26663,The Man I Love,1947-01-11,1947,0,0,0,0.406541
26665,Aberdeen,2000-07-05,2000,0,0,0,0.719865
26666,Calcutta,1947-08-29,1947,0,0,0,1.286181
26670,Noises Off...,1992-03-20,1992,12000000,2280148,-9719852,4.179487
26676,Neon Maniacs,1986-11-14,1986,1500000,0,-1500000,0.506196
26677,The Video Dead,1987-11-06,1987,0,0,0,1.381441
26679,Spookies,1986-05-14,1986,0,0,0,1.063636
26680,Shock Waves,1977-07-15,1977,200000,0,-200000,6.649791
26682,Roadracers,1994-07-22,1994,1000000,0,-1000000,3.520748
26685,How to Murder Your Wife,1965-01-26,1965,0,0,0,3.034758
26686,California Suite,1978-12-15,1978,0,0,0,3.075976
26687,The Unseeable,2006-11-02,2006,2000000,0,-2000000,0.502636
26688,Sorority Row,2009-09-09,2009,12500000,27206120,14706120,5.010852
26689,Retroactive,1997-01-01,1997,0,0,0,2.780487
26690,The Boston Strangler,1968-10-08,1968,0,0,0,3.877109
26691,Neuilly Yo Mama!,2009-08-12,2009,0,0,0,8.72912
26693,Ju-on: White Ghost,2009-06-27,2009,0,0,0,2.215998
26694,Big River Man,2009-01-15,2009,0,0,0,0.309604
26699,The Doorway to Hell,1930-10-18,1930,0,0,0,0.494331
26700,Nocturna,2007-09-06,2007,0,0,0,1.7564
26701,Humoresque,1946-09-25,1946,0,0,0,2.092012
26702,Devil Dog: The Hound of Hell,1978-10-31,1978,0,0,0,0.519687
26703,Dracula's Dog,1978-06-01,1978,0,0,0,1.072832
26710,My Baby's Daddy,2004-01-09,2004,0,51,51,5.513522
26712,The Enforcer,1951-02-24,1951,0,0,0,1.893149
26714,Two Seconds,1932-05-28,1932,0,0,0,0.504054
26715,Bitch Slap,2009-05-16,2009,0,199436,199436,7.489306
26718,G-Men,1935-05-04,1935,0,0,0,1.059075
26719,House of Games,1987-10-11,1987,0,2585639,2585639,5.524866
26722,Nine Miles Down,2009-10-01,2009,0,0,0,1.782376
26723,Imagine: John Lennon,1988-10-07,1988,0,0,0,1.69806
26725,Nomads,1986-03-07,1986,2278264,0,-2278264,5.917152
26728,Garfield's Fun Fest,2008-08-30,2008,0,0,0,1.304562
26730,Bugs Bunny's 3rd Movie: 1001 Rabbit Tales,1982-11-16,1982,0,0,0,2.894481
26736,Wizards of Waverly Place: The Movie,2009-08-28,2009,0,0,0,5.206696
26738,Rage,2009-09-24,2009,0,0,0,1.438568
26743,Thumbtanic,2000-07-07,2000,0,0,0,0.871762
26744,Force of Evil,1948-12-25,1948,0,0,0,4.386329
26748,Lone Star,1996-06-21,1996,5000000,13269963,8269963,9.069963
26750,Fall of the Republic: The Presidency of Barack H. Obama,2009-10-21,2009,200000,0,-200000,0.323969
26752,Silent Wedding,2009-02-18,2009,0,0,0,1.629036
26755,Brother's Keeper,1992-09-09,1992,0,0,0,0.003013
26758,Man with the Gun,1955-11-05,1955,0,0,0,1.54471
26761,Pursued,1947-03-02,1947,0,0,0,1.552655
26762,The Outfit,1973-10-01,1973,0,0,0,2.111084
26763,Burma VJ: Reporting from a Closed Country,2008-11-12,2008,0,0,0,0.72712
26765,Mr. Warmth: The Don Rickles Project,2007-12-04,2007,0,0,0,1.590689
26766,Slasher,2004-03-15,2004,0,0,0,0.661724
26768,Baby Love,1968-09-01,1968,0,0,0,1.057753
26769,Cocaine Cowboys II: Hustlin' with the Godmother,2008-07-29,2008,0,0,0,0.989028
26771,That Sinking Feeling,1980-10-01,1980,0,0,0,0.994335
26774,The Blood on Satan's Claw,1971-01-01,1971,140000,0,-140000,2.221513
26776,The Halliday Brand,1957-01-01,1957,0,0,0,0.697442
26781,Running Turtle,2009-06-11,2009,0,0,0,0.952942
26782,Shadows of Forgotten Ancestors,1965-09-03,1965,0,0,0,2.559625
26787,Gulliver's Travels,1996-02-04,1996,28000000,0,-28000000,2.48966
26789,No Mercy,1986-12-19,1986,0,12303904,12303904,11.273675
26791,Brigham City,2001-03-30,2001,1000000,852206,-147794,0.202478
26792,The Storm Gate,2006-02-12,2006,0,0,0,2.491206
26796,Telstar: The Joe Meek Story,2009-05-30,2009,0,0,0,0.938609
26797,Denis Leary: No Cure for Cancer,1993-01-12,1993,0,0,0,1.602822
26798,Switching Channels,1988-03-05,1988,0,0,0,2.100768
26801,Sealed Lips,1942-01-02,1942,0,0,0,0.365978
26803,Breaking Glass,1980-10-01,1980,0,0,0,0.975441
26805,Night Editor,1946-03-29,1946,0,0,0,0.835896
26807,Dragon Hill,2002-12-20,2002,0,0,0,0.084604
26808,Beau Brummell: This Charming Man,2006-06-19,2006,0,0,0,0.870653
26809,Prep & Landing,2009-12-24,2009,0,0,0,2.362086
26810,A Common Thread,2004-05-14,2004,0,0,0,1.956427
26811,Dr. Terror's House of Horrors,1965-02-23,1965,0,0,0,3.412202
26813,Himalaya,1999-01-01,1999,0,0,0,1.349366
26814,Love Happy,1949-10-12,1949,0,0,0,0.994508
26815,Rocket Singh: Salesman of the Year,2009-12-11,2009,1250000,0,-1250000,2.250426
26817,Sex and the Single Girl,1964-12-25,1964,0,0,0,1.045178
26820,My One and Only,2009-08-21,2009,0,2479538,2479538,4.138817
26823,Watercolors,2008-06-07,2008,0,0,0,0.806932
26824,Flamenco,1995-06-16,1995,0,0,0,0.107612
26825,Tell Them Who You Are,2004-09-06,2004,0,0,0,0.825475
26826,Wrong Side Up,2005-02-17,2005,0,0,0,0.176722
26827,Who's That Girl,1987-08-07,1987,0,7305209,7305209,3.78346
26829,The Houston Story,1956-02-01,1956,0,0,0,0.608893
26830,Gonin,1995-09-23,1995,0,0,0,1.51489
26831,That'll Be The Day,1973-05-13,1973,0,0,0,0.520862
26838,High Wall,1947-12-17,1947,0,0,0,0.552462
26841,Don't Even Think,2003-03-31,2003,0,700000,700000,0.492666
26842,The Message,1977-03-09,1977,0,0,0,8.119925
26843,Lion of the Desert,1981-04-17,1981,35000000,0,-35000000,2.875229
26845,Tarzan the Ape Man,1932-04-02,1932,0,0,0,4.179063
26847,Santa Baby,2006-12-10,2006,0,0,0,0.449333
26849,The Missing Juror,1944-11-16,1944,0,0,0,0.64961
26850,Under Suspicion,1991-09-27,1991,0,221295,221295,2.774589
26851,The Atomic Cafe,1982-03-17,1982,0,0,0,1.706144
26857,The Tingler,1959-07-29,1959,250000,0,-250000,2.28087
26860,White Zombie,1932-08-04,1932,50000,0,-50000,2.692891
26861,The Ministers,2009-10-16,2009,0,0,0,1.537562
26864,The Fish Child,2009-02-06,2009,0,0,0,0.887434
26865,X: The Unknown,1956-09-21,1956,0,0,0,7.530903
26866,Swords of Blood,1962-03-07,1962,0,0,0,3.086951
26872,The Untold Story of Emmett Louis Till,2005-01-01,2005,204956,0,-204956,0.381672
26873,To The Stars By Hard Ways,1980-06-06,1980,0,0,0,0.914097
26877,Naked Killer,1992-12-03,1992,0,0,0,2.063454
26879,How to Stuff a Wild Bikini,1965-07-14,1965,0,0,0,1.283731
26880,Children of Nature,1991-08-01,1991,0,0,0,0.397179
26881,The Incredible Hulk Returns,1988-02-21,1988,0,0,0,1.92429
26882,Bugcrush,2006-01-20,2006,0,0,0,1.670852
26883,The Trial of the Incredible Hulk,1989-05-06,1989,0,0,0,5.702677
26884,Platinum Blonde,1931-10-31,1931,0,0,0,1.974577
26886,Bright Future,2003-01-18,2003,0,0,0,1.685394
26888,Soul Power,2008-09-04,2008,0,0,0,0.687358
26889,The Brother from Another Planet,1984-09-07,1984,0,0,0,2.02372
26890,I Shot Andy Warhol,1996-05-01,1996,0,1814290,1814290,2.771201
26891,The Castle,1997-01-01,1997,0,0,0,1.949284
26893,The Lower Depths,1957-10-01,1957,0,0,0,1.580676
26895,Hush!,2001-09-09,2001,0,0,0,0.532229
26899,The Mudge Boy,2003-01-17,2003,800000,62852,-737148,7.137026
26900,The Bandit,1996-11-29,1996,0,0,0,1.961587
26910,Anbe Sivam,2003-01-14,2003,1700000,0,-1700000,0.654611
26911,Secret Smile,2005-12-12,2005,0,0,0,1.613314
26912,Quatermass and the Pit,1967-11-09,1967,0,0,0,9.347228
26914,Troll 2,1990-10-12,1990,0,0,0,7.932049
26916,Mercy Streets,2000-10-31,2000,0,0,0,0.643784
26920,Assassin's Creed: Lineage,2009-10-25,2009,0,0,0,3.812134
26921,The Mystery of the Marie Celeste,1935-04-27,1935,0,0,0,0.135118
26925,The Man They Could Not Hang,1939-08-17,1939,0,0,0,0.665719
26928,Buck and the Preacher,1972-03-17,1972,0,0,0,2.098149
26932,The Island of Dr. Moreau,1977-07-13,1977,0,0,0,8.780704
26933,Wild Reeds,1994-05-05,1994,0,0,0,2.115268
26935,Christmas in August,1998-01-24,1998,0,0,0,1.330697
26936,Boiling Point,1990-09-15,1990,0,0,0,1.961194
26939,The Quick and the Dead,1987-02-28,1987,0,0,0,0.932765
26940,A Night in Casablanca,1946-05-10,1946,0,0,0,2.329204
26941,Afterglow,1997-12-26,1997,0,2465960,2465960,1.426289
26942,Amy's Orgasm,2001-03-08,2001,0,0,0,1.294569
26945,Cardcaptor Sakura: The Movie,1999-08-21,1999,0,0,0,1.830762
26946,Attack of the Crab Monsters,1957-02-10,1957,70000,0,-70000,5.264676
26947,Gamera vs. Guiron,1969-03-21,1969,0,0,0,0.441542
26948,Loophole,1954-03-28,1954,0,0,0,0.400267
26949,In Love and War,1996-12-18,1996,0,0,0,2.369637
26953,Puppet Master,1989-10-12,1989,0,0,0,6.173017
26954,Puppet Master II,1990-11-28,1990,780000,0,-780000,2.788831
26955,Oasis,2002-08-09,2002,0,0,0,2.925034
26956,Puppet Master III Toulon's Revenge,1991-10-17,1991,800000,0,-800000,3.349812
26957,Puppet Master 4,1993-11-24,1993,0,0,0,2.420391
26958,Puppet Master 5: The Final Chapter,1994-09-21,1994,0,0,0,4.139393
26959,Curse of the Puppet Master,1998-05-26,1998,0,0,0,3.447033
26960,Retro Puppet Master,1999-11-09,1999,0,0,0,1.34643
26961,Puppet Master: The Legacy,2003-12-16,2003,0,0,0,1.169339
26962,Puppet Master vs Demonic Toys,2004-12-18,2004,0,0,0,1.945492
26963,The Secret of Kells,2009-02-09,2009,0,0,0,5.544992
26964,Family Viewing,1987-10-02,1987,0,0,0,1.131486
26969,8 Dates,2008-04-18,2008,0,0,0,0.422651
26971,Mediterranean Food,2009-02-06,2009,0,0,0,0.635504
26973,Pretty Baby,1978-04-05,1978,0,0,0,5.793494
26974,Pulgasari,1985-01-01,1985,0,0,0,0.435404
26976,Wit,2001-02-09,2001,0,0,0,2.593469
26978,Spacehunter: Adventures in the Forbidden Zone,1983-05-20,1983,15000000,16500000,1500000,3.521436
26983,Odds Against Tomorrow,1959-10-15,1959,0,0,0,1.56193
26985,The 12 Dogs of Christmas,2005-11-01,2005,2000000,0,-2000000,0.847668
26987,Christmas Do-Over,2006-12-16,2006,0,0,0,1.725668
26990,The Perfect Holiday,2007-12-12,2007,0,5800000,5800000,1.380701
27003,The Black Room,1935-07-15,1935,0,0,0,1.429967
27004,Ca$h,2010-01-01,2010,7000000,46488,-6953512,9.107829
27007,Overnight,2003-06-12,2003,550,0,-550,1.443607
27009,Beneath Loch Ness,2002-01-01,2002,0,0,0,1.055415
27010,Black Scorpion,1995-08-22,1995,0,0,0,2.389264
27012,Bone,1972-07-01,1972,0,0,0,0.326243
27016,"Ladies and Gentlemen, the Fabulous Stains",1982-10-01,1982,0,0,0,2.121307
27017,For Me and My Gal,1942-10-21,1942,802000,4371000,3569000,6.165341
27018,Australian Rules,2002-03-05,2002,0,0,0,0.160422
27019,Celine and Julie Go Boating,1974-09-18,1974,0,0,0,1.412839
27022,The Sorcerer's Apprentice,2010-07-13,2010,150000000,215283742,65283742,12.533525
27023,Saint John of Las Vegas,2009-06-10,2009,3800000,111731,-3688269,2.894924
27029,The Nun's Story,1959-06-18,1959,3500000,12800000,9300000,3.473993
27030,The Earrings of Madame de...,1953-09-16,1953,0,0,0,3.839254
27031,Samurai Rebellion,1967-05-27,1967,0,0,0,3.411366
27033,The Strange Love of Martha Ivers,1946-07-24,1946,0,0,0,7.898057
27034,Desert Fury,1947-08-15,1947,0,0,0,1.666871
27035,I Walk Alone,1948-01-16,1948,0,0,0,1.599095
27036,Too Late for Tears,1949-08-13,1949,0,0,0,1.167964
27040,Meshes of the Afternoon,1943-01-01,1943,275,0,-275,2.574317
27042,The ChubbChubbs!,2002-07-03,2002,0,0,0,1.859321
27045,The Crimson Kimono,1959-10-01,1959,0,0,0,1.346122
27046,The Irony of Fate. The Sequel,2007-12-21,2007,5000000,55635037,50635037,1.792402
27052,For a Lost Soldier,1992-05-22,1992,0,0,0,1.593471
27053,Le Jour se L√®ve,1939-06-08,1939,0,0,0,2.183613
27058,Diplomatic Siege,1999-11-17,1999,0,0,0,0.571035
27059,Divine Madness,1980-09-26,1980,0,0,0,0.732917
27061,Two Men in Manhattan,1959-10-16,1959,0,0,0,0.726282
27062,Lan Yu,2001-05-18,2001,0,0,0,1.023718
27064,Mishima: A Life in Four Chapters,1985-05-15,1985,5000000,502758,-4497242,8.591834
27066,The Voyeur,1994-01-27,1994,0,0,0,7.488283
27067,The Life of Jesus,1997-06-04,1997,0,0,0,2.419374
27069,The Raspberry Reich,2004-01-17,2004,0,0,0,3.639668
27070,Chopper Chicks in Zombietown,1989-04-05,1989,0,0,0,0.982881
27072,On the Silver Globe,1988-10-09,1988,0,0,0,1.962954
27074,Oklahoma!,1999-09-26,1999,0,0,0,0.871076
27076,Epoch: Evolution,2003-11-29,2003,0,0,0,2.374621
27079,High Roller: The Stu Ungar Story,2003-05-01,2003,0,0,0,0.888157
27084,Invasion of the Bee Girls,1973-06-01,1973,0,0,0,5.952421
27085,The Land That Time Forgot,1975-08-13,1975,1500000,0,-1500000,2.343888
27088,The Last American Virgin,1982-06-26,1982,0,0,0,9.390673
27090,Zero Day,2003-09-03,2003,20000,0,-20000,1.394528
27091,Harry And Max,2004-01-01,2004,0,0,0,1.052353
27092,Burnt Money,2000-05-11,2000,0,0,0,2.169971
27093,Close to Leo,2002-05-18,2002,0,0,0,1.024912
27094,Lenny,1974-11-10,1974,0,0,0,7.285627
27095,Cold Showers,2005-05-14,2005,0,0,0,2.337139
27098,All Things Fair,1995-03-08,1995,0,0,0,3.582047
27099,Come Undone,2000-06-07,2000,0,0,0,2.242307
27102,Full Moon in Paris,1984-08-29,1984,0,0,0,1.860248
27103,My Life in Pink,1997-05-28,1997,0,0,0,3.237812
27104,Steam: The Turkish Bath,1997-10-24,1997,0,0,0,1.74817
27105,Day of the Evil Gun,1968-03-01,1968,0,0,0,0.372015
27112,Corridor of Mirrors,1948-07-24,1948,0,0,0,0.482651
27114,The Phantom of Crestwood,1932-10-14,1932,0,0,0,0.471328
27115,The Walking Dead,1936-03-14,1936,0,0,0,1.057723
27116,Bluebeard,1972-09-01,1972,0,0,0,1.36682
27117,Sherlock Holmes and the Voice of Terror,1942-09-18,1942,0,0,0,2.134728
27118,The Hound of the Baskervilles,1939-03-31,1939,0,0,0,2.722222
27119,Tsatsiki,1999-10-01,1999,0,0,0,1.177552
27122,The Attic,2008-01-15,2008,700,0,-700,1.240934
27123,The Trench,1999-09-17,1999,0,0,0,5.738152
27130,I Walked with a Zombie,1943-04-21,1943,0,0,0,3.511113
27134,Boy Eats Girl,2005-06-07,2005,0,0,0,4.912303
27137,Sybil,2007-05-28,2007,0,0,0,1.512032
27138,Sybil,1976-11-14,1976,0,0,0,1.899992
27141,Liberty Heights,1999-11-17,1999,0,0,0,2.64721
27144,The Dark Eyes of London,1939-11-03,1939,0,0,0,0.635769
27145,The Aviator's Wife,1981-03-04,1981,0,0,0,7.326636
27146,Mr. Freedom,1969-01-09,1969,0,0,0,1.568747
27150,Silent Rage,1982-04-02,1982,4500000,10500000,6000000,1.808605
27152,"Gone, But Not Forgotten",2003-10-09,2003,0,0,0,1.01426
27154,Happy End,1999-12-11,1999,0,0,0,3.76579
27169,Gabriel Iglesias: I'm Not Fat... I'm Fluffy,2009-11-08,2009,0,0,0,1.227496
27171,The Lonely Guy,1984-01-27,1984,0,0,0,4.273982
27172,There Was a Crooked Man...,1970-09-18,1970,0,0,0,4.643058
27176,"The Prize Winner of Defiance, Ohio",2005-09-28,2005,0,0,0,2.270224
27179,It! The Terror from Beyond Space,1958-07-31,1958,0,0,0,1.618275
27181,The Phantom,2000-10-20,2000,0,0,0,2.521661
27182,Note by Note: The Making of Steinway L1037,2007-11-07,2007,0,0,0,0.128607
27190,A Muppets Christmas: Letters to Santa,2008-12-17,2008,0,0,0,1.228603
27191,The Greatest Show on Earth,1952-01-10,1952,4000000,36000000,32000000,4.011363
27196,Stardust,1974-10-24,1974,0,0,0,0.553636
27197,An Actor's Revenge,1963-01-13,1963,0,0,0,1.616275
27200,Sherlock Holmes in New York,1976-10-18,1976,0,0,0,0.566258
27201,Corvette Summer,1978-06-02,1978,0,15500000,15500000,5.695908
27202,Pauly Shore Is Dead,2003-03-11,2003,0,0,0,2.091305
27203,They Won't Believe Me,1947-07-16,1947,0,0,0,1.686848
27204,God Is Great and I'm Not,2001-09-26,2001,0,0,0,1.534982
27205,Inception,2010-07-14,2010,160000000,825532764,665532764,29.108149
27207,Bloodsucking Pharaohs in Pittsburgh,1991-05-02,1991,0,0,0,0.809104
27208,A Curtain Raiser,2006-08-07,2006,0,0,0,1.172728
27211,"Feyzo, the Polite One",1978-01-01,1978,0,0,0,0.857814
27212,A Bullet for Joey,1955-04-15,1955,0,0,0,1.569815
27214,Amityville 3-D,1983-11-18,1983,0,6333135,6333135,7.893775
27215,Rock Haven,2007-06-21,2007,0,0,0,0.986431
27217,The Sea,2002-09-13,2002,0,0,0,1.454165
27221,Where the Green Ants Dream,1984-08-31,1984,0,0,0,0.651787
27223,Lost in America,1985-03-15,1985,0,0,0,1.628303
27224,Lost in Yonkers,1993-05-14,1993,0,0,0,1.521922
27225,S.O.B.,1981-07-01,1981,0,0,0,2.648622
27230,Christmas Evil,1980-11-01,1980,750000,0,-750000,8.952589
27232,Conquest,1983-06-02,1983,0,0,0,8.261176
27233,Kids Return,1996-07-27,1996,0,0,0,3.222423
27236,Two-Lane Blacktop,1971-07-07,1971,850000,0,-850000,4.550433
27243,Dragons: A Fantasy Made Real,2004-12-01,2004,0,0,0,0.77455
27244,The Dungeonmaster,1984-08-24,1984,0,0,0,1.294294
27245,Electric Dragon 80.000 V,2001-01-31,2001,0,0,0,2.238958
27255,From a Place of Darkness,2008-03-25,2008,0,0,0,0.582832
27256,The Woman in Question,1952-02-18,1952,0,0,0,0.757337
27258,Home Movie,2008-07-10,2008,0,0,0,1.860205
27259,Long Time Dead,2002-01-18,2002,0,13102295,13102295,1.818561
27260,Brave New World,1998-04-19,1998,0,0,0,2.610987
27261,Orders to Kill,1958-07-25,1958,0,0,0,0.91468
27263,The Tall Target,1951-08-17,1951,0,0,0,0.439309
27265,Mother,1996-12-25,1996,0,0,0,7.860965
27270,America 3000,1986-04-08,1986,2000000,0,-2000000,1.354171
27271,Eye of the Tiger,1986-07-07,1986,0,0,0,4.279405
27273,The Flight of Dragons,1982-08-17,1982,0,0,0,2.370931
27274,Frankenhooker,1990-06-01,1990,2500000,205068,-2294932,5.097791
27275,G.O.R.A.,2004-11-12,2004,0,0,0,2.742702
27276,Gemini,1999-09-15,1999,0,0,0,2.108623
27277,The War Wagon,1967-05-27,1967,0,6000000,6000000,3.874603
27281,Operation Dumbo Drop,1995-07-28,1995,0,0,0,4.357971
27283,Sappho,2008-02-29,2008,0,0,0,1.855076
27286,Beautiful Losers,2008-04-01,2008,0,56386,56386,0.732748
27292,Prime Cut,1972-06-28,1972,0,0,0,3.156583
27294,Crime Wave,1985-04-12,1985,0,0,0,0.519774
27295,Mom and Dad Save the World,1992-07-24,1992,0,0,0,3.291757
27296,The Gingerdead Man,2005-01-01,2005,0,0,0,1.34144
27297,Grotesque,2009-01-17,2009,0,0,0,2.275789
27300,Hair High,2004-04-17,2004,0,0,0,3.27204
27303,Hideaway,1995-03-03,1995,15000000,12201255,-2798745,8.182165
27306,Cyber Wars,2004-01-01,2004,0,0,0,1.157129
27307,How I Got Into College,1989-05-19,1989,0,0,0,1.643663
27310,The Marine 2,2009-12-29,2009,0,0,0,8.143805
27313,I Drink Your Blood,1970-01-01,1970,0,0,0,2.030342
27316,Into the Mirror,2003-08-14,2003,0,0,0,2.424021
27317,Patton Oswalt: My Weakness Is Strong,2009-08-25,2009,0,0,0,0.905823
27318,Jack Frost,1997-11-18,1997,0,0,0,5.764598
27320,Jack Frost 2: Revenge of the Mutant Killer Snowman,2000-01-01,2000,0,0,0,1.440445
27322,Love Jones,1997-03-14,1997,10000000,0,-10000000,1.251862
27323,Joysticks,1983-03-04,1983,300000,3952448,3652448,2.290725
27324,Pulse,2001-02-10,2001,0,0,0,4.122317
27327,Phantom of the Paradise,1974-10-31,1974,0,0,0,6.469438
27328,The Last House on Dead End Street,1973-01-01,1973,3000,0,-3000,1.191593
27329,The Legend of Suriyothai,2001-08-17,2001,0,0,0,1.236038
27331,Charley Varrick,1973-09-19,1973,0,0,0,9.057212
27332,Tex,1982-07-30,1982,0,0,0,5.540117
27337,Linda Linda Linda,2005-07-23,2005,0,0,0,2.186388
27338,The Pretender 2001,2001-01-22,2001,0,0,0,0.762688
27339,The Pretender: Island of the Haunted,2001-12-10,2001,0,0,0,1.179954
27341,The Sign of Four: Sherlock Holmes' Greatest Case,1932-08-14,1932,0,0,0,0.086068
27342,Malone,1987-05-01,1987,0,0,0,4.904109
27344,Swamp Women,1956-11-16,1956,0,0,0,1.36807
27346,Maniac,1980-11-07,1980,350000,0,-350000,4.838469
27349,The Great Northfield Minnesota Raid,1972-05-12,1972,0,0,0,1.569337
27350,McBain,1991-09-20,1991,0,0,0,0.382527
27351,Meatball Machine,2005-01-01,2005,0,0,0,1.1965
27352,Braddock: Missing in Action III,1988-01-22,1988,0,6193901,6193901,7.362552
27353,Shredderman Rules,2007-06-09,2007,0,0,0,1.97503
27357,Fallen Art,2004-01-01,2004,0,0,0,0.481611
27358,Monsturd,2003-04-08,2003,0,0,0,0.110371
27359,Brand Upon the Brain! A Remembrance in 12 Chapters,2007-05-09,2007,0,0,0,1.547591
27360,King's Ransom,2005-04-22,2005,0,0,0,4.550206
27361,Black Moon,1975-09-24,1975,0,0,0,9.2161
27362,Drowning by Numbers,1988-09-10,1988,0,0,0,2.264156
27364,Paris Holiday,1958-05-09,1958,0,0,0,0.22625
27367,Mrs. Miniver,1942-06-04,1942,1344000,13500000,12156000,3.306745
27370,Paranormal Entity,2009-12-22,2009,0,0,0,1.59297
27371,Crimes of the Future,1970-08-01,1970,0,0,0,1.02287
27372,There Was a Father,1942-04-01,1942,0,0,0,0.538186
27374,Lake Mungo,2008-06-17,2008,0,0,0,5.634004
27375,Salesman,1969-01-01,1969,0,0,0,1.091894
27376,Muscle Beach Party,1964-03-25,1964,0,0,0,4.269022
27378,Heart of Glass,1976-11-12,1976,0,0,0,1.779207
27379,The Apocalypse Code,2007-10-02,2007,0,0,0,1.018081
27380,Megaforce,1982-06-25,1982,0,0,0,1.352144
27381,Innocent Blood,1992-09-25,1992,0,0,0,4.046861
27387,Gacy,2003-05-13,2003,250000,0,-250000,6.677536
27390,Sorority Babes in the Slimeball Bowl-O-Rama,1988-01-29,1988,90000,0,-90000,1.471453
27391,Polar Storm,2009-03-28,2009,0,0,0,1.649688
27395,Count Dracula's Great Love,1973-05-12,1973,0,0,0,0.674043
27396,Brannigan,1975-03-21,1975,0,0,0,1.878553
27397,Crossing Delancey,1988-09-16,1988,0,16262415,16262415,2.00871
27399,Forbidden,1953-12-02,1953,0,0,0,0.231607
27404,My Big Fat Independent Movie,2005-03-04,2005,0,0,0,0.79138
27405,Circus of Horrors,1960-04-01,1960,0,0,0,1.653187
27408,Never Too Young to Die,1986-06-13,1986,0,0,0,0.863445
27409,Night of the Devils,1972-04-29,1972,0,0,0,1.447142
27412,Hollywood Chainsaw Hookers,1988-03-01,1988,23000,0,-23000,2.351002
27414,"Silent Night, Deadly Night",1984-11-09,1984,1065000,0,-1065000,3.81324
27417,The Roost,2005-03-12,2005,0,0,0,0.76964
27418,Next of Kin,1989-10-20,1989,12000000,15942628,3942628,3.801832
27419,Les Bonnes Femmes,1960-04-22,1960,0,0,0,0.696824
27420,Graduation Day,1981-05-01,1981,0,0,0,2.590862
27425,Blind Beast,1969-01-25,1969,0,0,0,2.219862
27428,Bloody Reunion,2006-08-03,2006,0,0,0,1.050446
27429,Shivers,1975-10-10,1975,179000,0,-179000,11.540666
27430,Touchez Pas au Grisbi,1954-03-16,1954,0,0,0,6.609106
27431,The Cat o' Nine Tails,1971-02-11,1971,1000000,0,-1000000,4.392321
27432,Killer of Sheep,1978-11-14,1978,100000,362222,262222,2.777856
27437,The Bachelor and the Bobby-Soxer,1947-07-24,1947,0,0,0,2.250105
27439,Slaughter Hotel,1971-07-31,1971,0,0,0,2.941467
27440,Save Me,2007-01-01,2007,0,0,0,1.4001
27441,Countdown,1968-02-01,1968,0,0,0,2.105604
27442,Senseless,2008-01-01,2008,0,0,0,0.467144
27443,Silver Lode,1954-07-23,1954,0,0,0,1.237049
27444,Better Than Sex,2000-11-09,2000,0,0,0,7.563606
27446,The Fearmakers,1958-10-01,1958,0,0,0,0.659496
27447,Edge of Madness,2002-01-01,2002,0,0,0,1.058927
27448,The Two Mrs. Carrolls,1947-03-04,1947,0,0,0,1.408342
27449,Baby Face,1933-07-12,1933,187000,0,-187000,3.363332
27450,Chicago Joe and the Showgirl,1990-05-16,1990,0,0,0,0.751073
27451,Harvard Man,2001-01-01,2001,0,0,0,4.242462
27452,The Spiral Staircase,1946-02-06,1946,0,0,0,7.719019
27453,Sketches of Frank Gehry,2006-05-12,2006,0,0,0,1.821956
27455,Foolish,1999-04-09,1999,0,6033999,6033999,0.431822
27456,Thunderbolt,1929-06-20,1929,0,0,0,0.479627
27457,Peacetime,2009-08-14,2009,0,0,0,1.104471
27458,Little Darlings,1980-03-21,1980,0,0,0,5.296704
27459,Little Murders,1971-02-09,1971,0,0,0,1.612885
27460,Nick Fury: Agent of S.H.I.E.L.D.,1998-05-26,1998,0,0,0,1.282504
27461,Fat Man and Little Boy,1989-10-20,1989,0,0,0,8.011566
27462,Slave Girls from Beyond Infinity,1987-09-18,1987,0,0,0,0.935783
27464,O.C. and Stiggs,1985-01-01,1985,0,0,0,2.354286
27465,Once Upon a Crime,1992-03-06,1992,0,0,0,1.984181
27470,Skidoo,1968-12-19,1968,0,0,0,1.448899
27472,The Odd Couple II,1998-04-09,1998,0,0,0,2.196028
27475,The Slumber Party Massacre,1982-11-12,1982,0,0,0,6.133484
27476,Nightmare Sisters,1988-06-15,1988,40000,0,-40000,1.453912
27480,Last Ride,2009-07-02,2009,0,0,0,3.415676
27495,The Toolbox Murders,1978-03-15,1978,185000,0,-185000,2.159181
27496,Nightmare in Wax,1969-05-14,1969,0,0,0,0.91329
27498,Jack O,1995-10-10,1995,0,0,0,0.692228
27501,The Bat,1926-03-14,1926,0,0,0,1.074296
27502,The Monster,1925-03-16,1925,0,0,0,0.09386
27503,The Unknown,1927-06-04,1927,217000,0,-217000,1.48162
27504,The Unholy Three,1930-07-03,1930,0,0,0,0.277459
27505,The Unholy Three,1925-09-16,1925,103000,704000,601000,1.345287
27506,West of Zanzibar,1928-11-24,1928,259000,921000,662000,0.722511
27507,"Laugh, Clown, Laugh",1928-04-14,1928,293000,0,-293000,0.815852
27509,The Penalty,1920-08-15,1920,89000,0,-89000,0.971225
27511,He Who Gets Slapped,1924-12-22,1924,172000,0,-172000,0.719924
27517,The Man Who Laughs,1928-04-27,1928,0,0,0,2.571104
27521,The Boys in Company C,1978-02-02,1978,0,0,0,1.690559
27522,Waxworks,1924-11-13,1924,0,0,0,0.845187
27523,Salvatore Giuliano,1962-02-28,1962,0,0,0,1.306016
27526,The Crossing Guard,1995-11-15,1995,0,0,0,5.756462
27543,The Sound of Fury,1950-12-12,1950,0,0,0,1.029314
27544,The Company She Keeps,1951-01-27,1951,0,0,0,5.270237
27545,The Wasp Woman,1959-11-02,1959,50000,0,-50000,1.78919
27548,Slime City,1988-05-13,1988,50000,0,-50000,1e-06
27549,Beastmaster 2: Through the Portal of Time,1991-06-08,1991,6000000,869325,-5130675,4.038283
27550,Nina Frisk,2007-03-09,2007,0,0,0,0.195066
27551,The Barbarians,1987-03-01,1987,0,0,0,1.489798
27554,The Panic in Needle Park,1971-07-13,1971,1645000,0,-1645000,8.802676
27560,Cry of the Hunted,1953-05-08,1953,0,0,0,0.255534
27561,Trailer Park Boys: Countdown to Liquor Day,2009-09-25,2009,3500000,0,-3500000,3.093829
27563,Flamingo Road,1949-05-06,1949,0,0,0,2.004126
27567,The Maid,2009-10-16,2009,0,0,0,1.199005
27568,Panic in Year Zero!,1962-07-05,1962,0,0,0,2.653928
27569,Extraordinary Measures,2010-01-21,2010,31000000,15134293,-15865707,6.523155
27573,The Bounty Hunter,2010-03-16,2010,40000000,136000000,96000000,6.715263
27576,Salt,2010-07-21,2010,110000000,293329073,183329073,8.704455
27578,The Expendables,2010-08-03,2010,80000000,274470394,194470394,14.75562
27579,The American,2010-08-31,2010,20000000,65464324,45464324,7.275649
27581,The Other Guys,2010-08-06,2010,100000000,170432927,70432927,12.536621
27582,The Mechanic,2011-01-13,2011,40000000,51070807,11070807,9.832342
27583,Greenberg,2010-03-26,2010,0,6153967,6153967,8.509231
27584,High School,2010-06-03,2010,0,0,0,3.905764
27585,Rabbit Hole,2010-12-16,2010,5000000,5129058,129058,7.007993
27586,The Runaways,2010-03-19,2010,10000000,2995811,-7004189,19.42051
27588,Forget Me Not,2009-10-22,2009,0,0,0,4.458372
27590,Gotcha!,1985-05-03,1985,0,8800000,8800000,6.086982
27591,The People That Time Forgot,1977-07-06,1977,0,0,0,13.5265
27593,"Scotland, Pa.",2001-03-15,2001,0,0,0,3.227759
27595,Charlie & Boots,2009-09-03,2009,0,0,0,1.527217
27597,Stowaway,1936-12-25,1936,0,0,0,0.922047
27598,"You're Out of Your Mind, Madicken",1979-12-14,1979,0,0,0,1.488704
27599,Lotta Leaves Home,1993-09-18,1993,0,0,0,0.593493
27600,Lotta on Rascal Street,1992-07-07,1992,0,0,0,0.877781
27601,Citizen Toxie: The Toxic Avenger IV,2001-11-01,2001,500000,0,-500000,4.693487
27605,The 13 Roses,2007-10-19,2007,0,0,0,0.842613
27607,Parents,1989-01-27,1989,0,0,0,2.834709
27609,Personal Best,1982-02-05,1982,0,0,0,1.329464
27618,The Horribly Slow Murderer with the Extremely Inefficient Weapon,2008-01-01,2008,0,0,0,1.860321
27620,The Erotic Misadventures of the Invisible Man,2003-11-18,2003,0,0,0,1.090503
27621,The Cheetah Girls: One World,2008-08-22,2008,0,0,0,3.127143
27622,A Woman's Face,1941-05-09,1941,0,0,0,6.584553
27624,Maine Pyar Kiya,1989-10-16,1989,0,0,0,2.247454
27625,It Conquered the World,1956-07-14,1956,0,0,0,2.141695
27629,Here Comes the Groom,1951-09-20,1951,0,0,0,0.272093
27631,"Richard Pryor: I Ain't Dead Yet, #*%$#@!!",2003-01-01,2003,0,0,0,0.85116
27632,Black Sunday,1960-08-11,1960,0,0,0,4.683413
27635,Reign of Terror,1949-10-15,1949,0,0,0,0.89069
27636,The Whip and the Body,1963-08-29,1963,66500,0,-66500,2.227007
27637,Horst Schl√§mmer - Isch kandidiere!,2009-08-20,2009,0,0,0,1.461478
27638,Rio,1939-12-29,1939,0,0,0,0.326422
27642,Queen of Blood,1966-03-01,1966,0,0,0,1.362528
27644,Ride Lonesome,1959-02-15,1959,0,0,0,1.648486
27645,200 Motels,1971-11-10,1971,679000,0,-679000,1.307196
27646,Night of the Demons,2009-08-30,2009,10000000,0,-10000000,3.537361
27651,Puppet Master: Axis of Evil,2010-01-15,2010,0,0,0,0.866995
27653,An American Tail: The Mystery of the Night Monster,1999-02-04,1999,0,0,0,5.832963
27655,Tales of Manhattan,1942-08-05,1942,0,0,0,1.750525
27658,Cockfighter,1974-08-01,1974,0,0,0,1.044611
27662,Deep Space,1988-05-01,1988,1500000,0,-1500000,0.785271
27665,Uninvited Guest,1999-06-01,1999,0,170832,170832,0.269126
27671,Pop Skull,2007-07-06,2007,2000,0,-2000,0.222681
27674,Wolves of Wall Street,2002-12-31,2002,0,0,0,0.776524
27678,Barbarians at the Gate,1993-03-20,1993,0,0,0,1.685697
27679,D.C. Cab,1983-12-16,1983,0,0,0,1.730043
27681,Wish Upon a Star,1996-11-12,1996,0,0,0,3.332706
27683,The Last Time,2006-10-01,2006,0,0,0,3.587239
27686,State Fair,1945-08-29,1945,0,0,0,1.81628
27696,The Thirsting,2006-01-01,2006,350000,0,-350000,0.116875
27698,Kisaragi,2007-06-16,2007,0,0,0,1.176904
27699,The Awful Dr. Orlof,1962-05-14,1962,0,0,0,0.918733
27703,The Psychic,1977-08-10,1977,0,0,0,2.581618
27706,The Night Child,1975-04-22,1975,0,0,0,0.492197
27709,The Satan Bug,1965-03-26,1965,0,0,0,1.367743
27711,Killjoy,2000-10-24,2000,150000,0,-150000,0.531305
27712,Killjoy 2: Deliverance from Evil,2002-01-08,2002,30000,0,-30000,0.525622
27716,Coonskin,1975-08-20,1975,0,0,0,2.674903
27717,The Phantom Planet,1961-12-13,1961,0,0,0,0.99943
27719,The Peacekeeper,1998-01-18,1998,0,0,0,1.131262
27721,In Bar,2007-01-01,2007,0,0,0,1.959976
27723,Psycho Beach Party,2000-08-06,2000,1500000,0,-1500000,3.898441
27724,Psychopathia Sexualis,2006-06-08,2006,0,0,0,0.474898
27725,High Sierra,1941-01-25,1941,455000,0,-455000,6.27696
27726,Q,1982-10-29,1982,0,0,0,3.386544
27730,The Revenge of the Living Dead Girls,1987-09-16,1987,0,0,0,1.637235
27735,Wonderful World,2009-01-01,2009,0,0,0,4.033627
27738,Russkies,1987-11-06,1987,0,2189047,2189047,1.184009
27739,The Zombie Chronicles,2001-01-01,2001,0,0,0,0.036669
27740,A Return to Salem's Lot,1987-05-01,1987,12000000,0,-12000000,2.731501
27742,S√©ance,2000-08-07,2000,0,0,0,0.846866
27743,Serial Killing 101,2004-01-01,2004,0,0,0,0.251914
27745,The Filth and the Fury,2000-03-29,2000,0,0,0,2.756553
27748,15: The Movie,2003-04-27,2003,0,0,0,0.651396
27757,The Little Engine That Could,1991-01-01,1991,0,0,0,0.000124
27759,55 Days at Peking,1963-05-06,1963,17000000,10000000,-7000000,2.972529
27764,Slumber Party Massacre II,1987-10-30,1987,0,0,0,1.718146
27766,Santa Claws,1996-10-22,1996,0,0,0,0.036799
27767,Slumber Party Massacre III,1990-09-07,1990,0,0,0,1.986075
27768,Some Folks Call It a Sling Blade,1994-03-26,1994,0,0,0,0.459376
27769,Sometimes They Come Back,1991-05-07,1991,0,0,0,6.789271
27770,Sometimes They Come Back... Again,1996-09-03,1996,3000000,0,-3000000,2.637369
27771,Sometimes They Come Back... for More,1998-09-06,1998,0,0,0,1.927102
27777,The Racket,1928-11-01,1928,0,0,0,0.699893
27786,Steel Dawn,1987-11-06,1987,0,0,0,2.605644
27791,Strangeland,1998-10-02,1998,1100000,631221,-468779,2.31478
27793,The Neverending Story III: Escape from Fantasia,1994-10-26,1994,17000000,0,-17000000,6.252377
27799,Hana and Alice,2004-03-13,2004,0,0,0,1.906696
27804,The Thing Called Love,1993-07-16,1993,14000000,0,-14000000,2.923094
27805,Stunt Rock,1978-01-01,1978,0,0,0,0.423954
27813,Basket Case,1982-04-14,1982,35000,0,-35000,6.631724
27814,Brain Damage,1988-04-15,1988,0,0,0,4.899686
27815,Basket Case 2,1990-03-02,1990,2500000,0,-2500000,4.052825
27816,Basket Case 3,1992-02-01,1992,0,0,0,2.452019
27824,The Last Man,2000-04-15,2000,0,0,0,0.995043
27827,Manufacturing Dissent,2007-02-11,2007,0,0,0,0.259428
27832,The Corpse Grinders,1971-05-19,1971,47000,0,-47000,0.783754
27834,CQ,2001-05-12,2001,0,0,0,1.991025
27836,Summer Camp Nightmare,1987-04-17,1987,0,0,0,0.412768
27840,Mark of the Astro-Zombies,2002-01-01,2002,0,0,0,0.391997
27841,They Might Be Giants,1971-06-09,1971,0,0,0,2.303594
27843,Tokyo Zombie,2005-12-10,2005,0,0,0,1.120763
27845,Trees Lounge,1996-10-11,1996,0,0,0,3.464286
27847,Universal Soldier III: Unfinished Business,1999-12-01,1999,0,0,0,2.322004
27850,Halloweentown,1998-11-10,1998,0,0,0,5.318151
27854,For Whom the Bell Tolls,1943-07-12,1943,3000000,0,-3000000,14.373861
27857,Prick Up Your Ears,1987-04-17,1987,0,0,0,3.328585
27858,PT 109,1963-06-19,1963,0,0,0,1.256573
27859,Rated X,2000-01-01,2000,0,0,0,5.792724
27861,Mimino,1977-06-06,1977,0,0,0,1.479568
27862,Walking the Streets of Moscow,1963-01-01,1963,0,0,0,2.094777
27864,The Lathe of Heaven,1980-01-01,1980,0,0,0,1.422501
27865,The World According to Monsanto,2008-01-01,2008,0,0,0,0.577076
27866,Kevin Hart: I'm a Grown Little Man,2009-02-03,2009,0,0,0,1.784753
27873,Battletruck,1982-01-01,1982,1000000,3000000,2000000,0.815844
27875,Yaji and Kita: The Midnight Pilgrims,2005-04-02,2005,0,0,0,0.040872
27881,Zombie Island Massacre,1984-11-20,1984,0,0,0,0.637298
27883,Macbeth,1948-10-01,1948,0,0,0,1.663767
27884,The Story of Robin Hood and His Merrie Men,1952-05-26,1952,0,0,0,0.786528
27885,Just One of the Girls,1993-09-13,1993,0,0,0,7.895476
27886,Slaughter High,1986-01-01,1986,0,0,0,2.056449
27899,Little Caesar,1931-01-09,1931,0,0,0,9.019985
27902,Love Wrecked,2005-11-01,2005,0,0,0,6.608369
27904,Syndromes and a Century,2006-08-31,2006,0,0,0,1.851507
27905,Island of the Fishmen,1979-01-18,1979,0,0,0,1.273167
27906,Call of the Wild,2009-06-12,2009,0,270210,270210,1.409435
27907,Spirit of the Marathon,2008-01-24,2008,0,0,0,0.21496
27909,Alien from the Deep,1989-10-15,1989,0,0,0,0.178094
27915,Cuban Rafters,2002-04-12,2002,0,62153,62153,0.525869
27916,Redneck Zombies,1989-02-14,1989,0,0,0,1.801688
27917,Pool of London,1951-02-20,1951,0,0,0,1.327401
27918,The Invisible Ray,1936-01-20,1936,0,0,0,1.486415
27919,The Second Chance,2006-01-01,2006,1200000,0,-1200000,0.753558
27920,A Summer to Remember,1960-08-12,1960,0,0,0,0.353118
27922,Don't Grieve!,1969-06-06,1969,0,0,0,1.451998
27923,Hopelessly Lost,1973-06-06,1973,0,0,0,0.366869
27924,Autumn Marathon,1979-06-06,1979,0,0,0,1.095033
27925,Tears Were Falling,1982-01-01,1982,0,0,0,0.556977
27930,Rude Boy,1980-07-25,1980,0,0,0,1.152225
27932,Airport 1975,1974-10-18,1974,3000000,47000000,44000000,8.480501
27934,12 Chairs,1976-12-31,1976,0,0,0,0.778283
27935,Ordinary Miracle,1978-01-01,1978,0,0,0,1.619638
27936,Micmacs,2009-10-28,2009,33000000,14000000,-19000000,5.278672
27937,That Munchhausen,1979-01-01,1979,0,0,0,1.247706
27939,The House That Swift Built,1982-06-06,1982,0,0,0,0.008673
27940,Formula of Love,1984-01-01,1984,0,0,0,0.719761
27941,Lockjaw: Rise of the Kulev Serpent,2008-07-14,2008,0,0,0,0.681163
27942,–£–±–∏—Ç—å –¥—Ä–∞–∫–æ–Ω–∞,1988-01-01,1988,0,0,0,0.655748
27944,Rain Fall,2009-04-24,2009,7000000,0,-7000000,1.474186
27945,Hombre,1967-03-21,1967,5860000,12000000,6140000,8.019495
27952,Alone,2008-01-01,2008,0,0,0,1.214845
27953,Kabadayƒ±,2007-12-14,2007,0,10161213,10161213,1.111025
27957,The Breath,2009-10-15,2009,2000000,13500000,11500000,1.315237
27958,Cruising,1980-09-23,1980,0,0,0,10.03959
27960,I Saw the Sun,2009-01-01,2009,0,0,0,0.82448
27966,King of the Underworld,1939-01-14,1939,0,0,0,1.080246
27967,Mockingbird Don't Sing,2001-05-04,2001,0,0,0,0.808884
27969,Turk 182!,1985-02-15,1985,1900000,0,-1900000,1.411286
27970,Werewolf of London,1935-05-13,1935,0,0,0,8.579045
27972,Dark Victory,1939-04-22,1939,0,0,0,7.607677
27973,Dead End,1937-08-27,1937,300000,0,-300000,2.136689
27974,Bullets or Ballots,1936-06-06,1936,0,0,0,2.25051
27977,The Groove Tube,1974-06-23,1974,0,0,0,1.341516
27978,The Woman on Pier 13,1949-10-08,1949,0,0,0,0.768195
27983,"Yours, Mine and Ours",1968-04-24,1968,0,0,0,3.49506
27984,Far from Home,1989-06-30,1989,0,0,0,1.69302
27985,Far from Home: The Adventures of Yellow Dog,1995-01-13,1995,0,0,0,2.657337
27986,The Story of Temple Drake,1933-05-06,1933,0,0,0,0.294897
27989,Serious Moonlight,2009-12-04,2009,0,0,0,4.747197
27991,The Little Giant,1933-05-20,1933,0,0,0,0.631869
27993,Senior Trip,1995-09-08,1995,0,0,0,5.05806
27994,Sgt. Kabukiman N.Y.P.D.,1991-01-01,1991,0,0,0,1.202655
27995,She's Gotta Have It,1986-08-08,1986,0,0,0,7.056652
27996,Dr. Dolittle: Tail to the Chief,2008-03-04,2008,0,0,0,2.021759
27997,Shock Treatment,1981-10-30,1981,0,0,0,2.0212
27998,The Murder Man,1935-07-12,1935,0,0,0,0.917973
27999,The Killer Is Loose,1956-03-02,1956,0,0,0,1.136576
28000,Somebody Up There Likes Me,1956-07-03,1956,1920000,3360000,1440000,2.747776
28001,It's a Gift,1934-11-30,1934,0,0,0,1.837549
28005,Kama Sutra - A Tale of Love,1996-09-11,1996,3000000,4109095,1109095,7.124652
28006,I See a Dark Stranger,1946-07-04,1946,0,0,0,1.150804
28007,The Reckless Moment,1949-12-29,1949,0,0,0,1.588895
28013,Bangkok Hilton,1989-11-05,1989,0,0,0,1.274077
28018,Collision,2009-10-27,2009,0,0,0,0.557964
28019,"Give 'em Hell, Malone",2009-01-01,2009,15000000,0,-15000000,3.869951
28023,Riot in Cell Block 11,1954-02-28,1954,0,0,0,1.009744
28025,Moonlight Serenade,2009-01-01,2009,0,0,0,0.411335
28026,Prey for Rock & Roll,2003-01-20,2003,0,0,0,0.834421
28028,Sonny,2002-10-26,2002,110,0,-110,4.387474
28029,A Walk on the Moon,1999-01-29,1999,14000000,0,-14000000,7.703645
28030,Genghis Blues,1999-07-19,1999,0,0,0,0.692364
28031,If These Walls Could Talk 2,2000-03-05,2000,0,0,0,2.866914
28032,Thumbelina,1994-03-30,1994,28000000,11373501,-16626499,13.856199
28033,Stuart Saves His Family,1995-04-12,1995,0,0,0,1.390885
28036,Horror Business,2005-01-01,2005,15000,0,-15000,0.037702
28039,The New One-Armed Swordsman,1971-02-07,1971,0,0,0,0.768551
28043,Black Sabbath,1963-08-22,1963,0,0,0,4.363259
28044,Charlie Chan at the Opera,1936-12-05,1936,0,0,0,1.430149
28046,The Ghoul,1933-08-01,1933,0,0,0,1.380825
28047,Phoenix,1998-09-04,1998,0,0,0,1.643899
28049,"Kill Baby, Kill",1966-07-08,1966,0,0,0,2.230793
28050,Hatchet for the Honeymoon,1970-06-02,1970,0,0,0,1.491578
28051,5 Dolls for an August Moon,1970-02-14,1970,0,0,0,1.433703
28053,City Island,2009-03-06,2009,6000000,6670712,670712,7.016044
28054,Suburbia,1984-04-13,1984,0,0,0,1.778848
28055,Blood and Black Lace,1964-03-13,1964,0,0,0,5.54191
28058,Hercules in the Haunted World,1961-11-16,1961,0,0,0,0.857972
28059,SubUrbia,1996-02-07,1996,0,656747,656747,8.67935
28061,Lust of the Vampire,1957-04-05,1957,0,0,0,0.750623
28062,When Darkness Falls,2006-10-20,2006,0,0,0,1.044274
28063,"Caltiki, the Immortal Monster",1959-08-07,1959,0,0,0,0.544324
28064,Naked You Die,1968-02-20,1968,0,0,0,1.483254
28067,The Ghost Galleon,1974-06-28,1974,0,0,0,1.791601
28068,The Loreley's Grasp,1974-02-23,1974,0,0,0,0.337601
28070,Surf Nazis Must Die,1987-07-03,1987,0,0,0,1.788913
28071,Night of the Seagulls,1975-01-01,1975,0,0,0,2.009344
28072,Demon Witch Child,1975-03-03,1975,0,0,0,0.278839
28073,Curse of the Crimson Altar,1968-12-01,1968,0,0,0,1.634974
28089,The Messenger,2009-11-13,2009,6500000,1521261,-4978739,5.499937
28090,Maniac Cop 2,1990-12-13,1990,4000000,0,-4000000,2.412356
28093,In Which We Serve,1942-09-16,1942,0,0,0,0.861823
28100,Carousel,1956-02-16,1956,0,0,0,3.203634
28101,Chicago Massacre: Richard Speck,2007-04-15,2007,0,0,0,0.696757
28105,Word Wars,2004-05-28,2004,0,0,0,0.549944
28110,Dillinger,1973-07-20,1973,1000000,2000000,1000000,8.005804
28115,Dillinger,1945-03-02,1945,0,0,0,1.61966
28117,Delirious,1991-08-09,1991,18000000,5546827,-12453173,1.33724
28118,The Gruffalo,2009-12-25,2009,0,0,0,8.575933
28120,Crossfire,1947-07-22,1947,0,0,0,3.770441
28121,A Thin Line Between Love and Hate,1996-04-04,1996,0,0,0,2.256747
28123,Safe House,1998-07-01,1998,0,0,0,1.108988
28124,Seems Like Old Times,1980-12-19,1980,0,43995918,43995918,9.896381
28131,Pulp,1972-11-01,1972,0,0,0,1.397348
28134,The Impostors,1998-05-18,1998,0,2197921,2197921,2.533982
28136,Popatopolis,2009-06-10,2009,250000,0,-250000,0.81335
28138,Dinosaur Island,1994-03-23,1994,0,0,0,2.002248
28145,"They Shoot Horses, Don't They?",1969-12-10,1969,0,0,0,4.904915
28148,Ninja III: The Domination,1984-09-14,1984,0,0,0,2.313986
28153,It's Alive,1974-10-15,1974,0,0,0,2.564605
28155,It Lives Again,1978-05-10,1978,0,0,0,1.55933
28156,The Baby,1973-03-01,1973,0,0,0,1.261534
28159,It Lives By Night,1974-01-15,1974,0,0,0,0.35394
28162,A Matter of Life and Death,1946-08-22,1946,0,0,0,6.486938
28165,The Toxic Avenger Part II,1989-02-24,1989,0,0,0,2.553835
28169,The Toxic Avenger Part III: The Last Temptation of Toxie,1989-11-24,1989,0,0,0,1.883822
28170,The Gore Gore Girls,1972-12-15,1972,63500,0,-63500,2.415738
28171,Kandahar,2001-05-11,2001,0,0,0,1.462073
28172,Blood Feast,1963-06-06,1963,24500,4000000,3975500,1.783412
28173,Troma's War,1988-12-09,1988,0,0,0,0.91251
28176,Tucker: The Man and His Dream,1988-08-12,1988,0,0,0,4.647907
28177,Two Thousand Maniacs!,1964-03-20,1964,65000,0,-65000,1.682434
28178,Hachi: A Dog's Tale,2009-06-13,2009,16000000,47801389,31801389,8.621359
28180,Color Me Blood Red,1965-10-13,1965,50000,0,-50000,0.649273
28187,State Fair,1962-03-09,1962,0,0,0,0.242335
28188,Swamp Zombies!!!,2005-07-22,2005,12000,0,-12000,0.229139
28189,The Fall of the House of Usher,1928-10-04,1928,0,0,0,1.229788
28190,The Red Inn,1951-10-19,1951,0,0,0,1.460192
28196,The Avenging Conscience: or 'Thou Shalt Not Kill',1914-08-02,1914,0,0,0,0.449728
28198,Vampire in Venice,1988-09-15,1988,0,0,0,0.952127
28200,Sylvia,2003-10-17,2003,7000000,10000000,3000000,11.37237
28201,The Girl in the Caf√©,2005-06-25,2005,0,0,0,3.829855
28205,The Class,2007-03-16,2007,0,0,0,4.124123
28209,Emmanuelle II,1975-12-15,1975,0,0,0,3.476536
28211,Chloe,2009-03-25,2009,15000000,8459458,-6540542,10.445867
28212,La Vie de Boh√®me,1992-02-18,1992,0,0,0,2.482245
28213,A Tale of Springtime,1990-04-04,1990,0,0,0,1.934962
28216,"Mr. Death: The Rise and Fall of Fred A. Leuchter, Jr.",1999-12-29,1999,0,507941,507941,1.157478
28218,Deathstalker II,1987-11-11,1987,0,0,0,1.717162
28219,Baadasssss!,2004-01-20,2004,0,365248,365248,4.081547
28227,Collapse,2009-09-12,2009,0,0,0,2.221044
28229,Rumpelstiltskin,1995-11-24,1995,0,0,0,1.279968
28236,Concert for George,2002-11-29,2002,0,0,0,1.416876
28238,Hamlet,2009-12-26,2009,0,0,0,1.682371
28249,The Ace of Hearts,1921-09-17,1921,0,0,0,0.138424
28256,Satan Met a Lady,1936-07-22,1936,0,0,0,0.525533
28257,The Maltese Falcon,1931-06-13,1931,0,0,0,1.706761
28258,The Secret Six,1931-04-18,1931,0,0,0,0.767608
28260,Return of the Living Dead 3,1993-10-01,1993,2000000,54207,-1945793,9.796755
28261,Mad Love,1935-07-12,1935,0,0,0,1.734803
28263,Fifty/Fifty,1992-01-01,1992,0,0,0,1.199005
28264,Blood Rage,1987-06-01,1987,0,0,0,10.405166
28268,"I Was Born, But...",1932-06-03,1932,0,0,0,1.83041
28270,Gambit,1966-12-16,1966,0,0,0,3.035438
28271,The Devil Within Her,1975-01-01,1975,0,0,0,0.700924
28272,Equinox Flower,1958-09-07,1958,0,0,0,1.453332
28273,The End of Summer,1961-10-29,1961,0,0,0,0.716547
28275,Jingle Bells,1999-01-01,1999,0,0,0,1.145935
28276,Good Morning,1959-05-12,1959,0,0,0,2.284852
28279,Succubus,1968-04-19,1968,0,0,0,0.870649
28280,Direct Action,2004-01-01,2004,0,0,0,2.480543
28282,Waterborne,2005-03-13,2005,0,0,0,0.349646
28284,Parrish,1961-05-04,1961,1500000,4200000,2700000,1.058213
28285,The Three Faces of Eve,1957-12-23,1957,0,0,0,2.030279
28286,Reunion in France,1942-12-25,1942,0,0,0,0.933628
28288,The Gay Divorcee,1934-10-12,1934,520000,0,-520000,2.863935
28289,Cactus Flower,1969-12-16,1969,0,0,0,2.817742
28290,The Man in the Gray Flannel Suit,1956-05-08,1956,0,0,0,6.537021
28292,Follow the Fleet,1936-02-20,1936,0,0,0,6.363505
28293,Flying Down to Rio,1933-12-29,1933,0,0,0,5.110346
28295,I Saw What You Did,1965-07-21,1965,0,0,0,1.88974
28296,Queen Bee,1955-11-07,1955,0,0,0,5.002136
28297,Brute Force,1947-06-30,1947,0,0,0,3.119264
28299,"Forever, Darling",1956-02-09,1956,0,0,0,0.613542
28302,The Swan Princess: The Mystery of the Enchanted Kingdom,1998-08-04,1998,0,0,0,5.174917
28303,The Cheyenne Social Club,1970-06-12,1970,0,0,0,2.506287
28304,The Furies,1950-08-16,1950,0,0,0,7.437611
28307,Hammett,1982-09-17,1982,0,0,0,2.849203
28308,The Body,2001-04-13,2001,0,0,0,7.034927
28313,Losing Isaiah,1995-03-17,1995,17000000,7603766,-9396234,7.698526
28314,Ripper: Letter from Hell,2001-08-08,2001,0,0,0,0.650358
28318,Hitcher in the Dark,1989-01-01,1989,0,0,0,0.024529
28319,Nightmare City,1980-12-11,1980,0,0,0,3.185801
28320,Aurora Borealis,2005-04-22,2005,0,0,0,2.405421
28321,Naked Violence,1969-11-10,1969,0,0,0,1.077964
28323,I Will Fight No More Forever,1975-04-13,1975,0,0,0,0.489412
28324,Emmanuelle and the Last Cannibals,1977-10-21,1977,0,0,0,4.988184
28325,Emmanuelle Around the World,1977-09-16,1977,0,0,0,1.162538
28333,The Ladies Man,1961-06-21,1961,0,0,0,3.431962
28340,The Invisible Maniac,1990-07-13,1990,0,0,0,0.885077
28345,Heidi,1937-10-15,1937,0,0,0,1.396
28346,Blood Surf,2000-12-04,2000,0,0,0,1.377073
28349,The Dead Hate the Living!,2000-02-08,2000,150000,0,-150000,1.149604
28353,Def Jam's How to Be a Player,1997-08-06,1997,0,13960203,13960203,0.883889
28355,Case 39,2009-08-13,2009,27000000,29000000,2000000,9.644085
28356,Black Beauty,1971-01-01,1971,0,0,0,1.622733
28363,The Mad Magician,1954-05-19,1954,0,0,0,1.640884
28366,House of Fury,2005-03-31,2005,0,0,0,6.568728
28367,The Wonderful World of the Brothers Grimm,1962-08-07,1962,0,0,0,1.903363
28368,Gardens of Stone,1987-05-05,1987,0,5262047,5262047,2.787833
28370,Date With an Angel,1987-11-20,1987,0,0,0,1.600871
28373,The House of the Seven Gables,1940-02-29,1940,0,0,0,0.727327
28377,Hell Night,1981-08-28,1981,0,0,0,3.682167
28380,The Silent Scream,1979-11-23,1979,0,0,0,4.800728
28384,Husbands and Wives,1992-09-18,1992,0,0,0,9.450853
28387,Kicking and Screaming,1995-10-06,1995,0,718490,718490,3.367276
28389,Death Spa,1988-01-01,1988,0,0,0,1.796689
28391,Street Angel,1928-04-09,1928,0,0,0,1.709031
28392,Moonrise,1948-10-01,1948,0,0,0,0.69562
28406,The Fury of the Wolf Man,1972-02-07,1972,0,0,0,0.670545
28410,Tuff Turf,1985-01-11,1985,0,0,0,6.138911
28414,A Sunday in Hell: Paris-Roubaix,1977-02-25,1977,0,0,0,0.039703
28415,The Yakuza,1974-12-21,1974,0,0,0,3.037477
28416,Forest of the Damned,2005-05-13,2005,0,0,0,0.521107
28417,Les Barons,2009-11-04,2009,0,0,0,1.016201
28421,The Invisible Man Returns,1940-01-12,1940,0,0,0,1.360563
28422,Love Exposure,2008-11-29,2008,0,0,0,5.619382
28423,The Invisible Woman,1940-12-27,1940,0,0,0,1.294231
28424,The Loss of a Teardrop Diamond,2008-01-01,2008,0,0,0,1.458231
28425,The Invisible Man's Revenge,1944-06-09,1944,0,0,0,2.102317
28426,Invisible Agent,1942-07-31,1942,322000,1040000,718000,1.48335
28430,The Day the Earth Caught Fire,1961-11-01,1961,0,0,0,3.150237
28431,The Prisoner of Zenda,1952-11-14,1952,0,0,0,1.154559
28432,Footlight Parade,1933-10-21,1933,0,0,0,2.568773
28433,No Way Out,1950-08-16,1950,0,0,0,4.665032
28434,The House on Telegraph Hill,1951-08-27,1951,0,0,0,3.21606
28435,Murders in the Rue Morgue,1932-02-21,1932,0,0,0,2.522351
28436,The Curse of the Cat People,1944-03-03,1944,0,0,0,2.038602
28437,The Black Sleep,1956-06-15,1956,225000,0,-225000,1.105228
28438,The Leopard Man,1943-05-08,1943,0,0,0,1.494525
28440,Mystery on Monster Island,1981-04-03,1981,0,0,0,0.98068
28445,Extraterrestrial Visitors,1983-12-13,1983,0,0,0,0.878021
28446,Suspended Animation,2001-01-01,2001,0,0,0,0.124863
28448,Walker,1987-12-04,1987,5800000,257043,-5542957,1.799311
28450,The Rift,1990-03-09,1990,0,0,0,1.207963
28452,Slugs,1988-02-05,1988,0,0,0,1.770523
28455,Deceived,1991-09-27,1991,0,0,0,13.541552
28460,Sailor Moon Super S: The Movie,1995-12-23,1995,0,0,0,1.368536
28463,East/West,1999-09-01,1999,0,0,0,1.080972
28465,A Dangerous Man,2009-01-01,2009,6500000,0,-6500000,4.461175
28466,The Survivors,1983-06-24,1983,0,0,0,3.278056
28468,The Key,1983-10-18,1983,0,0,0,21.079551
28469,Der Herr Karl,1961-11-15,1961,0,0,0,0.192235
28472,Silsila,1981-07-29,1981,0,0,0,0.730577
28476,The Phantom Tollbooth,1970-11-07,1970,0,0,0,1.567121
28478,Fat People,2009-09-11,2009,0,0,0,1.102802
28480,Phantom,1922-11-13,1922,0,0,0,1.376588
28482,Supersonic Man,1979-11-01,1979,0,519204,519204,1.021641
28484,Colorado Territory,1949-06-11,1949,0,0,0,0.842243
28485,Satan's Blood,1978-08-12,1978,0,594947,594947,1.398033
28486,The Hound of the Baskervilles,2002-12-26,2002,0,0,0,1.070263
28488,Knife of Ice,1972-08-24,1972,0,0,0,1.086643
28489,Syndicate Sadists,1975-01-01,1975,0,0,0,0.855651
28490,I Died a Thousand Times,1955-11-09,1955,0,0,0,4.929826
28497,Brainstorm,1965-05-05,1965,0,0,0,0.194921
28498,Theatre of Blood,1973-03-15,1973,0,0,0,7.163505
28499,Open Graves,2009-09-19,2009,6500000,0,-6500000,2.662584
28500,Before The Dinosaurs - Walking With Monsters,2005-11-05,2005,0,0,0,1.556352
28501,The Pit and the Pendulum,1961-08-12,1961,200000,2000000,1800000,4.392322
28503,Dementia 13,1963-09-25,1963,30000,0,-30000,1.990789
28504,Spider Baby,1967-12-24,1967,65000,0,-65000,3.285286
28509,Komodo vs. Cobra,2005-08-19,2005,450000,0,-450000,2.135274
28510,Universal Soldier: Regeneration,2009-10-01,2009,14000000,875386,-13124614,8.226
28512,The Poseidon Adventure,2005-11-20,2005,0,0,0,1.900707
28519,The Winslow Boy,1999-04-16,1999,0,0,0,2.69143
28520,Uncertainty,2009-11-15,2009,0,0,0,3.089725
28522,Day of the Dead 2: Contagium,2005-08-10,2005,9000000,0,-9000000,1.343377
28524,Princess of Mars,2009-12-29,2009,0,0,0,0.886139
28525,The Unscrupulous Ones,1962-03-24,1962,0,0,0,0.107987
28526,Sir Arne's Treasure,1919-09-18,1919,0,0,0,0.413281
28527,The Polish Bride,1998-03-26,1998,0,0,0,0.730651
28528,The Harder They Fall,1956-05-09,1956,0,0,0,7.300676
28529,Sorceress,1995-01-04,1995,0,0,0,1.523521
28532,Castle of Blood,1964-02-27,1964,0,0,0,0.684865
28533,The Ghost,1963-03-30,1963,0,0,0,0.385836
28535,Crazy for Christmas,2005-12-25,2005,0,0,0,0.696355
28536,The Blancheville Monster,1963-06-06,1963,0,0,0,1.035388
28538,The Snow Devils,1967-01-18,1967,0,0,0,0.502126
28546,11:59,2005-10-01,2005,0,0,0,0.523074
28550,"It's the Easter Beagle, Charlie Brown",1974-04-09,1974,0,0,0,0.54854
28553,Cadence,1990-11-16,1990,0,0,0,5.450197
28561,Roadblock,1951-09-17,1951,0,0,0,0.501461
28564,Manhattan Melodrama,1934-05-04,1934,0,0,0,2.479383
28567,The Macomber Affair,1947-09-17,1947,0,0,0,0.438397
28569,Splendor in the Grass,1961-10-10,1961,0,0,0,9.739448
28571,The Heiress,1949-10-06,1949,2600000,0,-2600000,4.72533
28573,"Io, Emmanuelle",1969-09-11,1969,0,0,0,0.563726
28574,Caged Women,1982-11-10,1982,0,0,0,1.010907
28575,I'll Cry Tomorrow,1955-12-25,1955,0,0,0,0.887512
28577,I Want to Live!,1958-11-18,1958,0,0,0,3.930136
28580,The Lost Weekend,1945-11-25,1945,1250000,11000000,9750000,8.731331
28585,Bikini Girls on Ice,2009-08-14,2009,191000,0,-191000,0.618161
28586,Tormented,1960-09-22,1960,0,0,0,0.93057
28590,King Dinosaur,1955-07-17,1955,0,0,0,0.209484
28592,The Castle of the Living Dead,1964-08-05,1964,0,0,0,0.460466
28597,Problem Child 2,1991-07-03,1991,0,0,0,8.142992
28601,Problem Child 3,1995-05-13,1995,0,0,0,2.957796
28602,Zombie Wars,2006-11-10,2006,0,0,0,0.412061
28604,Lauderdale,1989-01-01,1989,0,0,0,1.5338
28605,Ghoulies II,1987-09-18,1987,0,0,0,3.606319
28609,Dragon Ball Z: Dead Zone,1989-06-15,1989,0,0,0,4.676852
28614,The First Deadly Sin,1980-10-03,1980,0,0,0,1.64451
28627,The Student of Prague,1913-08-22,1913,0,0,0,2.581248
28628,Stonewall,1995-10-01,1995,0,0,0,0.940228
28629,Eerie Tales,1919-11-05,1919,0,0,0,0.445493
28630,"George Lopez: Tall, Dark & Chicano",2009-08-09,2009,0,0,0,1.267411
28632,Zen,2009-01-10,2009,0,0,0,0.773499
28635,Wishmaster 3: Beyond the Gates of Hell,2001-10-23,2001,0,0,0,8.893041
28638,The Bird People in China,1998-06-10,1998,0,0,0,2.524187
28640,Devil's Den,2006-10-22,2006,1500000,0,-1500000,1.059665
28642,It's Gradiva Who Is Calling You,2006-09-07,2006,0,0,0,2.082789
28644,The Milk of Sorrow,2009-02-12,2009,0,0,0,0.982504
28646,Spoiler,1998-09-15,1998,0,0,0,0.972229
28650,The Thing with Two Heads,1972-07-19,1972,0,0,0,2.025217
28652,Love Camp 7,1969-10-04,1969,0,0,0,1.214539
28656,"Ilsa, the Mad Butcher",1977-01-21,1977,0,0,0,3.881271
28658,You'll Never Get Rich,1941-09-25,1941,0,0,0,3.467439
28659,Cat Girl,1957-09-01,1957,0,0,0,0.115374
28661,World for Ransom,1954-01-31,1954,0,0,0,0.777486
28663,Woman on the Run,1950-11-29,1950,0,0,0,2.371752
28665,Fame,2009-01-01,2009,0,0,0,6.803354
28666,The Woman Chaser,1999-10-08,1999,0,0,0,0.531492
28667,The Gorgon,1964-10-18,1964,0,0,0,2.490568
28668,The Whistler,1944-03-30,1944,0,0,0,0.304167
28669,Rasputin: The Mad Monk,1966-03-06,1966,0,0,0,1.921686
28670,The Secret of Blood Island,1964-12-01,1964,0,0,0,0.055175
28671,Habit,1996-08-31,1996,200000,0,-200000,0.550216
28673,Nightmare Castle,1965-06-16,1965,0,0,0,0.917919
28677,Without a Paddle: Nature's Calling,2009-01-13,2009,6300000,0,-6300000,2.390543
28678,Ironmaster,1983-03-10,1983,0,0,0,1.177765
28679,House on the Edge of the Park,1980-11-06,1980,0,0,0,3.227677
28681,Equinox,1970-10-01,1970,0,0,0,1.540694
28682,Emanuelle in America,1977-01-05,1977,0,0,0,1.854184
28684,Ring of Darkness,2004-02-28,2004,750000,0,-750000,0.961042
28686,War Wolves,2009-03-08,2009,500000,0,-500000,0.787961
28687,Unholy,2007-09-04,2007,250000,0,-250000,0.195333
28690,Fangs of the Living Dead,1969-07-23,1969,0,0,0,0.611558
28696,The Wild One,1953-12-30,1953,0,0,0,12.054691
28697,Fatal Fury: The Motion Picture,1994-07-16,1994,0,0,0,0.345017
28698,Everything,2004-10-08,2004,0,0,0,0.554708
28699,Underworld U.S.A.,1961-05-13,1961,0,0,0,6.606154
28704,Diminished Capacity,2008-07-04,2008,0,0,0,1.753039
28705,Close to Home,2005-07-15,2005,0,0,0,0.370231
28706,Staying Together,1989-01-01,1989,0,0,0,0.637
28710,Kamchatka,2002-10-17,2002,0,0,0,0.952055
28712,The Last Gangster,1937-11-12,1937,0,0,0,0.809707
28715,Madhouse,1974-03-01,1974,0,0,0,2.243631
28723,Diary of a Cannibal,2007-04-24,2007,0,0,0,0.414275
28730,Live from Baghdad,2002-12-07,2002,0,0,0,2.553649
28732,Fall Time,1995-05-13,1995,0,0,0,1.108494
28733,"Count Yorga, Vampire",1970-06-10,1970,64000,0,-64000,0.592223
28735,Deathsport,1978-04-01,1978,0,0,0,1.138395
28736,Hot Lead & Cold Feet,1978-07-05,1978,0,0,0,1.366163
28737,Iron Eagle IV,1995-01-01,1995,0,0,0,1.286323
28739,Cabin Fever 2: Spring Fever,2009-08-11,2009,10000000,0,-10000000,5.187
28740,Black Friday,2004-08-13,2004,0,0,0,1.108501
28741,I Can See You,2008-01-06,2008,0,0,0,0.404425
28742,1991: The Year Punk Broke,1992-01-01,1992,0,0,0,1.682201
28745,The Dancer,2000-06-07,2000,0,0,0,0.250106
28746,"Ilsa, the Tigress of Siberia",1977-09-29,1977,237000,0,-237000,1.404373
28751,976-Evil II,1992-04-22,1992,0,0,0,2.85339
28752,The Curse of the Werewolf,1961-05-01,1961,0,0,0,2.634682
28753,You Can't Cheat an Honest Man,1939-02-17,1939,0,0,0,0.540059
28757,The Swinging Barmaids,1975-07-15,1975,0,0,0,0.32959
28758,"Atlantis, the Lost Continent",1961-05-03,1961,0,0,0,1.542929
28761,White Hunter Black Heart,1990-09-14,1990,0,0,0,3.82281
28763,Island of Terror,1966-06-20,1966,0,0,0,2.500601
28768,Faceless,1987-09-01,1987,0,0,0,1.400361
28769,A Christmas Carol,2004-11-28,2004,0,0,0,1.37294
28770,The Man Who Could Cheat Death,1959-06-15,1959,0,0,0,0.844909
28771,Sherlock Holmes and the Masks of Death,1984-12-23,1984,0,0,0,0.206199
28772,One Night in Mongkok,2004-05-15,2004,0,0,0,1.294122
28774,Communion,1989-11-10,1989,0,1919653,1919653,2.628306
28775,The Neanderthal Man,1953-06-19,1953,0,0,0,1.717127
28778,The Devil-Ship Pirates,1964-05-15,1964,0,0,0,0.866972
28784,Hell Is a City,1960-04-10,1960,0,0,0,0.859878
28789,Never Give a Sucker an Even Break,1941-10-10,1941,0,0,0,0.263047
28790,Arcade,1993-07-20,1993,0,0,0,1.312411
28791,Brutal,2007-07-10,2007,0,0,0,1.077177
28793,Coffin Rock,2009-09-04,2009,0,0,0,0.940153
28794,The House by the Cemetery,1981-08-14,1981,0,0,0,4.510407
28796,Yakuza: Like a Dragon,2007-03-03,2007,0,0,0,0.227888
28801,Twins of Evil,1971-10-03,1971,0,0,0,2.619048
28802,Female Vampire,1975-01-24,1975,0,0,0,1.026248
28805,Apaharan,2005-01-01,2005,0,0,0,0.742058
28808,Detective Conan: The Last Wizard of the Century,1999-04-17,1999,0,0,0,3.679405
28810,Poppy,1936-06-17,1936,0,0,0,0.166494
28812,The Killer Wore Gloves,1974-08-05,1974,0,0,0,0.088333
28816,Chicago 10,2007-01-01,2007,0,0,0,1.165384
28820,Devilfish,1984-09-07,1984,0,0,0,0.694882
28830,Oppai Volleyball,2009-04-18,2009,0,0,0,0.511507
28844,"Black Emmanuelle, White Emmanuelle",1976-08-06,1976,0,0,0,1.723663
28847,Demonia,1990-10-01,1990,0,0,0,1.235247
28848,Touch of Death,1988-01-01,1988,0,0,0,1.138991
28851,Video Violence,1987-01-01,1987,0,0,0,0.008267
28855,The Return of Count Yorga,1971-08-18,1971,0,0,0,1.402173
28858,Brothers at War,2009-03-13,2009,0,0,0,0.460785
28859,Dolly Dearest,1991-11-25,1991,0,0,0,1.686426
28868,Being Cyrus,2005-12-08,2005,0,0,0,0.616126
28871,How About You...,2007-11-16,2007,9000000,706000,-8294000,1.139949
28874,Summer Wars,2009-08-01,2009,0,80768,80768,12.653798
28881,Wind,1992-09-11,1992,29000000,5519569,-23480431,8.004555
28891,Elsewhere,2009-01-15,2009,500000,0,-500000,12.239661
28893,Galaxy of Terror,1981-10-01,1981,700000,0,-700000,3.853415
28894,Rancho Notorious,1952-03-01,1952,0,0,0,1.654103
28902,In Dreams,1999-01-15,1999,0,0,0,6.028168
28904,The Dog Who Saved Christmas,2009-11-09,2009,0,0,0,0.515796
28907,The Harvey Girls,1946-01-18,1946,0,0,0,1.346707
28909,Above Us the Waves,1955-03-29,1955,0,0,0,1.136868
28910,Mark of the Vampire,1935-04-26,1935,305177,0,-305177,1.892786
28912,"Wild, Wild Planet",1965-01-01,1965,0,0,0,0.987971
28916,The Way Ahead,1944-06-09,1944,0,0,0,2.97028
28917,Familiar Strangers,2008-01-01,2008,0,0,0,1.624822
28920,Dream a Little Dream 2,1995-01-01,1995,0,0,0,1.326703
28925,Zone of the Dead,2009-02-22,2009,1000000,0,-1000000,1.770765
28932,F.I.S.T.,1978-04-26,1978,11,11,0,3.566996
28938,Men in the City,2009-09-09,2009,0,0,0,2.909318
28940,Eating Raoul,1982-03-24,1982,350000,0,-350000,11.758627
28941,Chopping Mall,1986-03-21,1986,800000,0,-800000,8.034105
28942,The Brood,1979-05-25,1979,1355000,0,-1355000,9.445978
28943,Shiner,2000-09-22,2000,0,0,0,3.314408
28955,First Man Into Space,1959-02-01,1959,0,0,0,1.343551
28963,The Thief of Bagdad,1924-03-18,1924,1135654,1213880,78226,3.878515
28966,Wings,1927-08-12,1927,2000000,0,-2000000,8.545698
28967,The Little Fox,1981-12-10,1981,0,0,0,1.025539
28969,The Velveteen Rabbit,2009-01-01,2009,0,0,0,0.74021
28971,Limelight,1952-10-31,1952,0,0,0,10.755881
28973,A King in New York,1957-10-25,1957,0,0,0,4.182204
28974,A Woman of Paris,1923-10-01,1923,0,0,0,1.74686
28975,Taffin,1988-02-26,1988,0,0,0,2.076455
28978,The Circus,1928-01-06,1928,9000000,0,-9000000,6.714813
28981,Escape to Athena,1979-06-06,1979,0,0,0,3.385456
28988,Blackboards,2000-09-01,2000,0,0,0,0.770711
28994,The Adventures of the Wilderness Family,1975-12-19,1975,0,0,0,2.034004
28997,Jean Charles,2009-06-26,2009,0,0,0,0.899425
29004,The District,2004-12-09,2004,0,0,0,1.321777
29005,McCabe & Mrs. Miller,1971-06-24,1971,0,0,0,5.442081
29007,The House of Branching Love,2009-08-21,2009,0,0,0,1.357815
29008,The 7th Day,2004-04-23,2004,0,0,0,1.447963
29009,O Coronel e o Lobisomem,2005-10-01,2005,0,0,0,0.645877
29014,Pedicab Driver,1989-02-24,1989,0,0,0,0.682949
29015,The Specials,2000-09-22,2000,0,0,0,5.46027
29020,Horton Hatches the Egg,1942-04-11,1942,0,0,0,0.947284
29021,Road to Utopia,1946-02-27,1946,0,0,0,1.456451
29030,The Tomb of Ligeia,1964-11-01,1964,0,0,0,3.631422
29032,The Secret Invasion,1964-09-16,1964,600000,0,-600000,0.284317
29039,The Arena,1974-03-13,1974,0,0,0,3.44163
29040,Matti: Hell Is for Heroes,2006-01-01,2006,0,0,0,1.925747
29043,White Hell of Pitz Palu,1929-10-10,1929,0,0,0,0.239934
29044,Street Fight,2005-01-01,2005,0,0,0,1.389875
29047,The Kid Stays in the Picture,2002-01-18,2002,40000,1434436,1394436,2.6493
29048,How I Won the War,1967-10-23,1967,0,0,0,1.494833
29049,The Plague of the Zombies,1966-01-12,1966,0,0,0,4.63932
29052,The Reptile,1966-03-06,1966,0,0,0,1.420766
29054,Black Scorpion II: Aftershock,1997-05-13,1997,0,0,0,0.984521
29055,Sting of the Black Scorpion,2002-11-06,2002,0,0,0,0.422609
29056,The Raven,1963-01-25,1963,350000,1499275,1149275,4.817514
29058,The Beast with a Million Eyes,1958-06-15,1958,23000,0,-23000,1.456121
29060,Diary of a Madman,1963-03-06,1963,0,0,0,0.95262
29063,The Biggest Fan,2002-01-01,2002,0,0,0,0.254458
29064,The Omega Code,1999-10-15,1999,0,2400000,2400000,1.789046
29066,Atlas,1961-05-01,1961,70000,0,-70000,0.164002
29067,"Die, Monster, Die!",1965-10-26,1965,0,0,0,2.274081
29069,The Velvet Vampire,1971-10-13,1971,0,0,0,1.132207
29071,The Undead,1957-03-01,1957,70000,0,-70000,1.116166
29072,Night of the Zombies,1981-01-01,1981,0,0,0,0.0
29074,Tales of Terror,1962-07-04,1962,0,0,0,2.356666
29076,Gun Shy,2000-02-04,2000,10000000,1631839,-8368161,6.370105
29077,The Bride,1985-08-16,1985,0,3558669,3558669,5.503779
29078,The Game of Their Lives,2005-01-01,2005,0,0,0,2.417256
29080,Heights,2005-01-01,2005,0,0,0,5.640893
29082,Les vampires,1915-11-13,1915,0,0,0,1.024098
29083,Snowboard Academy,1997-07-16,1997,0,0,0,0.149382
29084,Le Corbeau,1943-09-28,1943,0,0,0,1.957418
29094,The Lodger,1944-01-19,1944,0,0,0,1.662193
29095,Waxwork,1988-06-17,1988,0,808114,808114,8.575666
29100,The Chase,1946-11-16,1946,0,0,0,1.132405
29101,Too Fat Too Furious,2005-02-03,2005,4200000,0,-4200000,1.148274
29103,The Sadist,1963-04-01,1963,0,0,0,1.122097
29106,Whirlpool,1949-11-28,1949,0,0,0,1.427748
29107,The Grapes of Death,1978-07-05,1978,0,0,0,1.125715
29108,Gregory's Two Girls,1999-10-15,1999,0,0,0,0.540511
29109,Blue Seduction,2009-04-06,2009,1600000,0,-1600000,1.221297
29110,Garbage Warrior,2007-04-19,2007,0,0,0,0.132201
29111,Requiem for a Vampire,1971-08-01,1971,0,0,0,2.286054
29112,The Well,1951-09-10,1951,0,0,0,1.305958
29113,The Web,1947-05-25,1947,0,0,0,1.250236
29114,Satan's Cheerleaders,1977-06-01,1977,0,0,0,0.221465
29116,The Velvet Touch,1948-07-13,1948,0,0,0,1.611225
29117,The Unsuspected,1947-10-11,1947,0,0,0,0.938704
29122,An Everlasting Piece,2000-12-22,2000,0,0,0,0.875246
29124,Get Thrashed,2006-10-03,2006,0,0,0,1.065423
29126,Black Moon,1934-06-15,1934,0,0,0,0.336935
29128,Lips of Blood,1975-05-17,1975,0,0,0,1.350058
29129,The Shiver of the Vampires,1971-04-21,1971,0,0,0,0.97627
29130,The Demoniacs,1974-12-05,1974,0,0,0,1.022485
29134,Amreeka,2009-01-17,2009,0,0,0,2.08087
29135,No Such Thing,2001-05-12,2001,0,0,0,2.883184
29136,Flowers for Algernon,2000-02-20,2000,0,0,0,1.354927
29138,Crossing the Bridge: The Sound of Istanbul,2005-05-27,2005,0,0,0,1.172386
29140,The Fourth Man,1983-03-23,1983,0,0,0,3.034972
29142,Executive Action,1973-11-07,1973,0,0,0,1.838729
29143,Eyes of Laura Mars,1978-08-02,1978,7000000,20000000,13000000,3.705714
29144,John Oliver: Terrifying Times,2008-04-20,2008,0,0,0,1.019346
29146,Charly,1968-09-23,1968,950000,814666,-135334,2.526159
29150,Big Fan,2009-01-18,2009,250000,232732,-17268,5.130276
29151,Brief Interviews with Hideous Men,2009-01-19,2009,0,0,0,2.074774
29154,Stand and Deliver,1988-03-11,1988,0,13994920,13994920,5.355761
29159,Giallo,2010-03-13,2010,14000000,0,-14000000,2.542612
29161,Phenomena,1985-01-31,1985,3800000,0,-3800000,5.621519
29162,Ever Since the World Ended,2001-04-21,2001,0,0,0,0.347644
29167,The Case of the Bloody Iris,1972-08-04,1972,0,0,0,1.737506
29168,Dr. Moreau's House of Pain,2004-01-13,2004,0,0,0,0.145918
29173,The Raiders of Atlantis,1983-11-25,1983,0,0,0,0.804308
29182,44 Inch Chest,2009-10-08,2009,0,0,0,2.237262
29185,An Innocent Man,1989-10-06,1989,0,20047604,20047604,6.505887
29192,The Missing Lynx,2008-12-25,2008,0,0,0,1.851296
29193,The Spanish Prisoner,1997-09-08,1997,10000000,13835130,3835130,4.305735
29204,American Pop,1981-02-13,1981,0,6000000,6000000,2.340967
29211,Muhammad Ali - The Greatest,1969-11-21,1969,0,0,0,0.385825
29212,The Weapon,1957-05-17,1957,0,0,0,0.116025
29224,J√∂nssonligan & DynamitHarry,1982-09-17,1982,0,0,0,1.040732
29228,The Computer Wore Tennis Shoes,1969-12-29,1969,0,0,0,4.044429
29229,Left Behind II: Tribulation Force,2002-10-29,2002,0,0,0,1.610081
29231,The Immortals,1995-10-05,1995,50,83,33,0.825042
29233,Horton Hears a Who!,1970-01-01,1970,0,0,0,1.211643
29235,Premature Burial,1962-03-07,1962,0,1250000,1250000,9.555852
29236,The Arnelo Affair,1947-02-13,1947,0,0,0,0.467517
29237,Shock,1946-01-10,1946,375000,0,-375000,1.501391
29239,The Mummy's Tomb,1942-10-23,1942,0,0,0,0.674417
29242,The Mummy's Curse,1944-12-22,1944,0,0,0,2.121075
29243,The Mummy's Ghost,1944-07-07,1944,0,0,0,1.569494
29244,3 Godfathers,1948-12-01,1948,1243000,2841000,1598000,3.803268
29251,On Any Sunday,1971-07-28,1971,0,0,0,0.934156
29254,Rhubarb,1951-08-29,1951,0,0,0,0.351497
29257,Under the Gun,1951-02-22,1951,0,0,0,0.996367
29259,Le Trou,1960-03-18,1960,0,0,0,5.828566
29260,Trapped,1949-10-01,1949,0,0,0,0.821465
29262,The House of Sand,2005-05-13,2005,0,0,0,0.95418
29263,The Official Story,1985-04-03,1985,0,0,0,1.956906
29264,The Exterminating Angel,1962-05-01,1962,0,0,0,5.038905
29266,War and Peace,1966-03-14,1966,100000000,0,-100000000,2.604571
29267,Destiny,1921-10-06,1921,0,0,0,2.8041
29268,Castle of Sand,1974-10-19,1974,0,0,0,0.586331
29269,Tony Takitani,2004-08-10,2004,0,0,0,1.429707
29270,A Time for Drunken Horses,2000-01-01,2000,0,0,0,2.391796
29272,El Greco,2007-01-01,2007,0,0,0,0.660036
29275,Anita,2009-10-15,2009,0,0,0,0.467142
29284,Murder Is My Beat,1955-02-27,1955,0,0,0,0.164274
29286,The Black Cat,1941-05-02,1941,176000,0,-176000,0.935686
29290,The Green Slime,1968-12-19,1968,0,0,0,2.893789
29291,Klimt,2006-03-03,2006,0,0,0,2.987019
29293,House of the Dead 2,2005-10-14,2005,6000000,0,-6000000,2.693566
29299,The Invincible,2008-10-08,2008,0,0,0,0.398973
29313,Ella y el miedo,1964-06-17,1964,0,0,0,0.056538
29314,In Therapy,2009-04-17,2009,0,0,0,0.359685
29318,Devil Doll,1964-09-01,1964,0,0,0,0.670951
29320,The Devil-Doll,1936-07-10,1936,0,0,0,1.155181
29328,Castle in the Desert,1942-02-02,1942,0,0,0,0.736539
29333,Murder in a Blue World,1973-08-22,1973,0,0,0,0.157909
29336,The Cannibal Man,1973-06-01,1973,0,0,0,1.292862
29338,No One Heard the Scream,1973-01-01,1973,0,0,0,0.9866
29339,Nicholas Nickleby,2002-12-27,2002,0,0,0,4.056577
29342,The Bees,1978-11-01,1978,0,0,0,0.621558
29343,Humanoids from the Deep,1980-05-01,1980,0,0,0,7.44429
29345,The Terror Within,1989-01-20,1989,0,858591,858591,1.292125
29347,Fiend Without a Face,1958-07-03,1958,0,0,0,1.060049
29351,Satanik,1968-01-01,1968,0,0,0,0.470673
29352,Super Stooges vs the Wonder Women,1974-04-11,1974,0,0,0,0.291053
29353,My Little Chickadee,1940-02-09,1940,0,0,0,0.732382
29355,Wildcats,1986-02-14,1986,0,0,0,5.033047
29361,Antikiller D.K,2009-12-03,2009,2500000,2141028,-358972,0.928271
29362,Full of It,2007-03-01,2007,0,0,0,5.569036
29363,A World Without Thieves,2004-12-09,2004,0,0,0,3.856596
29365,Framed,1947-05-25,1947,0,0,0,0.546214
29368,A Place of One's Own,1945-05-28,1945,0,0,0,1.110736
29369,Made in U.S.A,1966-12-03,1966,50000,0,-50000,1.208341
29371,The Incredibly True Adventure of Two Girls In Love,1995-06-16,1995,0,0,0,2.149553
29372,Flying Tigers,1942-10-08,1942,0,0,0,1.636875
29376,The Band Wagon,1953-08-07,1953,0,0,0,3.573935
29377,Blood Alley,1955-10-01,1955,0,0,0,6.460812
29380,Easter Parade,1948-07-08,1948,0,0,0,2.28165
29381,Caged,1950-05-19,1950,0,0,0,0.957227
29382,Under Our Skin,2008-07-12,2008,0,0,0,0.241689
29383,The Winter War,1989-12-30,1989,4414000,0,-4414000,3.777036
29388,High Life,2009-02-07,2009,0,0,0,6.936818
29390,"Let's Kill Uncle, Before Uncle Kills Us",1966-11-18,1966,0,0,0,0.754169
29393,Macabre,1958-10-01,1958,90000,5000000,4910000,0.837849
29394,Homicidal,1961-07-26,1961,0,0,0,1.057432
29395,Brave,1994-01-01,1994,0,0,0,0.014213
29396,Strait-Jacket,1964-01-19,1964,0,0,0,1.727656
29398,Project X,1968-05-01,1968,0,0,0,1.185947
29399,Shanks,1974-10-09,1974,0,0,0,1.096082
29400,The Old Dark House,1963-10-30,1963,0,0,0,0.736818
29402,Mr. Sardonicus,1961-10-07,1961,0,0,0,1.933119
29403,The Night Walker,1964-12-01,1964,0,0,0,0.408128
29406,Trucker,2008-04-24,2008,2000000,0,-2000000,1.963322
29415,La B√™te Humaine,1938-12-23,1938,0,0,0,2.760745
29416,Horror of the Blood Monsters,1970-02-01,1970,0,0,0,0.696083
29419,Carnival Magic,1981-01-01,1981,0,0,0,0.153835
29420,Cinderella 2000,1977-09-14,1977,0,0,0,0.413552
29424,Hungry Wives,1972-05-01,1972,90000,0,-90000,1.633103
29425,The Crazies,1973-03-16,1973,275000,0,-275000,3.739226
29426,Survival of the Dead,2010-05-06,2010,4000000,0,-4000000,9.159799
29427,The Crazies,2010-02-26,2010,20000000,54956140,34956140,10.914556
29436,Beyond the Front Line,2004-03-05,2004,0,0,0,1.136339
29437,Rabid,1977-04-08,1977,530000,0,-530000,11.284126
29444,S.F.W.,1994-09-15,1994,0,0,0,2.504529
29445,Epidemic,1987-09-11,1987,0,0,0,2.354311
29449,Images,1972-05-01,1972,0,0,0,1.689005
29450,The Marathon Family,1982-01-01,1982,0,0,0,1.980535
29451,The Devil and Daniel Webster,1941-10-29,1941,0,0,0,6.735297
29452,The Face of Another,1966-07-15,1966,0,0,0,2.674886
29453,The Magician,1958-12-26,1958,0,0,0,7.606709
29454,Face to Face,1976-04-05,1976,0,0,0,1.814674
29455,Winter Light,1963-02-11,1963,0,0,0,4.338439
29456,Reconstruction,2003-05-17,2003,0,0,0,2.19353
29457,F√∂gi Is a Bastard,1998-01-01,1998,0,0,0,1.022938
29458,One Hundred Steps,2000-08-31,2000,0,1805884,1805884,4.67525
29461,Soul Food,1997-09-26,1997,0,0,0,2.647781
29463,Krush Groove,1985-10-25,1985,3000000,0,-3000000,1.560562
29464,Uptown Saturday Night,1974-07-26,1974,3000000,0,-3000000,2.008129
29466,The Magician,1926-10-24,1926,0,0,0,0.149622
29467,Tomorrow Is Another Day,1951-09-22,1951,0,0,0,0.5104
29470,The Devil Thumbs a Ride,1947-02-20,1947,0,0,0,0.629794
29471,Colonel Redl,1985-03-29,1985,0,0,0,1.923855
29473,Let's Do It Again,1975-10-11,1975,70000,11800000,11730000,1.411831
29475,The Five Heartbeats,1991-03-29,1991,0,0,0,5.861963
29477,Highway 301,1950-12-01,1950,0,0,0,0.516846
29478,A Raisin in the Sun,1961-05-28,1961,1500000,0,-1500000,2.501072
29481,Stranger on the Third Floor,1940-08-16,1940,171200,0,-171200,1.513716
29482,The Bloodstained Butterfly,1971-09-10,1971,0,0,0,0.798926
29483,Beautiful Kate,2009-06-13,2009,4300000,0,-4300000,3.124151
29484,Mysterious Mr. Moto,1938-10-14,1938,0,0,0,1.282223
29486,The Comedy of Terrors,1963-10-14,1963,0,0,0,2.133184
29487,The Mark of the Whistler,1944-10-09,1944,0,0,0,0.361934
29490,Voice of the Whistler,1945-10-30,1945,0,0,0,0.113959
29491,The Possession of Joel Delaney,1972-05-24,1972,1300000,0,-1300000,1.413939
29492,Reform School Girls,1986-08-22,1986,0,2510433,2510433,1.71373
29493,A Piece of the Action,1977-10-07,1977,0,0,0,1.266846
29496,Cut-Throats Nine,1972-07-10,1972,0,0,0,0.24991
29498,The Fourth Victim,1971-04-14,1971,0,0,0,0.404
29501,Falling Up,2009-09-29,2009,0,0,0,13.313415
29507,Enlightenment Guaranteed,2000-01-20,2000,0,0,0,1.026911
29510,The Busy Body,1967-03-12,1967,0,0,0,0.014963
29512,Bruiser,2000-02-13,2000,5000000,0,-5000000,3.139191
29514,Two Evil Eyes,1990-01-25,1990,9000000,0,-9000000,8.027314
29515,The Mack,1973-04-04,1973,0,0,0,1.392731
29538,Pyaar Impossible,2010-01-08,2010,0,0,0,0.748353
29539,Emmanuelle in Soho,1981-01-01,1981,0,0,0,0.11622
29542,Blood Dolls,1999-08-31,1999,0,0,0,0.596097
29562,Fascination,1979-01-01,1979,0,0,0,1.604674
29564,Smokin' Aces 2: Assassins' Ball,2010-01-19,2010,8000000,0,-8000000,6.102148
29565,The Night of the Hunted,1980-08-20,1980,0,0,0,1.465439
29568,In the City of Sylvia,2007-09-14,2007,0,0,0,0.727337
29570,Journey to the Seventh Planet,1962-03-10,1962,0,0,0,1.286897
29572,The Man Who Cried,2000-08-29,2000,0,0,0,5.15599
29577,On the Riviera,1951-04-20,1951,0,0,0,0.20228
29578,The Seven-Per-Cent Solution,1976-10-24,1976,0,0,0,1.313858
29582,The Odd Angry Shot,1979-03-01,1979,600000,0,-600000,1.092844
29584,Tai-Pan,1986-11-07,1986,25000000,0,-25000000,2.456811
29586,King Rat,1965-10-27,1965,0,0,0,2.383562
29587,Style Wars,1983-01-01,1983,0,0,0,0.870267
29589,Green for Danger,1946-12-07,1946,0,0,0,1.725261
29592,Lust for Life,1956-09-15,1956,0,0,0,4.478691
29595,Wal-Mart: The High Cost of Low Price,2005-11-04,2005,0,0,0,1.977106
29596,Nothing But the Night,1973-01-01,1973,0,0,0,3.953266
29597,Mutator,1989-05-15,1989,0,0,0,0.161919
29600,Mountaintop Motel Massacre,1986-03-31,1986,0,0,0,0.443656
29601,Buck Privates,1941-01-31,1941,0,0,0,1.633148
29607,Miami Golem,1985-11-12,1985,0,0,0,0.325
29609,The Ghost Train,1941-01-01,1941,0,0,0,0.431908
29610,The Man Who Wasn't There,1983-08-12,1983,0,0,0,0.621045
29611,Sole Survivor,1983-12-01,1983,350000,0,-350000,0.041923
29617,Remember the Night,1940-01-19,1940,0,0,0,1.996129
29621,Solo,1996-10-23,1996,0,0,0,1.899069
29627,Defence of the Realm,1986-09-06,1986,0,750000,750000,1.506457
29628,Get Crazy,1983-08-05,1983,0,1645711,1645711,0.584128
29630,Milarepa,2008-09-05,2008,0,0,0,0.262837
29631,The Big Bet,1985-01-01,1985,0,0,0,0.177243
29638,Werewolf in a Women's Prison,2006-10-19,2006,0,0,0,0.735715
29649,Sunset Park,1996-04-26,1996,0,0,0,1.231692
29656,16 Years of Alcohol,2003-08-14,2003,0,0,0,1.129269
29670,V2: Dead Angel,2007-01-11,2007,0,0,0,0.634341
29682,So Dear to My Heart,1948-11-29,1948,0,0,0,0.901443
29694,One of Our Dinosaurs Is Missing,1975-07-09,1975,0,0,0,2.233131
29695,iMurders,2008-08-09,2008,0,0,0,4.309659
29697,Faith Like Potatoes,2006-10-27,2006,0,0,0,0.629729
29698,Ratcatcher,1999-11-12,1999,0,0,0,2.45982
29702,Tenebre,1982-10-28,1982,0,0,0,13.925958
29705,The Tunnel,1935-10-27,1935,0,0,0,0.777387
29710,Khartoum,1966-06-09,1966,0,0,0,2.404428
29715,Major Dundee,1965-04-07,1965,3800000,14873,-3785127,3.055936
29717,The Adventures of Food Boy,2008-01-01,2008,0,0,0,0.414522
29721,Ghost Adventures,2007-07-25,2007,0,0,0,0.186205
29722,The Girl on a Motorcycle,1968-06-21,1968,0,0,0,0.896153
29723,The Concorde... Airport '79,1979-08-17,1979,14000000,13015688,-984312,3.514331
29735,The Laughing Policeman,1973-12-20,1973,0,0,0,1.579142
29737,Greased Lightning,1977-07-01,1977,0,0,0,3.558626
29739,Moving,1988-03-04,1988,0,0,0,2.466853
29740,I Am a Fugitive from a Chain Gang,1932-11-19,1932,195845,0,-195845,8.741855
29741,"Have Rocket, Will Travel",1959-08-01,1959,0,0,0,0.767836
29742,Zenon: The Zequel,2001-01-12,2001,0,0,0,1.294211
29743,Attila flagello di Dio,1982-01-01,1982,0,0,0,2.835882
29745,City Streets,1931-04-18,1931,0,0,0,1.207013
29748,Taste the Blood of Dracula,1970-05-07,1970,0,0,0,3.952446
29750,Metallica: A Year and a Half in the Life Of...,1992-08-12,1992,0,0,0,0.074941
29751,Batman Unmasked: The Psychology of the Dark Knight,2008-07-15,2008,0,0,0,1.084614
29756,13 Ghosts,1960-08-05,1960,0,0,0,6.586372
29760,Cayman Went,2009-06-05,2009,800000,0,-800000,0.579093
29778,Dracula Has Risen from the Grave,1968-11-07,1968,0,0,0,3.321958
29785,Of Time and the City,2008-10-31,2008,0,0,0,0.623718
29786,North Dallas Forty,1979-08-03,1979,0,26079312,26079312,5.66966
29787,Monkey Shines,1988-07-29,1988,7000000,5344577,-1655423,8.120652
29794,Howling II: Stirba - Werewolf Bitch,1985-08-28,1985,0,0,0,4.037458
29797,Ed Gein: The Butcher of Plainfield,2007-03-06,2007,1500000,0,-1500000,0.759707
29798,Dead Man's Hand,2007-07-01,2007,200000,0,-200000,0.081074
29799,Project Shadowchaser III,1995-01-01,1995,0,0,0,0.415906
29801,Fists of Iron,1995-01-01,1995,0,0,0,0.153846
29804,Rebound: The Legend of Earl 'The Goat' Manigault,1996-01-01,1996,0,0,0,4.90097
29805,Juggernaut,1974-09-25,1974,0,0,0,11.665082
29812,The Substitute 2: School's Out,1998-08-01,1998,0,0,0,6.643263
29817,Fairy Tales,1978-08-01,1978,0,0,0,1.274283
29819,Summer Camp,1979-06-01,1979,0,0,0,0.45402
29825,The Real Blonde,1997-09-14,1997,0,0,0,2.520458
29829,Mysterious Intruder,1946-04-11,1946,0,0,0,0.558991
29832,Martin & Orloff,2002-05-01,2002,0,0,0,0.837866
29835,Cause for Alarm,1951-03-30,1951,0,0,0,4.468337
29845,A Woman Under the Influence,1974-09-19,1974,0,0,0,8.824282
29846,The Accused,1949-01-14,1949,0,0,0,1.354166
29852,"Silent Night, Bloody Night",1972-11-01,1972,0,0,0,3.86571
29854,Seizure,1974-01-01,1974,250000,0,-250000,1.059095
29856,Hollywood Boulevard,1976-04-25,1976,60000,0,-60000,1.586171
29859,The Adventure of Sherlock Holmes' Smarter Brother,1975-01-01,1975,0,0,0,3.834924
29860,Hollywood Man,1976-10-01,1976,0,0,0,0.777456
29865,Trapped Ashes,2006-09-12,2006,0,0,0,0.749136
29871,Santo vs. the Vampire Women,1962-10-11,1962,0,0,0,0.801161
29872,Carefree,1938-09-02,1938,0,0,0,5.393625
29877,Curly Top,1935-07-26,1935,0,0,0,1.325188
29879,The Little Colonel,1935-02-22,1935,0,0,0,0.522191
29882,The Black Swan,1942-12-04,1942,0,0,0,2.438784
29883,The Untold,2002-07-29,2002,3000000,0,-3000000,1.259962
29884,Ball of Fire,1941-12-02,1941,0,0,0,8.206731
29885,The Barkleys of Broadway,1949-01-01,1949,0,0,0,1.537138
29886,The Bride Came C.O.D.,1941-07-12,1941,0,0,0,4.725522
29887,Bright Eyes,1934-12-28,1934,0,0,0,0.808053
29889,Silent Venom,2009-06-02,2009,0,0,0,1.151097
29890,Droid Gunner,1995-11-14,1995,0,0,0,0.668737
29896,Never Cry Werewolf,2008-05-11,2008,0,0,0,3.492425
29903,Barbarian Queen,1985-11-30,1985,0,0,0,1.424291
29904,Barbarian Queen II: The Empress Strikes Back,1992-01-01,1992,0,0,0,1.358164
29907,Restless Natives,1985-01-01,1985,0,0,0,0.953686
29911,FairyTale: A True Story,1997-01-01,1997,0,14000000,14000000,3.553746
29912,The Robe,1953-09-16,1953,4100000,36000000,31900000,3.826281
29914,Randy & the Mob,2007-10-13,2007,0,0,0,0.434371
29917,Exam,2009-06-19,2009,0,0,0,5.810371
29918,Lassie,1994-07-22,1994,0,0,0,3.645342
29919,The Six Wives of Henry Lefay,2009-01-01,2009,0,0,0,10.940348
29920,Easy Money,2010-01-15,2010,0,0,0,10.520394
29923,Detour,2009-07-31,2009,2200000,0,-2200000,0.66715
29924,Around the World in 80 Days,1989-04-16,1989,0,0,0,2.561525
29927,"Pretty Village, Pretty Flame",1996-05-11,1996,0,0,0,2.245575
29932,Hanussen,1988-05-20,1988,0,0,0,2.510551
29933,Kana≈Ç,1957-04-20,1957,0,0,0,2.599731
29937,Divided We Fall,2000-03-16,2000,0,0,0,1.43661
29938,Alien Escape,1996-01-01,1996,1000000,0,-1000000,0.106499
29941,Back To The Secret Garden,2001-01-01,2001,0,0,0,1.126743
29946,The Golden Bowl,2000-05-14,2000,15000000,0,-15000000,1.637394
29952,Bomb√≥n: The Dog,2004-09-23,2004,0,0,0,1.120045
29959,It Came from Beneath the Sea,1955-07-01,1955,0,0,0,2.917071
29960,Vampire Circus,1972-04-30,1972,0,0,0,1.72498
29963,Bright Star,2009-11-05,2009,8500000,4440055,-4059945,14.337355
29964,Haunts,1977-07-01,1977,0,0,0,0.100353
29965,Be with Me,2005-05-12,2005,0,0,0,1.262339
29966,Blood on the Moon,1948-11-09,1948,0,88,88,1.033927
29967,Moonfleet,1955-06-24,1955,0,0,0,1.585995
29968,Nothing in Common,1986-07-29,1986,0,0,0,8.750517
29971,Nayakan,1987-07-01,1987,0,0,0,0.014463
29972,24 City,2008-09-27,2008,0,0,0,0.699428
29973,Cobb,1994-12-02,1994,0,1007583,1007583,2.583363
29977,Poker King,2009-11-22,2009,0,0,0,1.129397
29979,Highwaymen,2004-02-13,2004,0,371396,371396,3.916636
29982,Unrelated,2007-10-18,2007,0,0,0,0.90642
29987,Facing Windows,2003-02-27,2003,0,15530077,15530077,3.701538
29988,Ishq,1997-11-28,1997,0,0,0,0.668028
29989,Skin,2009-07-24,2009,0,0,0,1.858361
29993,Samson and Delilah,1949-12-21,1949,3000000,11500000,8500000,2.528638
29996,Solomon and Sheba,1959-12-25,1959,5000000,12200000,7200000,1.739898
30002,The Munsters' Revenge,1981-01-01,1981,0,0,0,0.543038
30014,House by the River,1950-03-25,1950,0,0,0,7.26718
30015,Behind Locked Doors,1948-09-13,1948,0,0,0,0.221491
30017,Close-Up,1990-05-09,1990,0,0,0,2.972346
30018,Mother,2009-05-28,2009,5000000,17112713,12112713,5.030112
30019,Upperdog,2009-08-28,2009,3417000,0,-3417000,1.056898
30020,Taste of Cherry,1997-09-28,1997,0,0,0,7.894941
30022,Lady on a Train,1945-08-17,1945,0,0,0,2.36288
30023,Adventures of Power,2008-01-20,2008,2500000,0,-2500000,3.716988
30025,Sirocco,1951-06-13,1951,0,0,0,2.739096
30027,Assault of the Party Nerds,1989-01-01,1989,0,0,0,0.196902
30028,Assault of the Party Nerds 2,1995-05-09,1995,0,0,0,0.007301
30034,Shield for Murder,1954-08-27,1954,0,0,0,0.637993
30036,Rogue Cop,1954-09-17,1954,0,0,0,0.733632
30043,Green Chair,2005-06-10,2005,0,2000000,2000000,1.811957
30049,Time Walker,1982-11-01,1982,750000,0,-750000,2.936402
30054,The Tin Star,1957-10-23,1957,0,0,0,2.119657
30055,Gigantic (A Tale Of Two Johns),2002-01-01,2002,0,0,0,0.423356
30057,Direct from Brooklyn,1999-01-01,1999,0,0,0,0.001651
30059,Rudolph's Shiny New Year,1976-12-10,1976,0,0,0,1.402135
30060,The Plague Dogs,1982-10-21,1982,0,0,0,8.302414
30061,Justice League: Crisis on Two Earths,2010-02-23,2010,0,0,0,6.108241
30062,Eaten Alive,1976-12-25,1976,520000,0,-520000,5.394715
30065,The Wild Bull,2008-01-01,2008,0,0,0,0.004461
30068,Devil's Playground,2002-01-01,2002,0,0,0,1.078421
30069,Vision Quest,1985-02-15,1985,0,0,0,5.504082
30071,Where The Red Fern Grows,2003-05-03,2003,0,0,0,0.597556
30072,Possession,2002-10-02,2002,25000000,10113733,-14886267,4.439325
30074,Scooby-Doo! And the Legend of the Vampire,2003-03-04,2003,0,0,0,3.720994
30077,By the People: The Election of Barack Obama,2009-11-09,2009,0,0,0,0.614212
30080,Ship of Fools,1965-07-29,1965,0,0,0,3.235694
30081,R.S.V.P.,2002-01-15,2002,0,0,0,1.065015
30082,Forty Shades of Blue,2005-12-07,2005,1500000,0,-1500000,0.632369
30091,The Hire: Chosen,2001-01-01,2001,0,0,0,1.686588
30095,Passport to Pimlico,1949-10-26,1949,0,0,0,2.23933
30101,Where The Red Fern Grows II: The Classic Continues,1992-01-01,1992,0,0,0,0.005984
30102,Escape in the Fog,1945-04-05,1945,0,0,0,0.530205
30106,Gunnin' for That #1 Spot,2008-04-18,2008,0,0,0,0.194419
30112,Lost in Beijing,2007-02-16,2007,0,0,0,3.250682
30114,Wagons East!,1994-08-26,1994,0,0,0,4.102354
30117,Warlords of Atlantis,1978-05-01,1978,0,0,0,1.463804
30118,Outside Sales,2006-06-01,2006,0,0,0,0.292305
30121,Winter of Frozen Dreams,2009-06-01,2009,0,0,0,0.486764
30123,Striking Range,2006-06-01,2006,0,0,0,0.239659
30124,Tru Loved,2008-02-27,2008,0,0,0,0.447749
30125,Valentin,2003-04-11,2003,0,0,0,1.756683
30126,Snow White and the Three Stooges,1961-12-24,1961,0,0,0,3.136899
30127,The Invisible Woman,2009-06-05,2009,0,0,0,2.530169
30128,I Hope They Serve Beer in Hell,2009-09-25,2009,7000000,1429299,-5570701,3.208138
30131,El siete machos,1951-02-05,1951,0,0,0,0.278975
30137,The Haunted Palace,1963-08-27,1963,0,0,0,10.576153
30139,Phat Girlz,2006-01-01,2006,0,0,0,1.19271
30140,Rivers and Tides,2001-02-13,2001,0,0,0,0.759653
30141,The Singing Detective,2003-10-24,2003,0,0,0,12.650143
30142,"Vernon, Florida",1981-10-08,1981,0,0,0,1.320642
30143,Lupin the Third: The Secret of Mamo,1978-12-16,1978,0,0,0,0.961479
30146,Gunbuster vs Diebuster Aim for the Top! The GATTAI!! Movie,2006-10-01,2006,0,0,0,1.116784
30149,Sunes sommar,1993-12-25,1993,0,0,0,0.943978
30155,Naked Fear,2007-04-01,2007,0,0,0,2.512786
30157,Amateur,1994-08-05,1994,0,0,0,1.759012
30159,I Confess,1953-02-28,1953,0,0,0,10.424982
30162,The Red House,1947-03-16,1947,0,0,0,1.494675
30163,Fugitives,1986-06-06,1986,0,0,0,3.041709
30168,It Came from Hollywood,1982-12-10,1982,5000000,2091037,-2908963,1.629796
30174,1981,2009-09-04,2009,0,0,0,1.348299
30175,Morgan Stewart's Coming Home,1987-02-20,1987,0,0,0,0.393208
30177,A Tree Grows in Brooklyn,1945-02-28,1945,0,0,0,5.069932
30178,Stuart Little 3: Call of the Wild,2005-07-14,2005,0,0,0,4.014225
30180,Hype!,1996-11-08,1996,0,0,0,3.465337
30183,Zombies on Broadway,1945-05-01,1945,0,0,0,0.414715
30192,Standing in the Shadows of Motown,2002-11-15,2002,0,0,0,0.643481
30194,The Manhattan Project,1986-06-13,1986,18000000,3900000,-14100000,4.29831
30195,A Lady Without Passport,1950-08-03,1950,0,0,0,0.753699
30197,The Producers,1967-11-22,1967,947000,0,-947000,7.433784
30198,The Red Spectacles,1987-02-07,1987,0,0,0,0.297129
30202,Children of the Damned,1964-01-29,1964,0,0,0,2.416299
30203,Star Runners,2009-06-13,2009,0,0,0,4.464781
30204,"Move Over, Darling",1963-12-19,1963,0,0,0,2.518743
30230,International House,1933-05-27,1933,0,0,0,1.106024
30231,Oxford Blues,1984-08-24,1984,0,0,0,1.17383
30237,Onegin,1999-12-22,1999,14000000,206128,-13793872,7.171138
30238,Earthlings,2005-09-24,2005,0,0,0,4.059534
30239,Vincere,2009-05-19,2009,0,0,0,2.957936
30244,Kabul Express,2006-12-15,2006,0,0,0,1.235224
30245,Mr. Bones 2: Back from the Past,2008-11-27,2008,0,0,0,1.06374
30246,Civil Brand,2003-08-29,2003,0,0,0,0.436695
30250,Cold Souls,2009-08-07,2009,0,0,0,12.563435
30252,A Midsummer of Love,2009-07-31,2009,0,0,0,0.654897
30253,Late Bloomers,2006-10-05,2006,0,0,0,1.175698
30265,Chinese Box,1997-09-04,1997,0,0,0,1.543766
30266,"20,000 Leagues Under the Sea",1916-12-24,1916,200000,8000000,7800000,0.917777
30278,Comfort and Joy,1984-10-10,1984,0,0,0,4.772901
30285,The Evening Star,1996-12-25,1996,0,0,0,8.399114
30289,Megafault,2009-10-10,2009,1200000,0,-1200000,2.593354
30294,The First Olympics: Athens 1896,1984-05-20,1984,0,0,0,0.004425
30295,Father Goose,1964-10-12,1964,0,0,0,5.441136
30296,The Malibu Bikini Shop,1986-11-01,1986,0,0,0,1.014423
30298,The Secret of Santa Vittoria,1969-01-01,1969,0,0,0,1.63702
30299,The 27th Day,1957-01-07,1957,0,0,0,0.261083
30301,Black Angel,2002-04-12,2002,0,0,0,1.621973
30302,Death In Love,2008-07-17,2008,3000000,0,-3000000,0.859916
30304,Picture Bride,1995-05-05,1995,0,0,0,1.296912
30305,Fireball,2009-01-29,2009,0,0,0,0.739991
30307,The Devil Commands,1941-02-03,1941,0,0,0,1.209468
30308,Lured,1947-08-28,1947,0,0,0,2.153455
30309,Real Women Have Curves,2002-01-01,2002,0,0,0,2.363243
30312,Outrage,2009-01-01,2009,0,0,0,0.807849
30315,Kingdom of the Spiders,1977-08-24,1977,500000,17000000,16500000,2.884359
30319,Feel The Noise,2007-10-05,2007,0,0,0,1.81704
30330,The Late Shift,1996-02-24,1996,6000000,0,-6000000,1.913719
30331,Tart,2001-04-23,2001,3300000,0,-3300000,1.100095
30335,Nora Roberts' Angels Fall,2007-01-26,2007,0,0,0,0.858014
30341,Villain,1971-05-26,1971,0,0,0,1.874916
30345,The Black Castle,1952-12-15,1952,0,0,0,1.674452
30346,The Body Snatcher,1945-05-25,1945,0,0,0,2.257383
30347,Jesse Stone: Death in Paradise,2006-04-30,2006,0,0,0,6.490445
30348,Isle of the Dead,1945-09-01,1945,0,0,0,1.791188
30349,Mail Order Bride,2003-01-01,2003,0,0,0,0.788215
30351,All She Wants for Christmas,2006-12-18,2006,0,0,0,0.320403
30352,Disorganized Crime,1989-04-14,1989,0,0,0,1.249626
30361,Save Me,1994-01-01,1994,0,0,0,1.061046
30363,The State of Things,1982-03-22,1982,0,0,0,1.372892
30365,An Unreasonable Man,2007-01-31,2007,0,0,0,0.576198
30366,Leningrad Cowboys Meet Moses,1994-02-24,1994,0,0,0,0.548989
30368,Stray Dog,1949-10-17,1949,0,0,0,2.787661
30374,Crack in the World,1965-04-15,1965,873000,0,-873000,1.760193
30379,Megiddo: The Omega Code 2,2001-09-07,2001,0,0,0,1.414972
30385,Chainsaw Sally,2004-10-02,2004,40000,0,-40000,0.151445
30388,Reykjavik Whale Watching Massacre,2009-09-04,2009,4000000,0,-4000000,0.547182
30402,Intermedio,2005-03-29,2005,1000000,0,-1000000,0.737291
30411,Surf II,1984-01-01,1984,0,0,0,1.770573
30416,Stanley Kubrick: A Life in Pictures,2001-05-02,2001,0,0,0,2.48768
30421,A Chinese Ghost Story,1987-07-18,1987,0,0,0,7.792253
30427,Glory to the Filmmaker!,2007-06-02,2007,0,0,0,0.771126
30428,Romantic Prelude,2009-05-16,2009,0,0,0,0.008312
30431,Creation,2009-09-25,2009,0,0,0,3.744449
30432,Army of Crime,2009-05-17,2009,10000000,0,-10000000,10.741315
30443,Back in Action,1993-01-01,1993,0,0,0,0.499475
30447,Blood Curse,2006-02-24,2006,0,0,0,1.167209
30449,Imago mortis,2009-01-15,2009,3700000,0,-3700000,0.737245
30452,Elves,1989-01-01,1989,0,0,0,0.874661
30459,Fracchia Against Dracula,1985-12-20,1985,0,0,0,2.146347
30460,Dracula in Pakistan,1967-07-07,1967,0,0,0,0.323291
30462,The Comancheros,1961-10-30,1961,0,0,0,4.432418
30467,Virgin High,1991-01-23,1991,0,0,0,0.001393
30478,Bloody New Year,1987-05-11,1987,0,0,0,0.462164
30485,Blue Summer,1973-11-20,1973,0,0,0,0.506146
30492,Animal Room,1995-01-01,1995,0,0,0,0.057235
30496,The Tenant of Wildfell Hall,1997-10-26,1997,0,0,0,0.404641
30497,The Texas Chain Saw Massacre,1974-10-01,1974,85000,30859000,30774000,15.526413
30500,To Gillian on Her 37th Birthday,1996-10-18,1996,0,4137645,4137645,3.263681
30502,Big Top Pee-wee,1988-07-22,1988,0,15122000,15122000,15.227522
30506,The Princess and the Pirate,1944-11-10,1944,0,0,0,1.319154
30508,Berlin Calling,2008-10-01,2008,0,0,0,7.292134
30526,Pentathlon,1994-01-01,1994,0,0,0,2.471939
30527,Shake Hands With the Devil,2007-09-28,2007,11000000,0,-11000000,1.334478
30528,Bye Bye Love,1995-03-16,1995,0,0,0,2.47308
30529,The Truce,1997-02-10,1997,0,0,0,0.956069
30535,Along the Ridge,2006-05-05,2006,0,0,0,0.868057
30545,Dogging: A Love Story,2009-12-26,2009,0,0,0,0.063992
30547,The Champ,1979-07-10,1979,0,0,0,6.463112
30548,Zerophillia,2005-10-13,2005,325000,0,-325000,1.246805
30552,The Eroticist,1972-03-16,1972,0,0,0,0.533315
30554,When A Stranger Calls Back,1993-04-04,1993,0,0,0,1.224878
30565,The Hamster Factor and Other Tales of Twelve Monkeys,1997-01-01,1997,0,0,0,1.337041
30566,Blacula,1972-08-25,1972,500000,0,-500000,2.697458
30574,Experiment Perilous,1944-12-18,1944,0,0,0,0.661871
30575,Sailor Moon S the Movie: Hearts in Ice,1994-10-02,1994,0,0,0,0.921113
30576,Karlsson on the Roof,1974-12-07,1974,0,0,0,1.128245
30577,The Adventures of Hercules,1985-08-26,1985,0,0,0,1.264419
30579,Hallowed Ground,2007-01-01,2007,1500000,0,-1500000,1.284305
30583,Nils Karlsson Pyssling,1990-11-09,1990,0,0,0,1.036484
30584,Sword of the Valiant: The Legend of Sir Gawain and the Green Knight,1984-08-17,1984,0,0,0,1.263534
30586,Biggie and Tupac,2002-01-11,2002,0,0,0,1.56449
30587,Aziz Ansari: Intimate Moments for a Sensual Evening,2010-01-19,2010,0,0,0,0.714919
30588,Monsieur Verdoux,1947-04-11,1947,2000000,0,-2000000,6.466517
30592,The Jacksons: An American Dream,1992-11-15,1992,0,0,0,1.717329
30593,Heavy Traffic,1973-08-08,1973,950000,1500000,550000,0.820911
30596,Bodyguards and Assassins,2009-12-18,2009,23000000,5837674,-17162326,10.861339
30599,Kobe Doin' Work,2009-05-16,2009,0,0,0,0.159024
30614,Strange Impersonation,1946-03-16,1946,0,0,0,0.338774
30618,Bunraku,2010-09-01,2010,25000000,0,-25000000,6.475676
30619,D Day,2008-06-06,2008,5000000,0,-5000000,0.665913
30624,Road House,1948-09-22,1948,0,0,0,0.584114
30630,Conquest,1937-10-22,1937,0,0,0,0.277746
30631,The Kiss,1929-01-01,1929,0,0,0,0.087327
30633,Istanbul Tales,2005-04-11,2005,5000,0,-5000,0.407943
30634,Organize ƒ∞≈üler,2005-12-22,2005,20000,0,-20000,2.458282
30636,La Luna,1979-08-29,1979,0,0,0,3.651899
30637,Corridors of Blood,1958-12-01,1958,146000,0,-146000,1.54225
30640,The Man Who Changed His Mind,1936-09-11,1936,0,0,0,1.242866
30641,Grizzly Rage,2007-06-07,2007,2000000,0,-2000000,0.901783
30643,The Princess Academy,1987-04-01,1987,0,0,0,0.077598
30644,Raw Force,1982-07-01,1982,0,0,0,0.741194
30645,Mondo Trasho,1969-03-14,1969,2100,0,-2100,0.689076
30647,12:01 PM,1990-01-01,1990,0,0,0,1.927712
30648,Blindman,1971-11-15,1971,0,0,0,0.640175
30649,Carlin on Campus,1984-04-18,1984,0,0,0,0.448493
30653,The Best of Times,1986-01-31,1986,0,0,0,5.655712
30654,Ghoulies IV,1994-08-17,1994,0,0,0,2.470516
30655,Circuitry Man,1990-05-01,1990,0,0,0,0.935723
30656,Circuitry Man II: Plughead Rewired,1994-04-01,1994,0,0,0,0.521923
30665,Tap Roots,1948-08-25,1948,0,0,0,0.574034
30666,Stepfather II: Make Room For Daddy,1989-11-03,1989,0,1519796,1519796,11.067992
30667,Future Kick,1991-11-19,1991,0,0,0,1.340467
30669,Devil's Pond,2003-12-16,2003,0,0,0,1.455593
30671,Born Innocent,1974-09-10,1974,0,0,0,3.055891
30675,Planet Hulk,2010-02-02,2010,0,7000000,7000000,5.769957
30680,On the Doll,2007-10-12,2007,0,0,0,1.454686
30685,Blood Creek,2009-10-09,2009,0,0,0,4.065407
30688,Gemini,2005-06-09,2005,0,0,0,1.406225
30689,Four Flies on Grey Velvet,1971-12-17,1971,0,0,0,2.873255
30690,Hot to Trot,1988-08-26,1988,9000000,6436211,-2563789,1.99161
30694,The Resurrected,1991-10-06,1991,0,0,0,1.857722
30695,Chance Pe Dance,2010-01-15,2010,0,0,0,0.745225
30698,The Five People You Meet In Heaven,2004-12-05,2004,0,0,0,3.299518
30702,Conrack,1974-03-27,1974,0,0,0,1.557693
30707,Star 80,1983-11-11,1983,0,6472990,6472990,4.119518
30708,Cahill U.S. Marshal,1973-07-11,1973,0,0,0,3.131954
30709,...All the Marbles,1981-10-16,1981,0,0,0,1.417079
30712,Free Money,1998-12-03,1998,0,0,0,4.003018
30713,Shiver,2008-02-08,2008,0,0,0,1.631904
30718,Last of the Dogmen,1995-09-08,1995,0,0,0,3.205275
30719,I'll Be Seeing You,1944-12-31,1944,0,0,0,0.605364
30723,Cavegirl,1985-05-01,1985,0,0,0,1.692243
30734,Crisis,1946-02-25,1946,0,0,0,0.832827
30735,Alila,2003-06-06,2003,0,0,0,0.172669
30762,3: The Dale Earnhardt Story,2004-12-11,2004,0,0,0,1.140125
30765,The Amazing Panda Adventure,1995-08-25,1995,0,0,0,2.375865
30768,The Christmas Shoes,2002-01-01,2002,0,0,0,1.676703
30778,I Am Omega,2007-11-18,2007,0,0,0,6.924892
30779,Blackwoods,2001-10-25,2001,3000000,0,-3000000,0.616008
30780,Cabin By The Lake,2000-02-01,2000,0,0,0,5.390929
30784,The Criminal,1960-09-13,1960,0,0,0,5.197424
30785,Evil Toons,1992-01-08,1992,140000,0,-140000,1.789189
30787,Horror Hospital,1973-05-11,1973,0,0,0,13.316509
30789,Venom,1981-11-28,1981,0,0,0,3.049914
30792,The Corpse,1970-01-01,1970,0,0,0,0.000603
30793,House of Dracula,1945-12-06,1945,0,0,0,9.074831
30801,Son of Paleface,1952-07-14,1952,0,0,0,4.423289
30806,Out for a Kill,2003-08-14,2003,14000000,0,-14000000,3.984204
30810,Olga's House of Shame,1964-02-06,1964,0,0,0,0.151701
30814,Montana,1998-01-01,1998,0,0,0,1.174927
30815,Mortal Thoughts,1991-04-19,1991,8000000,0,-8000000,5.133778
30817,Stealth Fighter,1999-01-01,1999,0,0,0,1.019062
30839,Waterboys,2001-09-15,2001,0,0,0,2.48931
30840,Robin Hood,1991-05-13,1991,0,0,0,5.683753
30843,Antique,2008-01-01,2008,0,0,0,1.080883
30844,Beauty and the Beast,2009-11-04,2009,0,0,0,2.505008
30846,Burrowing,2009-02-07,2009,0,0,0,0.105414
30849,Living Proof,2008-10-18,2008,0,0,0,1.202831
30855,Dr Jekyll & Sister Hyde,1971-10-17,1971,0,0,0,5.608278
30856,Gunner Palace,2004-01-01,2004,0,0,0,0.798876
30858,Terra Nova,2008-08-08,2008,0,0,0,0.748532
30860,06/05,2004-12-15,2004,0,0,0,0.903115
30861,The Last House in the Woods,2007-08-24,2007,0,0,0,0.749871
30863,Mutant Aliens,2002-01-09,2002,0,0,0,0.209908
30867,Scott Walker: 30 Century Man,2006-10-31,2006,0,0,0,0.415136
30870,Cat in the Brain,1990-08-08,1990,100000,0,-100000,1.800842
30872,The Devil's Honey,1986-08-14,1986,0,0,0,1.354258
30873,No Impact Man,2009-09-04,2009,0,0,0,1.270889
30874,The New York Ripper,1982-01-01,1982,0,0,0,4.273868
30875,Manhattan Baby,1982-08-12,1982,300000,0,-300000,1.243242
30876,Last Cannibal World,1977-02-08,1977,0,0,0,2.661296
30877,Cut and Run,1985-08-08,1985,0,373530,373530,11.258125
30879,Body Count,1987-05-14,1987,0,0,0,0.452924
30885,Vampyres,1974-01-01,1974,0,0,0,1.743689
30888,The Coming of Sin,1978-06-01,1978,0,0,0,3.965041
30890,Radio Days,1987-01-30,1987,16000000,0,-16000000,8.782912
30892,The Ruling Class,1972-09-13,1972,0,0,0,2.186663
30901,All the Colors of the Dark,1972-02-28,1972,0,0,0,1.562543
30903,Blade of the Ripper,1971-01-15,1971,0,0,0,1.660014
30906,Frontrunners,2008-10-15,2008,0,0,0,0.004706
30909,If I Should Die Before I Wake,1952-04-29,1952,0,0,0,0.083797
30910,Went to Coney Island on a Mission from God... Be Back by Five,1998-01-01,1998,0,0,0,0.001652
30913,At Midnight I'll Take Your Soul,1964-11-09,1964,0,0,0,1.049373
30914,This Night I'll Possess Your Corpse,1967-03-13,1967,0,0,0,1.415683
30921,Scanner Cop,1994-07-27,1994,0,0,0,0.500389
30922,Atomic Train,1999-05-16,1999,0,0,0,1.165723
30923,Alice in Wonderland,1999-02-28,1999,21000000,0,-21000000,8.614303
30924,Motel Hell,1980-08-14,1980,3000000,0,-3000000,6.398395
30926,Pinocchio's Revenge,1996-10-07,1996,0,0,0,1.749695
30929,The Mutations,1974-09-25,1974,0,0,0,0.709955
30931,Dark Night of the Scarecrow,1981-10-24,1981,0,0,0,2.410045
30933,Home for the Holidays,1974-07-13,1974,0,0,0,0.984071
30934,Tower of Evil,1972-05-19,1972,0,0,0,0.817183
30941,The Anderson Tapes,1971-06-17,1971,3000000,0,-3000000,4.16741
30942,Fatal Contact,2006-10-05,2006,0,0,0,1.295367
30943,The Deep End of the Ocean,1999-03-12,1999,38000000,28121100,-9878900,5.78468
30944,On the Beach,2000-05-28,2000,0,0,0,6.10978
30946,All the Rage,1999-09-11,1999,0,0,0,2.00173
30948,Bloodmoon,1997-06-20,1997,0,0,0,0.514095
30949,Palmetto,1998-02-20,1998,0,0,0,4.475177
30950,Metroland,1997-08-30,1997,0,0,0,0.503503
30953,Bj√∂rk: Volumen,1999-01-01,1999,0,0,0,0.699852
30959,Kwaidan,1964-12-29,1964,0,0,0,4.130372
30963,Class Act,1992-06-05,1992,0,0,0,5.196912
30964,The Lost Son,1999-06-25,1999,0,0,0,0.504739
30966,Facing Ali,2009-01-01,2009,0,0,0,1.283207
30969,Louis C.K.: Chewed Up,2008-10-01,2008,0,0,0,1.836976
30970,Code Unknown,2000-05-19,2000,0,95242,95242,11.251674
30972,The Brides of Fu Manchu,1966-12-16,1966,0,0,0,0.563711
30973,The Visual Bible: The Gospel of John,2003-09-11,2003,10000000,4069090,-5930910,1.551648
30974,High Lane,2009-01-01,2009,0,0,0,5.055334
30975,Love's Unending Legacy,2007-04-07,2007,0,0,0,1.273015
30977,The Adventures of Tom Sawyer,1938-02-11,1938,0,0,0,0.979391
30979,The Horse Boy,2009-11-25,2009,0,0,0,0.647193
30982,The Tramp,1915-04-12,1915,0,0,0,1.940708
30983,From the Earth to the Moon,1998-04-05,1998,0,0,0,3.22315
30993,Flesh Eating Mothers,1988-09-16,1988,0,0,0,0.042826
30994,Dogs in Space,1986-12-18,1986,0,0,0,0.256896
30995,I Was a Teenage Zombie,1987-07-01,1987,0,0,0,0.920734
30996,Splatter University,1984-07-13,1984,0,0,0,0.946779
30997,Ghosthouse,1988-05-21,1988,0,0,0,2.739535
30998,The Confession,1999-03-26,1999,0,0,0,1.175226
30999,Jason and the Argonauts,2001-01-07,2001,30000000,0,-30000000,1.765811
31000,Amos & Andrew,1993-03-05,1993,0,0,0,3.941294
31002,Ticker,2001-01-01,2001,7000000,0,-7000000,6.527479
31003,Modern Vampires,1998-10-19,1998,0,0,0,6.010147
31004,The Mighty Quinn,1989-02-17,1989,0,4557214,4557214,2.326119
31005,Moonlight Mile,2002-09-09,2002,21000000,10011050,-10988950,14.074906
31007,Welcome to the Rileys,2010-10-29,2010,0,42145,42145,6.182802
31010,Uprising,2001-01-01,2001,0,0,0,7.957418
31011,Mr. Nobody,2009-09-11,2009,47000000,3547209,-43452791,11.817059
31013,Earth vs. the Spider,2001-10-07,2001,0,0,0,1.762141
31015,Body Count,1998-04-28,1998,0,0,0,1.280643
31016,Sidewalks of New York,2001-11-23,2001,1000000,2402459,1402459,2.678923
31017,"Truth or Consequences, N.M.",1997-01-01,1997,0,0,0,2.26858
31018,Path to War,2002-01-01,2002,0,0,0,1.365035
31021,The Collector,2005-09-14,2005,0,0,0,0.26853
31022,Aftermath,1994-01-01,1994,0,0,0,1.838661
31023,Butterfly,1999-09-24,1999,3000000,6000000,3000000,2.753674
31024,The Flanagan Boy,1953-04-10,1953,0,0,0,0.694949
31026,Distant,2002-12-20,2002,0,0,0,2.432672
31027,Dr. Wai in the Scriptures with No Words,1996-02-10,1996,0,0,0,1.734829
31031,The World Unseen,2007-09-09,2007,0,0,0,1.784141
31032,The Death of Mr. Lazarescu,2005-05-17,2005,0,0,0,3.360684
31034,Legend of Crystania: The Motion Picture,1995-07-29,1995,0,0,0,0.371865
31035,A Somewhat Gentle Man,2010-03-19,2010,0,0,0,2.408749
31036,When Night Falls,2007-06-01,2007,0,0,0,0.30254
31037,MacArthur,1977-07-01,1977,9000000,0,-9000000,1.956972
31040,The Situation,2006-01-01,2006,0,0,0,0.860383
31041,No Greater Love,2009-12-26,2009,0,0,0,0.458602
31042,Target Earth,1954-11-07,1954,100000,0,-100000,0.509404
31043,Mike's Murder,1984-03-09,1984,0,0,0,0.855695
31044,My Favorite Year,1982-10-01,1982,0,0,0,2.923672
31046,Jesse Stone: Stone Cold,2005-02-20,2005,0,0,0,3.557141
31047,Jesse Stone: Night Passage,2006-01-15,2006,0,0,0,4.577746
31048,Sweet Land,2005-10-21,2005,0,0,0,6.185658
31051,Lupin the Third: Bye Bye Liberty Crisis,1989-04-01,1989,0,0,0,0.630398
31052,The Accidental Tourist,1988-12-23,1988,0,0,0,4.771107
31056,A Short Film About Love,1988-01-01,1988,0,0,0,3.500562
31058,Bitter Rice,1949-09-21,1949,0,0,0,2.460003
31059,Nasha Russia: Yaytsa sudby,2010-01-21,2010,2000000,22212223,20212223,0.995285
31060,Recep ƒ∞vedik,2008-02-22,2008,500000,5330000,4830000,1.640271
31061,Recep ƒ∞vedik 2,2009-02-13,2009,0,0,0,1.679656
31063,The Calcium Kid,2004-01-01,2004,0,0,0,2.923272
31064,The Business of Strangers,2001-01-19,2001,0,0,0,2.239112
31065,Ike: Countdown to D-Day,2004-05-31,2004,0,0,0,6.988241
31067,Fail Safe,2000-04-09,2000,0,0,0,1.583899
31068,Killing Words,2003-01-01,2003,0,0,0,0.820094
31073,West Bank Story,2005-01-01,2005,0,0,0,0.452072
31074,The Wave,1981-10-04,1981,0,0,0,0.928528
31076,Fear and Trembling,2003-01-01,2003,0,0,0,1.693772
31078,Twelve Mile Road,2003-09-28,2003,0,0,0,0.82079
31082,Sixty Six,2006-01-01,2006,0,0,0,0.78269
31083,Some Girls,1988-09-09,1988,0,401421,401421,2.903563
31086,Gorp,1980-05-01,1980,0,0,0,1.052336
31094,Taking Sides,2001-01-01,2001,0,0,0,5.760896
31102,Pollyanna,1960-05-19,1960,0,0,0,3.254308
31104,Pigs and Battleships,1961-01-21,1961,0,0,0,1.770329
31111,The Sicilian Girl,2008-12-31,2008,0,0,0,1.547095
31112,"Bon Voyage, Charlie Brown (and Don't Come Back!)",1980-01-01,1980,0,2013193,2013193,0.594899
31116,Zaat,1971-01-01,1971,0,0,0,0.794203
31117,Superbabies: Baby Geniuses 2,2004-08-27,2004,0,9109322,9109322,7.538821
31118,The Skydivers,1963-01-01,1963,0,0,0,0.107058
31119,Monster a-Go Go,1965-07-01,1965,0,0,0,1.042017
31121,Shampoo,1975-03-13,1975,0,0,0,3.796195
31122,The Starfighters,1964-01-01,1964,0,0,0,0.252602
31123,Night Train to Mundo Fine,1966-11-01,1966,0,0,0,0.263079
31124,Five the Hard Way,1969-05-01,1969,0,0,0,0.211993
31125,The Hellcats,1968-05-08,1968,0,0,0,0.072124
31127,R.O.T.O.R.,1987-10-01,1987,0,0,0,0.811813
31128,Final Justice,1985-01-01,1985,0,0,0,0.231663
31129,The Final Sacrifice,1990-01-01,1990,1500,0,-1500,0.396057
31131,Outlaw of Gor,1988-12-01,1988,0,0,0,0.80656
31132,Kiler,1997-10-17,1997,0,0,0,1.550559
31134,Track of the Moon Beast,1976-01-01,1976,0,0,0,0.429003
31139,Office Romance,1977-10-26,1977,0,0,0,2.795768
31140,Party 7,2000-09-27,2000,0,0,0,0.476429
31142,Jet Boy,2001-09-30,2001,1200000,0,-1200000,0.901269
31146,Box of Moonlight,1996-08-29,1996,0,0,0,6.254986
31147,Tom Petty and the Heartbreakers: Runnin' Down a Dream,2007-10-14,2007,0,0,0,2.231719
31148,City for Conquest,1940-09-21,1940,0,0,0,1.461503
31150,Intruder,1989-01-27,1989,130000,0,-130000,5.456906
31151,Elvis That's the Way It Is,1970-11-11,1970,0,0,0,1.755621
31152,On Dangerous Ground,1951-12-17,1951,0,0,0,1.830056
31156,Dante's Hell Animated,2013-11-25,2013,0,0,0,0.787493
31160,Alma,2009-01-01,2009,0,0,0,1.700431
31161,Adrenaline Drive,1999-06-12,1999,0,0,0,0.222935
31162,Black Lightning,2009-12-31,2009,15000000,21500000,6500000,3.931527
31165,Inside I'm Dancing,2004-10-15,2004,0,0,0,4.333887
31167,Follow Me Quietly,1949-07-07,1949,0,0,0,0.793134
31169,The Courageous Heart of Irena Sendler,2009-04-19,2009,0,0,0,5.448612
31174,Richard III,1995-12-29,1995,0,0,0,4.561387
31175,Soul Kitchen,2009-09-09,2009,5000000,17872796,12872796,4.79386
31179,Tim,1979-07-13,1979,600000,809000,209000,7.165079
31183,The Magical Legend of the Leprechauns,1999-11-07,1999,0,0,0,2.043987
31184,The Accidental Gangster and the Mistaken Courtesean,2008-12-03,2008,0,0,0,1.251085
31185,Empire of Silver,2009-02-12,2009,0,0,0,0.742398
31189,Cairo Time,2009-09-13,2009,0,0,0,1.450946
31196,Growth,2010-01-29,2010,300000,0,-300000,2.660436
31200,Agatha,1979-02-09,1979,0,0,0,7.607516
31203,Little Nicholas,2009-09-30,2009,0,0,0,9.625107
31206,The Jolson Story,1946-10-10,1946,0,0,0,1.193303
31208,Making Plans for Lena,2009-09-02,2009,0,0,0,2.372304
31214,Stay as You Are,1978-09-14,1978,0,0,0,0.910542
31216,I Can't Think Straight,2008-06-01,2008,0,0,0,2.830411
31217,The Human Condition I: No Greater Love,1959-01-15,1959,0,0,0,2.756995
31218,The Firm,2009-09-18,2009,0,0,0,2.481581
31219,Ghosts... of the Civil Dead,1989-06-01,1989,0,0,0,1.73798
31220,Krippendorf's Tribe,1998-02-27,1998,0,0,0,3.177318
31221,Dragon Hunter,2008-12-01,2008,0,0,0,1.31226
31222,Progression,2009-01-01,2009,0,0,0,0.404863
31223,In The Hands Of The Gods,2007-09-14,2007,0,0,0,0.093773
31225,Paris is Burning,1990-03-13,1990,500000,3779620,3279620,4.101295
31227,4,2005-01-28,2005,0,0,0,0.785054
31237,Morning Light,2008-03-12,2008,0,0,0,0.088284
31240,Agent for H.A.R.M.,1966-01-05,1966,0,0,0,0.440429
31242,Just 4 Kicks,2003-01-01,2003,0,0,0,0.719194
31243,The Robot vs. The Aztec Mummy,1958-07-17,1958,0,0,0,1.186265
31244,Merlin's Shop of Mystical Wonders,1996-01-01,1996,0,0,0,0.908117
31245,Hobgoblins,1988-07-14,1988,0,0,0,1.09642
31246,From Justin to Kelly,2003-06-20,2003,12000000,4922166,-7077834,1.695369
31248,Ram Gopal Varma Ki Aag,2007-01-01,2007,0,0,0,0.568866
31251,Angels' Brigade,1979-01-01,1979,0,0,0,0.992629
31253,Girl in Gold Boots,1968-04-25,1968,0,0,0,0.481618
31254,Invasion of the Neptune Men,1961-01-01,1961,0,0,0,0.542344
31258,The Wild World of Batwoman,1966-01-01,1966,0,0,0,0.455183
31261,Halo Legends,2010-02-16,2010,100000,1000000,900000,1.731527
31262,The Man from London,2008-01-31,2008,0,0,0,8.901688
31263,"The Barbaric Beast of Boggy Creek, Part II",1984-02-13,1984,0,0,0,0.587529
31264,The Blade Master,1982-12-13,1982,0,0,0,3.169575
31265,Catalina Caper,1967-12-01,1967,0,0,0,0.225909
31270,The Great Spy Chase,1964-12-10,1964,0,0,0,1.576968
31273,With Fire and Sword,1999-02-08,1999,0,0,0,1.766518
31275,The Creeping Terror,1964-01-01,1964,0,0,0,0.47805
31276,Soultaker,1990-01-01,1990,0,0,0,0.707346
31277,Popstar,2005-01-01,2005,0,0,0,3.379955
31278,The Pumaman,1980-02-14,1980,0,0,0,1.706648
31280,Fire Maidens of Outer Space,1956-07-01,1956,0,0,0,0.957614
31281,Ghosts Can't Do It,1989-01-01,1989,0,25000,25000,0.836108
31282,I Accuse My Parents,1944-10-27,1944,0,0,0,0.616123
31283,Hannie Caulder,1971-11-08,1971,0,0,0,12.300262
31286,The Sinister Urge,1960-12-08,1960,0,0,0,0.437921
31287,Eegah,1962-06-08,1962,15000,3274,-11726,1.274228
31289,The Caiman,2006-03-24,2006,0,0,0,2.659206
31292,Code Name Coq Rouge,1989-08-25,1989,0,0,0,0.553682
31293,Love in the City,1953-11-27,1953,0,0,0,0.565378
31295,The Inside Man,1985-01-01,1985,0,0,0,0.908799
31297,Ninja 1,1962-12-01,1962,0,0,0,0.924169
31299,Little Ashes,2008-10-06,2008,2500000,0,-2500000,3.396498
31300,Under the Sun of Satan,1987-05-14,1987,0,0,0,1.579474
31303,Betty,1992-02-19,1992,0,0,0,0.209852
31304,A Swedish Love Story,1970-04-24,1970,0,0,0,0.098906
31306,Crazy in Alabama,1999-10-22,1999,0,0,0,7.250842
31309,Mr. Bug Goes to Town,1941-12-09,1941,0,0,0,1.21616
31319,The Embryo Hunts in Secret,1966-07-01,1966,0,0,0,1.036063
31321,Loners,2000-04-13,2000,0,0,0,1.308417
31324,Rage in Heaven,1941-03-07,1941,0,0,0,1.267769
31325,The Singer,2006-09-13,2006,0,0,0,2.725556
31329,By the Pricking of My Thumbs,2005-04-13,2005,0,0,0,2.331788
31332,The Stranger,1967-10-14,1967,0,0,0,1.384418
31334,47 Ronin,1994-10-22,1994,0,0,0,0.886644
31336,The Carriers Are Waiting,1999-05-19,1999,0,0,0,0.3943
31337,Contact High,2009-03-19,2009,0,0,0,1.430713
31338,Remembrance of Things to Come,2001-01-01,2001,0,0,0,0.107062
31340,The New Protocol,2008-03-19,2008,0,0,0,0.785909
31341,Blue Collar Comedy Tour: One for the Road,2006-06-15,2006,0,0,0,0.439344
31342,The Love Letter,1999-05-21,1999,0,0,0,2.012283
31343,Can Dialectics Break Bricks?,1973-01-01,1973,0,0,0,0.297024
31344,The 317th Platoon,1965-03-31,1965,0,0,0,1.25921
31345,Naked Childhood,1968-04-03,1968,0,0,0,1.952949
31347,Cardcaptor Sakura: The Sealed Card,2000-07-15,2000,0,0,0,1.31263
31353,Those Who Love Me Can Take the Train,1998-05-15,1998,0,0,0,1.156694
31354,Whatever You Say,2002-12-17,2002,0,0,0,0.651499
31355,Pretty Things,2001-11-14,2001,0,0,0,1.872374
31357,Waiting to Exhale,1995-12-22,1995,16000000,81452156,65452156,3.859495
31359,Would I Lie to You? 2,2001-02-07,2001,12560000,42700000,30140000,4.052991
31361,Bustin' Loose,1981-05-22,1981,0,0,0,1.527771
31362,In the Line of Duty: The F.B.I. Murders,1988-09-28,1988,0,0,0,0.145289
31364,Waqt: The Race Against Time,2005-04-22,2005,0,0,0,0.614761
31372,Samurai I: Musashi Miyamoto,1954-09-26,1954,0,0,0,3.28276
31374,Samurai II: Duel at Ichijoji Temple,1955-07-12,1955,0,0,0,2.235644
31377,Spy School,2008-01-01,2008,0,0,0,4.042314
31378,Samurai III: Duel at Ganryu Island,1956-01-03,1956,0,0,0,2.62459
31380,Time Chasers,1994-03-17,1994,0,0,0,0.437263
31382,The Touch of Satan,1971-08-23,1971,0,0,0,0.059353
31383,The Incredibly Strange Creatures Who Stopped Living and Became Mixed-Up Zombies!!?,1964-02-10,1964,0,0,0,0.781819
31385,Zombie Nightmare,1987-10-13,1987,0,0,0,5.402952
31388,Santa with Muscles,1996-11-08,1996,0,0,0,7.378936
31389,Miss Cast Away,2004-01-01,2004,0,0,0,1.593302
31390,Brothers in Arms,2005-01-01,2005,0,0,0,1.061451
31392,It's Hot In Paradise,1960-04-15,1960,0,0,0,7.123949
31393,The Unearthly,1957-06-28,1957,0,0,0,0.483134
31395,"Car 54, Where Are You?",1994-01-28,1994,10700000,1238080,-9461920,1.060709
31396,Hercules Against the Moon Men,1964-06-27,1964,0,0,0,0.793628
31397,Alien from L.A.,1988-01-01,1988,0,0,0,1.377641
31398,Michael the Brave,1970-01-01,1970,0,0,0,0.886381
31400,Balkan Spy,1984-02-23,1984,0,0,0,0.355784
31401,The Broken Landlord,1985-01-01,1985,0,0,0,0.689375
31402,Hababam Sƒ±nƒ±fƒ± Tatilde,1977-01-01,1977,0,0,0,0.619218
31404,Show People,1928-11-20,1928,0,0,0,1.158975
31405,Milk Brothers,1976-02-01,1976,0,0,0,0.626525
31407,Teddy Bear,1981-05-04,1981,0,0,0,0.759427
31408,Hababam Sƒ±nƒ±fƒ± Uyanƒ±yor,1976-01-01,1976,0,0,0,1.158092
31409,The Smiling Lieutenant,1931-08-01,1931,0,0,0,1.209386
31410,My Sweet Little Village,1985-08-01,1985,0,0,0,1.662033
31411,The Cameraman,1928-09-16,1928,0,0,0,4.824576
31412,The Girl with the Red Scarf,1978-01-01,1978,0,0,0,1.148834
31413,Innocence,1997-10-24,1997,0,0,0,1.159256
31414,Satantango,1994-02-08,1994,1500000,0,-1500000,7.515086
31416,The Wind,1928-09-15,1928,0,0,0,1.347008
31417,Eyes Without a Face,1960-01-11,1960,0,0,0,9.935891
31418,Everybody Dies But Me,2008-05-21,2008,0,235432,235432,0.689004
31421,The Gymnast,2006-04-11,2006,0,0,0,0.618117
31427,Fires on the Plain,1959-11-03,1959,0,0,0,3.464092
31428,Someone's Watching Me!,1978-11-27,1978,0,0,0,2.697299
31432,The Four Horsemen of the Apocalypse,1921-03-06,1921,0,0,0,1.717444
31439,To Live,1994-06-30,1994,0,0,0,5.260627
31442,Ivan's Childhood,1962-05-05,1962,0,0,0,5.16792
31443,The President's Man,2000-01-01,2000,0,0,0,0.785072
31445,Beyond Tomorrow,1940-01-01,1940,0,0,0,0.69219
31446,Archangel,2005-03-18,2005,0,0,0,2.461544
31448,The Invisible Kid,1988-01-01,1988,0,0,0,0.563189
31450,Pavee Lackeen: The Traveller Girl,2005-07-07,2005,0,0,0,0.616934
31451,Forever Strong,2008-09-26,2008,0,0,0,7.998711
31453,Double Identity,2009-12-18,2009,0,0,0,6.862603
31459,It Runs in the Family,2003-04-25,2003,0,0,0,2.791925
31460,Life Without Dick,2002-01-01,2002,0,0,0,2.476312
31462,Moving Violations,1985-04-19,1985,0,0,0,1.280358
31463,Subject Two,2006-01-20,2006,0,0,0,1.039179
31465,Traveller,1997-04-18,1997,0,0,0,2.166773
31472,Lust for a Vampire,1971-01-17,1971,0,0,0,0.846569
31473,An American Tail: The Treasure of Manhattan Island,1998-11-16,1998,0,0,0,3.272986
31486,They're a Weird Mob,1966-08-18,1966,0,0,0,0.076113
31498,The Mummy's Hand,1940-09-20,1940,0,0,0,1.622519
31501,Samurai X: Trust & Betrayal,1999-01-01,1999,0,0,0,1.857794
31502,Samurai X : Reflection,2001-12-12,2001,0,0,0,1.434366
31503,My Boyfriend's Back,1993-08-06,1993,0,3335984,3335984,2.183504
31504,Little Big League,1994-06-29,1994,0,0,0,1.960563
31506,Die Nibelungen: Siegfried,1924-02-13,1924,0,0,0,1.827403
31507,Dodsworth,1936-09-23,1936,0,0,0,2.010982
31509,Way Down East,1920-09-03,1920,0,0,0,1.649987
31510,Ben-Hur: A Tale of the Christ,1925-12-30,1925,3900000,9000000,5100000,2.301098
31511,Gold Diggers of 1933,1933-05-27,1933,0,0,0,2.286647
31512,Memories of Matsuko,2006-01-01,2006,0,0,0,3.175948
31513,Good News,1947-12-26,1947,0,0,0,0.793978
31514,√Ä Nous la Libert√©,1931-12-18,1931,0,0,0,1.209032
31515,The Boy Friend,1971-12-16,1971,0,0,0,0.543395
31516,On the Town,1949-12-08,1949,2111250,0,-2111250,3.446446
31522,A Woman Is a Woman,1961-09-06,1961,160000,100655,-59345,4.431293
31524,Sarfarosh,1999-04-30,1999,0,0,0,0.823247
31525,The Legend of Bhagat Singh,2002-06-07,2002,3000000,6000000,3000000,0.904409
31526,Queen Christina,1933-12-26,1933,1114000,2610000,1496000,2.886254
31527,The Scarlet Empress,1934-05-09,1934,900000,0,-900000,6.183889
31530,Shall We Dance,1937-05-07,1937,0,0,0,3.786353
31532,Love Me Tonight,1932-08-13,1932,0,0,0,1.981885
31534,Hababam Sƒ±nƒ±fƒ± Sƒ±nƒ±fta Kaldƒ±,1975-04-15,1975,0,0,0,1.337509
31535,Chairman of the Board,1998-03-13,1998,0,0,0,1.422904
31542,The Tree of Wooden Clogs,1978-09-21,1978,0,0,0,2.660443
31544,The Hitman,1991-05-01,1991,0,4654288,4654288,5.46508
31546,American Buffalo,1996-09-13,1996,0,665450,665450,7.031279
31547,≈ûaban Oƒülu ≈ûaban,1977-12-01,1977,0,0,0,1.115787
31548,Show Boat,1936-05-17,1936,0,0,0,0.606441
31549,Blood River,2009-01-01,2009,0,0,0,0.739832
31551,Lady Oscar,1979-03-03,1979,0,0,0,0.167831
31555,Pushover,1954-08-06,1954,0,0,0,1.076524
31556,He Walked by Night,1948-11-24,1948,0,0,0,2.3353
31557,The Pink Floyd and Syd Barrett Story,2003-03-24,2003,0,0,0,0.152314
31559,The Steel Trap,1952-11-12,1952,0,0,0,0.987394
31560,A Blueprint for Murder,1953-09-01,1953,0,0,0,1.093081
31561,Caesar and Cleopatra,1945-12-11,1945,0,0,0,1.057669
31563,Critical Condition,1987-01-16,1987,14000000,0,-14000000,2.451513
31578,Body Bags,1993-08-07,1993,0,0,0,2.954229
31579,God Told Me To,1976-10-31,1976,0,0,0,1.903143
31581,Bloody Mama,1970-03-24,1970,0,0,0,4.257796
31582,Flawless,1999-11-26,1999,0,4488529,4488529,8.608461
31583,Kill Me Again,1989-10-27,1989,4000000,0,-4000000,2.713132
31586,North,1994-07-22,1994,40000000,0,-40000000,15.534707
31587,Scarecrow,1973-04-11,1973,0,0,0,12.288092
31589,The Bad Sleep Well,1960-09-15,1960,0,0,0,4.550823
31591,Bad Company,1972-10-08,1972,0,0,0,6.975511
31592,The Old Dark House,1932-10-20,1932,0,0,0,5.962386
31593,Cutter's Way,1981-03-19,1981,3000000,0,-3000000,2.696125
31596,Lemora: A Child's Tale of the Supernatural,1973-05-01,1973,0,0,0,1.282366
31597,Narrow Margin,1990-09-21,1990,0,0,0,9.382971
31598,Q & A,1990-04-27,1990,0,0,0,2.79389
31600,Target,1985-11-08,1985,0,0,0,1.715126
31601,Teachers,1984-10-05,1984,0,0,0,2.275641
31602,The Chase,1966-02-17,1966,0,0,0,3.082889
31603,The Formula,1980-01-01,1980,0,8894289,8894289,4.402396
31604,The Killer Elite,1975-12-19,1975,0,0,0,1.3963
31605,The Last American Hero,1973-01-01,1973,0,0,0,2.342707
31606,The Package,1989-08-25,1989,0,0,0,3.721996
31608,Three Fugitives,1989-01-27,1989,15000000,40590000,25590000,3.96986
31609,Cheech & Chong Get Out of My Room,1985-01-01,1985,0,0,0,4.61363
31610,Trixie,2000-06-28,2000,0,0,0,1.626713
31611,White Man's Burden,1995-12-01,1995,8000000,0,-8000000,1.834099
31618,Betrayed,1988-08-26,1988,19000000,0,-19000000,2.812811
31621,Baby Take a Bow,1934-06-30,1934,0,0,0,1.700876
31623,Battleground,1949-11-09,1949,0,0,0,2.746799
31624,Torso,1973-01-04,1973,0,0,0,2.911722
31626,Bommarillu,2006-08-09,2006,1333333,5333333,4000000,0.654216
31629,Arundhati,2009-01-16,2009,2915739,14000000,11084261,0.558002
31633,The Marrying Man,1991-04-05,1991,26000000,12454768,-13545232,2.70816
31634,The Amazing Transparent Man,1960-02-01,1960,0,0,0,1.492473
31638,Beyond the Poseidon Adventure,1979-05-18,1979,0,0,0,3.276763
31640,Blood and Wine,1996-10-03,1996,26000000,0,-26000000,8.409956
31641,Digging to China,1997-07-07,1997,0,33556,33556,1.486062
31642,Heaven & Earth,1993-12-24,1993,33000000,0,-33000000,4.190541
31643,Jimmy Hollywood,1994-03-30,1994,30000000,0,-30000000,4.563989
31644,Dollars,1971-12-17,1971,0,0,0,3.951933
31646,Piranha Part Two: The Spawning,1981-01-01,1981,145786,0,-145786,3.468843
31647,A Nymphoid Barbarian in Dinosaur Hell,1990-01-01,1990,40000,0,-40000,0.639242
31648,12 Chairs,1971-06-21,1971,0,0,0,3.153779
31650,Someone to Watch Over Me,1987-10-09,1987,17000000,10278549,-6721451,3.50111
31651,The Field,1990-12-21,1990,0,1494399,1494399,1.656115
31652,The Mean Season,1985-02-15,1985,0,4300000,4300000,6.473842
31654,The Strongest Man in the World,1975-01-01,1975,0,0,0,2.621466
31655,The Terror,1963-06-17,1963,0,0,0,7.958403
31656,Thieves Like Us,1974-02-11,1974,0,0,0,3.072578
31657,Coming Home,1978-02-15,1978,3000000,0,-3000000,3.176733
31658,Hour of the Gun,1967-11-01,1967,0,0,0,1.030968
31659,Wise Guys,1986-04-17,1986,13000000,8475466,-4524534,1.884204
31661,Wrong Is Right,1982-04-16,1982,0,0,0,2.13645
31662,Affliction,1997-08-28,1997,6000000,6330054,330054,4.40959
31664,Mexican Hayride,1948-12-01,1948,0,0,0,1.01699
31665,Barbarosa,1982-01-01,1982,0,1736123,1736123,1.134435
31667,The Paradine Case,1947-12-31,1947,4258000,0,-4258000,3.983539
31668,All The Queen's Men,2001-10-14,2001,15000000,23000,-14977000,1.652275
31670,Children of the Stork,1999-11-24,1999,0,0,0,0.399815
31671,Breakout,1975-05-21,1975,1000000,16000000,15000000,2.301183
31672,Violent City,1970-09-17,1970,0,0,0,0.999659
31674,Cousins,1989-02-10,1989,13000000,22030000,9030000,7.584638
31675,Cromwell,1970-09-16,1970,3750000,0,-3750000,2.766155
31676,Desperate Hours,1990-10-05,1990,0,0,0,3.233994
31677,Diary of a Mad Housewife,1970-01-01,1970,0,0,0,0.229955
31678,The Hollywood Revue of 1929,1929-11-23,1929,0,0,0,1.182411
31679,Eyewitness,1981-02-13,1981,0,0,0,1.316179
31680,Prisoner 701: Sasori,2008-01-01,2008,0,0,0,1.321239
31681,Hell in the Pacific,1968-12-19,1968,0,0,0,2.664145
31682,The Incredible Shrinking Man,1957-02-22,1957,750000,0,-750000,4.910227
31685,The Hunchback of Notre Dame,1939-12-29,1939,0,0,0,4.42224
31686,Balibo,2009-07-21,2009,0,0,0,1.37652
31687,Circle of Eight,2009-10-27,2009,0,0,0,2.285697
31688,The Soviet Story,2008-01-01,2008,0,0,0,0.62718
31692,The Public Eye,1992-01-01,1992,0,0,0,6.268871
31694,Trouble in Mind,1985-01-01,1985,0,0,0,4.252324
31695,Whose Life Is It Anyway?,1981-12-02,1981,0,0,0,2.236259
31696,A Kiss Before Dying,1991-04-26,1991,0,15429177,15429177,6.073468
31700,Cold Steel,1987-01-01,1987,0,0,0,0.782932
31701,Cop,1988-01-01,1988,2,0,-2,2.478231
31703,Death Ship,1980-03-07,1980,0,0,0,3.245807
31713,The Narrow Margin,1952-05-03,1952,0,0,0,1.733848
31714,Private Eye,2009-02-16,2009,0,0,0,1.296645
31715,A Huey P. Newton Story,2001-06-18,2001,0,0,0,0.00911
31718,"Race for Your Life, Charlie Brown",1977-08-24,1977,0,0,0,1.219274
31723,Women in Trouble,2009-11-13,2009,3000000,18097,-2981903,7.052376
31742,Il Posto,1961-09-21,1961,0,0,0,0.412578
31743,Hachi-ko,1987-08-01,1987,0,0,0,2.118466
31767,The Devils,1971-07-01,1971,0,0,0,4.718102
31768,Amy,1997-09-12,1997,0,0,0,3.099788
31769,Venus Wars,1989-03-11,1989,0,0,0,1.189609
31770,"Hello, Frisco, Hello",1943-03-26,1943,0,0,0,0.294364
31772,The Terror of Tiny Town,1938-12-01,1938,0,0,0,0.400982
31773,Libeled Lady,1936-10-09,1936,0,0,0,3.025778
31774,Picking Up the Pieces,2000-05-26,2000,0,0,0,1.856043
31775,Dave Attell: Captain Miserable,2007-12-08,2007,0,0,0,0.147827
31776,Where the Money is,2000-04-14,2000,0,0,0,8.851354
31777,Morning Glory,1933-08-18,1933,0,0,0,1.376116
31780,The Rock-afire Explosion,2009-01-01,2009,0,0,0,0.11809
31781,Redemption: The Stan Tookie Williams Story,2004-03-03,2004,0,0,0,2.63693
31789,What a Drag,1996-03-27,1996,0,0,0,1.365302
31798,Roberta,1935-03-08,1935,0,0,0,5.424847
31804,The Road to Hong Kong,1962-01-01,1962,0,0,0,1.561911
31805,Road to Morocco,1942-11-10,1942,0,0,0,2.034301
31809,Type O Negative: After Dark,1998-01-01,1998,0,0,0,0.002307
31812,Road to Zanzibar,1941-04-11,1941,0,0,0,1.208267
31819,The Adventurer,1917-10-22,1917,0,0,0,2.36944
31821,Now You Know,2002-01-01,2002,380000,0,-380000,0.207584
31835,Twentieth Century,1934-05-11,1934,0,0,0,2.738773
31850,Breathless,2008-10-08,2008,0,0,0,2.861435
31855,Destined for Blues,2005-08-01,2005,0,0,0,1.173474
31856,Hydrozagadka,1971-04-30,1971,0,0,0,0.10628
31858,Made in Britain,1982-02-25,1982,0,0,0,2.097877
31863,True Believer,1989-02-17,1989,0,0,0,5.832721
31866,Sylvia Scarlett,1935-12-11,1935,0,0,0,1.094282
31867,Repo Men,2010-03-18,2010,32000000,18409891,-13590109,7.502967
31868,Intermezzo: A Love Story,1939-10-05,1939,0,0,0,2.475513
31869,The Ascent of Money,2009-01-01,2009,0,0,0,0.458794
31875,Last Resort,2000-02-23,2000,0,0,0,0.647706
31879,The Princess Comes Across,1936-05-22,1936,0,0,0,0.168696
31880,The Pool Boys,2011-09-30,2011,0,0,0,9.837218
31890,God on Trial,2008-09-03,2008,0,0,0,1.462217
31894,The Tuskegee Airmen,1995-08-25,1995,0,0,0,9.196429
31896,Finding Bliss,2009-01-01,2009,0,0,0,2.859237
31899,Ever Since Eve,1937-07-15,1937,0,0,0,0.46476
31900,Gainsbourg: A Heroic Life,2010-01-20,2010,0,0,0,11.021373
31901,For Pete's Sake,1974-06-26,1974,0,0,0,1.266873
31903,History Is Made at Night,1937-03-05,1937,0,0,0,0.75071
31906,The Beguiled,1971-03-31,1971,0,0,0,7.150611
31907,Don King: Only in America,1997-11-15,1997,0,0,0,2.799851
31908,Ghosts of Mississippi,1996-12-20,1996,0,0,0,15.50082
31909,Invaders from Mars,1986-01-01,1986,12000000,4884663,-7115337,3.580884
31911,Mr. Wonderful,1993-10-15,1993,0,0,0,13.011091
31913,"Next Stop, Greenwich Village",1976-02-04,1976,0,0,0,1.128702
31915,Prophecy,1979-01-01,1979,12000000,54000000,42000000,3.579175
31916,The Devil at 4 O'Clock,1961-10-18,1961,0,0,0,1.393799
31918,"The Russians Are Coming, The Russians Are Coming",1966-05-25,1966,0,0,0,3.767458
31919,The Van,1977-04-06,1977,0,0,0,0.582224
31921,They All Laughed,1981-01-01,1981,0,0,0,1.718048
31922,Year of the Gun,1991-09-10,1991,1182273,0,-1182273,1.74562
31923,"Welcome Home, Roxy Carmichael",1990-10-12,1990,0,0,0,2.935552
31924,The Morning After,1986-12-25,1986,0,25147055,25147055,2.995682
31927,One of Us,1989-01-01,1989,0,0,0,0.000308
31930,Murder!,1930-07-31,1930,0,0,0,1.988389
31932,City of Ghosts,2002-01-01,2002,0,0,0,2.481406
31933,The Land Before Time XII: The Great Day of the Flyers,2006-02-27,2006,0,0,0,2.83275
31935,Too Late the Hero,1970-05-20,1970,6250000,0,-6250000,7.710629
31936,Welcome Mr. Marshall!,1953-04-04,1953,0,0,0,1.019564
31937,The Split,1968-11-04,1968,0,0,0,0.812417
31938,The Devil's Brigade,1968-05-15,1968,0,0,0,3.007031
31939,Another Country,1984-01-01,1984,0,0,0,2.648073
31941,Who'll Stop the Rain,1978-08-02,1978,0,0,0,1.974018
31942,Midnight Ride,1990-01-01,1990,0,0,0,0.766401
31943,Emperor of the North,1973-05-23,1973,0,0,0,3.272151
31944,"Reuben, Reuben",1983-12-19,1983,0,0,0,0.679846
31945,The Sicilian,1987-10-23,1987,16500000,0,-16500000,5.979288
31947,King Kong Lives,1986-11-21,1986,10000000,4711220,-5288780,2.663294
31948,Gray Lady Down,1978-03-10,1978,0,5438927,5438927,3.507084
31950,The 'Human' Factor,1975-01-01,1975,0,0,0,0.169452
31952,The Vampire Lovers,1970-10-04,1970,0,0,0,3.448018
31954,Sub Zero,2005-07-20,2005,0,0,0,0.416792
31955,Mrs. Soffel,1984-12-26,1984,0,4385312,4385312,1.893822
31957,The bitter herb,1985-04-25,1985,0,0,0,0.36714
31962,Shining Through,1992-01-31,1992,0,21621000,21621000,5.860319
31965,Witchfinder General,1968-05-01,1968,0,0,0,8.658708
31967,Dante's Inferno: An Animated Epic,2010-02-09,2010,0,0,0,13.157995
31973,Soldier of God,2005-01-01,2005,0,0,0,0.088381
31977,Black,2005-02-04,2005,0,733094,733094,2.854219
31978,Defying Gravity,1997-07-09,1997,0,0,0,1.089872
31979,Played,2006-01-01,2006,0,0,0,0.951017
31980,Road to Rio,1947-12-25,1947,0,0,0,1.642712
31981,Jim Jefferies: I Swear to God,2009-05-16,2009,0,0,0,1.01532
31983,Darna Zaroori Hai,2006-04-28,2006,0,0,0,0.16023
31984,Satellite in the Sky,1956-07-21,1956,0,0,0,0.701096
31985,Lightspeed,2006-07-22,2006,0,0,0,1.028416
31987,Don Quixote,1992-01-01,1992,0,0,0,1.049371
31988,Hands Across the Table,1935-10-18,1935,0,0,0,0.780836
31991,Drifter: Henry Lee Lucas,2009-09-01,2009,0,0,0,1.089383
31993,Midnight,1939-03-24,1939,0,0,0,2.239212
31995,Jamaica Inn,1939-05-11,1939,0,0,0,3.876608
31997,Saboteur,1942-04-24,1942,0,0,0,4.911826
31998,Without Love,1945-01-01,1945,0,0,0,1.02174
32003,The Caretaker,2008-01-01,2008,0,0,0,0.157168
32004,The Wedding Night,1935-03-08,1935,0,0,0,0.567427
32005,Breaking Point,2009-12-04,2009,2500000,0,-2500000,1.622175
32008,Blast of Silence,1961-03-31,1961,0,0,0,0.683643
32013,Hacking Democracy,2006-01-01,2006,0,0,0,0.302182
32014,Timerider: The Adventure of Lyle Swann,1982-12-11,1982,0,0,0,2.093837
32015,I Am Cuba,1964-09-06,1964,0,0,0,2.254539
32020,Foxes,1980-02-29,1980,0,4400000,4400000,2.825173
32021,The Night Strangler,1973-01-16,1973,0,0,0,1.479178
32023,Son of Dracula,1943-10-05,1943,0,0,0,5.343065
32027,Carny,1980-05-23,1980,0,0,0,3.151704
32029,The Domino Principle,1977-03-23,1977,0,0,0,1.47076
32030,Hopscotch,1980-09-26,1980,0,0,0,3.637392
32031,Let's Get Harry,1986-01-01,1986,0,0,0,0.500088
32033,Pulse,1987-12-31,1987,0,0,0,5.398337
32034,Puppet on a Chain,1971-01-01,1971,0,0,0,0.456717
32035,Love at Large,1990-03-09,1990,0,0,0,4.633638
32037,The Cassandra Crossing,1976-12-18,1976,0,0,0,3.939797
32038,Tommy Tricker and the Stamp Traveller,1988-12-08,1988,0,0,0,0.382735
32040,The Killing of a Chinese Bookie,1976-02-15,1976,0,0,0,2.037561
32041,Hell Is for Heroes,1962-06-26,1962,0,0,0,3.062515
32042,Night Moves,1975-06-11,1975,0,0,0,4.132633
32043,The Guardian,1990-04-27,1990,0,17037887,17037887,7.444848
32044,California Split,1974-08-07,1974,0,0,0,3.148851
32047,Prince of the City,1981-08-19,1981,0,0,0,3.598627
32048,Still of the Night,1982-11-19,1982,10000000,0,-10000000,3.764354
32049,Best of the Best 2,1993-01-01,1993,0,6500000,6500000,13.053072
32050,The Black Windmill,1974-05-17,1974,0,0,0,1.26698
32051,Race with the Devil,1975-06-01,1975,0,0,0,2.621146
32052,Go Tell the Spartans,1978-07-12,1978,1500000,0,-1500000,1.737092
32053,The Ultimate Warrior,1975-01-01,1975,0,0,0,6.673398
32054,Hope and Glory,1987-09-03,1987,0,0,0,3.390491
32058,Making Mr. Right,1987-01-01,1987,0,0,0,1.954131
32059,The January Man,1989-01-13,1989,0,0,0,3.064362
32060,Brighton Beach Memoirs,1986-01-01,1986,0,0,0,2.563112
32064,The Time Guardian,1987-12-03,1987,0,0,0,0.701202
32065,Forced Vengeance,1982-07-30,1982,0,6660333,6660333,1.112171
32066,Anna Karenina,1948-01-22,1948,0,0,0,0.603149
32067,Beautiful Joe,2000-06-09,2000,0,0,0,1.495537
32068,The Scalphunters,1968-04-02,1968,0,0,0,6.559114
32069,Inserts,1975-01-01,1975,0,0,0,1.532399
32070,Ten Seconds to Hell,1959-07-17,1959,0,0,0,0.834275
32074,Company Business,1991-09-06,1991,0,1501785,1501785,1.228145
32075,A Dry White Season,1989-01-01,1989,0,0,0,2.868585
32076,The Believers,1987-06-09,1987,0,18753438,18753438,3.321608
32077,True Confessions,1981-09-25,1981,0,0,0,2.73921
32078,Panic in the Streets,1950-06-12,1950,0,0,0,8.164371
32079,Cohen and Tate,1988-01-01,1988,0,64227,64227,2.083318
32080,The Seven-Ups,1973-01-01,1973,0,0,0,2.121703
32081,The Pope of Greenwich Village,1984-06-22,1984,0,0,0,4.652503
32082,The Hospital,1971-12-14,1971,0,0,0,2.523584
32083,Married to It,1993-03-26,1993,0,0,0,1.424578
32084,Lebanon,2009-10-10,2009,0,0,0,3.842922
32085,Vincent,1982-01-01,1982,60000,0,-60000,6.675518
32087,Attack,1956-09-19,1956,0,0,0,2.155549
32088,The Little Drummer Girl,1984-10-19,1984,0,0,0,1.122905
32091,The Touch,2002-08-01,2002,0,0,0,4.887096
32092,Under the Bombs,2007-09-02,2007,0,0,0,0.488704
32093,The Mark of Zorro,1940-11-08,1940,0,0,0,7.431939
32097,"The Devil, Probably",1977-06-15,1977,0,0,0,0.767395
32099,The Rose of the Rascal,2001-01-01,2001,0,0,0,0.214933
32100,The Human Tornado,1976-10-02,1976,0,0,0,0.991969
32105,Carry On Jack,1963-11-01,1963,0,0,0,1.685834
32109,Carry On Spying,1964-06-01,1964,0,0,0,4.463738
32113,Carry On Teacher,1959-08-25,1959,0,0,0,3.180019
32117,Aprile,1998-03-27,1998,0,0,0,0.575039
32119,The Boys of St. Vincent,1992-12-06,1992,0,0,0,0.86539
32120,No Time For Love,1943-11-10,1943,0,0,0,0.626391
32122,The Devil's Playground,1976-08-12,1976,0,0,0,0.812881
32124,Dare,2009-11-13,2009,0,18088,18088,2.080893
32128,Category 6: Day of Destruction,2004-11-14,2004,0,0,0,2.442987
32130,Together Again,1944-12-23,1944,0,0,0,0.967785
32139,Soccer Dog: The Movie,1999-01-01,1999,0,0,0,0.111342
32140,Snowball Express,1972-01-01,1972,0,0,0,1.757944
32142,Barquero,1970-09-03,1970,0,0,0,1.101769
32143,Billy Two Hats,1974-03-20,1974,0,0,0,1.423976
32144,The Proposition,1998-03-26,1998,147773,0,-147773,2.57622
32146,Body Parts,1991-08-02,1991,0,0,0,3.518972
32147,Starchaser: The Legend of Orin,1985-01-01,1985,15000000,3360800,-11639200,0.732814
32148,Space Mutiny,1988-01-01,1988,0,0,0,1.311115
32149,Once Upon a Time,2008-01-31,2008,0,0,0,0.736211
32150,Undercover,2007-01-01,2007,0,0,0,1.065071
32151,Triangle,2007-10-01,2007,5000000,0,-5000000,1.311671
32152,APT.,2006-07-06,2006,0,0,0,1.709284
32157,Hanbando,2006-07-13,2006,0,0,0,1.066176
32158,The Restless,2006-12-20,2006,0,0,0,2.096442
32159,Bloody Tie,2006-01-01,2006,0,0,0,0.675193
32160,Running Wild,2006-01-01,2006,0,0,0,1.898149
32162,Colour of the Loyalty,2005-01-01,2005,0,0,0,0.837863
32163,Mr. Socrates,2005-11-11,2005,0,0,0,0.670898
32164,Divergence,2005-01-01,2005,0,0,0,0.893082
32166,Chasing Sleep,2000-09-08,2000,0,0,0,1.800665
32168,Typhoon,2005-01-01,2005,0,0,0,1.946581
32169,Can Go Through Skin,2009-01-29,2009,0,0,0,0.058229
32171,Infection,2004-10-02,2004,0,0,0,1.406611
32173,Bunshinsaba: Ouija Board,2004-08-05,2004,2500000,0,-2500000,3.563634
32182,David Cross: The Pride Is Back,1999-09-18,1999,0,0,0,0.222578
32194,Comrade X,1940-12-13,1940,0,0,0,0.562359
32195,My Date with the President's Daughter,1998-04-19,1998,0,0,0,5.019029
32196,"Dance, Girl, Dance",1940-08-30,1940,0,0,0,0.523843
32202,Hey Good Lookin',1982-10-01,1982,1500000,0,-1500000,0.257958
32206,Quantum Apocalypse,2010-02-24,2010,2500000,0,-2500000,1.51939
32208,Wild Horses,1995-08-10,1995,0,0,0,0.56792
32213,Another Public Enemy,2005-01-27,2005,0,0,0,1.659613
32221,Rambling Rose,1991-09-10,1991,7500000,6266621,-1233379,3.399684
32226,The Indian,2007-01-01,2007,0,0,0,0.003889
32227,Hunk,1987-03-06,1987,0,1749956,1749956,1.832238
32228,5ive Days to Midnight,2004-01-01,2004,0,0,0,1.05306
32229,Explosive City,2004-01-01,2004,0,0,0,1.677638
32233,Running on Karma,2003-01-01,2003,0,0,0,1.542607
32234,Doppelganger,2003-09-27,2003,0,0,0,0.542608
32235,Northfork,2003-01-01,2003,0,0,0,3.450973
32237,Whispering Corridors 3: Wishing Stairs,2003-08-01,2003,0,0,0,2.768803
32242,Phone,2002-07-26,2002,0,0,0,2.28971
32248,Gojoe: Spirit War Chronicle,2000-09-11,2000,0,0,0,1.451588
32249,2000 AD,2000-01-01,2000,0,0,0,1.494306
32250,Ju-on: The Curse,2000-02-11,2000,4000000,0,-4000000,3.332192
32255,The Palm Beach Story,1942-11-07,1942,0,0,0,3.926841
32261,Scandal,1989-03-03,1989,0,8800000,8800000,2.132858
32263,David Cross: Let America Laugh,2003-11-04,2003,0,0,0,0.273623
32272,Death Bell,2008-08-06,2008,0,0,0,3.562387
32273,It All Starts Today,1999-03-12,1999,0,0,0,1.450026
32274,Cradle Will Rock,1999-12-10,1999,0,0,0,6.481649
32275,Duel in the Sun,1946-12-31,1946,6000000,20400000,14400000,8.441279
32276,"Easy Riders, Raging Bulls",2003-03-09,2003,0,0,0,6.268935
32284,Dream for an Insomniac,1996-04-18,1996,0,24,24,5.540427
32285,Cornered!,2008-01-01,2008,0,0,0,0.95451
32286,From Mexico With Love,2009-03-15,2009,0,0,0,0.309273
32293,The Cheetah Girls,2003-08-15,2003,0,0,0,5.973243
32294,Mr. Blandings Builds His Dream House,1948-06-04,1948,0,0,0,2.737464
32295,Khal Nayak,1993-05-26,1993,0,0,0,0.375295
32298,Seeing Other People,2004-01-01,2004,0,0,0,1.589601
32302,3 Ninjas: High Noon at Mega Mountain,1998-04-10,1998,0,0,0,3.014082
32303,Mitchell,1975-09-10,1975,0,0,0,1.588835
32304,Nine Lives,2002-01-01,2002,0,0,0,0.990855
32305,Simon Sez,1999-01-01,1999,0,0,0,3.106424
32306,The Underground Comedy Movie,1999-01-01,1999,0,0,0,0.489061
32307,Santa Claus Conquers the Martians,1964-11-14,1964,200000,0,-200000,1.66793
32308,Ed,1996-03-15,1996,0,0,0,5.174212
32316,Marci X,2003-08-22,2003,20000000,1675706,-18324294,4.15656
32317,Le Million,1931-04-03,1931,0,0,0,0.774436
32318,The Navigator,1924-10-13,1924,0,0,0,3.031803
32319,Beware of a Holy Whore,1971-08-28,1971,0,0,0,1.147121
32322,"Dr. Black, Mr. Hyde",1976-01-01,1976,0,0,0,0.000578
32323,The Railrodder,1965-06-20,1965,0,0,0,0.313521
32325,Mi Vida Loca,1994-06-08,1994,0,0,0,1.788829
32326,The Cruise,1998-10-23,1998,0,0,0,0.802931
32327,Dreams That Money Can Buy,1947-09-01,1947,0,0,0,0.244574
32328,Gay Purr-ee,1962-10-24,1962,0,0,0,1.976192
32329,Looking for Langston,1989-10-31,1989,0,0,0,0.006566
32330,Worth Winning,1989-10-27,1989,0,0,0,2.350811
32331,Stealing Home,1988-08-26,1988,0,7467504,7467504,7.168975
32332,Hugo Pool,1997-01-01,1997,0,0,0,2.44908
32334,Love and Pigeons,1984-01-07,1984,0,0,0,2.372133
32336,Station for Two,1982-06-06,1982,0,0,0,1.208227
32338,Every Jack has a Jill,2009-07-29,2009,0,0,0,6.997563
32387,Stick,1985-04-26,1985,22000000,0,-22000000,6.357952
32388,Golden Swallow,1968-04-03,1968,0,0,0,1.390381
32389,Logorama,2009-01-01,2009,0,0,0,2.603271
32390,Royal Palace,2005-11-23,2005,0,0,0,4.057695
32395,The Greatest,2009-01-17,2009,6000000,0,-6000000,7.588652
32407,Malice in Wonderland,2009-01-01,2009,0,0,0,1.392095
32428,Lonesome Ghosts,1937-12-24,1937,0,0,0,1.736422
32430,The Bells of St. Mary's,1945-12-27,1945,0,21300000,21300000,2.614074
32444,Dorian Blues,2004-01-01,2004,0,0,0,2.288041
32446,Parting Glances,1986-01-01,1986,0,0,0,2.699266
32450,Brain Donors,1992-04-17,1992,0,918239,918239,5.141952
32451,Heavy Metal in Baghdad,2007-09-08,2007,0,0,0,0.630144
32456,Two Girls and a Guy,1997-09-07,1997,1000000,2057193,1057193,4.967667
32458,Forgotten Silver,1995-10-28,1995,650000,0,-650000,8.535898
32465,Type O Negative: Symphony for the Devil,2006-01-01,2006,0,0,0,0.046401
32480,The Marquis of Grillo,1981-12-22,1981,0,0,0,3.431432
32484,Dimples,1936-10-08,1936,0,0,0,1.146347
32488,Days of Wine and Roses,1962-12-26,1962,0,0,0,3.942198
32489,Thoroughly Modern Millie,1967-03-21,1967,0,0,0,2.608222
32497,Farsan,2010-02-12,2010,0,0,0,1.480269
32499,The Bad and the Beautiful,1952-12-25,1952,1558000,0,-1558000,3.12508
32502,Coldblooded,1995-09-15,1995,0,0,0,2.342756
32511,"Police, Adjective",2009-05-15,2009,1089360,48298,-1041062,0.663231
32513,Cold Comfort Farm,1995-01-01,1995,0,0,0,1.92386
32517,"Justice, My Foot!",1992-01-01,1992,0,0,0,2.21879
32519,"Kiss Me, Guido",1997-07-18,1997,0,0,0,0.910655
32520,Eight Diagram Pole Fighter,1984-02-17,1984,0,0,0,2.6489
32523,The Work and the Glory III: A House Divided,2006-11-22,2006,6500000,1325092,-5174908,0.752508
32526,Soldier's Girl,2003-05-31,2003,0,0,0,2.955559
32528,Spartacus,2004-04-18,2004,0,0,0,9.616734
32532,Everything Will Be OK,2006-01-10,2006,0,0,0,1.519048
32534,I Am So Proud of You,2008-01-01,2008,0,0,0,0.472132
32536,Rejected,2000-07-25,2000,0,0,0,3.50564
32540,The Disappeared,2008-01-01,2008,0,0,0,0.901538
32543,Carnival in Flanders,1935-12-03,1935,0,0,0,0.550797
32546,Lugares comunes,2002-10-04,2002,0,0,0,0.477275
32547,Social Genocide,2004-03-18,2004,0,0,0,0.077482
32552,It's a Great Feeling,1949-08-01,1949,0,0,0,1.095354
32556,Jamie Foxx: I Might Need Security,2002-02-23,2002,0,0,0,1.178633
32558,Portrait of Jennie,1948-12-25,1948,0,0,0,2.2315
32559,Mall Girls,2009-09-25,2009,0,0,0,1.127443
32560,Rio Conchos,1964-10-28,1964,0,0,0,1.842453
32562,The Celluloid Closet,1996-01-30,1996,0,0,0,6.784687
32563,The Flame and the Arrow,1950-07-09,1950,0,0,0,1.180546
32567,The Endurance: Shackleton's Legendary Antarctic Expedition,2000-09-02,2000,0,2452566,2452566,1.079975
32568,The Man in the White Suit,1951-08-07,1951,0,0,0,3.579001
32569,X: The Man with the X-Ray Eyes,1963-09-18,1963,0,0,0,4.259969
32571,"Monkeyshines, No. 1",1890-11-21,1890,0,0,0,1.163672
32574,Meet John Doe,1941-03-12,1941,0,0,0,10.750619
32575,Putney Swope,1969-07-10,1969,0,0,0,2.500992
32577,The Parole Officer,2001-08-10,2001,0,0,0,2.844934
32579,Under the Same Moon,2008-03-20,2008,0,23311391,23311391,2.410635
32582,The Message,2009-09-22,2009,0,0,0,2.208448
32588,Uncle Nino,2003-12-05,2003,0,0,0,0.026729
32590,The Center of the World,2001-04-19,2001,0,0,0,3.247122
32593,Snow White: The Fairest of Them All,2001-10-28,2001,0,0,0,5.885524
32594,Ecaterina Teodoroiu,1979-01-01,1979,0,0,0,0.0
32595,Howling III: The Marsupials,1987-01-01,1987,0,0,0,5.1189
32596,An Ideal Husband,1947-11-14,1947,0,0,0,0.362895
32599,Alex in Wonderland,1970-01-01,1970,0,0,0,0.488919
32600,Seven Chances,1925-03-11,1925,0,0,0,4.590055
32601,The Moromete Family,1987-09-28,1987,0,0,0,0.597043
32604,Transylvania,2006-09-09,2006,0,0,0,1.072008
32609,Mickey One,1965-09-27,1965,0,0,0,1.213787
32610,Babes in Arms,1939-10-13,1939,0,0,0,4.779775
32611,Babes in Toyland,1961-12-14,1961,0,0,0,1.365451
32612,The Traveler,2010-10-01,2010,0,0,0,1.628307
32613,Horror Express,1972-09-30,1972,300000,0,-300000,12.004189
32615,The Offence,1973-01-11,1973,0,0,0,1.832915
32616,Swing,2002-03-20,2002,0,0,0,0.390499
32617,Bite the Bullet,1975-09-26,1975,4000000,0,-4000000,10.099042
32620,The Drowning Pool,1975-07-01,1975,0,0,0,3.027586
32622,Angela,1995-01-01,1995,0,0,0,2.197439
32623,Night of the Ghouls,1959-01-01,1959,0,0,0,1.301056
32624,When the Road Bends: Tales of a Gypsy Caravan,2006-04-30,2006,0,0,0,0.295596
32625,Personal Velocity,2002-01-01,2002,0,0,0,5.304475
32627,The MacKintosh Man,1973-01-01,1973,0,0,0,7.051042
32628,Three Ages,1923-09-24,1923,0,0,0,1.539713
32630,America The Beautiful,2008-08-01,2008,0,0,0,0.515876
32631,The Hunted,1995-02-24,1995,0,0,0,2.756986
32633,Almost Normal,2005-05-26,2005,0,0,0,1.175873
32634,Two Rode Together,1961-07-26,1961,0,0,0,14.936586
32635,A Place in the World,1992-04-09,1992,0,0,0,1.155347
32636,Vanya on 42nd Street,1994-09-13,1994,0,0,0,7.039846
32638,Cartoon All-Stars to the Rescue,1990-04-21,1990,0,0,0,0.61108
32640,Wonderland,1999-05-13,1999,0,0,0,1.433822
32643,The Love Bug,1997-11-29,1997,0,0,0,4.482274
32644,Two of a Kind,1983-01-01,1983,0,23646952,23646952,3.018747
32646,Safe,1995-06-23,1995,0,0,0,8.180047
32648,Into Thin Air: Death on Everest,1997-11-09,1997,0,0,0,1.086509
32649,Sandor slash Ida,2005-02-04,2005,0,0,0,0.317766
32652,Mystery of the Wax Museum,1933-02-18,1933,0,0,0,2.356071
32654,The Storm Warriors,2009-12-10,2009,100000000,0,-100000000,2.860376
32657,Percy Jackson & the Olympians: The Lightning Thief,2010-02-01,2010,95000000,226497209,131497209,9.785895
32665,The Jigsaw Man,1984-08-24,1984,0,0,0,1.716467
32666,Wild West Comedy Show: 30 Days & 30 Nights - Hollywood to the Heartland,2006-09-08,2006,0,0,0,0.350601
32669,The Two Jakes,1990-08-10,1990,19000000,10000000,-9000000,4.476578
32671,Hate Crime,2006-03-16,2006,0,40758,40758,0.310181
32673,The Kingdom of Fairies,1903-08-31,1903,0,0,0,0.929242
32677,Rescue From Gilligan's Island,1978-10-14,1978,0,0,0,1.26494
32678,Dead Man Running,2009-01-01,2009,5000000,0,-5000000,2.735297
32683,The Flapper,1920-05-10,1920,0,0,0,0.071809
32684,The Window,1949-08-06,1949,0,0,0,0.937987
32685,Ernest Scared Stupid,1991-10-11,1991,0,0,0,4.197955
32686,Gray's Anatomy,1996-09-11,1996,0,0,0,1.391296
32687,Gabrielle,2005-01-01,2005,0,0,0,1.129631
32688,Mondo Cane,1962-03-30,1962,0,0,0,1.3411
32689,First Name: Carmen,1983-09-04,1983,0,0,0,2.094005
32690,Scandal,1950-04-30,1950,0,0,0,1.215475
32691,Nouvelle Vague,1990-03-23,1990,0,0,0,2.291103
32692,Godard's Passion,1982-05-26,1982,0,0,0,2.387475
32694,The Rutles 2: Can't Buy Me Lunch,2002-01-01,2002,0,0,0,0.321264
32695,Walking Vengeance,2008-10-31,2008,19000000,0,-19000000,0.214011
32707,Breaking Dawn,2004-10-16,2004,0,0,0,1.418651
32708,Freedom,2000-10-10,2000,0,0,0,0.908927
32716,3 Bad Men,1926-08-28,1926,0,0,0,0.970037
32720,Hail Mary,1985-01-23,1985,0,0,0,0.818375
32726,Hellfighters,1968-11-27,1968,0,0,0,2.332425
32728,Before Stonewall,1984-09-15,1984,0,0,0,0.083594
32740,Krrish,2006-06-23,2006,0,0,0,4.431245
32742,Nirvana: Live! Tonight! Sold Out!!,1994-01-01,1994,0,0,0,0.489783
32761,The Seventh Continent,1989-05-19,1989,0,0,0,5.694032
32764,71 Fragments of a Chronology of Chance,1994-05-18,1994,0,0,0,2.445019
32767,Romero,1989-08-25,1989,0,0,0,2.188691
32782,Come Dance at My Wedding,2009-06-06,2009,0,0,0,0.818503
32790,The Good Witch,2008-01-19,2008,0,0,0,6.93335
32823,Get Him to the Greek,2010-06-04,2010,40000000,90029656,50029656,7.33335
32825,Wild in the Country,1961-06-15,1961,0,0,0,0.994694
32830,Humble Pie,2007-01-01,2007,0,0,0,0.15472
32831,"Buona Sera, Mrs. Campbell",1968-12-16,1968,0,0,0,1.103138
32834,MVP: Most Valuable Primate,2000-08-11,2000,0,0,0,0.632251
32836,Bill Burr: Why Do I Do This?,2008-09-23,2008,0,0,0,1.080121
32845,Wrong Side of Town,2010-02-23,2010,1500000,0,-1500000,1.751625
32847,"Now, Voyager",1942-10-31,1942,0,0,0,2.480798
32850,Act of Violence,1949-02-01,1949,0,0,0,2.496859
32855,In Country,1989-09-15,1989,18,0,-18,6.329111
32856,Valentine's Day,2010-02-10,2010,52000000,216485654,164485654,7.466721
32858,The Return of the Vampire,1943-11-11,1943,0,0,0,1.09212
32859,Wooden Crosses,1932-03-17,1932,0,0,0,1.730379
32862,Revenge of the Zombies,1943-09-17,1943,0,0,0,0.476775
32866,Accident On Hill Road,2009-12-31,2009,0,0,0,0.00631
32868,The Vicious Kind,2009-01-17,2009,0,0,0,2.425754
32872,Til There Was You,1997-05-30,1997,1000000,0,-1000000,2.700061
32887,Alias Nick Beal,1949-03-04,1949,0,0,0,0.752976
32888,Ski School 2,1994-02-17,1994,0,0,0,1.829375
32891,The Severed Heads,1957-05-01,1957,0,0,0,0.583051
32893,Broken Windows,2008-09-26,2008,0,0,0,0.56422
32901,Mine,2009-03-01,2009,0,0,0,0.075976
32904,Tony,2010-02-05,2010,0,0,0,3.23304
32909,Mulan: Rise of a Warrior,2009-11-26,2009,12000000,13380561,1380561,2.977779
32911,Wide Awake,1998-03-20,1998,6000000,0,-6000000,2.976537
32916,Scooby-Doo! Abracadabra-Doo,2010-02-16,2010,0,0,0,6.945449
32921,Captains of the Clouds,1942-02-21,1942,0,0,0,2.686813
32924,Catchfire,1990-04-03,1990,0,0,0,3.981125
32926,Recep ƒ∞vedik 3,2010-02-12,2010,0,0,0,0.990875
32928,The Extraordinary Adventures of Mr. West in the Land of the Bolsheviks,1924-04-26,1924,0,0,0,0.090387
32929,Backfire,1950-02-11,1950,0,0,0,4.597515
32930,Bill Maher: '...But I'm Not Wrong',2010-02-18,2010,0,0,0,0.546922
32932,Under the Mountain,2009-12-10,2009,0,0,0,6.401471
32934,Train of Shadows,1997-12-13,1997,0,0,0,0.108385
32940,The Terminal Man,1974-06-19,1974,0,0,0,3.664402
32941,The House Across the Lake,1954-04-16,1954,0,0,0,0.319175
32945,The Strange Woman,1946-10-25,1946,0,0,0,1.070331
32946,Jim Jefferies: Contraband,2008-11-10,2008,0,0,0,1.091529
32958,O Contador de Hist√≥rias,2009-08-07,2009,0,0,0,0.571197
32961,The Lavender Hill Mob,1951-06-21,1951,0,0,0,4.546546
32969,Pretty Poison,1968-07-18,1968,1800000,0,-1800000,1.916337
32978,Necrosis,2009-01-01,2009,0,0,0,1.982029
32985,Solomon Kane,2009-09-16,2009,45000000,7810000,-37190000,9.667535
32990,Mother of Mine,2005-09-30,2005,3500000,0,-3500000,3.075638
32996,We're Not Dressing,1934-04-27,1934,0,0,0,0.157967
33001,Other Men's Women,1931-01-17,1931,0,0,0,0.730406
33002,New World Order,2009-03-13,2009,0,0,0,0.142355
33003,Maxed Out,2006-03-10,2006,0,0,0,0.682081
33005,Mimic: Sentinel,2003-04-14,2003,0,0,0,2.803406
33009,Remarkable Power,2008-01-01,2008,0,0,0,0.877894
33015,Go West,1925-11-01,1925,0,0,0,1.014248
33016,Deadly Blessing,1981-08-14,1981,2500000,0,-2500000,3.175395
33018,Schizo,1976-11-11,1976,0,0,0,0.966239
33020,Dracula A.D. 1972,1972-09-27,1972,0,0,0,11.174533
33025,Mannequin,1937-12-14,1937,0,0,0,0.182215
33028,Too Hot to Handle,1938-09-16,1938,0,0,0,0.533529
33030,In Name Only,1939-08-18,1939,0,0,0,0.839403
33031,Come Live with Me,1941-01-31,1941,0,0,0,1.047901
33034,Keeper of the Flame,1943-01-28,1943,0,0,0,0.67635
33035,A Film with Me in It,2008-10-17,2008,0,0,0,1.771273
33037,"Hey There, It's Yogi Bear",1964-01-01,1964,0,0,0,1.136583
33039,Princess O'Rourke,1943-10-23,1943,0,0,0,0.319906
33045,Parasite Eve,1997-01-01,1997,0,0,0,0.888421
33049,The Heavenly Body,1944-03-23,1944,0,0,0,0.426453
33052,My Sister Eileen,1942-09-24,1942,0,0,0,1.989347
33055,Murphy's Law,1986-04-18,1986,0,0,0,2.722264
33057,Alvin Purple,1973-12-20,1973,0,0,0,1.159291
33061,Troll,1986-01-17,1986,1100000,5450815,4350815,10.254424
33065,Alesha Popovich and Tugarin the Dragon,2004-12-23,2004,4000000,1730000,-2270000,1.760091
33068,Hell House,2001-09-12,2001,0,0,0,0.45788
33076,Wholly Moses,1980-06-13,1980,0,14155617,14155617,9.389486
33077,Without Reservations,1946-05-13,1946,0,0,0,0.762928
33078,A Zed & Two Noughts,1985-10-04,1985,0,0,0,3.464385
33079,Dishonored Lady,1947-05-16,1947,0,0,0,0.394262
33081,Paheli,2005-06-24,2005,0,0,0,1.436484
33091,The Girl,2009-02-10,2009,0,0,0,0.88414
33095,Good Old Daze,1994-05-21,1994,0,0,0,3.004877
33102,The Girl from Monday,2005-01-01,2005,0,0,0,1.396149
33104,Don,1978-04-20,1978,0,0,0,0.734834
33106,Silver Medalist,2009-01-20,2009,0,0,0,0.492563
33107,And Soon the Darkness,2010-02-25,2010,0,0,0,6.904518
33108,The Bremen Town Musicians,1969-06-06,1969,0,0,0,2.02395
33111,Enchantment,1948-12-25,1948,0,0,0,0.19741
33112,It Started with Eve,1941-09-26,1941,0,0,0,1.865744
33114,Comrade Pedersen,2006-02-24,2006,0,0,0,1.260266
33115,Unfaithfully Yours,1948-12-10,1948,0,0,0,3.473029
33116,Godspeed,2009-01-01,2009,0,0,0,0.23636
33117,Tea for Two,1950-09-02,1950,0,0,0,1.196395
33124,1942: A Love Story,1994-04-15,1994,0,0,0,1.033872
33125,Border,1997-07-13,1997,0,0,0,1.740518
33126,Chung Kuo - Cina,1972-12-26,1972,0,0,0,0.067808
33127,High The True Tale of American Marijuana,2008-01-01,2008,0,0,0,0.039662
33130,Gewoon Hans,2009-12-30,2009,0,0,0,0.04291
33134,The Horseman,2008-08-03,2008,0,0,0,7.900269
33135,Fun,1994-01-01,1994,0,0,0,1.709151
33138,The Times of Harvey Milk,1984-10-07,1984,0,0,0,2.496262
33146,Om Jai Jagadish,2002-07-08,2002,0,0,0,0.15194
33150,Howard Zinn: You Can't Be Neutral on a Moving Train,2004-06-18,2004,0,0,0,0.935472
33152,Who Is Cletis Tout?,2001-09-12,2001,0,0,0,6.804386
33155,Galaxina,1980-06-06,1980,5500000,4865000,-635000,1.409619
33157,Waterloo,1970-10-26,1970,25000000,3052000,-21948000,3.240624
33159,The Donner Party,2009-10-23,2009,0,0,0,0.665873
33166,Downhill Racer,1969-11-06,1969,16500000,0,-16500000,2.550124
33172,Watchers,1988-12-02,1988,0,0,0,2.612373
33175,The Actors,2003-03-16,2003,0,0,0,0.921539
33194,Xiu Xiu: The Sent-Down Girl,1998-02-19,1998,0,0,0,1.286747
33195,Triage,2009-01-01,2009,0,0,0,9.51301
33196,Tidal Wave,2009-06-06,2009,16000000,11301649,-4698351,4.136356
33199,No Regret,2006-11-16,2006,0,0,0,0.553169
33201,Jeremiah,1998-12-14,1998,0,0,0,1.24097
33202,Jo Jeeta Wohi Sikandar,1992-05-22,1992,0,0,0,0.637779
33203,Orwell Rolls in His Grave,2003-10-23,2003,0,0,0,0.769924
33205,Dodes'ka-den,1970-10-31,1970,0,0,0,1.696371
33209,WWE: The Rise & Fall of ECW,2004-11-16,2004,0,0,0,0.321089
33214,Bad Timing,1980-03-02,1980,0,0,0,3.467449
33215,Tenure,2009-10-24,2009,0,0,0,0.85016
33217,Diary of a Wimpy Kid,2010-03-19,2010,15000000,75700498,60700498,12.139919
33218,Daddy Long Legs,1955-05-05,1955,0,0,0,2.16539
33221,Into the West,1992-10-23,1992,0,0,0,1.979369
33222,The Revolution Will Not Be Televised,2003-03-07,2003,0,0,0,1.845605
33224,Black Tuesday,1954-12-31,1954,0,0,0,0.839328
33226,Rembrandt's J'Accuse...!,2008-10-04,2008,0,0,0,0.58526
33228,The Magus,1968-12-10,1968,0,0,0,3.566565
33229,Dickson Greeting,1891-01-01,1891,0,0,0,1.041504
33241,Protocols Of Zion,2005-03-04,2005,0,0,0,0.479049
33245,It's My Party,1996-03-22,1996,0,0,0,2.791667
33250,Real Life,1979-03-02,1979,0,0,0,4.768672
33251,The Way Home,2002-04-05,2002,2000000,0,-2000000,1.832369
33253,6ixtynin9,1999-11-19,1999,0,0,0,0.948699
33255,Stoked: The Rise And Fall Of Gator,2004-06-25,2004,0,0,0,0.782053
33257,Fando and Lis,1968-01-01,1968,0,0,0,1.115749
33258,More American Graffiti,1979-08-03,1979,2500000,15014674,12514674,3.084426
33272,Lucky Country,2009-07-16,2009,0,0,0,0.342535
33273,Cell 211,2009-11-06,2009,5700000,19300483,13600483,8.075698
33274,Street Fighter: Round One - FIGHT!,2009-02-03,2009,0,0,0,0.155751
33278,Deadly Friend,1986-10-10,1986,0,8988731,8988731,5.012318
33280,Cry in the Woods,2004-04-02,2004,0,0,0,0.110872
33294,In Your Hands,2004-01-23,2004,0,0,0,1.580642
33295,More Than a Game,2008-09-06,2008,0,887029,887029,1.199003
33297,Her Name Is Sabine,2008-01-29,2008,0,0,0,0.507087
33301,Confessions of a Driving Instructor,1976-09-01,1976,0,0,0,0.78247
33302,The Girl from Paris,2001-09-05,2001,0,0,0,0.795662
33303,Confessions of a Window Cleaner,1974-01-01,1974,0,0,0,0.65365
33305,Scanners III: The Takeover,1992-01-31,1992,0,0,0,1.614913
33310,Smash Palace,1982-04-30,1982,0,0,0,0.051346
33314,Nora Roberts' Midnight Bayou,2009-03-28,2009,0,0,0,1.144161
33315,"Monkeyshines, No. 2",1890-11-21,1890,0,0,0,0.399258
33316,London's Trafalgar Square,1890-01-01,1890,0,0,0,0.3471
33317,"Monkeyshines, No. 3",1890-11-21,1890,0,0,0,0.276161
33318,Men Boxing,1891-04-30,1891,0,0,0,0.619106
33319,The Burmese Harp,1956-01-21,1956,0,0,0,2.026764
33320,Millennium Actress,2001-07-28,2001,0,37641,37641,5.330725
33321,The Dirt Bike Kid,1985-11-24,1985,0,0,0,0.151977
33324,Harlan County U.S.A.,1976-10-15,1976,0,0,0,1.595006
33331,The World's Greatest Athlete,1973-02-14,1973,0,0,0,0.527295
33333,Blue Spring,2001-09-10,2001,0,0,0,1.734291
33336,Taxi for Tobruk,1961-05-09,1961,0,0,0,1.951488
33338,The Underdog Knight,2008-11-28,2008,0,0,0,0.571227
33339,Camp,2003-09-05,2003,0,1628154,1628154,6.411695
33340,The Angel,2009-10-02,2009,0,0,0,0.06017
33343,Gypsy 83,2001-01-01,2001,0,0,0,0.469538
33344,The House of Yes,1997-10-10,1997,1500000,626057,-873943,3.974374
33345,Under the Cherry Moon,1986-07-02,1986,0,10090429,10090429,6.421995
33352,Aftermath,2004-03-26,2004,0,0,0,0.5564
33355,For Love or Country: The Arturo Sandoval Story,2000-11-18,2000,0,0,0,0.642243
33356,The Falls,1980-01-01,1980,0,0,0,0.866004
33357,The Valachi Papers,1972-06-01,1972,0,0,0,1.725038
33358,The Mostly Unfabulous Social Life of Ethan Green,2005-04-29,2005,0,152810,152810,0.767631
33360,Let's Not Get Angry,1966-04-20,1966,0,0,0,1.239307
33364,A Patch of Blue,1965-12-10,1965,800000,6792000,5992000,2.46167
33365,The Night Before the Exams,2006-02-17,2006,2457000,0,-2457000,4.250923
33367,Harem,1985-11-20,1985,0,0,0,1.825468
33370,Done the Impossible,2006-07-28,2006,0,0,0,1.192406
33371,The Little Bear Movie,2001-08-07,2001,0,0,0,0.082116
33374,Class Reunion,1982-10-29,1982,0,0,0,2.086059
33375,My Bollywood Bride,2006-01-14,2006,0,0,0,0.885042
33377,Bush's Brain,2004-03-13,2004,0,0,0,0.173324
33379,Greenfingers,2001-07-27,2001,0,1443067,1443067,6.618392
33380,Gayniggers from Outer Space,1992-01-01,1992,0,0,0,1.671405
33382,Chappaqua,1967-11-04,1967,0,0,0,0.10547
33386,Charlie Chan at the Circus,1936-03-27,1936,0,0,0,0.296281
33387,Charlie Chan at the Race Track,1936-08-14,1936,0,0,0,0.533025
33388,Charlie Chan at Treasure Island,1939-08-31,1939,0,0,0,0.597515
33389,City in Darkness,1939-11-15,1939,0,0,0,1.068644
33390,Charlie Chan in Egypt,1935-06-04,1935,0,0,0,1.06717
33391,Charlie Chan in London,1934-09-12,1934,0,0,0,0.727814
33392,Charlie Chan in Honolulu,1938-12-30,1938,0,0,0,0.606726
33393,Charlie Chan in Paris,1935-01-21,1935,0,0,0,0.553082
33394,Charlie Chan in Reno,1939-06-16,1939,0,0,0,1.02741
33395,Charlie Chan in Shanghai,1935-10-14,1935,0,0,0,1.540778
33407,Twigson,2009-10-16,2009,0,0,0,0.229765
33408,The Crush,1993-04-02,1993,6000000,13609396,7609396,8.976337
33409,The Stoning of Soraya M.,2008-09-07,2008,0,0,0,3.694624
33419,The House of Fear,1945-03-16,1945,0,0,0,3.148801
33421,The Pearl of Death,1944-08-01,1944,0,0,0,1.483085
33427,LEGO: The Adventures of Clutch Powers,2010-01-01,2010,0,0,0,1.605238
33429,Helen,2008-08-29,2008,0,0,0,0.389045
33430,Twin Falls Idaho,1999-07-30,1999,0,0,0,1.596052
33431,A Snake of June,2002-01-01,2002,0,0,0,1.877874
33436,The Brain,1969-03-07,1969,0,0,0,3.574703
33441,Robot Carnival,1987-07-21,1987,0,0,0,1.193577
33446,The Sun King,2005-02-11,2005,0,0,0,2.309915
33447,Summer in Tyrol,1964-09-25,1964,0,0,0,0.183896
33454,Scaramouche,1952-05-08,1952,3005000,6746000,3741000,3.803547
33457,Nayak: The Real Hero,2001-09-07,2001,0,0,0,1.394925
33459,Lightning Bug,2004-04-09,2004,0,0,0,1.057788
33460,Sehar,2005-07-29,2005,0,0,0,0.463688
33468,The Brain That Wouldn't Die,1962-02-25,1962,62000,0,-62000,2.131425
33470,American Boy: A Profile of: Steven Prince,1978-09-16,1978,155000,0,-155000,0.211543
33472,Abbott and Costello Go to Mars,1953-04-05,1953,0,0,0,4.196009
33474,Abbott and Costello in the Foreign Legion,1950-08-05,1950,0,0,0,0.992299
33475,Abbott and Costello Meet the Invisible Man,1951-03-07,1951,0,0,0,6.870281
33476,Abbott and Costello Meet the Keystone Kops,1955-01-01,1955,736,0,-736,1.268897
33477,"Abbott and Costello Meet the Killer, Boris Karloff",1949-09-18,1949,686,0,-686,1.099256
33481,The Worthless,1982-10-15,1982,0,0,0,0.780772
33482,Here Come the Co-eds,1945-01-01,1945,717,0,-717,0.947703
33484,Hit the Ice,1943-06-02,1943,0,0,0,0.634062
33486,Keep 'Em Flying,1941-11-28,1941,0,0,0,0.74624
33489,All That... for This?!,1993-01-01,1993,0,0,0,0.593933
33491,Venus Beauty Institute,1999-02-03,1999,0,0,0,2.725499
33494,The Wedding Photographer,2009-10-16,2009,0,0,0,1.113918
33495,2061 - Un anno eccezionale,2007-10-26,2007,0,0,0,1.050868
33501,The Moment After,1999-07-04,1999,0,0,0,1.842117
33504,El Bola,2000-10-20,2000,0,0,0,2.503983
33506,Indian Summer,1993-04-23,1993,0,0,0,2.406006
33510,Puffball,2007-10-28,2007,0,0,0,0.824586
33511,Nowhere Boy,2009-12-25,2009,0,0,0,5.08732
33516,Gothic,1986-11-30,1986,0,0,0,2.578902
33517,Beyond the Clouds,1995-06-06,1995,0,0,0,7.047574
33518,Alligator,1980-07-02,1980,1500000,0,-1500000,5.500439
33519,Amityville: A New Generation,1993-09-29,1993,1500000,0,-1500000,6.401828
33521,Dracula,1979-07-20,1979,0,0,0,3.31004
33523,In the Navy,1941-05-30,1941,0,0,0,1.499739
33525,Morons from Outer Space,1985-03-29,1985,0,0,0,1.566559
33534,Nikitich and The Dragon,2006-03-16,2006,4500000,3468423,-1031577,1.833185
33539,Once Upon a Forest,1993-06-18,1993,13000000,6582052,-6417948,3.14419
33541,Ride 'Em Cowboy,1942-02-13,1942,0,0,0,0.830594
33542,Rumble in the Bronx,1995-01-30,1995,7500000,32392047,24892047,12.314278
33543,Satan's School For Girls,1973-01-01,1973,0,0,0,0.856423
33545,The Siege of Firebase Gloria,1989-01-27,1989,0,0,0,1.683509
33546,The Time of Their Lives,1946-08-16,1946,0,0,0,1.131386
33551,The Wistful Widow of Wagon Gap,1947-10-07,1947,0,0,0,0.196905
33555,Sherlock Holmes,2010-01-26,2010,1000000,0,-1000000,2.719197
33556,Ishqiya,2010-01-29,2010,0,0,0,1.135644
33557,Daddy and Them,2001-10-26,2001,0,0,0,8.404739
33558,Dog Eat Dog,2009-01-23,2009,0,0,0,0.833698
33560,Totally Fucked Up,1993-01-12,1993,0,0,0,1.520025
33563,Bickford Shmeckler's Cool Ideas,2006-06-02,2006,0,0,0,2.555543
33564,The Swimmer,1968-05-15,1968,0,0,0,3.589888
33569,White Night Wedding,2008-01-18,2008,0,0,0,0.726311
33570,Ice Castles,2010-02-09,2010,0,0,0,1.579212
33575,Pat and Mike,1952-06-13,1952,0,0,0,2.415004
33582,Teenage Dirtbag,2009-10-20,2009,0,0,0,0.878564
33583,The Decameron,1971-01-01,1971,0,0,0,5.619235
33586,Heavy Petting,2007-10-20,2007,2800000,0,-2800000,2.913855
33588,White Light/Black Rain: The Destruction of Hiroshima and Nagasaki,2007-08-06,2007,0,0,0,0.550383
33592,White of the Eye,1988-05-20,1988,0,0,0,3.121105
33600,Der Fuehrer's Face,1943-01-01,1943,0,0,0,1.52028
33602,Temple Grandin,2010-02-06,2010,0,0,0,4.762242
33604,We Are Not Angels,1992-01-01,1992,0,0,0,0.722909
33611,The Robbery of the Third Reich,2004-02-16,2004,0,0,0,0.171958
33613,The Girl Who Kicked the Hornet's Nest,2009-11-27,2009,4000000,43498108,39498108,8.405013
33623,Innocence,2004-12-01,2004,0,0,0,4.306859
33624,Double z√©ro,2004-06-16,2004,0,0,0,3.528875
33625,Killing Emmett Young,2002-01-01,2002,0,0,0,1.739286
33627,OceanWorld 3D,2009-01-01,2009,8000000,0,-8000000,1.072832
33630,Vivacious Lady,1938-08-31,1938,0,0,0,0.67326
33632,Sweet Bird of Youth,1962-08-31,1962,0,0,0,2.444359
33633,Oleanna,1994-11-04,1994,0,124693,124693,1.954153
33638,The Life and Times of Judge Roy Bean,1972-12-18,1972,0,0,0,4.15819
33641,Frankenfish,2004-10-09,2004,0,0,0,7.698433
33642,Hells Angels on Wheels,1967-06-01,1967,0,0,0,6.325139
33644,How Stella Got Her Groove Back,1998-08-14,1998,20000000,37672350,17672350,3.645263
33657,A Smile Like Yours,1997-08-27,1997,0,0,0,2.507368
33660,Shiloh,1996-11-30,1996,0,0,0,2.89449
33665,Opening Night,1977-12-22,1977,0,0,0,4.692033
33666,The Glass Bottom Boat,1966-06-09,1966,0,0,0,0.942977
33667,Gentleman's Agreement,1947-11-11,1947,2000000,7800000,5800000,6.857318
33668,Designing Woman,1957-05-16,1957,0,0,0,1.904237
33670,Up the Academy,1980-06-06,1980,0,0,0,1.987499
33673,His Kind of Woman,1951-08-29,1951,0,0,0,4.285717
33676,Losin' It,1983-04-08,1983,7000000,1246141,-5753859,3.132019
33680,Grand Hotel,1932-05-25,1932,700000,2594000,1894000,11.118844
33682,Something Like Happiness,2005-06-29,2005,0,0,0,1.427816
33684,The Wild Bees,2001-11-08,2001,0,0,0,0.727954
33688,Jonny Vang,2003-02-14,2003,0,0,0,0.195557
33689,It Takes Two,1995-11-17,1995,0,0,0,7.777735
33691,Stereo,1969-06-23,1969,0,0,0,1.080535
33693,Funny Ha Ha,2002-09-20,2002,0,76901,76901,1.147626
33701,French Fried Vacation 2,1979-11-22,1979,0,0,0,5.921814
33704,The Box,2004-10-06,2004,0,0,0,0.867684
33708,Charlie Chan's Secret,1936-01-17,1936,0,0,0,0.630625
33709,Going Hollywood,1933-12-22,1933,0,0,0,0.196363
33710,Paris Blues,1961-09-27,1961,0,0,0,2.073112
33712,Trudell,2005-01-01,2005,0,0,0,0.792173
33714,I'm Staying,2007-04-19,2007,1000000,404785,-595215,0.594488
33719,Rudolph the Red-Nosed Reindeer: The Movie,1998-10-16,1998,0,0,0,2.623087
33721,The Boogens,1981-09-25,1981,0,0,0,0.235578
33723,The Eye: Infinity,2005-03-24,2005,0,0,0,1.268879
33725,A Hole in the Head,1959-09-15,1959,0,0,0,3.113228
33726,Can-Can,1960-03-09,1960,0,0,0,0.803604
33728,"Captain Newman, M.D.",1963-12-25,1963,0,0,0,0.858836
33729,Come Blow Your Horn,1963-06-05,1963,0,0,0,0.911508
33730,Fitzwilly,1967-04-19,1967,0,0,0,2.168226
33731,Marjorie Morningstar,1958-04-24,1958,0,0,0,0.728406
33733,One More Time,1970-05-01,1970,0,0,0,0.277486
33734,Pal Joey,1957-10-25,1957,0,0,0,2.774084
33735,Pressure Point,1962-01-01,1962,0,0,0,0.397274
33738,Take Me Out to the Ball Game,1949-03-09,1949,0,0,0,1.795678
33740,That's Entertainment!,1974-06-21,1974,0,0,0,1.048027
33743,"The 5,000 Fingers of Dr. T.",1953-07-01,1953,0,0,0,3.52006
33744,The Impossible Years,1968-12-05,1968,0,0,0,0.152165
33754,Scared Stiff,1953-04-27,1953,0,0,0,0.687672
33762,Band of the Hand,1986-04-11,1986,8700000,4865912,-3834088,4.397712
33765,A Kind of Loving,1962-04-12,1962,0,0,0,0.720133
33766,Smooth Talk,1985-11-17,1985,0,0,0,3.312484
33774,Tony Manero,2008-08-28,2008,0,0,0,1.855988
33783,It's Pat,1994-08-26,1994,0,0,0,2.022118
33784,Huset vid v√§gens √§nde,2003-01-29,2003,0,0,0,0.054755
33786,Starring Maja,2009-09-11,2009,0,0,0,0.155356
33787,"Get Smart, Again!",1989-02-26,1989,0,0,0,2.278459
33788,Possession,2009-07-16,2009,0,0,0,6.253597
33789,Wasting Away,2007-10-16,2007,0,0,0,0.630617
33792,State of the Union,1948-04-30,1948,0,0,0,1.927017
33796,Mountains of the Moon,1990-02-16,1990,0,0,0,1.870581
33799,Place Vendome,1998-10-07,1998,0,0,0,0.758979
33801,Beyond the Door,1975-07-31,1975,350000,0,-350000,0.865986
33806,The Misfortunates,2009-10-07,2009,0,0,0,3.961008
33809,Everyone Else,2009-03-26,2009,0,0,0,2.417076
33810,A Chump at Oxford,1940-02-16,1940,0,0,0,3.007421
33811,Border Incident,1949-10-28,1949,0,0,0,0.81594
33813,Born to Kill,1947-05-03,1947,0,0,0,2.187318
33814,Cast a Dark Shadow,1955-09-20,1955,0,0,0,0.756618
33817,Satan√°s - Profile of a Killer,2007-03-04,2007,0,0,0,1.994352
33823,Paper Clips,2004-09-08,2004,0,0,0,0.224164
33827,The Graffiti Artist,2006-01-19,2006,0,0,0,0.490745
33828,Criminal Lovers,1999-08-17,1999,0,0,0,2.569774
33831,The Onion Field,1979-09-09,1979,0,0,0,9.637341
33838,The Care Bears Adventure in Wonderland,1987-08-07,1987,0,2608000,2608000,0.803093
33839,Cheaper by the Dozen,1950-03-31,1950,0,0,0,2.084567
33842,25 Carat,2008-10-29,2008,0,0,0,0.580317
33843,The Burglar,1957-06-01,1957,0,0,0,0.252556
33851,A Prayer for the Dying,1987-09-11,1987,6000000,1432687,-4567313,2.527521
33857,Bye-Bye Bin Laden,2009-01-01,2009,0,0,0,0.004706
33870,Mao's Last Dancer,2009-10-01,2009,25000000,20719451,-4280549,1.862215
33871,"Merry Christmas, Drake and Josh",2008-12-05,2008,0,0,0,1.063469
33875,Pok√©mon Heroes: Latios and Latias,2002-07-13,2002,0,20867919,20867919,4.01309
33908,Three‚Ä¶ Extremes,2004-09-02,2004,0,0,0,4.128086
33909,Wall Street: Money Never Sleeps,2010-09-02,2010,70000000,134748021,64748021,9.819864
33913,Tomorrow at Dawn,2009-08-12,2009,0,0,0,0.398101
33914,Frankenweenie,1984-12-14,1984,1000000,0,-1000000,5.280241
33916,Czech Dream,2004-03-30,2004,0,17393,17393,0.919556
33923,Chicago Deadline,1949-10-17,1949,0,0,0,0.965746
33924,City That Never Sleeps,1953-06-12,1953,0,0,0,1.089195
33927,Deadfall,1993-10-08,1993,10000000,18,-9999982,1.145806
33931,The Sea Wolf,1941-03-21,1941,0,0,0,0.682129
33932,Shortcut to Happiness,2003-02-19,2003,0,0,0,3.201148
33954,Hawks and Sparrows,1966-01-05,1966,0,0,0,2.833298
33974,Mammoth,2009-01-19,2009,10000000,0,-10000000,3.586906
33984,First Love,2006-06-10,2006,0,0,0,0.738746
33988,The Pit and the Pendulum,2009-04-24,2009,0,0,0,1.000992
33990,Little Witches,1996-12-23,1996,0,0,0,1.531474
33994,ivans xtc.,2000-09-12,2000,0,0,0,1.916908
33996,Farewell,2009-09-04,2009,0,0,0,3.20997
33997,Desert Flower,2009-09-24,2009,0,14631377,14631377,4.290624
33998,A Monkey in Winter,1962-05-11,1962,0,0,0,1.74424
34000,The Million Pound Note,1954-01-07,1954,0,0,0,1.617205
34003,Turtles Forever,2009-11-21,2009,0,0,0,4.718655
34004,Children of the Living Dead,2001-06-11,2001,500,0,-500,0.517797
34006,A Slight Case of Murder,1938-03-05,1938,0,0,0,1.421327
34012,The Appaloosa,1966-09-14,1966,0,0,0,1.883122
34013,Mademoiselle Chambon,2009-10-14,2009,0,0,0,1.289526
34014,Moon Over Parador,1988-09-09,1988,20000000,0,-20000000,2.044436
34015,We Live in Public,2009-08-28,2009,0,0,0,0.89579
34016,She's Out of My League,2010-03-11,2010,20000000,49779728,29779728,8.101247
34019,The Hidden Blade,2004-10-30,2004,0,0,0,1.033814
34023,Bloodsucking Freaks,1976-11-02,1976,0,0,0,1.622125
34024,King of the Hill,1993-08-20,1993,0,0,0,4.375347
34025,Kisses,2008-07-11,2008,0,0,0,1.162099
34036,Imagining Argentina,2003-09-13,2003,0,0,0,1.293476
34038,Magical Mystery Tour,1967-12-25,1967,0,0,0,2.70213
34043,On the Line,2001-10-26,2001,0,0,0,4.118177
34044,Waco: The Rules of Engagement,1997-09-19,1997,0,0,0,0.455574
34045,One Day in September,1999-10-22,1999,0,0,0,1.039367
34052,Jack and the Beanstalk,1974-07-20,1974,0,0,0,1.906173
34053,Everybody's All-American,1988-11-04,1988,0,0,0,4.405975
34057,In Memory of My Father,2005-06-03,2005,0,0,0,0.00972
34061,"Above the Street, Below the Water",2009-10-23,2009,0,0,0,2.194163
34064,Marilena de la P7,2006-02-15,2006,0,0,0,0.579393
34065,Pok√©mon: Destiny Deoxys,2004-07-22,2004,0,0,0,6.421866
34067,Pok√©mon: Lucario and the Mystery of Mew,2005-07-16,2005,0,0,0,3.59535
34068,Assassin(s),1997-04-30,1997,0,0,0,2.499591
34069,Cargo,2009-09-24,2009,0,0,0,7.937996
34070,Songs from the Second Floor,2000-10-06,2000,0,0,0,2.42118
34075,Beyond Witch Mountain,1982-02-20,1982,0,0,0,0.311312
34077,The Giant Gila Monster,1959-06-25,1959,0,0,0,1.847223
34078,The Screaming Skull,1958-01-01,1958,0,0,0,1.05475
34079,Bond Girls Are Forever,2002-11-06,2002,0,0,0,0.8254
34081,Ted Bundy,2002-11-22,2002,0,0,0,3.718957
34082,Road to Bali,1952-01-01,1952,0,0,0,2.713688
34084,I Bury the Living,1958-07-01,1958,0,0,0,0.520916
34086,Spaced Invaders,1990-04-27,1990,3000000,15369573,12369573,2.428279
34090,Siberia,1998-08-27,1998,0,0,0,0.399587
34092,Lover of Loser,2009-09-23,2009,0,0,0,0.674356
34093,Rendez-vous,1985-05-15,1985,0,0,0,2.690581
34098,Ticks,1993-10-12,1993,2000000,0,-2000000,2.76411
34100,Zen Noir,2004-04-21,2004,0,0,0,0.007565
34101,Hollywood Shuffle,1987-03-20,1987,0,0,0,6.502861
34106,You Can't Take It With You,1938-08-23,1938,1644736,7433101,5788365,4.370592
34113,Urgh! A Music War,1981-01-01,1981,0,0,0,0.102459
34125,Vampire Journals,1997-02-25,1997,0,0,0,1.592755
34127,Wonder Man,1945-01-01,1945,0,0,0,2.395994
34128,Peter and Vandy,2009-01-01,2009,500000,11276,-488724,0.892007
34130,Goin' South,1978-10-06,1978,0,0,0,9.07909
34131,Gamera vs. Viras,1968-03-20,1968,0,0,0,0.903575
34134,Barbie in A Mermaid Tale,2010-01-26,2010,0,16441438,16441438,6.833148
34138,Night Of The Twisters,1996-01-01,1996,0,0,0,1.323659
34144,"Dear Guest, When Will You Leave?",2010-02-26,2010,3750000,5000000,1250000,0.597058
34145,The Big Risk,1960-03-23,1960,0,0,0,2.247349
34148,Imitation of Life,1959-01-01,1959,0,0,0,4.480053
34151,Blame It on the Bellboy,1992-03-06,1992,0,0,0,7.777791
34152,Crooklyn,1994-05-13,1994,0,0,0,2.533022
34158,The People Speak,2009-12-13,2009,0,0,0,1.256236
34163,George Carlin: Playin' with Your Head,1986-05-02,1986,0,0,0,1.093867
34167,Looking for Kitty,2004-05-06,2004,0,0,0,0.493451
34170,Larger Than Life,1996-10-31,1996,30000000,0,-30000000,3.521921
34179,14 Blades,2010-02-04,2010,20000000,0,-20000000,3.511346
34181,Gertrud,1964-12-19,1964,0,0,0,2.13253
34182,Confucius,2010-02-11,2010,22000000,0,-22000000,3.927871
34184,The Burglars,1971-10-31,1971,0,0,0,1.409302
34186,The Ax,2005-03-02,2005,0,0,0,4.171214
34187,The Bitter Tea of General Yen,1933-01-06,1933,0,0,0,2.170292
34188,The Jerk Theory,2009-02-05,2009,0,0,0,2.080815
34192,The Code Conspiracy,2002-04-10,2002,0,0,0,0.3507
34193,Magic,1978-11-08,1978,0,0,0,3.944012
34194,Tenchi the Movie 2: The Daughter of Darkness,1997-08-02,1997,0,0,0,0.410598
34195,The Dead Outside,2008-01-01,2008,0,0,0,1.302258
34196,God Is Brazilian,2003-01-31,2003,0,0,0,2.034715
34202,Intruders,1992-05-17,1992,0,0,0,0.799816
34203,Justin Time,2010-01-01,2010,0,0,0,0.206471
34204,Return to Halloweentown,2006-10-20,2006,0,0,0,3.444536
34205,Halloweentown II: Kalabar's Revenge,2001-10-12,2001,0,0,0,7.767959
34207,Duck Season,2004-10-22,2004,0,0,0,1.563754
34208,Katalin Varga,2009-07-10,2009,0,0,0,0.775806
34210,Twelve in a Box,2007-02-01,2007,0,0,0,0.105316
34214,Crude,2009-09-09,2009,0,0,0,0.446609
34216,The Drummer,2007-08-09,2007,0,0,0,0.16932
34219,Chevolution,2008-04-01,2008,0,0,0,0.266668
34223,Vamp,1986-07-18,1986,1900000,4790926,2890926,4.119963
34231,The Graves,2010-01-29,2010,0,0,0,3.321312
34233,Adventures of Don Juan,1948-12-01,1948,0,0,0,2.050167
34269,Across the Wide Missouri,1951-10-01,1951,0,0,0,2.298765
34276,First Men in the Moon,1964-07-01,1964,0,0,0,3.593732
34280,L'aventure c'est l'aventure,1972-05-04,1972,0,0,0,2.077329
34282,Whistle Down the Wind,1961-07-25,1961,0,0,0,1.735533
34283,The Pervert's Guide to Cinema,2006-10-06,2006,0,0,0,1.873131
34288,The Last Broadcast,1998-10-23,1998,0,0,0,1.399495
34299,Beautiful,2000-09-10,2000,0,0,0,2.788606
34300,Ernest Rides Again,1993-01-01,1993,0,0,0,0.386295
34303,Hitman Hart: Wrestling with Shadows,1998-12-20,1998,0,0,0,1.226662
34308,Modigliani,2004-05-18,2004,12000000,0,-12000000,7.275868
34309,Most Wanted,1997-10-10,1997,25000000,11838218,-13161782,10.323838
34311,Sleepaway Camp II: Unhappy Campers,1988-10-31,1988,0,0,0,4.066053
34312,Sleepaway Camp III: Teenage Wasteland,1989-02-05,1989,0,0,0,2.18729
34314,Turbulence,1997-01-09,1997,55000000,11466088,-43533912,5.304043
34322,Murphy's Romance,1985-12-25,1985,13000000,30867525,17867525,1.46034
34325,Dead Kennedys: The Early Years,1987-01-01,1987,0,0,0,0.0
34326,"The Yakuza Papers, Vol. 1: Battles Without Honor and Humanity",1973-01-13,1973,0,0,0,2.11911
34327,The Woman in Green,1945-07-27,1945,0,0,0,1.483385
34328,Monster in a Box,1992-05-15,1992,0,311245,311245,0.009961
34334,That Night,1992-12-17,1992,0,0,0,1.645769
34335,Nine Dead,2010-01-01,2010,2000000,0,-2000000,9.711183
34341,Men with Brooms,2002-09-20,2002,7500000,4245870,-3254130,1.418177
34372,"The Execution of Mary, Queen of Scots",1895-08-28,1895,0,0,0,0.938418
34374,Murder by Decree,1979-02-01,1979,0,0,0,7.92465
34376,Mannequin Two: On the Move,1991-01-07,1991,13000000,3752426,-9247574,2.62835
34377,The Boys in the Band,1970-03-16,1970,0,0,0,2.502984
34379,No Man's Land,1987-10-23,1987,0,0,0,2.406724
34380,Instrument: Ten Years with the Band Fugazi,1999-03-22,1999,0,0,0,0.489398
34381,On Broadway,2007-04-25,2007,0,0,0,0.249291
34388,Funeral in Berlin,1966-12-22,1966,0,0,0,13.869663
34389,Iraq in Fragments,2006-01-21,2006,0,202000,202000,0.541397
34417,Good Intentions,2010-03-09,2010,0,0,0,0.806576
34420,Wrong Rosary,2009-10-09,2009,0,0,0,0.479697
34421,The Perfect Weapon,1991-03-15,1991,10000000,14061361,4061361,1.634827
34423,The Slammin' Salmon,2009-01-01,2009,0,0,0,3.761656
34424,Party Monster: The Shockumentary,1998-06-11,1998,0,0,0,0.626864
34433,Dragon Ball Z: Broly - The Legendary Super Saiyan,1993-03-06,1993,0,0,0,7.348249
34444,Even Cowgirls Get the Blues,1994-05-13,1994,8000000,0,-8000000,2.970724
34449,The Battle of Neretva,1969-10-07,1969,12000000,0,-12000000,1.78856
34453,Grateful Dawg,2000-10-14,2000,0,0,0,0.052403
34456,I'm No Angel,1933-10-06,1933,225000,2850000,2625000,1.533379
34459,"Sheba, Baby",1975-03-26,1975,0,0,0,0.299956
34461,Alice's Adventures in Wonderland,1972-01-01,1972,2500000,0,-2500000,4.042391
34462,Women in Cages,1971-10-19,1971,0,0,0,2.446506
34463,Three Little Pigs,1933-05-27,1933,15719,0,-15719,3.969019
34469,Julius Caesar,2002-12-27,2002,0,0,0,2.580637
34474,Blonde Venus,1932-09-09,1932,0,0,0,1.007167
34479,Scars of Dracula,1970-11-08,1970,478375,0,-478375,3.764162
34480,The Descent: Part 2,2009-10-14,2009,0,0,0,5.306121
34482,The Clique,2008-11-11,2008,0,0,0,1.841563
34494,Sorry if I Love You,2008-01-25,2008,0,0,0,6.16374
34496,Storage,2009-09-10,2009,0,0,0,0.346332
34505,Bill Hicks: Relentless,1992-01-01,1992,0,0,0,0.853196
34506,George Carlin: Carlin at Carnegie,1982-10-10,1982,0,0,0,0.933868
34507,Doug Stanhope: Deadbeat Hero,2004-08-24,2004,0,0,0,0.408733
34509,George Carlin: Back in Town,1996-03-11,1996,0,0,0,1.381696
34512,George Carlin: What Am I Doing in New Jersey?,1988-06-09,1988,0,0,0,0.001021
34513,George Carlin: You Are All Diseased,1999-02-06,1999,0,0,0,0.897667
34515,Katt Williams: The Pimp Chronicles Pt. 1,2006-09-16,2006,0,0,0,0.951326
34516,Lisa Lampanelli: Long Live The Queen,2009-01-01,2009,0,0,0,0.495726
34518,Ninja Bachelor Party,1991-01-01,1991,0,0,0,0.297758
34521,Paul Mooney: Analyzing White America,2002-01-01,2002,0,0,0,0.079491
34527,Murder at the Savoy,1993-10-06,1993,0,0,0,0.510797
34528,The Human Condition II: Road to Eternity,1959-11-20,1959,0,0,0,1.914775
34530,The Human Condition III: A Soldier's Prayer,1961-01-28,1961,0,0,0,2.327284
34544,The A-Team,2010-06-10,2010,110000000,177238796,67238796,16.747793
34549,Max Keeble's Big Move,2001-10-05,2001,12000000,17292381,5292381,2.828884
34557,Turn the Beat Around,2010-02-26,2010,0,0,0,0.384834
34560,Halloweentown High,2004-10-08,2004,0,0,0,4.019593
34561,Purple Butterfly,2003-05-22,2003,0,0,0,0.191922
34563,Our Family Wedding,2010-03-12,2010,14000000,21409028,7409028,8.204894
34564,Shrimp on the Barbie,1990-08-31,1990,0,458996,458996,0.879697
34573,Alice in Wonderland,1985-12-09,1985,14000000,0,-14000000,3.794133
34574,Nadja,1994-09-13,1994,0,0,0,7.720056
34576,The Most Dangerous Man in America: Daniel Ellsberg and the Pentagon Papers,2009-10-16,2009,0,0,0,1.804135
34577,Daishizen no Maj≈´: Bagi,1984-08-19,1984,0,0,0,0.145241
34581,Twist of Faith,2005-07-04,2005,0,0,0,0.141932
34582,Junk Mail,1997-02-21,1997,0,0,0,0.336763
34583,The Final,2010-01-28,2010,0,0,0,4.010976
34584,The NeverEnding Story,1984-04-05,1984,27000000,20158808,-6841192,14.225919
34586,Kandahar,2010-02-04,2010,7000000,15172408,8172408,1.011029
34588,If I Were You,2006-01-06,2006,0,0,0,2.926799
34592,ZMD: Zombies of Mass Destruction,2009-01-01,2009,0,0,0,1.425986
34595,Alexandra's Project,2003-05-16,2003,0,0,0,1.689471
34598,Fast Getaway,1991-03-14,1991,0,0,0,0.953081
34599,Heart Like A Wheel,1983-04-01,1983,0,0,0,0.857342
34600,Ernest Goes to Africa,1997-01-01,1997,0,0,0,0.506874
34601,Three Way,2004-06-29,2004,0,0,0,2.769025
34604,Casual Sex?,1988-04-22,1988,0,12277096,12277096,1.319188
34614,A Hole in My Heart,2004-01-01,2004,0,0,0,8.05287
34615,"Cry, the Beloved Country",1995-12-15,1995,0,676525,676525,0.894647
34623,Young Man with a Horn,1950-02-09,1950,0,0,0,0.872948
34626,Merantau,2009-08-06,2009,0,0,0,3.20408
34630,Hippie Masala - Forever in India,2006-10-12,2006,0,0,0,0.380906
34631,You're Gonna Miss Me: A Film About Roky Erickson,2007-06-10,2007,0,0,0,0.508032
34636,The Neverending Story II: The Next Chapter,1990-10-24,1990,32000000,16283667,-15716333,6.658994
34637,The Navigator: A Medieval Odyssey,1988-09-16,1988,0,0,0,1.478701
34647,Enter the Void,2009-05-05,2009,13000000,754249,-12245751,8.378149
34650,Deadline at Dawn,1946-04-03,1946,0,0,0,0.71349
34651,Devil's Doorway,1950-09-15,1950,0,0,0,3.952323
34652,Drive a Crooked Road,1954-03-10,1954,0,0,0,0.981332
34653,A Single Man,2009-10-19,2009,7000000,0,-7000000,10.952545
34658,The Odd Couple,1979-08-09,1979,0,0,0,1.058969
34662,Li'l Abner,1959-12-11,1959,0,0,0,0.611118
34666,The Swissmakers,1978-11-03,1978,0,0,0,0.806546
34667,Nightfall,1957-05-13,1957,0,0,0,3.457573
34671,Olga,2004-08-20,2004,0,0,0,1.620858
34672,Chestnut: Hero of Central Park,2004-10-21,2004,0,0,0,7.816233
34681,Melvin Goes to Dinner,2003-12-04,2003,0,0,0,1.097895
34683,House of Angels,1992-02-21,1992,0,0,0,1.43749
34689,The Barefoot Contessa,1954-01-01,1954,0,0,0,6.730728
34696,Fuel,2009-01-01,2009,0,0,0,0.007032
34697,Butterfly,1982-02-05,1982,0,0,0,1.514551
34703,Agallas,2009-09-04,2009,0,0,0,0.083073
34714,Diamond Men,2000-01-01,2000,0,0,0,0.644655
34723,The Adventures of Huck Finn,1993-04-02,1993,6500000,0,-6500000,4.048513
34729,Our Lips Are Sealed,2000-05-18,2000,0,0,0,3.254827
34732,They Call Me Mister Tibbs!,1970-07-10,1970,0,0,0,5.424482
34734,Stir of Echoes: The Homecoming,2007-08-11,2007,0,0,0,0.630496
34745,Catch Me If You Can,1989-10-14,1989,0,0,0,1.404418
34746,Death Wish 5: The Face of Death,1994-01-14,1994,5000000,1702394,-3297606,3.595599
34748,Give My Regards to Broad Street,1984-11-28,1984,0,0,0,1.134476
34752,The Glass Wall,1953-03-19,1953,0,0,0,0.3981
34759,Ziggy  Stardust and the Spiders from Mars,1973-12-23,1973,0,0,0,1.167518
34760,"'night, Mother",1986-09-12,1986,0,442000,442000,0.798428
34763,Aarya 2,2009-11-27,2009,0,0,0,0.476043
34764,Karthik Calling Karthik,2010-02-06,2010,0,293500,293500,1.847916
34765,Zenon: Z3,2004-06-11,2004,0,0,0,2.004174
34766,Zenon: Girl of the 21st Century,1999-01-23,1999,0,0,0,7.274451
34767,The White Stripes: Under Great White Northern Lights,2009-01-01,2009,0,0,0,0.383393
34768,The Honeymoon Machine,1961-08-16,1961,0,0,0,0.857511
34769,Defendor,2009-09-12,2009,3500000,44462,-3455538,5.600277
34772,Sin: The Movie,2000-10-24,2000,0,0,0,0.247132
34774,In Search of the Castaways,1962-12-01,1962,0,0,0,2.679615
34777,King of Triads,2010-01-21,2010,0,0,0,2.753066
34778,Christmas in July,1940-10-18,1940,0,0,0,1.282498
34783,I'm All Right Jack,1959-08-18,1959,0,0,0,1.636426
34784,Grim Reaper,2007-01-16,2007,0,0,0,0.275394
34787,Drawing Restraint 9,2005-07-01,2005,0,0,0,1.994926
34789,Irish Jam,2006-01-01,2006,0,0,0,1.055619
34792,Petey Wheatstraw,1977-11-01,1977,0,0,0,1.084755
34794,The St  Francisville Experiment,2000-04-15,2000,0,0,0,0.932625
34796,City Girl,1930-02-16,1930,0,0,0,2.933003
34800,The Cub Tiger from Kwang Tung,1973-03-31,1973,0,0,0,7.948485
34803,Death at a Funeral,2010-04-15,2010,21000000,49050886,28050886,10.863441
34806,The Back-Up Plan,2010-04-23,2010,35000000,77477008,42477008,6.629999
34812,H.G. Wells' War of the Worlds,2005-06-28,2005,1000000,0,-1000000,1.314076
34813,The Losers,2010-04-23,2010,25000000,23580000,-1420000,12.798367
34835,It Felt Like a Kiss,2009-01-01,2009,0,0,0,0.52541
34836,Salute,2008-07-17,2008,1949120,0,-1949120,0.194191
34838,The Tango Lesson,1997-11-28,1997,0,0,0,0.192391
34840,The Housekeeper,2002-11-13,2002,0,0,0,0.827852
34843,Hawking,2004-12-10,2004,0,0,0,6.400496
34847,College,1927-09-10,1927,0,0,0,0.959282
34851,Predators,2010-07-03,2010,40000000,126248813,86248813,9.034929
34856,China Strike Force,2000-12-21,2000,0,0,0,1.264429
34857,Kiss Me Kate,1953-11-26,1953,0,0,0,12.325805
34862,Solar Attack,2006-05-25,2006,0,0,0,1.27843
34866,Mafioso,1962-10-24,1962,0,0,0,0.242384
34867,The Manson Family,2003-08-18,2003,0,0,0,0.683586
34869,Cargo 200,2007-06-06,2007,0,121129,121129,1.592152
34870,Medea,1988-01-01,1988,0,0,0,1.485953
34875,The Pace That Kills,1935-01-01,1935,0,0,0,0.148926
34898,Heavens Fall,2006-07-20,2006,4000000,0,-4000000,0.527074
34899,The Vertical Ray of the Sun,2000-05-24,2000,0,0,0,0.864406
34902,Day and Night,2004-08-06,2004,0,0,0,0.802831
34905,Confessions of a Pop Performer,1975-01-01,1975,0,0,0,0.708985
34921,Winter Soldier,1972-01-27,1972,0,0,0,0.51934
34933,Bully for Bugs,1953-08-08,1953,0,0,0,2.238992
34935,Tenchi Muy√¥! In Love,1996-04-20,1996,0,0,0,1.312999
34937,An Englishman in New York,2009-04-27,2009,0,0,0,1.032342
34941,The Last Time I Committed Suicide,1997-06-20,1997,0,0,0,1.380375
34942,Balto III: Wings of Change,2004-04-14,2004,0,0,0,4.818355
34943,The Face Behind the Mask,1941-01-16,1941,0,0,0,0.671336
34944,Background to Danger,1943-07-03,1943,0,0,0,0.622868
34945,The Conspirators,1944-10-24,1944,0,0,0,0.755304
34977,Penthouse,1933-09-08,1933,0,0,0,0.567585
34981,Operation Homecoming: Writing the Wartime Experience,2007-02-09,2007,0,0,0,0.0391
34989,Slovenian Girl,2009-09-30,2009,2600000,0,-2600000,2.177976
34991,Gumshoe,1971-12-01,1971,0,0,0,1.827144
34995,Puerto Vallarta Squeeze,2003-02-26,2003,0,0,0,0.730894
34996,The Addiction,1995-01-10,1995,0,0,0,3.137285
35001,Run of the Arrow,1957-09-05,1957,0,0,0,0.741432
35002,When Dinosaurs Ruled the Earth,1970-10-25,1970,0,0,0,2.600011
35005,Conversations with Mother,2004-04-15,2004,0,0,0,0.173357
35006,The Mask of Dimitrios,1944-07-01,1944,0,0,0,5.619832
35007,It Always Rains on Sunday,1947-11-25,1947,0,0,0,0.581171
35008,Rapt,2009-11-18,2009,0,0,0,1.613113
35009,Storm Warning,1951-02-10,1951,0,0,0,0.859415
35010,A Man Who Was Superman,2008-01-31,2008,0,3848034,3848034,1.95315
35016,Koko Flanel,1990-02-23,1990,0,0,0,0.015894
35017,The Brothers Rico,1957-09-01,1957,0,0,0,7.18577
35019,Nanny McPhee and the Big Bang,2010-03-26,2010,35000000,93246388,58246388,8.983275
35021,The Old Fairy Tale: When the Sun Was God,2003-09-19,2003,0,0,0,0.977722
35022,Sanshiro Sugata,1943-03-25,1943,0,0,0,1.804231
35023,Two of a Kind,1951-07-01,1951,0,0,0,0.214159
35025,Le Mac,2010-02-16,2010,0,0,0,3.685297
35026,Lucky Luke,2009-10-21,2009,27000000,0,-27000000,4.572642
35030,The Young One,1960-09-05,1960,0,0,0,0.675926
35031,The Milky Way,1969-03-15,1969,0,0,0,2.031936
35032,The Pirate,1948-06-11,1948,3700000,2956000,-744000,1.830178
35038,Dragon Fight,1989-09-01,1989,0,0,0,1.226795
35044,Full Body Massage,1995-10-01,1995,0,0,0,1.852584
35052,Cracks,2009-12-04,2009,0,0,0,7.836321
35056,Date Night,2010-04-08,2010,55000000,152263880,97263880,8.443736
35057,Boys' Night Out,1962-06-21,1962,0,0,0,0.905639
35059,High Noon,2009-04-04,2009,0,0,0,3.872766
35064,Dhadkan,2000-08-11,2000,0,0,0,0.64129
35066,Born Romantic,2000-09-14,2000,0,0,0,1.427917
35068,Murphy's War,1971-07-01,1971,0,0,0,1.276311
35069,Loins of Punjab Presents,2008-09-12,2008,0,0,0,0.079372
35072,Atragon,1963-12-22,1963,0,0,0,1.387117
35073,"The Beast from 20,000 Fathoms",1953-06-13,1953,210000,5000000,4790000,3.424057
35074,Dinoshark,2010-01-01,2010,0,0,0,1.681603
35075,Leaves from Satan's Book,1920-01-24,1920,0,0,0,0.385286
35076,The Botany of Desire,2009-10-28,2009,0,0,0,0.83081
35077,Three Strangers,1946-01-28,1946,0,0,0,2.541367
35080,The Cat's Meow,2001-08-03,2001,7000000,3646994,-3353006,13.546984
35101,The Last Flight of Noah's Ark,1980-06-24,1980,0,11000000,11000000,1.012665
35105,Slayers: The Motion Picture,1995-08-05,1995,0,0,0,0.953583
35106,Pray For Death,1985-01-11,1985,0,0,0,1.20342
35109,Alice in Wonderland,1966-12-26,1966,0,0,0,1.716036
35110,Samoura√Øs,2002-06-19,2002,0,0,0,1.944397
35113,I Want You,1998-02-15,1998,0,0,0,6.888131
35114,Destino,2003-08-05,2003,1500000,0,-1500000,1.64689
35115,"Davy Crockett, King of the Wild Frontier",1955-05-25,1955,0,0,0,5.497359
35118,Diamonds,1999-12-10,1999,0,0,0,1.652447
35119,A Cry in the Dark,1988-11-11,1988,15000000,6908797,-8091203,3.970538
35122,Splendor,1999-01-29,1999,0,45703,45703,3.508075
35123,The Verdict,1946-11-23,1946,0,0,0,0.701376
35124,Nazarin,1959-05-11,1959,0,0,0,1.128152
35125,Taxi Zum Klo,1980-11-01,1980,0,0,0,0.970078
35128,Edge of Fury,1958-05-01,1958,0,0,0,0.412671
35129,Edge of the City,1957-08-02,1957,0,0,0,0.584232
35138,Little Big Soldier,2010-02-14,2010,25000000,0,-25000000,4.691882
35139,Teenagers from Outer Space,1959-06-01,1959,0,0,0,1.448853
35144,The Journey of Natty Gann,1985-09-25,1985,0,2135577,2135577,1.29288
35148,Playmobil: The Secret of Pirate Island,2009-10-13,2009,0,0,0,0.014168
35151,Hello Again,1987-11-06,1987,0,20419446,20419446,1.078703
35153,The Heavy,2010-04-08,2010,4500000,0,-4500000,6.120644
35156,The End of the Line,2009-06-12,2009,0,0,0,0.512026
35161,The Hanging Garden,1997-01-01,1997,0,0,0,0.437883
35164,In the Beginning,2009-11-11,2009,0,0,0,2.88063
35165,The Rainbow Thief,1990-09-01,1990,10000000,0,-10000000,1.216923
35166,The Reenactment,1968-01-05,1968,0,0,0,0.165803
35169,Furry Vengeance,2010-04-02,2010,35000000,39340177,4340177,10.794556
35170,Snake and Crane Arts of Shaolin,1978-03-08,1978,0,0,0,1.513866
35172,The Son,2002-05-23,2002,0,0,0,1.916933
35176,Kill Me Later,2001-09-14,2001,0,0,0,0.563767
35177,Dinotopia: Quest for the Ruby Sunstone,2005-05-17,2005,0,0,0,1.51255
35178,A Horse for Danny,1995-04-08,1995,0,0,0,0.444872
35185,The Smallest Show on Earth,1957-04-09,1957,0,0,0,0.73743
35188,The Disorderly Orderly,1964-12-16,1964,0,0,0,3.159212
35189,The Errand Boy,1961-11-28,1961,0,0,0,1.294024
35196,Restoration,1995-12-29,1995,19000000,0,-19000000,10.979269
35197,The Reeds,2009-10-30,2009,0,0,0,1.674675
35199,Wordplay,2006-06-26,2006,0,0,0,0.750184
35200,The Return of a Man Called Horse,1976-06-28,1976,0,0,0,1.247876
35201,The Holcroft Covenant,1985-09-20,1985,0,0,0,3.163464
35203,If These Walls Could Talk,1996-10-13,1996,0,0,0,1.632083
35206,Death in the Garden,1956-09-21,1956,0,0,0,1.116063
35207,Terry Fator: Live from Las Vegas,2009-09-01,2009,0,0,0,0.387385
35215,Smart House,1999-06-26,1999,0,0,0,1.788834
35217,Friendship!,2010-01-13,2010,0,0,0,2.631214
35219,The Missing Person,2009-01-16,2009,0,0,0,1.031066
35221,Father of Invention,2010-02-14,2010,0,0,0,3.688516
35227,Foolish Wives,1922-01-11,1922,1100000,400200,-699800,0.838095
35233,The Scout,1994-09-30,1994,0,0,0,5.715608
35237,Suicide Killers,2006-08-27,2006,0,0,0,0.038824
35241,Charlie Murphy: I Will Not Apologize,2010-01-01,2010,0,0,0,0.360583
35250,The Locals,2003-10-17,2003,0,0,0,0.888951
35253,Madame Tutli-Putli,2007-05-19,2007,0,0,0,1.265747
35257,Christmas Carol: The Movie,2001-12-07,2001,0,0,0,5.549395
35262,George Washington Slept Here,1942-10-30,1942,0,0,0,0.377717
35263,The Farewell,2000-05-14,2000,0,0,0,0.042859
35265,L'imbalsamatore,2002-09-06,2002,0,56878,56878,1.40558
35280,The Other,1972-05-23,1972,0,0,0,1.764306
35284,Anzio,1968-07-24,1968,0,0,0,1.565244
35292,Funny Bones,1995-09-20,1995,0,0,0,3.208265
35297,Daisy Diamond,2007-11-23,2007,0,0,0,0.483574
35304,Miss Sweden,2004-03-09,2004,0,0,0,0.739267
35320,School Of Life,2005-02-19,2005,0,0,0,3.602035
35327,Framed,1988-02-25,1988,0,5839164,5839164,1.385902
35336,Brothers: The Return,2006-03-10,2006,0,0,0,0.087759
35337,The Triumph of Love,2001-12-12,2001,0,0,0,0.816047
35343,Varning f√∂r J√∂nssonligan,1981-12-04,1981,0,0,0,0.083938
35371,Thrashin',1986-08-29,1986,0,0,0,7.723056
35379,IMAX Mummies Secrets Of The Pharohs,2007-05-25,2007,4000000,0,-4000000,1.845584
35381,Crossfire Trail,2001-01-21,2001,0,0,0,4.806092
35384,Down and Derby,2005-04-15,2005,0,0,0,0.470117
35392,Merrill's Marauders,1962-03-16,1962,0,0,0,1.599099
35395,Bunny and the Bull,2009-11-27,2009,0,81010,81010,3.939557
35396,The Island,2009-12-29,2009,0,0,0,0.71826
35401,Fear in the Night,1947-04-18,1947,0,0,0,0.842237
35402,Icarus,2010-02-09,2010,0,0,0,2.342446
35404,The File on Thelma Jordon,1950-01-18,1950,0,0,0,0.622745
35405,S*P*Y*S,1974-09-05,1974,0,0,0,0.774252
35411,The Dancer and the Thief,2009-11-27,2009,0,0,0,0.491141
35412,On the Beach,1959-12-16,1959,0,0,0,4.00437
35418,Nightmare,1956-08-20,1956,0,0,0,0.391958
35428,What Men Talk About,2010-03-04,2010,1950000,12005838,10055838,3.022666
35429,The Hive,2008-02-17,2008,0,0,0,0.81938
35435,Eden of the East Movie I: The King of Eden,2009-11-28,2009,0,0,0,1.346965
35436,The Villain,2009-11-25,2009,0,0,0,1.868374
35451,Love on Sunday,2006-07-22,2006,0,0,0,0.1279
35453,The Last Chase,1981-04-01,1981,0,0,0,0.505303
35458,Crazy on the Outside,2010-01-08,2010,0,88335,88335,3.170053
35463,Fatal Beauty,1987-10-30,1987,0,0,0,1.473833
35464,The Goodbye Kiss,2006-02-24,2006,0,0,0,1.327665
35543,The Great Flamarion,1945-01-14,1945,0,0,0,0.886128
35545,Mata Hari,1931-12-26,1931,558000,2227000,1669000,1.41344
35552,The Extraordinary Adventures of Ad√®le Blanc-Sec,2010-04-09,2010,25000000,34100000,9100000,6.710598
35554,Cado dalle nubi,2009-11-27,2009,0,0,0,6.40477
35555,Unknown White Male,2005-06-01,2005,0,0,0,0.743772
35558,StarStruck,2010-02-14,2010,0,0,0,5.458241
35561,Arizona,1940-12-25,1940,0,0,0,0.911053
35564,The Midnight Hour,1985-11-01,1985,0,0,0,1.14151
35568,2081,2009-05-29,2009,0,0,0,5.269893
35569,Carman: The Champion,2001-03-02,2001,0,0,0,0.42934
35572,Harishchandrachi Factory,2009-07-01,2009,0,0,0,0.261998
35580,The Bridges at Toko-Ri,1954-12-01,1954,0,0,0,1.853113
35583,The Lost Battalion,2001-12-02,2001,0,0,0,2.953812
35588,Geronimo: An American Legend,1993-12-10,1993,35000000,18635620,-16364380,4.653462
35610,Philadelphia Experiment II,1993-11-12,1993,5000000,2970,-4997030,1.155075
35611,Assignment: Outer Space,1960-08-25,1960,0,0,0,0.177727
35612,New Waterford Girl,1999-01-01,1999,0,0,0,0.638452
35614,A Troll in Central Park,1994-10-07,1994,23000000,71368,-22928632,3.612089
35619,Storm,2009-02-07,2009,0,0,0,0.983842
35623,For My Father,2008-06-13,2008,0,0,0,0.375176
35626,Return to Sleepaway Camp,2008-11-04,2008,4000000,0,-4000000,1.829692
35632,Laser Mission,1989-11-01,1989,0,0,0,1.980727
35634,The Grumpy,1986-12-20,1986,0,0,0,1.693389
35637,Captain Abu Raed,2007-12-11,2007,0,0,0,0.180001
35638,"Sick: The Life and Death of Bob Flanagan, Supermasochist",1997-01-01,1997,0,116806,116806,0.491945
35639,K3 en het IJsprinsesje,2006-07-19,2006,0,0,0,0.043827
35645,Gold Diggers: The Secret of Bear Mountain,1995-11-03,1995,0,0,0,5.508101
35646,Kocken,2005-02-25,2005,0,0,0,0.747848
35650,Maelstr√∂m,2000-09-08,2000,0,0,0,1.343844
35651,Time Out,2001-09-10,2001,0,0,0,1.770055
35652,That's It,2008-10-05,2008,4000,0,-4000,0.450727
35656,As Good As Dead,2010-01-25,2010,0,0,0,1.984924
35659,Countdown to Looking Glass,1984-10-14,1984,0,0,0,0.04179
35663,The Incredible Petrified World,1957-01-01,1957,0,0,0,0.329719
35668,They Came from Beyond Space,1967-05-01,1967,0,0,0,1.27689
35669,The Satanic Rites of Dracula,1973-11-03,1973,0,544476,544476,2.067929
35671,Kaleidoscope,1966-09-22,1966,0,0,0,0.653037
35680,Madeline,1998-07-10,1998,0,0,0,2.847458
35683,Single White Female 2: The Psycho,2005-10-25,2005,2000000,0,-2000000,1.126803
35685,Lady Chatterley's Lover,1981-06-29,1981,0,0,0,8.637148
35687,"LSD: Love, Sex aur Dhokha",2010-03-19,2010,0,0,0,0.367068
35688,Why Did I Get Married Too?,2010-04-02,2010,20000000,60072596,40072596,2.576815
35689,Don McKay,2009-04-24,2009,0,0,0,2.212466
35690,The Last Song,2010-03-31,2010,0,0,0,5.541073
35691,Letters to God,2010-04-09,2010,0,0,0,4.008071
35692,The Black Knight,1954-08-26,1954,0,0,0,0.720182
35694,Chelsea Walls,2002-04-19,2002,0,0,0,1.246464
35696,Juwanna Mann,2002-06-21,2002,15600000,0,-15600000,3.970857
35698,The Star of Bethlehem,2007-10-23,2007,0,0,0,0.007207
35701,Gumball 3000: The Movie,2003-01-01,2003,0,0,0,0.098902
35703,Holiday in the Sun,2001-11-10,2001,0,0,0,2.906816
35712,Secret Things,2002-10-16,2002,0,105090,105090,3.768411
35716,Preacher's Kid,2010-01-29,2010,7000000,0,-7000000,0.739298
35717,Pola X,1999-05-12,1999,0,0,0,1.698111
35718,Nude For Satan,1974-10-30,1974,0,0,0,1.824931
35724,The Genius Club,2006-01-01,2006,0,0,0,0.157721
35730,Amateur Porn Star Killer 3: The Final Chapter,2009-01-13,2009,0,0,0,2.750049
35731,Amateur Porn Star Killer 2,2008-05-13,2008,0,0,0,0.587751
35733,Amateur Porn Star Killer,2006-06-30,2006,45,0,-45,0.648648
35735,Badding,2000-08-18,2000,0,0,0,0.142328
35749,Alice In Acidland,1968-01-01,1968,0,0,0,0.479417
35752,Nana 2,2006-12-09,2006,0,0,0,1.501197
35759,My Super Psycho Sweet 16,2009-10-23,2009,1,0,-1,1.096116
35760,White Palms,2006-01-15,2006,0,0,0,0.550164
35780,Thunderbirds are GO,1966-12-15,1966,0,0,0,0.948355
35790,Charulata,1964-04-17,1964,0,0,0,0.823651
35791,Resident Evil: Afterlife,2010-09-09,2010,60000000,300228084,240228084,0.452934
35793,Penny Points to Paradise,1951-01-01,1951,0,0,0,0.110769
35796,Lawn Dogs,1997-11-21,1997,7000000,0,-7000000,4.255263
35797,Coup de Torchon,1981-11-04,1981,0,0,0,2.272213
35801,Dr. Jekyll and Mr. Hyde,2008-05-17,2008,0,0,0,0.911584
35802,Suzanne's Diary for Nicholas,2005-03-27,2005,0,0,0,1.098311
35806,Freud: The Secret Passion,1962-12-12,1962,0,0,0,1.114302
35810,The Amazing Quest of Ernest Bliss,1936-07-28,1936,0,0,0,0.505588
35813,The Bat,1959-08-09,1959,0,0,0,8.819138
35818,Les parasites,1999-01-20,1999,0,0,0,0.367584
35824,The Navigators,2001-11-16,2001,0,0,0,3.514414
35826,Wicked Stepmother,1989-02-03,1989,0,0,0,0.000578
35831,"Belphegor, Phantom of the Louvre",2001-04-04,2001,0,0,0,2.873012
35837,Boogie,2009-10-22,2009,0,0,0,1.004781
35838,Tristana,1970-03-29,1970,0,0,0,7.530264
35840,The Hell of '63,2009-12-17,2009,0,0,0,1.233845
35841,The Lonely Passion of Judith Hearne,1987-12-23,1987,0,0,0,0.872709
35847,The Kids,1957-11-14,1957,0,0,0,0.941141
35848,Hukkle,2002-10-24,2002,0,0,0,0.656484
35849,Hangover Square,1945-10-29,1945,0,0,0,0.545943
35851,Runaway,2005-04-26,2005,2000000,0,-2000000,0.80693
35852,Obsession,1949-08-03,1949,0,0,0,0.686758
35854,Flash Point,2007-07-26,2007,8000000,0,-8000000,7.039209
35856,A Matter of Size,2009-04-27,2009,0,0,0,0.746956
35861,The Crucified Lovers,1954-11-23,1954,0,0,0,1.244892
35862,Wedding Trough,1975-01-01,1975,0,0,0,0.52976
35867,Days and Nights in the Forest,1970-01-16,1970,0,0,0,1.67554
35868,Green Dragon,2001-01-01,2001,0,0,0,0.755576
35888,Cat Chaser,1989-01-01,1989,0,0,0,0.547716
35891,Mansquito,2005-03-05,2005,5000000,0,-5000000,1.801287
35895,A Cry in the Night,1956-08-17,1956,0,0,0,1.017665
35896,Beyond the Forest,1949-10-21,1949,0,0,0,0.913724
35907,Kaante,2002-12-20,2002,0,0,0,0.738115
35908,Evil Angel,2009-02-05,2009,0,0,0,0.846074
35911,Cult of the Cobra,1955-05-30,1955,0,0,0,0.843099
35917,Crime in the Streets,1956-06-10,1956,0,0,0,0.632498
35919,Creature with the Atom Brain,1955-07-01,1955,0,0,0,3.210566
35921,Compulsion,1959-04-01,1959,0,0,0,1.240376
35922,The Rolling Stones: Cocksucker Blues,1972-01-01,1972,0,0,0,0.725557
35926,Baby Face Nelson,1957-12-11,1957,0,0,0,0.491917
35927,Babar The Movie,1989-07-28,1989,0,0,0,0.94982
35935,Derrida,2002-03-12,2002,0,0,0,0.073617
35936,Sarafina!,1992-09-18,1992,0,0,0,1.166646
35939,Glorious 39,2009-11-20,2009,6000000,0,-6000000,3.353004
35944,Lucky Break,2001-08-24,2001,0,0,0,0.689177
35945,Howling V: The Rebirth,1989-01-01,1989,0,0,0,0.187499
35946,The Hollow,2004-08-25,2004,900000,0,-900000,0.685905
35951,Dark Asylum,2001-11-08,2001,0,0,0,0.005225
35953,Land of Death,2004-05-20,2004,0,0,0,0.158494
35954,Cornered,1945-12-25,1945,0,0,0,1.022576
35955,Desperate,1947-05-09,1947,0,0,0,0.826279
35956,The Phenix City Story,1955-08-14,1955,0,0,0,0.799574
35957,Dial 1119,1950-11-03,1950,0,0,0,0.440097
35958,New York Confidential,1955-02-15,1955,0,0,0,0.785647
35964,Vavien,2009-11-18,2009,0,0,0,0.647691
35967,Baptism of Blood,2006-01-01,2006,0,0,0,0.125059
35976,The End,1978-05-10,1978,0,45000000,45000000,4.510919
35977,Pumpkinhead II: Blood Wings,1994-03-16,1994,0,0,0,2.138141
35986,No Orchids for Miss Blandish,1948-04-13,1948,0,0,0,0.153413
35987,Lola Mont√®s,1955-12-23,1955,0,0,0,1.971887
35992,"Munster, Go Home!",1966-06-15,1966,0,0,0,1.54763
35995,Herbie Hancock: Possibilities,2006-04-18,2006,0,0,0,0.360934
36003,"Danger! 50,000 Zombies",2004-01-01,2004,0,0,0,0.20207
36006,Ruggles of Red Gap,1935-03-08,1935,0,0,0,1.181128
36040,Walkabout,1971-07-01,1971,0,0,0,10.177086
36041,The Big Gay Musical,2009-07-20,2009,0,0,0,0.770296
36046,The Work and the Glory,2004-11-24,2004,7500000,3347647,-4152353,0.52757
36047,The In Crowd,2000-07-19,2000,15000000,5217498,-9782502,1.991904
36048,Judy Berlin,1999-01-01,1999,0,0,0,0.316842
36049,Rich and Strange,1931-12-10,1931,0,0,0,1.581063
36054,Champagne,1928-08-19,1928,0,0,0,0.560815
36055,Easy Virtue,1928-03-05,1928,0,0,0,0.957802
36056,The Ring,1927-10-01,1927,0,0,0,1.986461
36063,MW,2009-07-03,2009,0,0,0,0.742827
36067,13 Lakes,2004-10-20,2004,0,0,0,0.190302
36068,Marquis,1989-04-26,1989,0,0,0,0.914873
36072,Mount Head,2002-01-01,2002,0,0,0,0.339732
36073,Guinea Pig 2: Flower of Flesh and Blood,1985-10-07,1985,0,0,0,1.714745
36075,Splatter: Naked Blood,1996-02-20,1996,0,0,0,1.209099
36079,Tale of Tales,1979-01-01,1979,0,0,0,2.414009
36089,The Giant Claw,1957-06-01,1957,0,0,0,0.975971
36090,Emperor Tomato Ketchup,1971-01-01,1971,0,0,0,0.547011
36091,Crying Out Love in the Center of the World,2004-05-08,2004,0,0,0,1.298809
36092,Be With You,2004-01-01,2004,0,0,0,2.361066
36093,Behind the Sun,2001-12-12,2001,0,0,0,1.836865
36094,Stanley & Iris,1990-02-09,1990,23000000,5820015,-17179985,1.914881
36095,Cure,1997-11-06,1997,20000,99000,79000,3.111281
36096,Lucifer Rising,1974-04-10,1974,0,0,0,1.303516
36102,The Swindle,1955-09-09,1955,0,0,0,1.348045
36105,Set Me Free,1999-02-12,1999,0,0,0,0.440391
36106,True Heart Susie,1919-06-01,1919,0,0,0,1.00589
36107,More,1998-01-01,1998,0,0,0,1.85929
36108,To Each His Own Cinema,2007-05-19,2007,0,0,0,10.604359
36109,The Grind,2009-09-22,2009,1200000,0,-1200000,0.085637
36113,Getting Home,2007-01-01,2007,0,0,0,0.641419
36115,Unmade Beds,2009-09-02,2009,0,0,0,4.746696
36117,Rocker,1972-02-02,1972,0,0,0,0.126661
36119,Shyness Machine Girl,2009-01-01,2009,0,0,0,1.547952
36120,Ruhr,2009-11-02,2009,0,0,0,0.603494
36123,Under the Sea 3D,2009-02-13,2009,0,0,0,2.286995
36124,Until the Light Takes Us,2008-01-01,2008,0,0,0,1.580266
36129,Hedgehog in the Fog,1975-10-23,1975,0,0,0,2.643565
36130,102 Minutes That Changed America,2008-01-01,2008,0,0,0,1.302925
36132,Samson & Sally,1984-01-01,1984,0,0,0,1.541025
36133,Buddy Buddy,1981-01-01,1981,0,0,0,1.566468
36136,Another Day in Paradise,1998-12-30,1998,0,0,0,2.58581
36137,Nordsee ist Mordsee,1976-04-02,1976,0,0,0,0.16225
36138,State Affairs,2009-11-25,2009,0,0,0,1.16594
36139,High Plains Invaders,2009-08-30,2009,2000000,0,-2000000,1.225217
36140,Far from Vietnam,1967-01-01,1967,0,0,0,0.536192
36141,The Underneath,1995-04-28,1995,6500000,0,-6500000,2.059771
36142,The Dark House,2009-11-27,2009,1300000,0,-1300000,0.981868
36143,Flanders,2006-08-30,2006,0,0,0,0.446475
36153,Bigfoot,2008-01-01,2008,0,0,0,0.582484
36161,Winnie-the-Pooh,1969-01-01,1969,0,0,0,2.168142
36162,Winnie-the-Pooh and a Busy Day,1972-01-01,1972,0,0,0,0.755415
36163,Winnie-the-Pooh Goes Visiting,1971-01-01,1971,0,0,0,2.082421
36164,Crazy Waiting,2008-01-01,2008,0,0,0,0.613041
36165,Crimes of the Past,2009-01-01,2009,0,0,0,0.460918
36172,Negative Happy Chain Saw Edge,2008-01-19,2008,0,0,0,0.492981
36175,Turtles Are Surprisingly Fast Swimmers,2005-07-02,2005,0,0,0,0.92083
36179,The One Man Band,1970-09-18,1970,0,0,0,2.674446
36185,Closed Note,2007-09-09,2007,0,0,0,0.206494
36194,The Go-Between,1971-09-24,1971,100000,0,-100000,3.815323
36196,Party Girl,1995-06-09,1995,150000,472370,322370,1.165039
36204,No Smoking,2007-10-26,2007,0,0,0,1.129091
36206,Ride the High Country,1962-06-20,1962,813000,0,-813000,3.102999
36208,A Dog's Life,1918-04-14,1918,0,0,0,1.972147
36210,Not One Less,1999-09-07,1999,0,0,0,1.896931
36211,Jap√≥n,2002-01-01,2002,250050,0,-250050,0.398828
36212,Rebirth of Mothra II,1997-12-13,1997,0,0,0,0.885005
36214,Rebirth of Mothra,1996-12-14,1996,0,0,0,1.116129
36215,Vital,2004-01-01,2004,0,0,0,1.43638
36218,Pok√©mon: Jirachi Wish Maker,2003-07-19,2003,0,0,0,5.190942
36220,The Creature Wasn't Nice,1983-07-01,1983,0,0,0,0.837756
36221,Postman Blues,1997-08-16,1997,0,0,0,0.6744
36222,Dead or Alive: Final,2002-01-12,2002,0,0,0,0.903011
36223,Zebraman,2004-01-30,2004,0,0,0,1.184277
36224,Subconscious Cruelty,2000-10-12,2000,100,0,-100,1.349913
36226,Chinese Roulette,1976-11-16,1976,0,0,0,2.740046
36228,Genesis,1998-01-01,1998,0,0,0,0.830977
36229,3¬∞ k√§lter,2006-03-16,2006,0,0,0,0.005145
36233,Posse,1993-05-14,1993,0,0,0,2.113993
36234,Timecode,2000-03-22,2000,4000000,0,-4000000,0.966535
36236,The Witches,1967-02-22,1967,0,0,0,2.63039
36241,The Dead,2004-04-16,2004,0,0,0,0.664293
36242,Blues Harp,1998-07-15,1998,0,0,0,0.210358
36243,"Godzilla, Mothra and King Ghidorah: Giant Monsters All-Out Attack",2001-12-15,2001,9400000,0,-9400000,1.7519
36244,Rainy Dog,1997-06-28,1997,0,0,0,0.596908
36245,Diary of a Chambermaid,1964-01-01,1964,0,0,0,3.003084
36246,Monday,2000-01-01,2000,0,0,0,1.089339
36247,Rebirth of Mothra III,1998-12-12,1998,0,0,0,1.080796
36249,Romy and Michele: In the Beginning,2005-01-01,2005,0,0,0,0.589159
36251,Switching Goals,1999-12-12,1999,0,0,0,3.152153
36253,The Wayward Cloud,2005-05-19,2005,0,0,0,1.606481
36257,Tiny Toon Adventures: How I Spent My Vacation,1992-03-11,1992,0,0,0,1.034057
36258,Orion's Key,1996-01-01,1996,0,0,0,0.213531
36259,Theodore Rex,1995-12-14,1995,33500000,0,-33500000,2.583686
36261,The Heroic Ones,1970-08-14,1970,0,0,0,1.133914
36264,The Deserters,1986-09-22,1986,0,0,0,0.050103
36265,Simon of the Desert,1965-02-08,1965,0,0,0,4.728698
36266,Cyclo,1995-01-01,1995,0,0,0,1.781952
36269,Winning London,2001-03-27,2001,0,0,0,3.234789
36272,Out of Reach,2004-01-01,2004,20000000,0,-20000000,2.916012
36273,The City of Lost Souls,2000-09-15,2000,0,0,0,0.408024
36274,Deadly Outlaw: Rekka,2002-09-21,2002,0,0,0,0.480518
36275,Killer Fish,1979-12-07,1979,0,0,0,1.266801
36278,Top Dog,1995-04-28,1995,6000000,5093707,-906293,1.557791
36281,Shara,2003-01-01,2003,0,0,0,1.19689
36282,Fudoh: The New Generation,1996-10-12,1996,0,0,0,1.647619
36283,"What Did You Do in the War, Daddy?",1966-01-01,1966,0,0,0,1.972935
36288,Night and the City,1992-10-11,1992,0,0,0,2.853018
36290,Crimes of Fashion,2004-01-01,2004,0,0,0,7.107178
36292,Teenage Angst,2008-01-01,2008,0,0,0,0.253047
36293,Bridge of Dragons,1999-01-01,1999,0,0,0,0.532741
36294,Evasive Action,1998-01-01,1998,0,0,0,0.098074
36296,"Work Hard, Play Hard",2004-01-01,2004,0,0,0,0.892913
36298,"Me, Them And Lara",2010-01-01,2010,0,0,0,2.303734
36299,The Grave,1996-01-01,1996,4000000,0,-4000000,0.009678
36301,The Tangerine Bear: Home in Time for Christmas!,2000-01-01,2000,0,0,0,1.408414
36323,Jungledyret,1993-01-01,1993,0,0,0,0.63744
36324,Pouic-Pouic,1963-11-20,1963,0,0,0,2.125139
36325,Bananas!*,2009-10-09,2009,0,0,0,0.502688
36328,Longford,2006-10-26,2006,0,0,0,5.044132
36329,Paju,2009-10-28,2009,0,0,0,0.899398
36331,Dark City,1950-10-17,1950,0,0,0,1.634663
36334,Deadline - U.S.A.,1952-03-14,1952,0,0,0,2.020902
36335,Dear Murderer,1947-06-23,1947,0,0,0,0.595312
36337,Delusion,1991-06-07,1991,1000000,0,-1000000,0.156722
36339,Double Confession,1950-04-01,1950,0,0,0,0.200896
36342,Each Dawn I Die,1939-08-19,1939,0,0,0,2.037482
36344,Alaska,1996-08-14,1996,23000000,0,-23000000,2.318141
36349,Black Moon Rising,1986-01-10,1986,0,6637565,6637565,2.379451
36351,Light Sleeper,1992-08-21,1992,5000000,0,-5000000,7.468807
36353,Stratosphere Girl,2004-01-01,2004,0,0,0,1.331185
36355,Flipper,1996-05-17,1996,25530000,20080020,-5449980,4.557006
36357,Rent-a-Kid,1995-01-01,1995,0,0,0,1.155255
36361,House Calls,1978-03-15,1978,0,28460702,28460702,0.975702
36362,King of Kings,1961-10-11,1961,5037000,14483352,9446352,3.657476
36372,Half Moon Street,1986-08-13,1986,0,0,0,1.441189
36373,M,1951-03-01,1951,0,0,0,2.006075
36375,Edge of Doom,1950-08-03,1950,0,0,0,1.119234
36377,General Nil,2009-04-17,2009,0,0,0,0.107958
36380,Boys Don't Cry,2000-02-25,2000,0,0,0,1.016074
36391,King Size,1988-05-02,1988,0,0,0,0.529836
36392,Kogel-mogel,1988-08-15,1988,0,0,0,0.406377
36401,Pornography,2003-09-19,2003,0,0,0,1.610562
36402,The Welts,2004-10-08,2004,0,0,0,0.617523
36404,A Trip Down the River,1970-10-19,1970,0,0,0,0.98832
36405,Reverse,2009-11-12,2009,0,0,0,0.591291
36407,Strawberry Wine,2009-05-08,2009,0,0,0,0.303507
36415,Snow White and Russian Red,2009-04-21,2009,0,0,0,0.909863
36416,We're All Christs,2006-04-21,2006,0,0,0,0.351422
36419,After.Life,2010-04-09,2010,4500000,3606395,-893605,9.063797
36421,Howling VI: The Freaks,1991-01-01,1991,0,0,0,2.61499
36427,I Saw Mommy Kissing Santa Claus,2002-10-23,2002,0,0,0,1.107049
36430,The Stickup,2002-02-01,2002,0,0,0,0.448193
36432,Art & Copy,2009-08-21,2009,0,0,0,0.655022
36434,Stag,1997-04-01,1997,0,0,0,0.854723
36439,The Unknown Soldier,1955-12-23,1955,0,0,0,1.012983
36443,The Union: The Business Behind Getting High,2007-05-08,2007,200000,0,-200000,2.058076
36446,Camille 2000,1969-07-15,1969,0,0,0,1.848455
36447,Carried Away,1996-01-26,1996,0,0,0,1.67218
36457,Mademoiselle,1966-06-01,1966,0,0,0,0.612006
36460,The Man With Bogart's Face,1980-10-03,1980,0,0,0,0.627655
36463,Miami Expos√©,1956-09-01,1956,0,0,0,0.121358
36464,The Gathering Storm,2002-04-22,2002,0,0,0,3.091089
36465,Into the Storm,2009-05-31,2009,0,0,0,11.322269
36484,Rick,2003-01-01,2003,0,0,0,0.331349
36488,Bachelor Mother,1939-06-30,1939,0,0,0,0.90772
36489,Bride of the Monster,1955-05-11,1955,0,0,0,1.406932
36491,Carlton-Browne of the F.O.,1959-03-10,1959,0,0,0,0.63657
36492,Carnal Knowledge,1971-10-21,1971,0,28623900,28623900,2.837238
36495,The Great McGinty,1940-08-23,1940,0,0,0,0.857056
36498,Hail the Conquering Hero,1944-08-09,1944,0,0,0,1.405996
36499,His Private Secretary,1933-06-10,1933,0,0,0,0.795697
36505,On Earth as It Is in Heaven,1995-11-03,1995,0,0,0,0.70595
36511,White Wall,2010-05-07,2010,250000,0,-250000,0.801652
36513,No Man of Her Own,1932-12-30,1932,0,0,0,0.101465
36514,Once a Thief,1965-04-24,1965,0,0,0,0.634556
36516,One Way Street,1950-04-01,1950,0,0,0,0.562246
36519,Payment Deferred,1932-11-07,1932,0,0,0,0.528123
36520,Playgirl,1954-04-21,1954,0,0,0,0.563998
36522,Private Hell 36,1954-09-03,1954,0,0,0,0.48487
36523,Felix The Cat: The Movie,1988-10-01,1988,9000000,1964253,-7035747,0.030576
36527,Phar Lap,1983-08-11,1983,0,0,0,0.709445
36529,Metamorphosis,1990-08-07,1990,0,0,0,0.444072
36530,Voyage to the Planet of Prehistoric Women,1968-01-01,1968,0,0,0,1.212575
36536,Sesame Street Presents Follow That Bird,1985-08-02,1985,0,0,0,1.779267
36540,Winnie the Pooh and the Honey Tree,1966-01-01,1966,0,0,0,1.685725
36542,Mr. Right,2009-07-13,2009,0,0,0,0.603245
36549,Yesterday Was a Lie,2008-01-01,2008,0,0,0,0.185714
36550,Jack and the Beanstalk,2009-11-06,2009,0,0,0,2.157779
36554,The Desert Rats,1953-05-20,1953,0,0,0,6.414758
36555,Best of the Best 3: No Turning Back,1995-05-17,1995,0,0,0,1.567945
36557,Casino Royale,2006-11-14,2006,150000000,599045960,449045960,23.065078
36561,I Am Dina,2002-03-08,2002,0,0,0,6.978177
36566,Cheech & Chong's Hey Watch This,2010-04-20,2010,0,0,0,0.814713
36568,Paulie,1998-04-17,1998,0,0,0,3.913118
36569,The Crimson Wing: Mystery of the Flamingos,2008-12-17,2008,0,0,0,0.45372
36571,The Dirty Dozen: Next Mission,1985-02-04,1985,0,0,0,2.086634
36572,The Dirty Dozen: The Deadly Mission,1987-03-01,1987,0,0,0,2.562477
36573,The Dirty Dozen: The Fatal Mission,1988-02-14,1988,0,0,0,1.75819
36575,Kevin Nealon: Now Hear Me Out!,2009-09-04,2009,0,0,0,0.158757
36576,Curse of the Pink Panther,1983-08-12,1983,11000000,4491986,-6508014,8.046375
36577,Vampire Girl vs. Frankenstein Girl,2009-09-09,2009,0,0,0,1.27754
36583,Operation Crossbow,1965-04-01,1965,115,0,-115,2.375904
36584,Interview with the Assassin,2002-05-09,2002,500000,0,-500000,0.573201
36586,Blade II,2002-03-22,2002,54000000,155010032,101010032,17.05064
36588,The Immortal Voyage of Captain Drake,2009-01-17,2009,0,0,0,1.013848
36593,The Naked Gun 33‚Öì: The Final Insult,1994-03-18,1994,30000000,51132598,21132598,10.587232
36597,Wuthering Heights,2009-01-18,2009,0,0,0,8.747636
36599,Prom Night,1980-07-18,1980,1000000,14796236,13796236,3.65867
36600,The Flesh and Blood Show,1972-10-01,1972,0,0,0,0.000844
36606,Full Tilt Boogie,1997-09-09,1997,0,0,0,11.009822
36607,Dave Attell's Insomniac Tour: Uncensored!,2005-02-04,2005,0,0,0,0.05283
36610,Wolf,2004-11-05,2004,0,0,0,1.535646
36612,The Hard Way,1943-02-20,1943,0,0,0,0.709005
36613,Martian Successor Nadesico: The Motion Picture - Prince of Darkness,1998-08-01,1998,0,0,0,0.624579
36614,The Sum of Us,1994-07-12,1994,32,0,-32,1.407427
36615,Little Red Flowers,2006-04-08,2006,0,0,0,0.879088
36616,B√©b√©'s Kids,1992-07-31,1992,0,0,0,6.997911
36618,Zero 2,2010-01-18,2010,400000,0,-400000,1.285726
36620,Splinters,2008-01-01,2008,0,0,0,0.687295
36626,Mr. Kuka's Advice,2008-07-05,2008,0,0,0,0.647487
36627,The Deluge,1974-09-02,1974,0,0,0,0.868637
36628,Lo,2009-07-01,2009,0,0,0,1.550234
36629,Comic Book Villains,2002-09-03,2002,0,0,0,1.237955
36630,Zandalee,1991-05-09,1991,0,0,0,2.217656
36631,Never Let Go,1960-01-01,1960,0,0,0,0.372205
36634,The People Against O'Hara,1951-09-01,1951,0,0,0,3.02441
36635,Danger Signal,1945-11-14,1945,0,0,0,0.221643
36643,The World Is Not Enough,1999-11-08,1999,135000000,361832400,226832400,12.130127
36645,Modesty Blaise,1966-05-01,1966,0,0,0,4.969116
36647,Blade,1998-08-21,1998,45000000,131183530,86183530,15.043454
36648,Blade: Trinity,2004-12-08,2004,65000000,128905366,63905366,18.860681
36652,The Good Earth,1937-08-06,1937,0,0,0,1.085948
36657,X-Men,2000-07-13,2000,75000000,296339527,221339527,0.954467
36658,X2,2003-04-24,2003,110000000,407711549,297711549,0.913096
36662,Dacii,1967-05-31,1967,0,0,0,0.506846
36663,Dreamkiller,,,2500000,0,-2500000,0.035294
36665,General Idi Amin Dada,1974-11-01,1974,0,0,0,0.519972
36668,X-Men: The Last Stand,2006-05-24,2006,210000000,459359555,249359555,0.867943
36669,Die Another Day,2002-11-17,2002,140000000,431971116,291971116,12.996474
36670,Never Say Never Again,1983-10-07,1983,36000000,160000000,124000000,10.231985
36671,B.T.K.,2008-07-08,2008,0,0,0,1.714772
36672,Coming Out,1989-11-08,1989,0,0,0,0.599984
36674,Bert: The Last Virgin,1995-12-25,1995,0,0,0,0.880511
36676,Jonestown: The Life and Death of Peoples Temple,2006-04-26,2006,0,0,0,0.870182
36677,Solarbabies,1986-11-26,1986,25000000,1579260,-23420740,1.278665
36678,"Hijacking Catastrophe: 9/11, Fear & the Selling of American Empire",2004-09-10,2004,0,0,0,0.225411
36679,Godzilla vs. King Ghidorah,1991-12-14,1991,0,0,0,1.541436
36680,TechnoCalyps,2006-05-01,2006,0,0,0,0.315713
36681,Secret,2009-10-01,2009,0,0,0,1.16621
36683,20th Century Boys - Chapter 1: Beginning of the End,2008-08-19,2008,20000000,31244858,11244858,1.889519
36685,The Rocky Horror Picture Show,1975-08-14,1975,1200000,112892319,111692319,8.699428
36686,The Tomb,2009-11-05,2009,8800000,0,-8800000,3.512529
36691,Solitary Man,2009-09-07,2009,15000000,5024782,-9975218,5.829644
36692,Bloodsport III,1996-12-05,1996,0,0,0,1.946108
36693,Bloodsport: The Dark Kumite,1999-03-30,1999,0,0,0,6.352793
36695,The Goddess,2004-11-30,2004,0,0,0,0.810164
36696,Space Dogs,2010-03-18,2010,25000000,6500000,-18500000,4.037707
36698,The Interceptor,2009-10-08,2009,7000000,1877122,-5122878,1.08213
36699,We Are from the Future 2,2010-02-18,2010,0,8910819,8910819,1.218959
36702,Cremaster 5,1997-01-01,1997,0,0,0,0.881401
36703,Beeswax,2009-08-09,2009,0,0,0,0.528434
36704,In Society,1944-08-16,1944,0,0,0,1.132645
36706,Little Giant,1946-02-22,1946,0,0,0,0.389627
36709,Map of the Human Heart,1993-04-22,1993,0,0,0,2.172631
36712,Everything Must Go,1996-12-04,1996,0,0,0,0.001655
36718,Lagerfeld Confidential,2007-10-10,2007,0,0,0,0.438339
36724,The Decline of Western Civilization Part II: The Metal Years,1988-06-17,1988,0,0,0,1.350703
36730,My House in Umbria,2003-05-25,2003,0,0,0,2.734283
36731,The Roman Spring of Mrs. Stone,1961-12-28,1961,0,0,0,0.943604
36736,The Drawn Together Movie: The Movie!,2010-04-20,2010,0,0,0,6.088599
36737,Carny,2009-04-24,2009,0,0,0,1.354308
36738,Boy Interrupted,2009-10-03,2009,350000,0,-350000,0.786304
36739,School Daze,1988-02-12,1988,0,0,0,6.25967
36741,School for Scoundrels,1960-03-24,1960,0,0,0,1.332883
36746,Punk's Not Dead,2007-07-27,2007,0,0,0,0.408705
36748,Raggedy Ann & Andy: A Musical Adventure,1977-04-01,1977,0,0,0,0.215018
36751,Twice Upon a Time,1983-08-05,1983,0,0,0,0.572516
36758,The Portrait of a Lady,1996-10-18,1996,0,3692836,3692836,4.13905
36759,Sgt. Pepper's Lonely Hearts Club Band,1978-07-24,1978,18000000,0,-18000000,2.32677
36760,The 3rd Voice,1960-03-05,1960,0,0,0,0.823651
36762,Rock 'n' Roll Nightmare,1987-01-02,1987,53000,0,-53000,0.186921
36763,Salem's Lot,2004-06-20,2004,0,0,0,14.098705
36764,Uuno Turhapuro,1973-08-24,1973,0,0,0,0.245969
36765,Professori Uuno D.G. Turhapuro,1975-08-29,1975,0,0,0,0.003921
36766,Lottovoittaja UKK Turhapuro,1976-08-27,1976,0,0,0,0.060764
36767,H√§py Endk√∂? Eli kuinka Uuno Turhapuro sai niin kauniin ja rikkaan vaimon,1977-08-26,1977,0,0,0,0.221224
36768,Uuno Turhapuro armeijan leiviss√§,1984-08-31,1984,0,0,0,0.8324
36769,Uuno Epsanjassa,1985-09-27,1985,0,0,0,0.00022
36771,Uuno Turhapuro ‚Äì This Is My Life,2004-09-10,2004,0,0,0,0.219689
36772,The Test-tube Adult and Simo's Angels,1979-10-12,1979,0,0,0,0.000308
36773,The Third Miracle,1999-09-13,1999,0,0,0,2.269601
36775,The Ambushers,1967-12-22,1967,0,0,0,0.916421
36779,Killer Tomatoes Strike Back!,1991-11-14,1991,0,0,0,1.499106
36784,Stricken,2009-11-26,2009,4000000,0,-4000000,4.443755
36785,The Dependent,1969-01-01,1969,0,0,0,0.438059
36786,While the City Sleeps,1956-05-30,1956,0,0,0,5.249028
36789,"Hook, Line and Sinker",1930-12-26,1930,0,0,0,0.172525
36791,In This World,2002-11-17,2002,0,0,0,0.907637
36796,American Samurai,1992-01-01,1992,0,0,0,1.280278
36797,RocketMan,1997-10-10,1997,16000000,0,-16000000,5.345663
36799,Sugar,2004-05-22,2004,375581,0,-375581,1.238765
36800,Metropia,2009-10-21,2009,5060730,0,-5060730,3.360982
36801,Cemetery Junction,2010-04-14,2010,0,0,0,8.740728
36807,The Sixth Man,1997-03-28,1997,0,0,0,3.747649
36808,Hollywood Hot Tubs,1984-07-01,1984,0,0,0,0.035358
36811,The Last Station,2009-09-04,2009,0,0,0,4.029732
36814,The Street with No Name,1948-07-14,1948,0,0,0,0.819833
36815,The Agony and the Ecstasy,1965-10-07,1965,0,0,0,2.122253
36817,Two Heads Are Better Than None,2000-07-15,2000,0,0,0,0.78037
36818,Smorgasbord,1983-04-13,1983,0,0,0,0.596799
36819,Time Bandits,1981-07-13,1981,5000000,42365581,37365581,9.841623
36820,Won Ton Ton: the Dog Who Saved Hollywood,1976-07-26,1976,0,0,0,0.693608
36821,The Perils of Pauline,1914-03-31,1914,0,0,0,0.603245
36826,The Loveless,1981-08-07,1981,0,0,0,0.845368
36832,Born in Flames,1983-11-03,1983,0,0,0,0.000578
36833,No Skin Off My Ass,1991-01-01,1991,0,0,0,0.337348
36834,Total Eclipse,1995-11-02,1995,0,339889,339889,4.546552
36835,Oasis of the Zombies,1982-04-20,1982,0,0,0,1.04865
36836,Stacy: Attack of the Schoolgirl Zombies,2001-08-18,2001,0,0,0,1.610079
36841,The Sheik,1921-11-20,1921,0,0,0,0.807162
36843,Life Is Sweet,1990-11-15,1990,0,0,0,5.82664
36850,A New Leaf,1971-03-11,1971,0,0,0,2.03483
36851,Beau Geste,1939-07-24,1939,112,0,-112,3.004471
36855,The Reluctant Astronaut,1967-09-05,1967,0,0,0,1.765691
36859,Bells of Innocence,2003-01-01,2003,0,0,0,1.738232
36861,Bob Saget: That Ain't Right,2007-01-01,2007,0,0,0,0.305739
36863,Everything's Cool,2007-01-01,2007,0,0,0,0.00506
36865,The Disappearance of Haruhi Suzumiya,2010-02-05,2010,0,0,0,4.655416
36867,Shark Skin Man and Peach Hip Girl,1998-01-01,1998,0,0,0,0.651725
36868,The Jetsons Meet the Flintstones,1987-01-01,1987,0,0,0,1.059743
36871,Late Chrysanthemums,1954-06-15,1954,0,0,0,0.508473
36872,When a Woman Ascends the Stairs,1960-01-15,1960,0,0,0,1.421128
36874,The Country Doctor,1909-07-08,1909,0,0,0,0.255157
36877,The Blood of a Poet,1932-01-20,1932,0,0,0,1.547374
36878,Testament of Orpheus,1960-02-18,1960,0,0,0,2.952714
36879,The Beast in Heat,1977-07-19,1977,0,0,0,2.324007
36880,Wodaabe: Herdsmen of the Sun,1989-01-01,1989,0,0,0,0.012758
36883,Midnight Movies: From the Margin to the Mainstream,2006-06-20,2006,0,0,0,1.372346
36885,Schoolgirl Report Part 3: What Parents Find Unthinkable,1972-02-17,1972,0,0,0,2.110381
36886,Schoolgirl Report Part 4: What Drives Parents to Despair,1972-09-28,1972,0,0,0,2.198993
36887,Schoolgirl Report Part 2: What Keeps Parents Awake at Night,1971-08-26,1971,0,0,0,1.923782
36888,Schoolgirl Report Part 1: What Parents Don't Think Is Possible,1970-10-23,1970,0,0,0,1.700458
36895,Suzaku,1997-01-01,1997,0,0,0,3.340118
36896,Killer Tomatoes Eat France!,1992-11-18,1992,0,0,0,0.519994
36897,Pok√©mon: Mewtwo Returns,2000-12-30,2000,0,0,0,4.584737
36907,The Plague,1992-01-01,1992,0,0,0,0.574504
36909,American Yakuza,1993-01-01,1993,0,0,0,0.854563
36912,The Sting II,1983-02-18,1983,0,6347072,6347072,3.659745
36914,Like Father Like Son,1987-10-02,1987,0,34377585,34377585,9.071509
36915,Heaven's Prisoners,1996-05-17,1996,25000000,0,-25000000,9.264679
36916,The Men Who Tread on the Tiger's Tail,1945-12-28,1945,0,0,0,2.137943
36917,Ju-on: Black Ghost,2009-06-27,2009,0,0,0,1.280953
36918,The Emperor and the Golem,1952-01-04,1952,0,0,0,0.503671
36919,"Waiter, Scarper!",1981-01-01,1981,0,0,0,0.118324
36922,The Kaiser's Lackey,1951-08-31,1951,0,0,0,0.420539
36926,Ghosts of Abu Ghraib,2007-01-01,2007,0,0,0,0.017756
36929,Big Bully,1996-01-26,1996,15000000,2042530,-12957470,2.936443
36931,On the Edge,2006-08-31,2006,0,0,0,0.609931
36939,Boogie Woogie,2009-06-17,2009,0,0,0,3.820477
36940,The First Beautiful Thing,2010-01-15,2010,0,0,0,6.883023
36943,In God's Hands,1998-04-24,1998,0,0,0,0.327559
36944,Fat Head,2009-02-03,2009,0,0,0,0.729334
36947,Manufacturing Consent: Noam Chomsky and the Media,1992-11-06,1992,0,0,0,1.044237
36949,99 River Street,1953-03-10,1953,0,0,0,1.01233
36950,You Don't Know Jack,2010-04-14,2010,0,0,0,14.988063
36952,Dreams with Sharp Teeth,2008-06-04,2008,0,0,0,0.626458
36955,True Lies,1994-07-14,1994,115000000,378882411,263882411,11.396099
36956,Come Undone,2010-04-30,2010,0,0,0,2.08337
36960,Memory,2006-11-01,2006,0,0,0,1.531457
36962,Puppetry of the Penis: Live at the Forum,2001-01-01,2001,0,0,0,0.222382
36964,Pucked,2006-01-01,2006,0,0,0,1.637948
36968,Life-Size,2000-03-05,2000,0,0,0,6.648653
36970,Oceans,2009-10-17,2009,0,19406406,19406406,7.785003
36971,Whisky,2004-08-06,2004,0,0,0,0.790495
36972,Scooby-Doo Goes Hollywood,1979-10-21,1979,0,0,0,2.132875
36983,Tornado!,1996-05-06,1996,0,0,0,1.429564
36984,Trespassing,2004-10-22,2004,0,0,0,1.180205
36992,Shakma,1990-10-05,1990,0,0,0,3.185409
36996,The President's Man: A Line in the Sand,2002-01-01,2002,0,0,0,0.585455
36998,The Eighth Day,1996-01-01,1996,0,0,0,2.887239
37000,A Lake,2008-09-01,2008,0,0,0,0.415622
37003,U2 3D,2007-05-19,2007,15000000,22730842,7730842,0.900864
37005,All Souls Day: Dia de los Muertos,2005-01-01,2005,0,0,0,0.826307
37006,Mi mejor enemigo,2005-01-01,2005,0,0,0,0.563469
37015,Lookin' Italian,1994-01-01,1994,0,0,0,0.031968
37019,Dr. Jekyll and Ms. Hyde,1995-08-25,1995,8000000,0,-8000000,1.341723
37020,Saved by the Bell: Wedding in Las Vegas,1994-10-07,1994,0,0,0,0.518179
37021,"Ranma ¬Ω: Nihao, My Concubine",1992-08-02,1992,0,0,0,0.178741
37022,Saved by the Bell: Hawaiian Style,1992-11-27,1992,0,0,0,0.884908
37024,"Ranma ¬Ω: The Movie 1, Big Trouble in Nekonron, China",1991-11-02,1991,0,0,0,0.713292
37025,The Prince and the Pauper,1937-05-08,1937,0,0,0,5.67106
37028,The Magic Flute,2006-09-07,2006,0,0,0,2.176554
37030,Shaolin Temple 2: Kids from Shaolin,1984-01-26,1984,0,3554460,3554460,0.703225
37032,Martial Arts of Shaolin,1986-03-01,1986,10000000,0,-10000000,3.058256
37034,True Legend,2010-02-09,2010,20000000,0,-20000000,4.434924
37036,All Through the Night,1941-12-02,1941,0,0,0,0.946931
37037,"Dr. Syn, Alias the Scarecrow",1963-12-06,1963,0,0,0,1.452854
37038,All Night Long,1962-02-06,1962,0,0,0,1.444562
37039,Among the Living,1941-12-19,1941,0,0,0,0.267565
37041,The Woman on the Beach,1947-06-02,1947,0,0,0,1.422265
37042,Satan's Sadists,1969-06-01,1969,0,0,0,0.732246
37044,Wisconsin Death Trip,1999-09-05,1999,0,0,0,0.853628
37047,Love Hina Christmas Special: Silent Eve,2000-12-24,2000,0,0,0,0.337904
37048,Mobile Suit Gundam 00: A Wakening of the Trailblazer,2010-09-18,2010,0,0,0,1.838247
37049,The Mouse and His Child,1977-11-18,1977,0,0,0,0.754872
37050,So Normal,2003-10-23,2003,0,0,0,2.119218
37053,Tenchu!,1969-08-09,1969,0,0,0,1.196355
37055,Elephant,1989-02-13,1989,0,0,0,0.000578
37056,Letters to Juliet,2010-05-14,2010,30000000,0,-30000000,7.282488
37058,I'm Here,2010-03-01,2010,0,0,0,3.143801
37059,2012: Supernova,2009-10-27,2009,0,0,0,1.231509
37060,Rocks,2003-06-05,2003,0,0,0,0.615096
37062,The Passion of Darkly Noon,1995-01-02,1995,0,0,0,1.035019
37066,The Beat Generation,1959-07-03,1959,0,0,0,0.318002
37079,God's Little Acre,1958-09-23,1958,0,0,0,2.351003
37080,Mother and Child,2009-11-07,2009,7000000,0,-7000000,3.373907
37083,Pay or Die!,1960-07-27,1960,0,0,0,0.356422
37084,The Big Night,1951-11-13,1951,0,0,0,1.017716
37086,A Hatful of Rain,1957-07-17,1957,0,0,0,0.489202
37087,711 Ocean Drive,1950-07-01,1950,0,0,0,1.063786
37088,Aileen: Life and Death of a Serial Killer,2003-09-09,2003,0,0,0,3.502005
37091,FAQs,2005-07-16,2005,0,0,0,0.166635
37094,Falling Down,1993-02-26,1993,25000000,40903593,15903593,10.175138
37098,The Last Truck: Closing of a GM Plant,2009-09-07,2009,0,0,0,0.004777
37100,Sailor Moon R: The Movie,1993-12-05,1993,0,0,0,0.91974
37103,"Heaven Knows, Mr. Allison",1957-03-13,1957,0,0,0,3.584126
37108,A Kid in King Arthur's Court,1995-08-11,1995,0,0,0,5.874511
37112,The Great Locomotive Chase,1956-06-08,1956,0,0,0,1.875042
37123,The Sheriff of Fractured Jaw,1958-10-28,1958,0,0,0,0.568903
37124,Will Success Spoil Rock Hunter?,1957-07-29,1957,0,0,0,0.95743
37126,Impulse,1954-01-01,1954,0,0,0,0.137185
37128,Jolly Fellows,1934-12-09,1934,0,0,0,0.768147
37129,Only Old Men Are Going to Battle,1973-06-06,1973,0,0,0,1.286164
37133,Volga - Volga,1938-04-24,1938,0,0,0,0.171433
37135,Tarzan,1999-06-18,1999,150000000,448000000,298000000,12.453452
37136,The Naked Gun: From the Files of Police Squad!,1988-12-02,1988,12000000,78756177,66756177,15.698222
37137,The Naked Gun 2¬Ω: The Smell of Fear,1991-06-28,1991,23000000,86930411,63930411,9.794569
37141,The Babysitter,1995-10-17,1995,0,0,0,2.761837
37144,True Crime,1996-03-12,1996,0,0,0,1.217249
37146,Penn & Teller Get Killed,1989-09-22,1989,0,0,0,0.004948
37165,The Truman Show,1998-06-04,1998,60000000,264118201,204118201,13.155901
37168,The Dog Who Stopped the War,1984-10-03,1984,1340000,0,-1340000,1.641502
37169,The Human Centipede (First Sequence),2009-04-26,2009,2011799,0,-2011799,12.84585
37172,Athadu,2005-08-10,2005,0,0,0,0.668636
37174,Carnival,1982-02-17,1982,0,0,0,1.425654
37175,Say a Word for the Poor Hussar,1980-01-01,1980,0,0,0,0.091027
37176,The Pokrovsky Gates,1982-01-01,1982,0,0,0,0.651047
37177,The Dog in the Manger,1977-01-01,1977,0,0,0,0.382529
37178,Virtuality,2009-06-26,2009,0,0,0,3.172738
37181,About Elly,2009-02-10,2009,0,0,0,10.35646
37183,The Glass Web,1953-11-11,1953,0,0,0,0.54829
37185,Comrades: Almost a Love Story,1996-11-02,1996,0,0,0,1.851502
37189,Four Adventures of Reinette and Mirabelle,1987-02-04,1987,0,0,0,0.478024
37190,Transylmania,2009-12-04,2009,0,263941,263941,2.589745
37191,"I, the Jury",1982-04-22,1982,0,0,0,0.905788
37193,Hue and Cry,1947-02-01,1947,0,0,0,0.807369
37196,The Daisy Chain,2008-01-01,2008,0,0,0,1.474485
37198,Inferno,1953-08-12,1953,1055000,0,-1055000,2.290681
37202,The Home Teachers,2004-01-09,2004,0,0,0,0.151532
37203,Throw Down Your Heart,2009-03-30,2009,0,0,0,0.040008
37204,Summer Magic,1963-07-07,1963,0,0,0,1.03185
37206,A Shine of Rainbows,2009-10-01,2009,6000000,0,-6000000,6.760491
37209,The Saddest Music in the World,2003-09-17,2003,0,0,0,1.308142
37211,Scooby-Doo! and the Reluctant Werewolf,1988-01-01,1988,0,0,0,2.374519
37213,Lovely Complex,2006-07-12,2006,0,0,0,1.085039
37214,Go for Broke!,1951-05-04,1951,0,0,0,0.191472
37215,Death Takes a Holiday,1934-03-30,1934,0,0,0,0.545576
37216,Blind Date,1959-08-01,1959,0,0,0,0.308031
37218,For the Moment,1993-10-01,1993,120,0,-120,0.347124
37222,The V.I.P.s,1963-05-01,1963,0,0,0,0.547188
37223,Oneechanbara The Movie,2008-04-26,2008,0,0,0,0.613431
37227,Of Unknown Origin,1983-11-24,1983,4000000,0,-4000000,3.009764
37228,Anarchism in America,1983-01-01,1983,0,0,0,0.152418
37230,Saturday Night and Sunday Morning,1960-08-29,1960,0,0,0,1.62152
37232,Travellers and Magicians,2003-09-09,2003,0,0,0,0.635804
37233,The Firm,1993-06-30,1993,42000000,270248367,228248367,9.678367
37234,Sex & Drugs & Rock & Roll,2010-01-08,2010,2000000,0,-2000000,1.017808
37237,Bullet to Beijing,1995-12-20,1995,0,0,0,2.254598
37238,Geronimo,1962-05-01,1962,0,0,0,0.400573
37239,Antonio Gaud√≠,1984-07-09,1984,0,0,0,0.270774
37244,Leave it to Beaver,1997-08-22,1997,0,0,0,1.635911
37247,The Graduate,1967-12-21,1967,3000000,104945305,101945305,12.057829
37254,Mermaid Chronicles Part 1: She Creature,2001-12-20,2001,0,0,0,2.088049
37255,Ween: Live in Chicago,2004-05-04,2004,0,0,0,0.043068
37257,Witness for the Prosecution,1957-12-17,1957,3000000,9000000,6000000,9.730217
37258,Equus,1977-10-16,1977,0,0,0,2.193595
37259,Blood Into Wine,2010-02-19,2010,0,0,0,0.876887
37264,Straight Talk,1992-04-03,1992,0,0,0,2.30139
37265,All Ladies Do It,1992-02-21,1992,0,0,0,4.258331
37266,Secret Passage,2004-01-01,2004,0,0,0,0.482335
37269,My Fake Fiance,2009-04-19,2009,0,0,0,7.793433
37270,The Third Wheel,2002-05-31,2002,0,0,0,2.710482
37272,"A Cool, Dry Place",1998-01-29,1998,0,0,0,0.837313
37284,Acacia,2003-10-17,2003,2000000,0,-2000000,1.46791
37288,Take Care of My Cat,2001-10-13,2001,0,0,0,0.848101
37291,Trust,1990-09-09,1990,700000,0,-700000,4.085688
37292,Broken Arrow,1950-08-01,1950,0,0,0,8.83625
37294,Station West,1948-10-16,1948,0,0,0,9.775598
37296,Protocol,1984-12-21,1984,0,0,0,3.665599
37300,The Woman in White,1948-05-15,1948,0,0,0,0.550873
37301,A Big Hand for the Little Lady,1966-05-31,1966,0,0,0,1.929093
37302,Left Behind,2000-10-30,2000,0,0,0,2.663191
37305,Pork Chop Hill,1959-05-29,1959,0,0,0,2.522122
37306,Voodoo Moon,2006-06-04,2006,0,0,0,0.533343
37307,Conagher,1991-07-01,1991,0,0,0,0.559199
37308,100 Rifles,1969-03-26,1969,0,0,0,1.739815
37309,Canyon Passage,1946-07-17,1946,0,0,0,0.719063
37311,Band of Angels,1957-08-03,1957,0,0,0,1.570377
37312,Killer at Large,2008-11-21,2008,0,0,0,0.249513
37315,The Best Man,1964-04-05,1964,0,0,0,0.402307
37316,A Bullet for the General,1966-12-06,1966,0,0,0,1.933152
37317,The Tall Men,1955-09-22,1955,0,0,0,1.445309
37327,Wagon Master,1950-04-19,1950,0,0,0,11.445717
37329,The Baron of Arizona,1950-03-04,1950,0,0,0,0.869231
37333,Lake Consequence,1993-02-23,1993,0,0,0,0.63326
37335,Bolero: Dance of Life,1981-05-27,1981,0,0,0,1.455537
37339,The Man Who Skied Down Everest,1975-09-19,1975,0,0,0,0.000578
37340,The Man Who Watched Trains Go By,1952-12-01,1952,0,0,0,0.340178
37342,Maniac,1963-10-30,1963,0,0,0,0.434981
37343,Cash on Demand,1961-10-01,1961,0,0,0,0.832953
37345,Princess Caraboo,1994-09-16,1994,0,3021629,3021629,1.943323
37347,Fort Apache,1948-03-26,1948,2500000,3000000,500000,5.499979
37348,Monte Walsh,2003-01-17,2003,0,0,0,0.96798
37351,The Mystery of the Yellow Room,2003-06-11,2003,0,0,0,1.312686
37352,An Act of Murder,1948-12-05,1948,0,0,0,0.403008
37354,Greg Giraldo: Midlife Vices,2009-08-16,2009,0,0,0,0.221435
37360,The Blacksmith,1922-07-21,1922,0,0,0,0.743502
37368,The Fugitive,1947-11-03,1947,0,0,0,0.462747
37373,Island in the Sun,1957-06-12,1957,0,0,0,0.681977
37376,The Cube,1969-02-23,1969,0,0,0,0.697339
37380,Thunder Bay,1953-05-21,1953,0,0,0,0.588655
37404,Hercules and the Amazon Women,1994-04-24,1994,0,0,0,1.703566
37405,Eden,2006-11-02,2006,0,0,0,0.180599
37406,"Lewis Black: Red, White & Screwed",2006-06-10,2006,0,0,0,1.532796
37408,Vicki,1953-10-05,1953,0,0,0,0.162439
37410,Henry Fool,1997-09-07,1997,0,1334786,1334786,1.786768
37412,Warlock,1959-06-10,1959,0,0,0,12.089402
37413,Down Three Dark Streets,1954-09-02,1954,0,0,0,0.329004
37414,The Killer Inside Me,2010-02-19,2010,13000000,0,-13000000,6.324751
37419,What's a Human Anyway?,2006-03-17,2006,0,0,0,0.273028
37420,Timescape,1992-05-09,1992,0,0,0,2.537927
37426,The Ape,1940-09-30,1940,0,0,0,0.691803
37429,Vali,2009-01-09,2009,0,0,0,0.077756
37430,Conan the Barbarian,2011-08-17,2011,90000000,48795021,-41204979,10.949076
37431,No Way Back,1995-05-12,1995,0,0,0,7.529758
37432,Fab Five: The Texas Cheerleader Scandal,2008-08-02,2008,0,0,0,1.66291
37433,Neo Tokyo,1989-04-15,1989,0,0,0,3.143612
37434,Devil's Diary,2007-09-22,2007,0,0,0,1.381287
37437,My Side of the Mountain,1969-01-01,1969,0,0,0,0.437809
37438,"Road, Movie",2009-09-18,2009,0,0,0,0.080727
37440,Monster Ark,2008-01-01,2008,0,0,0,0.575611
37445,Les Mis√©rables: 10th Anniversary Concert at the Royal Albert Hall,1995-10-14,1995,0,0,0,0.748285
37447,Berkeley in the Sixties,1990-01-01,1990,0,0,0,0.10664
37451,The Inn of the Sixth Happiness,1958-12-11,1958,0,0,0,1.064714
37453,Molly: An American Girl on the Home Front,2006-11-26,2006,0,0,0,0.412692
37454,Maigret Lays a Trap,1958-01-29,1958,0,0,0,1.430996
37455,Police Python 357,1976-03-31,1976,0,0,0,0.928291
37460,Raavan,2010-06-18,2010,4500000,4200000,-300000,1.160169
37462,Wicked as They Come,1956-05-22,1956,0,0,0,0.522081
37463,Phantom of the Rue Morgue,1954-03-27,1954,0,0,0,0.657419
37464,Monstrosity,1963-09-01,1963,0,0,0,0.404998
37467,The Atomic Submarine,1959-11-29,1959,0,0,0,0.459754
37468,The Big Lift,1950-04-26,1950,0,0,0,0.143869
37472,Ip Man 2,2010-04-21,2010,12902809,36000000,23097191,1.9602
37481,Day of the Outlaw,1959-07-01,1959,0,0,0,1.317399
37482,The Crooked Way,1949-04-22,1949,0,0,0,1.302981
37484,I Love Trouble,1948-01-15,1948,0,0,0,0.730743
37487,The Secret Ways,1961-04-01,1961,0,0,0,0.288557
37488,Hit Man,1972-12-20,1972,0,0,0,0.916712
37495,Four Lions,2010-05-07,2010,967686,4270000,3302314,11.934045
37497,Border Radio,1987-11-01,1987,0,0,0,0.308762
37498,Knock Off,1998-09-04,1998,33000000,0,-33000000,5.213714
37501,Vieni avanti cretino,1982-04-07,1982,0,0,0,1.34614
37502,Heaven's Soldiers,2005-06-14,2005,8000000,0,-8000000,0.839479
37511,Stingray Sam,2009-01-20,2009,0,0,0,0.404118
37512,Satan's Brew,1976-10-07,1976,0,0,0,0.416417
37513,The Quiet Duel,1949-03-19,1949,0,0,0,0.504985
37514,Pray the Devil Back to Hell,2008-11-07,2008,0,0,0,0.551061
37516,Judas Kiss,1998-09-16,1998,0,0,0,3.115132
37517,Kiss or Kill,1997-04-23,1997,0,0,0,0.289738
37520,X: The Unheard Music,1986-03-01,1986,0,0,0,0.387414
37523,Envy,2009-08-08,2009,0,0,0,0.623099
37526,The Dentist 2: Brace Yourself,1998-12-11,1998,0,0,0,1.127098
37527,Dr. Giggles,1992-10-23,1992,0,8403433,8403433,1.252367
37529,The Prophecy: Forsaken,2005-09-06,2005,0,0,0,1.040221
37530,House II: The Second Story,1987-05-14,1987,0,7800000,7800000,13.416334
37532,Slam,1998-10-07,1998,1,0,-1,0.555304
37533,White Wedding,1989-11-08,1989,0,0,0,1.204953
37534,The New Daughter,2009-12-18,2009,0,0,0,4.818627
37536,Ringmaster,1998-11-25,1998,3500000,9247881,5747881,0.556435
37545,Morning of the Earth,1971-01-01,1971,0,0,0,0.106567
37550,Seven Beauties,1975-12-20,1975,0,0,0,1.356974
37556,Charlie Brown's Christmas Tales,2002-12-08,2002,0,0,0,0.716603
37557,Shanghai Triad,1995-04-30,1995,0,0,0,1.100915
37558,Little Brothers,1999-04-06,1999,0,0,0,0.142742
37560,Door-to-Door Maniac,1961-12-07,1961,0,0,0,0.619492
37563,A Summer's Tale,1996-06-05,1996,0,0,0,2.207306
37564,William Kunstler Disturbing the Universe,2009-06-02,2009,0,0,0,0.040001
37565,St Trinian's 2: The Legend of Fritton's Gold,2009-12-18,2009,0,0,0,5.309602
37567,Fall,1997-06-20,1997,0,0,0,1.555954
37570,Love in Another Language,2009-12-18,2009,0,0,0,0.761288
37571,Death Machines,1976-09-14,1976,0,0,0,0.002841
37573,My Only Sunshine,2009-03-05,2009,0,0,0,0.453519
37581,Christopher Strong,1933-03-09,1933,0,0,0,0.282898
37582,Sleeping Dogs,1977-10-06,1977,0,0,0,0.756689
37583,Herb & Dorothy,2009-06-05,2009,0,0,0,0.692956
37584,Pandora's Box,2008-09-06,2008,0,0,0,0.539564
37585,Night on the Galactic Railroad,1985-07-13,1985,0,0,0,0.608891
37586,Egg,2007-11-09,2007,0,0,0,0.735263
37587,Willy The Sparrow,1988-03-09,1988,0,0,0,0.558829
37588,Bruce Lee: A Warrior's Journey,2000-10-22,2000,0,0,0,1.165594
37590,Plato's Academy,2009-07-22,2009,0,0,0,1.03853
37596,Boy on a Dolphin,1957-04-18,1957,0,0,0,0.855032
37598,Butch and Sundance: The Early Days,1979-06-15,1979,0,0,0,0.627647
37600,Cool!,2004-09-16,2004,0,0,0,0.122083
37601,Tombs of the Blind Dead,1972-04-10,1972,0,0,0,1.203655
37602,Oysters at Nam Kee's,2002-09-05,2002,0,0,0,0.457576
37603,Diversant,2004-09-06,2004,0,0,0,0.559723
37605,The Last Voyage,1960-02-19,1960,0,0,0,1.92857
37606,Valmont,1989-11-17,1989,33000000,1132112,-31867888,8.40852
37607,Some Kind of Hero,1982-04-02,1982,0,0,0,0.979394
37608,The New Centurions,1972-08-03,1972,0,0,0,1.765721
37609,The Cheetah Girls 2,2006-07-31,2006,0,0,0,4.225869
37610,The Geisha Boy,1958-11-02,1958,0,0,0,1.771469
37613,Basil,1998-07-22,1998,0,0,0,0.901256
37615,Cover Up,1949-02-25,1949,0,0,0,0.199569
37616,Palookaville,1995-09-07,1995,0,0,0,1.669597
37618,The Asphyx,1972-12-05,1972,0,0,0,1.808388
37621,The Jodorowsky Constellation,1994-01-01,1994,0,0,0,0.306716
37626,St. Ives,1976-08-01,1976,0,0,0,6.264423
37627,The Little Prince,1974-11-06,1974,0,0,0,6.582652
37628,The Criminal Life of Archibaldo de la Cruz,1955-01-01,1955,0,0,0,1.054443
37629,Angel Cop,1989-10-31,1989,0,0,0,1e-06
37630,Protektor,2009-09-22,2009,0,0,0,0.566863
37631,Madame Curie,1943-12-15,1943,0,0,0,2.378019
37632,The Order,2001-12-10,2001,0,0,0,5.167183
37633,Nos amis les Terriens,2007-04-18,2007,0,0,0,0.257249
37635,Witness to Murder,1954-04-15,1954,0,0,0,1.097008
37636,High Art,1998-06-12,1998,0,1929168,1929168,7.601439
37637,There's Always Tomorrow,1956-02-01,1956,0,0,0,0.573692
37640,Let's Get Lost,1988-09-15,1988,0,0,0,0.081978
37641,Elvis Has Left the Building,2004-08-27,2004,11500000,0,-11500000,1.806785
37645,22 Bullets,2010-03-23,2010,24000000,0,-24000000,6.69573
37646,Choppertown: The Sinners,2005-08-14,2005,0,0,0,0.002494
37650,Nothing Sacred,1937-11-25,1937,0,0,0,1.345548
37652,Didier,1997-01-28,1997,0,0,0,3.740902
37653,The Three Brothers,1995-12-13,1995,7500000,0,-7500000,3.965037
37656,Hooked on the Game,2009-11-26,2009,3500000,3704408,204408,1.900502
37658,Anthony Adverse,1936-08-29,1936,0,0,0,0.332132
37659,When You're Strange,2009-01-17,2009,0,0,0,2.669145
37661,Icon,2005-01-01,2005,0,0,0,0.513753
37662,The Railway Children,1970-12-21,1970,0,0,0,1.47155
37665,Wake,2009-02-25,2009,0,0,0,0.959561
37667,Captives,1994-05-03,1994,0,0,0,1.926109
37668,Mega Man,2010-05-07,2010,0,0,0,0.358371
37672,"Same Time, Next Year",1978-04-23,1978,118,19,-99,2.103581
37673,Destiny,1997-05-09,1997,0,0,0,0.395469
37679,Screaming Mimi,1958-06-25,1958,0,0,0,0.219682
37684,36 Hours,1964-11-26,1964,0,0,0,1.473239
37686,Super 8,2011-06-08,2011,50000000,260095987,210095987,19.529911
37688,Lahore,2010-03-19,2010,0,0,0,0.016925
37690,Get Educated: Paathshaala,2010-04-16,2010,0,0,0,0.657101
37691,Bread and Roses,2000-05-10,2000,0,0,0,1.428582
37695,Newsmakers,2009-05-07,2009,4000000,0,-4000000,0.233752
37696,Fear X,2003-01-13,2003,0,0,0,2.059918
37698,The Roaring Twenties,1939-10-23,1939,0,0,0,5.259307
37700,Mr. Bjarnfre√∞arson,2009-12-26,2009,0,0,0,0.585443
37702,Forbidden City Cop,1996-02-16,1996,0,0,0,1.937146
37707,Splice,2009-10-06,2009,26000000,0,-26000000,8.181407
37708,Wild Things: Foursome,2010-06-01,2010,0,0,0,1.932851
37710,The Tourist,2010-12-08,2010,100000000,278731369,178731369,12.845045
37711,Princess Raccoon,2005-05-28,2005,0,0,0,0.751468
37712,Pistol Opera,2001-10-27,2001,0,0,0,1.177322
37714,The Assassin Next Door,2009-04-15,2009,3000000,0,-3000000,1.782869
37715,Love for Sale,2008-02-09,2008,1000000,0,-1000000,0.276374
37716,Mr Accident,2000-03-24,2000,0,0,0,0.881467
37718,The Muse,1999-08-27,1999,0,0,0,1.533253
37719,A Night at the Opera,1935-11-08,1935,0,0,0,9.587994
37720,The Hiding Place,1975-05-04,1975,0,0,0,0.263147
37721,Accidents Happen,2009-04-23,2009,0,0,0,6.756741
37722,Waking the Dead,2000-03-23,2000,8500000,327418,-8172582,1.241671
37724,Skyfall,2012-10-25,2012,200000000,1108561013,908561013,20.309585
37725,It's a Boy Girl Thing,2006-12-26,2006,15500000,7385434,-8114566,8.960677
37727,J√∂nssonligan f√•r guldfeber,1984-10-19,1984,0,0,0,0.055894
37728,J√∂nssonligan p√• Mallorca,1989-11-03,1989,0,0,0,1.020666
37730,J√∂nssonligan spelar h√∂gt,2000-12-25,2000,0,0,0,0.508715
37731,J√∂nssonligans st√∂rsta kupp,1995-02-03,1995,0,0,0,0.364376
37735,Easy A,2010-09-10,2010,8000000,74952305,66952305,15.138144
37736,Take Out,2004-05-13,2004,0,0,0,0.48253
37737,Kites,2010-05-21,2010,0,0,0,6.100998
37744,Rocketship X-M,1950-06-02,1950,0,0,0,1.113762
37748,800 Bullets,2002-10-18,2002,0,0,0,1.390326
37749,Looking for Mr. Goodbar,1977-10-19,1977,0,22512655,22512655,7.637221
37753,Consenting Adults,1992-10-16,1992,18000000,21591728,3591728,2.967012
37754,"Cornbread, Earl and Me",1975-05-21,1975,0,0,0,0.028101
37757,Never Sleep Again: The Elm Street Legacy,2010-05-04,2010,0,0,0,2.48821
37765,Ace,1981-01-01,1981,0,0,0,2.436658
37766,Uro,2006-08-25,2006,0,0,0,0.573746
37767,Fun Is Beautiful,1980-01-19,1980,0,0,0,1.75852
37768,Borotalco,1982-01-22,1982,0,0,0,0.015022
37769,The Second Tragic Fantozzi,1976-04-15,1976,0,0,0,4.232902
37770,Fantozzi To The Rescue,1990-01-15,1990,0,0,0,2.504909
37774,The Last Tycoon,1976-11-18,1976,0,0,0,2.709464
37775,"Bianco, rosso e Verdone",1981-02-20,1981,0,0,0,4.178734
37776,Dead Fury,2008-08-05,2008,0,0,0,0.417365
37777,Soap and Water,1983-10-27,1983,0,0,0,2.058947
37779,The Last Flight,2009-11-05,2009,24000000,0,-24000000,3.106936
37780,The Sensation Of Sight,2006-08-01,2006,0,0,0,0.292292
37786,Sex and the City 2,2010-05-26,2010,100000000,288347692,188347692,7.255991
37789,R.O.D - Read or Die,2001-05-23,2001,0,0,0,0.134032
37793,Ghosts,1997-09-04,1997,0,0,0,1.281344
37797,Whisper of the Heart,1995-07-15,1995,0,0,0,10.550235
37799,The Social Network,2010-09-30,2010,40000000,224920315,184920315,16.972995
37801,Lewis Black:  Black on Broadway,2004-05-14,2004,0,0,0,0.430497
37803,The Movie Tokyo Friends: The Movie,2006-08-12,2006,0,0,0,0.293786
37810,Eyes Wide Open,2009-05-20,2009,0,0,0,1.362835
37813,Shadow,2010-05-14,2010,0,0,0,2.949394
37816,Dark Island,2010-05-22,2010,0,0,0,1.012268
37817,Oh My God!,2007-03-30,2007,0,0,0,2.04761
37818,The Allnighter,1987-05-01,1987,0,0,0,0.612445
37820,Death in Brunswick,1990-11-08,1990,0,0,0,0.913987
37821,Killers,2010-06-04,2010,75000000,98159963,23159963,6.540621
37822,Badmaash Company,2010-05-07,2010,6250000,8500000,2250000,1.490661
37828,Armadillo,2010-05-27,2010,1500000,0,-1500000,2.333307
37832,Mammuth,2010-04-21,2010,0,0,0,1.744295
37833,Reefer Madness,1936-01-15,1936,100000,0,-100000,1.602866
37834,Knight and Day,2010-06-15,2010,117000000,261930431,144930431,12.758942
37835,The Exterminator,1980-09-10,1980,0,0,0,3.576607
37839,Bunker Palace Hotel,1989-01-01,1989,0,0,0,0.849358
37840,Love Me Not,2006-11-09,2006,0,0,0,0.621995
37842,Wild Grass,2009-05-20,2009,0,0,0,2.055282
37843,Blood Beach,1980-09-01,1980,2000000,0,-2000000,2.232045
37845,French Roast,2008-09-30,2008,0,0,0,0.997772
37848,The Treasure Hunter,2009-12-09,2009,0,0,0,1.254761
37849,The Robbers,2009-11-20,2009,0,0,0,0.381294
37850,Rebellion,2009-10-08,2009,0,0,0,0.917119
37851,Hooked on the Game 2. The Next Level,2010-04-15,2010,3500000,2294357,-1205643,0.884241
37853,Mister Roberts,1955-07-13,1955,0,0,0,2.593458
37857,Don's Plum,2001-02-10,2001,0,6297,6297,5.339888
37858,Bandaged,2009-04-03,2009,0,0,0,0.276734
37861,Valhalla Rising,2009-09-04,2009,5641880,30638,-5611242,8.651468
37865,Buried Alive,1990-05-09,1990,0,0,0,1.963322
37866,The Polar Bear King,1991-11-28,1991,0,0,0,0.611756
37873,Shinsengumi: Assassins of Honor,1969-12-05,1969,0,0,0,1.157489
37876,Andrew Dice Clay: One Night with Dice,1987-05-16,1987,0,0,0,0.024904
37900,Hell's Kitchen,1998-09-11,1998,6000000,0,-6000000,2.973539
37903,The White Ribbon,2009-05-21,2009,15238800,0,-15238800,11.059855
37905,The Horde,2009-08-28,2009,0,0,0,5.319546
37910,Voices of a Distant Star,2002-02-02,2002,0,0,0,3.85131
37911,5 Against the House,1955-06-10,1955,0,0,0,1.094261
37916,Swept Away,1974-12-18,1974,0,0,0,1.614531
37917,Honkytonk Man,1982-12-15,1982,0,0,0,3.793634
37918,The Agronomist,2003-09-21,2003,0,0,0,0.250206
37920,An American Rhapsody,2001-06-22,2001,0,850225,850225,4.284793
37921,In Harm's Way,1965-04-06,1965,0,0,0,2.29139
37922,Unconditional Love,2002-08-23,2002,0,0,0,8.173719
37923,Last Embrace,1979-05-04,1979,0,0,0,1.483958
37924,Sweeney Todd,2006-01-03,2006,0,0,0,3.996675
37925,Celine: Through the Eyes of the World,2010-02-17,2010,0,0,0,0.115143
37926,"Abraxas, Guardian of the Universe",1990-12-18,1990,0,0,0,0.59923
37927,Statues Also Die,1953-05-01,1953,0,0,0,0.362516
37928,Cencoroll,2009-08-22,2009,0,0,0,1.05118
37929,Fortress,1985-11-24,1985,0,0,0,1.134903
37931,MacGruber,2010-05-21,2010,10000000,6110000,-3890000,11.107782
37932,Flicka 2,2010-05-04,2010,0,0,0,1.669915
37933,Tales from Earthsea,2006-07-29,2006,22000000,68000000,46000000,9.409701
37935,One Dark Night,1983-02-01,1983,978000,0,-978000,1.301316
37936,Happy Birthday to Me,1981-05-15,1981,0,0,0,6.558858
37938,Stranger in Our House,1978-10-31,1978,0,0,0,1.361976
37939,Youth of the Beast,1963-04-21,1963,0,0,0,1.610094
37941,Vinnaithaandi Varuvaayaa,2010-02-26,2010,3000000,12000000,9000000,1.036233
37942,City of Fear,1959-02-01,1959,0,0,0,0.304594
37943,Eureka,1983-05-01,1983,0,123572,123572,1.721489
37947,Snakehead Terror,2004-01-01,2004,0,0,0,1.7636
37949,A Monkey's Tale,1999-06-02,1999,0,0,0,0.281748
37950,Charlie St. Cloud,2010-05-01,2010,44000000,48190704,4190704,6.273131
37951,Raajneeti,2010-06-04,2010,0,0,0,1.043552
37952,The Weeping Meadow,2004-02-20,2004,0,0,0,1.249402
37954,The Breaking Point,1950-10-06,1950,0,0,0,1.826074
37958,Immortals,2011-11-10,2011,75000000,226904017,151904017,10.363671
37959,GO,2001-10-20,2001,0,0,0,1.416314
37961,Kaiji: The Ultimate Gambler,2009-10-10,2009,0,0,0,1.769717
37963,Phobia 2,2009-09-23,2009,0,0,0,1.463995
37964,Brown Sugar,2002-10-05,2002,8000000,27362712,19362712,3.142874
37969,The Incredible Journey,1963-11-20,1963,0,0,0,1.791587
37973,Alone,2007-03-28,2007,0,0,0,2.205727
37975,The Star Maker,1995-09-21,1995,0,0,0,1.702639
37978,Niagara Motel,2005-03-23,2005,0,0,0,0.479042
37984,Eye in the Sky,2007-06-21,2007,0,0,0,1.225718
37985,The Trials Of Darryl Hunt,2007-06-15,2007,0,0,0,0.153671
37988,Vares: Private Eye,2004-07-22,2004,0,0,0,0.944547
37991,Don Camillo in Moscow,1965-09-17,1965,0,0,0,1.757168
37992,Phantom Lady,1944-01-28,1944,0,0,0,2.014953
37993,Angels of the Sun,2006-03-04,2006,0,0,0,0.300501
37997,Permanent Vacation,1980-01-01,1980,0,0,0,2.212593
37998,Freeze Me,2000-05-23,2000,0,0,0,0.36883
38000,Rainbow Eyes,2007-12-27,2007,0,0,0,0.186752
38006,The Abominable Snowman,1957-08-26,1957,0,0,0,4.719784
38007,Ira & Abby,2006-01-01,2006,0,0,0,1.238213
38008,Ghosts of Cit√© Soleil,2006-01-01,2006,0,0,0,0.106679
38010,Fish Story,2009-03-20,2009,0,0,0,1.525928
38011,Diary of June,2005-12-01,2005,0,0,0,0.695878
38013,Hanging Garden,2005-10-08,2005,0,0,0,0.836703
38015,Tazza: The High Rollers,2006-09-28,2006,0,0,0,1.874722
38017,Letters From a Killer,1998-08-21,1998,0,0,0,1.453073
38018,Strayed,2003-08-20,2003,0,0,0,2.202524
38019,Sunflower,2005-09-10,2005,0,0,0,0.630693
38020,Planet of Dinosaurs,1977-11-18,1977,0,0,0,0.858026
38021,Changing Times,2004-01-01,2004,0,0,0,1.475074
38022,Amar Akbar Anthony,1977-01-02,1977,0,0,0,0.618416
38023,The Young in Heart,1938-07-06,1938,0,0,0,0.645252
38025,Invisible Waves,2006-03-02,2006,0,0,0,1.274388
38027,Mandingo,1975-06-06,1975,0,0,0,2.854369
38030,Jiang Hu,2004-05-26,2004,0,0,0,1.259639
38031,You Will Meet a Tall Dark Stranger,2010-05-23,2010,22000000,0,-22000000,6.36477
38033,Chain Letter,2010-10-01,2010,0,0,0,2.726794
38034,The Heroine,1973-04-26,1973,0,0,0,6.374456
38035,Sweet Sugar,1972-06-09,1972,0,0,0,1.308294
38043,Shag,1989-07-21,1989,0,0,0,1.096473
38046,Retrograde,2004-11-02,2004,2000000,0,-2000000,1.755974
38047,Eureka,2000-05-18,2000,0,0,0,1.955392
38048,The Wild Stallion,2009-10-06,2009,0,0,0,0.189995
38049,In His Hands,2005-01-01,2005,0,0,0,0.258096
38050,The Adjustment Bureau,2011-03-03,2011,50200000,127869379,77669379,9.420301
38052,Please Vote for Me,2007-01-01,2007,0,0,0,0.171225
38054,Princess Aurora,2005-01-01,2005,0,0,0,1.092424
38055,Megamind,2010-10-28,2010,130000000,321887208,191887208,11.603905
38057,The Secret of the Magic Gourd,2007-06-29,2007,0,0,0,1.10277
38060,The Lorax,1972-02-14,1972,0,0,0,1.689215
38061,Anybody's Son Will Do,,,0,0,0,0.0
38065,Salvage,2006-01-01,2006,25000,0,-25000,1.112933
38073,Going the Distance,2010-09-01,2010,32000000,42045846,10045846,6.876053
38074,Zeder,1983-08-25,1983,0,0,0,0.011656
38077,Red Dust,1932-10-22,1932,0,0,0,1.108833
38080,The Judge and the Assassin,1976-03-10,1976,0,0,0,0.699883
38082,Love and Bullets,1979-01-01,1979,0,0,0,1.53506
38084,House III: The Horror Show,1989-04-28,1989,0,1738897,1738897,2.171427
38087,Mystery Team,2009-08-28,2009,0,0,0,3.010717
38091,Nobody Knows Anybody,1999-11-26,1999,0,0,0,0.458272
38093,Just Wright,2010-05-14,2010,0,21520719,21520719,8.870325
38096,Last Summer,1969-06-10,1969,0,3,3,1.10941
38099,Hand of Death,1976-07-15,1976,0,0,0,4.070091
38107,The Star Packer,1934-07-30,1934,0,0,0,1.067416
38111,The Third Jihad,2008-01-01,2008,0,0,0,0.107065
38117,Beastly,2011-01-21,2011,17000000,43165571,26165571,7.364563
38119,Neil Young & Crazy Horse: Rust Never Sleeps,1979-08-15,1979,0,0,0,0.126661
38120,Zombies of Mora Tau,1957-03-01,1957,0,0,0,0.823628
38124,Tales From the Script,2009-01-10,2009,0,0,0,2.016411
38125,Curse of the Fly,1965-05-01,1965,0,0,0,1.168944
38126,Return of the Fly,1959-07-01,1959,0,0,0,4.804353
38129,Martin Lawrence: You So Crazy,1994-04-27,1994,0,0,0,0.394194
38132,My 5 Wives,2000-09-08,2000,0,0,0,0.743283
38134,Vicious Lips,1986-01-01,1986,0,0,0,0.275547
38135,The Debut,2000-05-18,2000,1000000,0,-1000000,0.212418
38138,A Fork in the Road,2010-04-20,2010,0,0,0,2.203307
38140,To Rob a Thief,2007-08-31,2007,4002313,6,-4002307,1.02071
38141,World Gone Wild,1987-10-01,1987,0,0,0,0.515717
38142,5 Centimeters per Second,2007-03-03,2007,5000000,0,-5000000,11.324028
38143,The Story of Qiu Ju,1992-10-02,1992,0,0,0,2.063614
38145,Robert Schimmel: Unprotected,1999-01-01,1999,0,0,0,0.454925
38147,"Oh, God! Book II",1980-10-03,1980,0,0,0,1.189834
38148,"Oh, God! You Devil",1984-11-07,1984,0,0,0,0.634045
38150,Heartless,2009-11-21,2009,0,0,0,3.977054
38151,It Started in Naples,1960-08-06,1960,0,0,0,1.029336
38153,Shadow Conspiracy,1997-01-31,1997,45000000,2154540,-42845460,3.733574
38154,Lorelei: The Witch of the Pacific Ocean,2005-03-05,2005,0,0,0,0.355432
38155,Zu: Warriors from the Magic Mountain,1983-02-05,1983,0,0,0,1.401607
38156,The Big I Am,2010-04-07,2010,0,0,0,1.903759
38157,Wishmaster 4: The Prophecy Fulfilled,2002-06-10,2002,0,0,0,2.637066
38162,Top of the World,1998-01-01,1998,0,0,0,0.594651
38163,Bernard and Doris,2006-09-01,2006,0,0,0,1.333473
38164,Chaos,1984-11-22,1984,0,0,0,1.133154
38165,The Mysterious Island,1973-03-17,1973,0,0,0,1.398672
38166,The Stranger,2010-06-01,2010,0,0,0,1.23558
38167,Eat Pray Love,2010-08-12,2010,60000000,204594016,144594016,15.904834
38171,Anastasia,1956-12-13,1956,3520000,0,-3520000,3.504149
38178,Sign 'o' the Times,1987-11-20,1987,0,0,0,0.002001
38183,The Hire: Ambush,2001-01-01,2001,0,0,0,0.910518
38185,The Hire: Hostage,2002-01-01,2002,0,0,0,1.043612
38187,The Hire: Powder Keg,2001-01-01,2001,0,0,0,1.30639
38189,The Hire: The Follow,2001-01-01,2001,0,0,0,1.203082
38190,The Hire: Ticker,2002-01-01,2002,0,0,0,1.194806
38191,The Sunchaser,1996-05-29,1996,0,0,0,2.35809
38195,Bambou,2009-07-08,2009,0,0,0,0.184114
38198,Itinerary of a Spoiled Child,1988-11-30,1988,0,0,0,2.477377
38199,Unthinkable,2010-06-14,2010,15000000,0,-15000000,6.983803
38201,Framed,1975-08-01,1975,0,0,0,0.510182
38202,Logan's War:  Bound by Honor,1998-11-01,1998,0,0,0,0.413608
38203,The Wedding Waltz,1988-09-01,1988,0,0,0,0.121574
38205,Kummeli Goldrush,1997-12-05,1997,0,0,0,0.874388
38219,"Yor, the Hunter from the Future",1983-08-19,1983,0,0,0,0.737005
38221,Space Amoeba,1970-08-01,1970,0,0,0,0.570395
38222,On a Clear Day You Can See Forever,1970-06-17,1970,0,0,0,3.453076
38223,Harriet the Spy,1996-07-10,1996,12000000,0,-12000000,4.086563
38225,Wild America,1997-07-02,1997,0,0,0,7.477411
38226,Moonbase,1997-12-06,1997,0,0,0,0.172094
38234,Undisputed III : Redemption,2010-05-22,2010,3000000,0,-3000000,16.201377
38237,Robo Warriors,1996-01-01,1996,0,0,0,0.110215
38238,The Widows of Thursdays,2009-09-10,2009,0,0,0,0.184002
38243,Fatty Finn,1980-12-18,1980,0,0,0,0.432522
38244,Casa de los Babys,2003-09-05,2003,0,0,0,2.329471
38246,Servants of Twilight,1991-05-01,1991,0,0,0,0.03803
38248,Technotise: Edit & I,2009-04-08,2009,0,0,0,1.487018
38251,Mediterraneo,1991-01-31,1991,0,4532791,4532791,5.557759
38255,Historien om Kim Skov,1981-01-01,1981,0,0,0,0.01575
38256,Hierro,2009-09-26,2009,0,0,0,1.908312
38262,Department Store,1986-01-01,1986,0,0,0,2.892796
38264,Fire of Conscience,2010-04-01,2010,0,0,0,1.377678
38267,War-Gods of the Deep,1965-05-26,1965,0,0,0,1.363235
38268,The War in Space,1977-12-17,1977,0,0,0,0.598144
38269,War of the Colossal Beast,1958-06-04,1958,0,0,0,0.217456
38271,Grand Hotel Excelsior,1982-01-01,1982,0,0,0,1.552341
38273,Calling Dr. Death,1943-12-17,1943,0,0,0,0.795767
38274,Seven Girlfriends,1999-11-06,1999,0,0,0,0.637771
38280,Choking Man,2006-04-01,2006,0,0,0,0.728412
38281,Atomic Rulers,1965-01-01,1965,0,0,0,0.510191
38282,The Witnesses,2007-03-07,2007,0,0,0,1.293938
38285,Il Ragazzo di Campagna,1984-01-01,1984,0,0,0,3.000716
38286,Three Men and a Leg,1997-12-27,1997,0,0,0,5.149498
38289,Eccezzziunale... veramente,1982-01-01,1982,0,0,0,0.002538
38291,Educating Rita,1983-09-21,1983,0,0,0,2.172275
38293,Porridge,1979-08-12,1979,0,0,0,1.225441
38294,Purely Belter,2000-11-03,2000,0,0,0,0.529083
38295,She's So Lovely,1997-08-29,1997,18000000,0,-18000000,2.314911
38303,You Again,2010-09-24,2010,20000000,32005248,12005248,12.820452
38304,Far Away,2001-08-29,2001,0,0,0,0.060327
38307,The Ape,2009-09-01,2009,0,0,0,0.279744
38309,Lucky 13,2005-01-02,2005,0,0,0,1.242629
38310,Firefighters,1985-01-01,1985,0,0,0,2.017345
38311,The Steamroller and the Violin,1961-12-30,1961,0,0,0,1.419898
38313,School of Thieves,1986-09-25,1986,0,0,0,3.080456
38315,Scuola di ladri 2,1987-09-22,1987,0,0,0,1.211666
38317,Zookeeper,2011-07-06,2011,80000000,169852759,89852759,11.341084
38318,Burnt by the Sun 2: Intercession,2010-04-22,2010,55000000,0,-55000000,7.091212
38319,Your Highness,2011-04-08,2011,49900000,26121638,-23778362,5.67375
38321,Priest,2011-05-05,2011,60000000,78309131,18309131,8.259952
38322,"Big Mommas: Like Father, Like Son",2011-02-16,2011,32000000,83615414,51615414,7.564777
38323,Mama,1976-12-10,1976,0,0,0,1.169625
38325,How I Ended This Summer,2010-02-17,2010,2500000,0,-2500000,2.444839
38326,Yuri's Day,2008-08-12,2008,0,0,0,0.788614
38327,My best enemy,2006-03-10,2006,0,0,0,3.592797
38328,Che ne sar√† di noi,2004-01-01,2004,0,0,0,2.105611
38329,The Adventures of the Electronic,1979-01-01,1979,0,0,0,0.373786
38330,The Perfect Neighbor,2005-09-13,2005,0,0,0,0.308064
38332,Kolya - Rolling Stone,2005-10-13,2005,0,0,0,0.218747
38336,Hipsters,2008-12-25,2008,15000000,16810383,1810383,2.587727
38340,A High Wind in Jamaica,1965-06-04,1965,0,0,0,1.235903
38344,On a Clear Day,2005-08-18,2005,0,0,0,0.662855
38346,Bowery at Midnight,1942-10-30,1942,0,0,0,1.204657
38348,War of the Buttons,1994-09-29,1994,0,0,0,2.166408
38349,Wilby Wonderful,2004-09-13,2004,0,0,0,2.955368
38356,Transformers: Dark of the Moon,2011-06-28,2011,195000000,1123746996,928746996,4.503505
38357,Morning Glory,2010-01-12,2010,40000000,58785180,18785180,10.771255
38358,The Last Exorcism,2010-08-27,2010,1800000,67738090,65938090,6.397109
38359,The Red Snowball Tree,1974-03-25,1974,0,0,0,0.525573
38360,The Cranes Are Flying,1957-10-12,1957,0,0,0,9.524512
38361,"Home Among Strangers, a Stranger Among His Own",1974-11-11,1974,0,0,0,0.907144
38362,High Rollers,1976-08-12,1976,0,0,0,1.457168
38363,Fair Game,2010-05-20,2010,22000000,24188922,2188922,6.303785
38364,The Square Peg,1958-12-04,1958,0,0,0,1.311922
38365,Grown Ups,2010-06-24,2010,80000000,271430189,191430189,23.981251
38366,The Cyclone,1996-01-01,1996,0,0,0,4.815947
38368,Uncle Boonmee Who Can Recall His Past Lives,2010-05-21,2010,0,0,0,3.380308
38371,The Career of Nikos Dyzma,2002-03-15,2002,0,0,0,1.170163
38373,Demons of War,1998-03-20,1998,0,0,0,0.293433
38376,Nathalie...,2003-09-11,2003,0,0,0,1.213791
38381,Just My Luck,1957-11-14,1957,0,0,0,0.234146
38382,Man of the Moment,1955-01-01,1955,0,0,0,0.462887
38389,Up in the World,1956-01-01,1956,0,0,0,0.926374
38395,Scene of the Crime,1949-07-28,1949,0,0,0,0.474896
38396,That's Life,1998-01-01,1998,0,0,0,4.800415
38397,"La leggenda di Al, John e Jack",2002-01-01,2002,0,0,0,3.757084
38398,Just Bea,2004-01-23,2004,0,0,0,0.455098
38399,Foon,2005-11-30,2005,1645885,0,-1645885,0.119301
38404,Bela Lugosi Meets a Brooklyn Gorilla,1952-09-04,1952,0,0,0,0.107203
38407,Shanghai,2010-06-10,2010,50000000,0,-50000000,7.370332
38408,Life As We Know It,2010-10-02,2010,38000000,105610124,67610124,7.824962
38409,Erasing David,2009-01-01,2009,0,0,0,0.160763
38410,The Poughkeepsie Tapes,2007-04-27,2007,0,0,0,6.036528
38414,Fresh Bait,1995-03-08,1995,0,0,0,1.343707
38415,Bran Nue Dae,2009-08-09,2009,7,7,0,0.265854
38417,The Thief,1952-10-15,1952,0,0,0,0.905746
38421,Joy House,1964-06-12,1964,0,0,0,0.568238
38425,Fantasy Mission Force,1983-02-13,1983,0,0,0,1.603767
38427,Heidi,1968-11-17,1968,0,0,0,1.086392
38429,Alive Day Memories: Home from Iraq,2007-09-09,2007,0,0,0,0.129789
38430,Seventeen Moments in Spring,1973-01-01,1973,0,0,0,0.977018
38432,The Tarnished Angels,1957-11-21,1957,0,0,0,1.309422
38433,Bulldog Drummond Comes Back,1937-09-24,1937,0,0,0,0.161802
38437,Bulldog Drummond Escapes,1937-04-21,1937,0,0,0,0.112882
38438,Buffet Froid,1979-12-19,1979,0,0,0,1.540335
38440,Gangster,2006-04-28,2006,0,0,0,0.720185
38442,The Firemen's Ball,1967-12-15,1967,0,0,0,2.589616
38445,The Strength of Water,2009-08-27,2009,0,0,0,0.075993
38446,Frightmare,1974-11-05,1974,0,0,0,0.689582
38448,Ondine,2009-09-14,2009,12000000,1644755,-10355245,4.757269
38450,The Last Hard Men,1976-04-22,1976,0,0,0,1.095995
38453,The Black Camel,1931-06-21,1931,0,0,0,0.377614
38454,Charlie Chan on Broadway,1937-09-22,1937,0,0,0,0.839146
38455,Charlie Chan at Monte Carlo,1937-12-17,1937,0,0,0,0.714825
38456,Charlie Chan's Murder Cruise,1940-05-02,1940,0,0,0,0.860084
38457,Charlie Chan at the Wax Museum,1940-09-06,1940,0,0,0,0.514756
38458,Charlie Chan in Panama,1940-03-01,1940,0,0,0,0.380712
38459,Murder Over New York,1940-12-13,1940,0,0,0,0.816624
38460,Dead Men Tell,1941-03-28,1941,0,0,0,0.359691
38461,Charlie Chan in Rio,1941-09-05,1941,0,0,0,0.477933
38462,Charlie Chan in the Secret Service,1944-02-14,1944,0,0,0,0.738818
38463,The Chinese Cat,1944-05-20,1944,0,0,0,0.773964
38464,Black Magic,1944-08-19,1944,0,0,0,0.301454
38465,The Shanghai Cobra,1945-09-29,1945,0,0,0,0.710153
38467,The Scarlet Clue,1945-05-11,1945,0,0,0,0.477824
38468,The Jade Mask,1945-01-26,1945,0,0,0,0.807733
38469,Shadows Over Chinatown,1946-06-27,1946,0,0,0,0.211814
38470,Dangerous Money,1946-10-12,1946,0,0,0,0.578904
38471,Dark Alibi,1946-05-25,1946,0,0,0,0.600083
38472,The Trap,1946-11-30,1946,0,0,0,0.603541
38494,The Mysterious Mr. Wong,1934-12-22,1934,0,0,0,0.274155
38499,The Howling: New Moon Rising,1995-01-01,1995,0,0,0,1.089187
38500,Howling IV: The Original Nightmare,1988-11-01,1988,0,0,0,1.666704
38502,The Necessities of Life,2008-08-25,2008,0,0,0,0.16008
38503,Christina's House,2000-02-24,2000,0,0,0,1.305349
38505,"One, Two, Three, Sun",1993-08-18,1993,0,0,0,1.510005
38509,Polish Wedding,1998-01-16,1998,0,0,0,4.387797
38510,How to Make a Monster,2001-10-14,2001,0,0,0,1.372241
38516,Karol: A Man Who Became Pope,2005-04-18,2005,0,0,0,1.1978
38517,The Brooke Ellison Story,2004-01-01,2004,0,0,0,6.560524
38523,Ponette,1996-09-10,1996,0,0,0,0.409967
38526,Bangkok Adrenaline,2009-05-14,2009,0,0,0,0.6146
38530,Symmetry,2003-09-16,2003,0,0,0,0.593173
38531,Back Stage,1919-09-07,1919,0,0,0,0.717345
38540,Age of Heroes,2011-05-19,2011,0,0,0,2.990369
38541,The Divide,2011-03-13,2011,3000000,22000,-2978000,7.406609
38542,The Disappearance of Alice Creed,2009-09-12,2009,800000,867714,67714,7.271526
38543,Ironclad,2011-03-03,2011,25000000,0,-25000000,12.17054
38545,The Unbelievable Truth,1989-04-01,1989,0,0,0,2.407454
38546,Three Wise Guys,2005-11-30,2005,0,0,0,0.059979
38547,7 Kocalƒ± H√ºrm√ºz,2009-11-20,2009,0,0,0,0.307432
38548,Margaret Cho: I'm the One That I Want,2000-07-01,2000,0,0,0,0.109302
38551,Snakes and Earrings,2008-09-20,2008,0,0,0,2.307249
38553,Shelter Island,2003-02-01,2003,0,0,0,0.422043
38554,Dear God,1996-11-01,1996,0,0,0,1.952957
38556,Tough Enough,1983-05-20,1983,0,0,0,0.413716
38557,The River,1984-12-01,1984,18000000,11500000,-6500000,6.303384
38558,Shakedown,1988-05-06,1988,0,0,0,1.596442
38560,Sunset,1988-04-29,1988,16000000,4594452,-11405548,1.835663
38568,Howl,2010-08-26,2010,30000,617000,587000,5.416588
38570,The 41‚ÄìYear‚ÄìOld Virgin Who Knocked Up Sarah Marshall and Felt Superbad About It,2010-06-08,2010,0,0,0,6.138381
38575,The Karate Kid,2010-06-10,2010,40000000,357852395,317852395,11.690781
38577,The Old Man and the Sea,1999-07-03,1999,0,0,0,2.295286
38579,Marmaduke,2010-06-04,2010,50000000,83761844,33761844,12.285545
38580,The Little Matchgirl,2006-09-07,2006,0,0,0,3.529071
38582,Godzilla vs. Mechagodzilla,1974-03-20,1974,0,0,0,1.931568
38583,Separate Lies,2005-09-16,2005,0,0,0,1.14753
38585,A Study in Scarlet,1933-05-14,1933,0,0,0,0.613837
38594,Dragon Ball: Yo! Son Goku and Friends Return!!,2008-10-01,2008,0,0,0,3.217392
38601,Part of the Weekend Never Dies,2008-04-24,2008,0,0,0,1.517989
38602,Little Lord Fauntleroy,1980-11-25,1980,0,0,0,6.821649
38604,Kamui,2009-09-19,2009,0,0,0,1.621692
38606,The Trouble with Angels,1966-03-29,1966,0,0,0,1.452646
38608,Power Trip,2003-12-17,2003,0,0,0,0.092029
38610,Automatic,1995-04-08,1995,0,0,0,0.330638
38611,The Sacketts,1979-05-08,1979,0,0,0,0.341176
38614,Romantik Komedi,2010-02-05,2010,0,0,0,0.838318
38615,Heartbreak Hotel,1988-09-30,1988,0,0,0,0.732975
38616,Marjoe,1972-07-24,1972,0,0,0,0.06978
38617,Off Limits,1988-03-11,1988,12000000,7242035,-4757965,11.516965
38618,Tarzan and the Lost City,1998-04-24,1998,0,0,0,0.740462
38621,Firelight,1997-09-14,1997,0,0,0,5.57396
38622,Gormenghast,2000-01-17,2000,0,0,0,1.44482
38625,Battle Under Orion,2009-06-13,2009,0,0,0,0.855191
38626,Going Postal,2010-05-30,2010,0,0,0,5.818278
38629,Bear Island,1979-12-05,1979,12200000,0,-12200000,1.854507
38631,Confessions of a Burning Man,2003-10-23,2003,0,0,0,0.28021
38636,Dancing Outlaw II: Jesco Goes to Hollywood,1999-01-01,1999,0,0,0,0.286328
38637,Vaaranam Aayiram,2008-11-14,2008,3000000,14000000,11000000,0.505589
38638,Divine Horsemen: The Living Gods of Haiti,1985-01-01,1985,0,0,0,0.003553
38643,Los Angeles Plays Itself,2003-09-07,2003,0,0,0,1.678293
38645,And Then Came Lola,2009-01-01,2009,0,0,0,1.319694
38646,Nicholas and Alexandra,1971-11-29,1971,0,0,0,1.952752
38652,River of Death,1989-09-29,1989,0,0,0,0.901269
38654,When Eight Bells Toll,1971-03-09,1971,0,0,0,1.317333
38655,"Boeing, Boeing",1965-12-22,1965,0,0,0,1.476618
38659,Ride a Crooked Trail,1958-09-01,1958,0,0,0,1.597373
38661,Tarzan Escapes,1936-11-06,1936,0,0,0,1.610075
38662,The Hurricane Express,1932-08-01,1932,0,0,0,0.546163
38665,The Legend of the Lone Ranger,1981-08-20,1981,18000000,2945600,-15054400,1.38292
38666,The Wild and the Innocent,1959-05-27,1959,0,0,0,0.314313
38668,The Eternal Jew,1940-11-28,1940,0,0,0,1.595573
38670,The Five Man Army,1969-10-16,1969,0,0,0,0.996376
38674,Trailer Park Boys,1999-07-15,1999,0,0,0,2.158798
38677,Adhurs,2010-01-13,2010,0,0,0,0.570528
38680,40 Guns to Apache Pass,1967-05-01,1967,0,0,0,1.158998
38681,Mission Bloody Mary,1965-08-13,1965,0,0,0,0.018488
38683,Cobra Woman,1944-05-12,1944,0,0,0,0.694724
38684,Jane Eyre,2011-03-11,2011,0,34710627,34710627,7.089084
38687,Flesh and the Devil,1926-12-25,1926,373000,658000,285000,0.765315
38688,Pandora and the Flying Dutchman,1951-02-15,1951,0,0,0,1.10641
38691,Coney Island,1917-10-29,1917,0,0,0,0.684674
38695,Monsieur Hire,1989-05-24,1989,0,0,0,1.561092
38697,Hollywood Canteen,1944-12-31,1944,0,0,0,0.46387
38700,Bad Boys for Life,2018-11-07,2018,0,0,0,2.178546
38701,The Devil's Rain,1975-07-01,1975,0,0,0,1.750414
38702,Reckless,1984-02-03,1984,0,0,0,1.383981
38705,Convict 13,1920-10-27,1920,0,0,0,0.817589
38706,The Sect,1991-03-01,1991,0,0,0,1.883218
38714,Save the Tiger,1973-02-14,1973,0,0,0,0.974663
38715,Cobra,1925-01-02,1925,0,0,0,0.220388
38716,Rebecca of Sunnybrook Farm,1938-03-18,1938,0,0,0,0.493065
38717,Madison,2001-01-23,2001,0,0,0,1.534055
38718,Reversal of Fortune,1990-10-05,1990,0,15445131,15445131,7.929751
38719,The Private Life of Don Juan,1934-01-01,1934,0,0,0,0.373596
38720,Walk Don't Run,1966-01-01,1966,0,0,0,1.900797
38721,Wife vs. Secretary,1936-02-28,1936,0,0,0,4.722337
38722,My Family,1995-05-03,1995,5500000,0,-5500000,3.121288
38724,Some Came Running,1958-12-18,1958,0,0,0,1.796844
38726,Stage Door Canteen,1943-06-24,1943,0,0,0,0.789004
38727,Susannah of the Mounties,1939-06-13,1939,0,0,0,0.978316
38728,A Colt Is My Passport,1967-02-04,1967,0,0,0,0.332499
38729,A Delicate Balance,1973-11-12,1973,0,0,0,0.09179
38730,A Fool There Was,1915-01-12,1915,0,0,0,0.303639
38731,An Unmarried Woman,1978-05-26,1978,2515000,24000000,21485000,1.148295
38732,Bend of the River,1952-02-13,1952,0,0,0,2.062483
38742,Cops,1922-03-15,1922,0,0,0,1.42553
38743,The Dukes,2007-04-23,2007,0,0,0,0.334768
38745,Gulliver's Travels,2010-12-25,2010,112000000,237382724,125382724,7.565799
38746,Bare Knuckles,2010-01-01,2010,0,0,0,0.327457
38749,Jack the Bear,1993-04-02,1993,0,0,0,5.063771
38751,The Man Who Cheated Himself,1950-12-26,1950,0,0,0,0.543796
38753,Passion Play,2010-09-10,2010,8000000,0,-8000000,7.230431
38757,Tangled,2010-11-24,2010,260000000,591794936,331794936,14.684761
38759,The Saga of Gosta Berling,1924-03-09,1924,0,0,0,0.356157
38761,Night of the Lepus,1972-10-04,1972,0,0,0,1.179811
38765,Chisum,1970-07-23,1970,6000000,0,-6000000,3.334076
38766,Halls of Montezuma,1951-01-04,1951,0,0,0,0.78686
38769,Little Miss Broadway,1938-07-29,1938,0,0,0,0.58126
38770,Major Barbara,1941-05-14,1941,0,0,0,0.318553
38772,Melvin and Howard,1980-09-19,1980,0,0,0,6.737435
38773,Three on a Couch,1966-03-01,1966,0,0,0,1.821423
38774,Mr. Moto Takes a Chance,1938-06-24,1938,0,0,0,0.539182
38775,Night Tide,1961-08-15,1961,0,0,0,0.91597
38778,Dinner for Schmucks,2010-07-30,2010,69000000,86387857,17387857,11.623718
38780,Rampage,2009-08-14,2009,0,0,0,5.085308
38782,The Wind in the Willows,1983-12-27,1983,0,0,0,0.948788
38783,Trilogy of Terror,1975-03-04,1975,0,0,0,1.488031
38785,The Boys of Baraka,2005-03-11,2005,0,0,0,0.077318
38787,Day Dreams,1922-11-15,1922,0,0,0,1.697152
38789,I Manegen med Glenn Killing: Live fr√•n Berns,1995-09-30,1995,0,0,0,0.002328
38792,Those Daring Young Men in Their Jaunty Jalopies,1969-04-28,1969,0,0,0,4.336514
38794,Tosun Pasha,1976-01-01,1976,64200,698200,634000,0.91597
38800,The Rare Breed,1966-02-02,1966,0,0,0,5.046033
38802,For the Love of Benji,1977-06-10,1977,0,0,0,0.022568
38804,The Emperor Waltz,1948-06-07,1948,0,0,0,1.300086
38805,Lilies of the Field,1963-06-04,1963,0,0,0,1.114368
38807,Badman's Territory,1946-01-04,1946,0,0,0,0.623176
38808,The Man from the Alamo,1953-08-07,1953,0,0,0,1.229874
38809,Black and White,1999-09-04,1999,10000000,5241315,-4758685,1.191035
38810,Dogtooth,2009-06-01,2009,0,110197,110197,17.713581
38811,The Great Madcap,1949-11-25,1949,0,0,0,0.872592
38812,Hard Luck,1921-03-14,1921,0,0,0,0.543829
38821,The Tough Ones,1999-01-14,1999,1143000,0,-1143000,0.559
38828,Left Behind III: World at War,2005-01-01,2005,0,0,0,0.756699
38830,My Wife's Relations,1922-05-15,1922,0,0,0,1.049141
38831,Lady with the Dog,1960-01-28,1960,0,0,0,0.494283
38834,The Year of the Wolf,2007-12-05,2007,0,0,0,0.167646
38837,Unfinished Piece for Mechanical Piano,1977-09-05,1977,0,0,0,1.201266
38842,Middle Men,2009-05-17,2009,22000000,0,-22000000,7.095445
38843,Ramona and Beezus,2010-07-23,2010,0,0,0,7.467591
38846,The Beautiful Person,2008-09-12,2008,0,0,0,2.291742
38849,Android,1982-10-15,1982,0,0,0,1.295139
38850,Stolen,2009-10-10,2009,2000000,7306,-1992694,2.300459
38866,Between Strangers,2002-08-30,2002,0,0,0,0.410523
38867,Delta of Venus,1995-06-09,1995,0,62949,62949,1.099187
38868,A Decade Under the Influence,2003-04-25,2003,0,0,0,0.381538
38869,Wyj≈õcie awaryjne,1982-12-25,1982,0,0,0,6e-06
38870,Komedia malzenska,1994-05-07,1994,0,0,0,0.001177
38872,Kiler-√≥w 2-√≥ch,1999-01-08,1999,0,0,0,0.991107
38874,Don't Tempt Me,2001-11-30,2001,1200000,0,-1200000,1.214691
38875,Senno≈õƒá,2008-10-17,2008,0,0,0,0.271583
38876,"W≈Çatcy m√≥ch. ƒÜmoki, Czopki i Mondzio≈Çy",2009-02-13,2009,0,0,0,0.008064
38877,Not the Messiah (He's a Very Naughty Boy),2010-03-25,2010,0,0,0,4.829942
38878,She's Too Young,2004-02-16,2004,0,0,0,0.384404
38879,The Beaches of Agn√®s,2008-12-17,2008,0,0,0,0.440432
38880,Promises,2001-01-01,2001,0,0,0,0.549502
38883,Protect and Serve,2010-01-03,2010,0,0,0,1.936988
38884,Land and Freedom,1995-01-01,1995,0,0,0,6.144235
38890,Great Guns,1941-10-10,1941,0,0,0,0.783975
38898,Night Train,1959-09-06,1959,0,0,0,2.230891
38901,"Milwaukee, Minnesota",2003-01-21,2003,0,17350,17350,0.656954
38904,Mrs. Dalloway,1997-09-01,1997,0,3309421,3309421,1.335544
38907,West,2002-05-23,2002,0,0,0,0.565893
38908,Film Geek,2005-01-25,2005,0,0,0,0.723122
38909,Salsa,1988-07-09,1988,0,8892589,8892589,1.659488
38911,Yasmin,2004-08-07,2004,0,0,0,1.230355
38913,Awakening,2008-04-29,2008,0,0,0,0.407417
38914,Here Comes Mr. Jordan,1941-08-07,1941,0,0,0,1.123158
38916,Modern Girls,1986-11-07,1986,0,0,0,6.060204
38918,Kiss me Kismet,2006-03-30,2006,0,0,0,1.39567
38920,The Club,1980-09-18,1980,0,0,0,0.475739
38921,Burglar,1987-03-20,1987,0,0,0,1.417505
38922,Fatso,1980-02-01,1980,0,0,0,0.578345
38923,High School U.S.A.,1983-10-16,1983,0,0,0,1.278839
38925,The Lords of Flatbush,1974-05-01,1974,160000,4000000,3840000,1.391503
38931,Oh My God,2009-11-13,2009,0,0,0,1.566266
38932,Holy Water,2009-07-01,2009,0,0,0,0.743612
38937,Adopted,2009-01-01,2009,0,0,0,0.15901
38939,Tales from the Crypt,1972-03-09,1972,0,0,0,4.407775
38940,Men of War,1994-09-04,1994,0,0,0,3.323673
38941,How Much Does the Trojan Horse Weigh?,2008-12-26,2008,0,0,0,0.406783
38944,The Leaning Tower,2006-10-20,2006,0,0,0,0.401608
38950,Hero and the Terror,1988-08-26,1988,0,0,0,3.541487
38951,Charly,2002-09-20,2002,0,0,0,0.775503
38953,Ryan's Daughter,1970-12-09,1970,0,0,0,4.340461
38955,Project S,1993-10-21,1993,0,0,0,1.262539
38960,A Song for Martin,2001-03-16,2001,0,0,0,0.156531
38961,Tamara Drewe,2010-07-14,2010,0,0,0,10.201299
38962,Murder by Proxy,1954-03-19,1954,0,0,0,0.495447
38963,Going by the Book,2007-08-18,2007,0,14961069,14961069,1.066558
38964,Stolen Face,1952-05-01,1952,0,0,0,0.10767
38965,18 Again!,1988-04-08,1988,0,0,0,1.555163
38966,The Night Before,1988-04-15,1988,0,0,0,3.351537
38967,Nobody's Perfect,1990-02-02,1990,0,0,0,0.444066
38970,"Remember Me, My Love",2003-02-11,2003,0,0,0,4.996071
38971,Pavement: Slow Century,2002-10-22,2002,0,0,0,0.042737
38977,A Stranger of Mine,2005-07-16,2005,0,0,0,1.955782
38978,Ned Kelly,1970-07-01,1970,0,0,0,0.695389
38980,The Wild Life,1984-09-28,1984,0,9500000,9500000,7.093984
38981,Seven Minutes in Heaven,1985-05-09,1985,0,0,0,7.636506
38982,Fresh Horses,1988-11-18,1988,0,0,0,4.782781
38983,Attack the Gas Station 2,2010-01-21,2010,0,0,0,0.275271
38984,Coco Chanel & Igor Stravinsky,2009-12-30,2009,0,5753490,5753490,2.277923
38985,Sorcerer,1977-06-24,1977,22000000,12000000,-10000000,13.966833
38986,The Party Animal,1984-07-18,1984,0,0,0,0.634612
38987,Possible Worlds,2000-01-01,2000,0,0,0,0.811769
38988,5150 Elm's Way,2009-10-09,2009,0,0,0,2.646218
38995,Caf√© solo o con ellas,2007-06-19,2007,0,0,0,0.193364
38996,Dead of Night,1974-08-28,1974,0,0,0,1.937881
39001,My Teacher's Wife,1999-11-10,1999,0,0,0,2.843628
39002,No Holds Barred,1989-06-02,1989,8000000,16093651,8093651,0.863547
39005,The Crimson Permanent Assurance,1983-01-01,1983,0,0,0,1.400679
39008,The Year of the Hare,1977-12-23,1977,0,0,0,0.680347
39013,Winter's Bone,2010-06-11,2010,2000000,13831503,11831503,7.27941
39015,Sailor Beware,1952-02-08,1952,0,0,0,0.58554
39016,Living It Up,1954-07-15,1954,0,0,0,0.449448
39023,Dead Time,2007-04-19,2007,0,0,0,0.369155
39024,The Forbidden Door,2009-01-22,2009,0,0,0,0.763369
39026,Costa Rican Summer,2010-05-24,2010,0,0,0,1.796242
39027,Kickboxer 3: The Art of War,1992-06-11,1992,0,0,0,2.426706
39029,Kill!,1968-06-22,1968,0,0,0,0.678387
39037,The Good Guy,2009-04-25,2009,3200000,0,-3200000,6.269507
39039,Awaara,1951-04-07,1951,0,0,0,0.59037
39041,The Conrad Boys,2006-01-01,2006,0,0,0,0.563318
39042,Multiple Sarcasms,2010-05-07,2010,0,0,0,0.332584
39043,Countess Dracula,1971-01-31,1971,0,0,0,1.979907
39044,The Curse of the Mummy's Tomb,1964-10-18,1964,0,0,0,1.942771
39045,Pinocchio and the Emperor of the Night,1987-08-06,1987,8000000,3261638,-4738362,0.743274
39048,The Locked Door,1929-11-16,1929,0,0,0,0.263857
39053,Cyrus,2010-06-18,2010,7000000,0,-7000000,10.42001
39055,Free Style,2008-12-24,2008,0,140987,140987,0.739681
39056,Ritual,2000-12-07,2000,0,0,0,0.606866
39057,Pok√©mon: Arceus and the Jewel of Life,2009-07-18,2009,0,50673078,50673078,2.969691
39060,What's Up with Love?,2002-02-08,2002,0,0,0,0.427357
39061,Gie,2005-07-13,2005,0,0,0,1.085018
39062,Coupe de Ville,1990-03-09,1990,0,715,715,5.168379
39064,Joni's Promise,2005-04-26,2005,0,0,0,0.24535
39067,Macabre,2009-10-08,2009,0,0,0,1.542516
39072,Happy Tears,2009-10-16,2009,0,0,0,0.891071
39074,The Bedroom Window,1987-01-16,1987,0,0,0,4.187498
39083,Blackjack,1998-06-11,1998,0,0,0,1.685334
39084,Once a Thief,1996-09-29,1996,0,0,0,0.691361
39088,Tycoon,2002-06-06,2002,0,0,0,1.030832
39100,Dragon Ball Z: The World's Strongest,1990-03-10,1990,0,0,0,6.223436
39101,Dragon Ball Z: The Tree of Might,1990-06-07,1990,0,0,0,4.955965
39102,Dragon Ball Z: Lord Slug,1991-03-19,1991,0,0,0,3.961243
39103,Dragon Ball Z: Return of Cooler,1992-03-07,1992,0,0,0,5.46959
39104,Dragon Ball Z: Super Android 13,1992-07-11,1992,0,0,0,4.854487
39105,Dragon Ball Z: Bojack Unbound,1993-07-10,1993,0,0,0,5.229103
39106,Dragon Ball Z: Bio-Broly,1994-07-09,1994,0,0,0,4.252
39107,Dragon Ball Z: Fusion Reborn,1995-03-04,1995,0,0,0,6.778755
39108,Dragon Ball Z: Wrath of the Dragon,1995-07-15,1995,0,0,0,5.264225
39111,4bia,2008-04-25,2008,0,0,0,1.716418
39113,Bikini Beach,1964-07-22,1964,0,0,0,0.706082
39123,20th Century Boys - Chapter 3: Our Flag,2009-08-19,2009,0,0,0,0.918276
39125,Love the Hard Way,2003-03-27,2003,0,0,0,1.955042
39127,Ripley Under Ground,2005-11-06,2005,0,0,0,2.591725
39128,Ernest In The Army,1998-02-24,1998,0,0,0,1.08121
39129,Slam Dunk Ernest,1995-06-20,1995,0,0,0,0.77623
39130,Dinner at Eight,1933-08-29,1933,0,0,0,1.633915
39137,The Private Life of Plants,1995-01-01,1995,0,0,0,0.288119
39140,Funny About Love,1990-09-21,1990,0,0,0,0.831716
39141,Tadpole,2002-11-01,2002,150000,2891288,2741288,9.203416
39142,The Battle of the Rails,1946-02-27,1946,0,0,0,0.177342
39144,Dragon Ball: Curse of the Blood Rubies,1986-12-20,1986,0,0,0,2.71067
39145,Dragon Ball: Sleeping Princess in Devil's Castle,1987-07-18,1987,0,0,0,2.981616
39148,Dragon Ball: The Path to Power,1996-03-02,1996,0,0,0,2.175262
39154,The Giant Spider Invasion,1975-10-01,1975,300000,0,-300000,0.808843
39155,Bulletproof Salesman,2008-03-10,2008,0,0,0,0.003763
39164,House of the Long Shadows,1983-06-17,1983,7500000,0,-7500000,1.185515
39166,The Black Pimpernel,2007-09-14,2007,5000000,0,-5000000,0.481556
39172,After,2009-10-23,2009,0,0,0,0.396803
39176,The Awakening,1980-07-31,1980,0,0,0,1.004992
39177,Artemisia,1997-09-10,1997,0,0,0,0.989115
39179,Surplus: Terrorized Into Being Consumers,2003-11-21,2003,0,0,0,0.341109
39180,See Spot Run,2001-03-02,2001,0,0,0,10.47844
39183,Once in a Lifetime: The Extraordinary Story of the New York Cosmos,2006-01-01,2006,1000000,0,-1000000,0.110813
39185,Winning Time: Reggie Miller vs. The New York Knicks,2010-03-14,2010,0,0,0,1.130406
39193,Firecracker,2005-10-11,2005,0,0,0,0.115112
39194,Rhinoceros,1974-01-21,1974,0,0,0,0.083894
39195,Spontaneous Combustion,1990-02-23,1990,0,0,0,1.250266
39197,Miss Firecracker,1989-04-28,1989,0,0,0,6.250816
39209,Shalako,1968-11-06,1968,1455000,2620000,1165000,6.229674
39210,Somewhere,2010-09-03,2010,8000000,0,-8000000,7.098301
39211,W.W. and the Dixie Dancekings,1975-05-21,1975,0,0,0,0.457418
39213,Coach,2010-06-13,2010,0,0,0,3.708888
39214,"Boy, Did I Get a Wrong Number!",1966-06-08,1966,0,0,0,0.320794
39217,Maine Pyaar Kyun Kiya,2005-07-15,2005,0,0,0,0.581967
39219,The Facts of Life,1960-11-14,1960,0,0,0,0.264959
39220,I'll Take Sweden,1965-06-18,1965,0,0,0,1.025312
39222,The Kiss of the Vampire,1963-09-11,1963,0,0,0,0.820649
39225,With Six You Get Eggroll,1968-08-07,1968,0,0,0,2.938017
39227,When in Rome,2002-11-26,2002,0,0,0,3.732537
39229,Mobile Suit Gundam II: Soldiers of Sorrow,1981-07-11,1981,0,0,0,0.886893
39230,Mobile Suit Gundam III: Encounters in Space,1982-03-13,1982,0,0,0,0.149422
39231,Man's Favorite Sport?,1964-01-29,1964,0,0,0,3.070786
39233,Once Around,1991-01-18,1991,0,0,0,0.869616
39239,British Sounds,1970-01-01,1970,0,0,0,0.027537
39240,The Truth,2010-05-20,2010,0,0,0,0.594305
39241,The Human Dutch,1963-01-01,1963,250000,0,-250000,0.200911
39242,The Other Me,2000-09-08,2000,0,0,0,1.691634
39243,Off Beat,1986-04-10,1986,0,0,0,1.27024
39246,Talhotblond,2009-02-01,2009,0,0,0,1.395757
39253,Lucky Trouble,2011-01-12,2011,0,0,0,2.709273
39254,Real Steel,2011-09-28,2011,110000000,299268508,189268508,19.265552
39256,Godzilla 1985,1984-12-15,1984,2000000,4100000,2100000,2.894009
39260,RoboGeisha,2009-10-03,2009,0,0,0,4.341112
39261,The House That Dripped Blood,1971-06-16,1971,0,0,0,1.2985
39262,The Mummy's Shroud,1967-03-15,1967,0,0,0,2.446438
39263,Blood from the Mummy's Tomb,1971-06-16,1971,0,0,0,6.353881
39264,Godzilla vs. Megalon,1973-03-17,1973,760000,0,-760000,2.298163
39266,Triumph of the Will,1935-03-28,1935,0,0,0,4.558863
39269,Out of the Blue,1980-05-01,1980,0,0,0,2.057876
39274,The Challenge,1982-07-23,1982,0,0,0,0.3985
39276,King Kong Escapes,1967-07-22,1967,0,0,0,1.324961
39278,Missing,2008-06-12,2008,0,0,0,1.104995
39279,AM1200,2008-10-03,2008,0,0,0,0.523995
39282,Funny Lady,1975-03-15,1975,0,0,0,1.528577
39283,Carnosaur,1993-05-21,1993,1000000,1753979,753979,0.293373
39284,To Joy,1950-02-20,1950,0,0,0,0.515892
39285,Beauty & the Briefcase,2010-07-20,2010,0,0,0,5.794289
39286,Four Last Songs,2007-01-11,2007,0,0,0,0.550246
39287,Stagecoach,1966-04-21,1966,0,0,0,0.631761
39288,Morning Departure,1950-02-21,1950,0,0,0,0.727709
39293,The Human Factor,1979-12-18,1979,0,0,0,0.510856
39298,Frozen Days,2005-01-01,2005,0,0,0,0.011092
39301,Someone to Run With,2006-07-13,2006,0,0,0,0.289787
39303,2:13,2009-04-25,2009,3500000,0,-3500000,0.861213
39305,Children of Beslan,2005-01-01,2005,0,0,0,0.07304
39306,The 13th Letter,1951-02-21,1951,0,0,0,0.281938
39308,Slave Girls,1967-02-25,1967,0,0,0,1.018994
39309,Wonderwall,1968-05-17,1968,0,0,0,1.051944
39310,New Jersey Drive,1995-04-19,1995,0,0,0,0.629955
39311,Murders in the Zoo,1933-03-31,1933,0,0,0,0.228654
39312,Restrepo,2010-06-25,2010,0,1422910,1422910,4.577881
39314,Mighty Joe Young,1949-07-27,1949,94,0,-94,2.812461
39315,Tykho Moon,1996-11-28,1996,0,0,0,1.19659
39317,Money Is Not Everything,2001-01-05,2001,0,0,0,0.113477
39318,Alias Jesse James,1959-03-20,1959,0,0,0,0.677904
39319,Tales of Vesperia: The First Strike,2009-10-03,2009,0,0,0,1.227391
39323,Dragon Ball Z: Bardock - The Father of Goku,1990-10-17,1990,0,0,0,3.959933
39324,Dragon Ball Z: The History of Trunks,1993-02-24,1993,0,0,0,3.781296
39327,The Music of Chance,1993-06-23,1993,0,0,0,0.769841
39331,The Body,2003-08-22,2003,0,0,0,0.541255
39333,180¬∞ South: Conquerors of the Useless,2010-02-10,2010,0,0,0,1.005463
39334,Hannah Free,2009-12-11,2009,0,0,0,0.370737
39335,Moebius,1996-10-17,1996,0,0,0,0.419892
39337,Lewis Black: Stark Raving Black,2009-10-08,2009,0,0,0,0.671906
39340,Behind Convent Walls,1978-01-25,1978,0,0,0,1.224938
39341,Big Bad Wolf,2006-10-25,2006,0,0,0,3.467833
39342,Fight for Your Life,1977-10-03,1977,0,0,0,1.233805
39345,Casper Meets Wendy,1998-09-08,1998,0,0,0,4.457964
39346,Casper: A Spirited Beginning,1997-09-09,1997,0,0,0,11.869785
39347,Hello Brother,1999-09-09,1999,0,0,0,0.179068
39348,Sacco and Vanzetti,2006-04-06,2006,0,31894,31894,0.240888
39349,Sugar Hill,1994-02-25,1994,0,0,0,2.157297
39356,Boy,2010-02-14,2010,3,43,40,3.308503
39358,London River,2009-02-09,2009,0,0,0,3.176543
39368,Flu Bird Horror,2008-08-23,2008,0,0,0,1.326206
39369,French Film,2008-12-05,2008,0,0,0,1.019161
39371,L'allenatore nel pallone,1984-10-26,1984,0,0,0,0.13914
39376,Tales from the Golden Age,2009-05-29,2009,0,0,0,0.685049
39378,The Wind Journeys,2009-04-30,2009,0,0,0,1.038141
39382,Ivanhoe,1982-02-23,1982,0,0,0,1.049948
39385,La v√©rit√© si je mens !,1997-04-01,1997,4000000,29456000,25456000,5.099557
39386,The Corsican File,2004-10-06,2004,0,0,0,4.542654
39387,Loves of a Blonde,1965-12-12,1965,0,0,0,1.598199
39391,Gypsy,1962-12-01,1962,0,0,0,2.184068
39395,Summer Holiday,2008-01-01,2008,0,0,0,0.472286
39398,Waiting for Armageddon,2009-01-01,2009,0,0,0,0.156913
39400,Labors of Hercules,1958-02-20,1958,0,0,0,1.077227
39401,The Secrets of Jonathan Sperry,2008-04-27,2008,1000000,0,-1000000,0.305672
39402,Hercules Unchained,1959-02-14,1959,0,0,0,0.807818
39406,My Chauffeur,1986-01-24,1986,0,0,0,0.185346
39407,The Climax,1944-10-20,1944,0,0,0,0.804396
39408,The Creature Walks Among Us,1956-04-26,1956,0,0,0,0.546229
39409,The Strange Door,1951-06-21,1951,0,0,0,1.08745
39410,Mothra,1961-07-30,1961,0,0,0,1.935424
39412,Emmanuelle 3,1977-12-15,1977,0,0,0,2.224085
39413,My Afternoons with Margueritte,2010-06-02,2010,0,0,0,4.730143
39414,Paper Man,2009-06-15,2009,0,0,0,6.072397
39415,Loulou,1980-09-03,1980,0,0,0,1.982488
39422,Door on the Left as You Leave the Elevator,1988-08-31,1988,0,0,0,1.499816
39424,Music from Another Room,1998-04-24,1998,0,0,0,1.131018
39428,The Neon Bible,1995-08-23,1995,0,0,0,0.370342
39433,The Front,2010-04-17,2010,5000000,0,-5000000,0.879077
39434,The Stendhal Syndrome,1996-01-26,1996,0,0,0,3.326404
39435,Cowboy,1958-02-19,1958,0,0,0,4.314564
39436,Sleepless,2001-01-05,2001,4000000,0,-4000000,2.001031
39437,Beloved,1998-10-16,1998,0,0,0,1.557283
39440,Waiting for 'Superman',2010-09-24,2010,0,0,0,2.718721
39442,Sergio,2009-01-20,2009,0,0,0,0.006632
39446,At Risk,2010-04-10,2010,5000000,0,-5000000,9.502186
39448,"Yes, Madam",1985-01-01,1985,0,0,0,1.060097
39449,Steel Frontier,1995-03-28,1995,0,0,0,0.163373
39450,White on Rice,2009-05-31,2009,0,0,0,0.204236
39451,Little Fockers,2010-12-21,2010,100000000,310650585,210650585,9.73941
39452,Exit Through the Gift Shop,2010-01-24,2010,0,4790751,4790751,5.188466
39453,Death and Cremation,2010-06-15,2010,0,0,0,0.967814
39458,I Got Next,2011-06-13,2011,10000,0,-10000,0.157802
39459,The Oklahoma Kid,1939-03-11,1939,0,0,0,0.894215
39462,Godzilla's Revenge,1969-12-20,1969,150000,0,-150000,1.334439
39463,True Blue,1996-11-15,1996,0,0,0,0.426634
39464,Godzilla vs. Hedorah,1971-07-24,1971,250000,0,-250000,2.631502
39465,Godzilla vs. Mothra,1992-12-12,1992,0,0,0,1.838219
39466,Godzilla vs. SpaceGodzilla,1994-12-10,1994,10300000,0,-10300000,1.728526
39467,Still Breathing,1997-09-01,1997,0,0,0,1.161851
39468,Godzilla vs. Megaguirus,2000-11-03,2000,8300000,0,-8300000,2.073747
39469,Godzilla: Tokyo S.O.S.,2003-12-13,2003,0,0,0,1.892602
39472,Man Trouble,1992-07-17,1992,30,4,-26,0.83333
39473,Silent Fall,1994-10-28,1994,30000000,3180674,-26819326,3.034244
39477,Small Town Saturday Night,2010-05-31,2010,0,0,0,4.922475
39485,Hotel Sahara,1951-12-31,1951,0,0,0,0.532447
39486,Secretariat,2010-08-20,2010,35000000,60251371,25251371,7.681383
39488,Giant,2009-01-01,2009,0,0,0,0.734235
39493,Goth,2008-12-20,2008,0,0,0,0.553858
39494,Private Detective 62,1933-06-10,1933,0,0,0,0.503424
39495,Love with the Proper Stranger,1963-12-25,1963,0,0,0,3.028502
39497,Escanaba in da Moonlight,2001-01-26,2001,0,0,0,0.153041
39503,Inside Moves,1980-12-19,1980,0,0,0,0.178039
39504,Moolaad√©,2004-08-04,2004,0,214605,214605,0.759538
39506,Story of a Prostitute,1965-02-28,1965,0,0,0,0.524014
39507,The Dead,1987-09-03,1987,0,0,0,1.543035
39509,Cold Storage,2009-05-01,2009,0,0,0,0.105417
39510,Blood Tea and Red String,2006-10-04,2006,0,0,0,0.303121
39513,Paul,2011-02-14,2011,40000000,97552050,57552050,10.24382
39514,RED,2010-10-13,2010,58000000,71664962,13664962,12.595165
39516,The Fallen,2004-01-01,2004,0,0,0,0.650079
39517,Clapham Junction,2007-07-22,2007,0,0,0,1.754729
39519,Beach Red,1967-08-03,1967,0,0,0,0.923161
39522,Mega Piranha,2010-04-10,2010,3000000,0,-3000000,6.600017
39535,Tarot,1973-01-01,1973,0,0,0,0.000578
39536,The Amazing Johnathan: Wrong on Every Level,2006-11-18,2006,0,0,0,0.063139
39538,Contagion,2011-09-08,2011,60000000,137551594,77551594,8.244359
39541,Stolen Summer,2002-03-22,2002,0,0,0,1.329626
39543,Mon Oncle d'Am√©rique,1980-05-21,1980,0,0,0,6.545371
39544,Oblivion Island: Haruka and the Magic Mirror,2009-08-22,2009,0,0,0,1.919196
39545,TiMER,2009-05-14,2009,0,0,0,5.081422
39554,Doc Savage: The Man of Bronze,1975-06-01,1975,0,0,0,1.028259
39557,Decision at Sundown,1957-11-10,1957,0,0,0,1.805429
39558,Face of a Fugitive,1959-05-01,1959,0,0,0,2.216087
39562,To Be Fat Like Me,2007-01-08,2007,0,0,0,0.767762
39563,The Eclipse,2009-04-24,2009,0,0,0,8.585525
39567,Jack the Ripper,1976-09-23,1976,0,0,0,1.486499
39578,The Monster Club,1981-04-11,1981,0,0,0,2.055833
39641,Adrift,2009-07-31,2009,0,0,0,2.312705
39681,Seven Days,2010-06-22,2010,0,0,0,2.775577
39690,The Weathering Continent,1992-06-21,1992,0,0,0,0.0796
39691,Cats & Dogs 2 : The Revenge of Kitty Galore,2010-07-30,2010,85000000,112483764,27483764,7.941637
39693,Echoes of the Rainbow,2010-04-11,2010,0,0,0,1.867779
39695,The Rains of Ranchipur,1956-03-23,1956,0,0,0,0.663348
39704,KISS Meets the Phantom of the Park,1978-10-28,1978,0,0,0,1.431692
39749,Dr√∂mk√•ken,1993-10-29,1993,0,0,0,0.382586
39750,Stonehenge Apocalypse,2010-01-01,2010,0,0,0,1.010072
39751,Drunken Monkey,2002-12-06,2002,0,0,0,0.924708
39764,Glass: A Portrait of Philip in Twelve Parts,2007-09-07,2007,0,20,20,0.498877
39766,The Challenge,1970-02-10,1970,0,0,0,0.233947
39767,Getting Any?,1994-01-01,1994,0,0,0,1.797279
39768,Beware of the Car!,1966-01-01,1966,0,0,0,1.449833
39770,Brief Crossing,2001-03-06,2001,0,0,0,1.895977
39771,The Lady in Red,1979-07-01,1979,0,0,0,0.85977
39772,Little Crumb,1999-12-22,1999,0,0,0,0.155577
39773,Just Peck,2009-01-01,2009,0,0,0,0.868951
39775,Caged Heat,1974-04-19,1974,180000,0,-180000,2.030808
39776,Peking Opera Blues,1986-09-06,1986,0,0,0,0.773614
39779,Portrait in Black,1960-07-27,1960,0,0,0,1.099834
39780,Oscar and Lucinda,1997-12-31,1997,0,0,0,1.462571
39781,The Kids Are All Right,2010-07-09,2010,3500000,34705850,31205850,5.899155
39785,Pulling John,2009-01-01,2009,0,0,0,0.110588
39786,Visual Acoustics,2009-10-09,2009,0,0,0,0.817628
39787,Jacknife,1989-03-10,1989,0,0,0,8.158307
39788,Vinci,2004-09-17,2004,0,0,0,1.599269
39793,First Love,2000-04-01,2000,0,0,0,0.632282
39797,Att stj√§la en tjuv,1996-12-25,1996,0,0,0,0.370968
39798,Bashing,2005-05-12,2005,0,0,0,0.279208
39800,Life During Wartime,2009-10-10,2009,4500000,744816,-3755184,3.311392
39806,Princess Kaiulani,2010-05-14,2010,9000000,771499,-8228501,1.818296
39814,Salvage,2010-03-22,2010,0,0,0,1.494051
39816,The Pool,2008-09-03,2008,0,0,0,0.196489
39824,The Sitter,2007-09-16,2007,0,0,0,1.131975
39827,The Who: Thirty Years of Maximum R&B,1994-08-15,1994,0,0,0,0.01426
39829,The Six Million Dollar Man,1973-03-07,1973,0,0,0,1.418486
39830,Bass Ackwards,2010-01-23,2010,0,0,0,0.772541
39833,Love Me Tender,1956-11-15,1956,1000000,9000000,8000000,1.157582
39834,Violent Saturday,1955-04-01,1955,0,0,0,1.21996
39837,Yaadein,2001-01-01,2001,0,0,0,0.451303
39839,Baghban,2003-01-01,2003,0,1100000,1100000,1.482993
39840,"If I Want to Whistle, I Whistle",2010-03-26,2010,0,0,0,1.498166
39844,Deranged,1974-02-02,1974,200000,0,-200000,2.400628
39845,Love Ranch,2010-06-30,2010,0,0,0,4.753132
39849,Enlighten Up!,2008-01-01,2008,0,0,0,0.00353
39850,Eros,2004-09-09,2004,0,0,0,3.497789
39851,Clean,2004-09-01,2004,0,0,0,2.767142
39853,The Cat Concerto,1947-04-25,1947,0,0,0,1.411151
39857,The Untold Story,1993-05-13,1993,0,0,0,1.590232
39859,See No Evil,1971-09-02,1971,0,0,0,0.732123
39861,Corruption,1968-07-18,1968,0,0,0,0.931555
39867,Don't Go in the House,1980-03-28,1980,250000,0,-250000,1.811797
39868,Evilspeak,1981-08-22,1981,1000000,0,-1000000,1.120185
39871,The Major and the Minor,1942-09-16,1942,0,0,0,1.283194
39872,Female Prisoner Scorpion: Jailhouse 41,1972-12-30,1972,0,0,0,1.01857
39874,My Bloody Valentine,1981-02-11,1981,2200000,0,-2200000,3.407098
39875,Popcorn,1991-02-01,1991,0,0,0,3.399036
39882,Schoolgirls in Chains,1973-01-01,1973,45000,0,-45000,0.054443
39885,School of the Holy Beast,1974-02-16,1974,0,0,0,1.941312
39889,The Candy Snatchers,1973-01-01,1973,0,0,0,0.002001
39890,The City of the Dead,1960-09-09,1960,0,0,0,1.514972
39891,The Devil Rides Out,1968-07-20,1968,0,0,0,3.974766
39893,The Nanny,1965-10-27,1965,0,0,0,1.433802
39895,From a Whisper to a Scream,1987-09-25,1987,1100000,1400000,300000,1.392022
39899,Turkey Shoot,1982-03-25,1982,32000000,0,-32000000,5.409525
39901,Knockabout,1979-04-12,1979,0,0,0,1.132673
39902,Rigoletto,1993-07-13,1993,0,0,0,0.000844
39903,Solstorm,2007-11-02,2007,0,0,0,0.797786
39907,Bang Rajan,2000-12-29,2000,0,0,0,1.148337
39914,Chaos,2005-08-10,2005,0,0,0,0.615145
39915,Green Snake,1993-04-10,1993,0,0,0,1.189603
39916,Contamination,1980-08-02,1980,0,0,0,1.06063
39922,The Sinful Dwarf,1973-12-20,1973,0,0,0,1.182635
39925,Fear in the Night,1972-07-09,1972,0,0,0,0.018596
39927,Freeway II: Confessions of a Trickbaby,1999-09-10,1999,0,0,0,0.552559
39928,H6: Diary of a Serial Killer,2005-01-01,2005,0,0,0,0.976804
39929,Hello Mary Lou: Prom Night II,1987-11-13,1987,0,2683519,2683519,5.383766
39930,"Henry II, Portrait of a Serial Killer",1996-10-10,1996,0,0,0,1.597247
39931,Mark of the Devil,1970-02-19,1970,0,0,0,1.631239
39933,Toe to Toe,2010-02-26,2010,0,0,0,0.234749
39934,Longtime Companion,1990-05-01,1990,0,0,0,0.89738
39936,All That I Love,2009-05-13,2009,0,0,0,0.375059
39938,Little Women,1933-11-24,1933,424,0,-424,3.277545
39939,Super Troopers,2001-01-18,2001,3000000,18492362,15492362,7.351028
39940,Picnic,1955-11-18,1955,0,0,0,8.500509
39943,To the Ends of the Earth,1948-02-07,1948,0,0,0,0.249965
39946,The Browning Version,1951-04-06,1951,0,0,0,1.039215
39948,Two Way Stretch,1960-12-20,1960,0,0,0,2.486721
39953,"Boys Life: Three Stories of Love, Lust, and Liberation",1994-09-30,1994,0,0,0,0.054148
39957,Burning Bright,2012-05-02,2012,0,0,0,3.446584
39958,The War Boys,2009-05-30,2009,0,0,0,1.132012
39959,Open House,2010-08-03,2010,0,0,0,1.124815
39961,The Land Before Time XIII: The Wisdom of Friends,2007-11-27,2007,0,0,0,2.212037
39962,Tamala 2010: A Punk Cat in Space,2002-10-19,2002,0,0,0,0.355372
39964,Lost & Found,1999-04-23,1999,1,100,99,1.337096
39965,Emmanuelle in Bangkok,1976-05-06,1976,0,0,0,1.584748
39967,L.627,1992-09-09,1992,0,0,0,0.470823
39968,Western,1997-05-09,1997,0,0,0,0.575924
39973,The Mountain of the Cannibal God,1978-05-23,1978,0,0,0,1.917511
39978,The Twin,1984-10-10,1984,0,0,0,1.03469
39979,The Big Racket,1976-08-12,1976,0,0,0,0.681936
39982,Just Before Dawn,1981-10-14,1981,0,0,0,1.239
39983,Chaos,2000-06-30,2000,0,0,0,1.095095
39987,Gestapo's Last Orgy,1977-01-21,1977,0,0,0,1.491001
39988,Late Night Trains,1975-04-09,1975,0,0,0,1.190145
39991,A Blade in the Dark,1983-08-06,1983,0,0,0,4.04674
39992,House of Clocks,1989-01-01,1989,0,0,0,0.114406
39993,Short Night of Glass Dolls,1971-10-21,1971,0,0,0,1.812472
39994,Deported Women of the SS Special Section,1975-12-31,1975,0,0,0,0.876006
39995,Long Weekend,1978-10-14,1978,0,0,0,2.209843
39998,The Fruit is Swelling,1997-03-12,1997,0,0,0,2.023832
40000,Mom,1991-01-01,1991,0,0,0,0.991827
40001,Mrs. Winterbourne,1996-04-19,1996,25000000,10070000,-14930000,9.1861
40004,Never Say... Never!,2005-09-28,2005,0,0,0,0.648189
40012,Raising Jeffrey Dahmer,2006-04-13,2006,0,0,0,0.041153
40016,Birdemic: Shock and Terror,2010-02-27,2010,0,0,0,2.52968
40017,Kalyug,2005-12-09,2005,0,0,0,0.14583
40022,Caliber 9,1972-02-15,1972,0,0,0,3.855015
40025,Black Ransom,2010-01-07,2010,0,0,0,2.041582
40026,Night Shadows,1984-08-01,1984,2500000,0,-2500000,2.97235
40028,Not of This Earth,1988-05-20,1988,210000,107352,-102648,1.569865
40029,The Bamboo House of Dolls,1973-12-21,1973,0,0,0,1.026093
40034,Fade to Black,1980-10-14,1980,0,0,0,0.988408
40039,Spiders,2000-01-01,2000,0,0,0,1.831412
40040,Spiders 2: Breeding Ground,2001-01-01,2001,0,0,0,1.168436
40041,Dead Kids,1981-10-16,1981,0,0,0,0.705654
40043,Island of Death,1976-04-26,1976,0,0,0,1.710088
40044,Tarzan Finds a Son!,1939-06-16,1939,0,0,0,2.40912
40045,Tarzan's New York Adventure,1942-05-01,1942,0,0,0,4.17024
40047,Elvis,1979-02-10,1979,2100000,0,-2100000,2.034144
40048,In My Sleep,2010-04-23,2010,0,0,0,0.963613
40054,Too Shy to Try,1978-01-01,1978,0,0,0,1.166358
40055,Le Grand pardon,1982-01-27,1982,0,0,0,0.433724
40056,Prom Queen: The Marc Hall Story,2004-06-01,2004,0,0,0,0.189572
40059,The Deadly Spawn,1983-04-22,1983,0,0,0,0.938534
40060,The Manitou,1978-04-28,1978,0,0,0,1.664737
40061,Happy Easter,1984-10-24,1984,0,0,0,1.432816
40064,To the Devil a Daughter,1976-03-04,1976,0,0,0,2.130583
40069,Premonition,2004-01-01,2004,0,0,0,1.002051
40070,Seeding of a Ghost,1983-12-29,1983,0,0,0,0.683008
40071,Darlings!,1984-02-08,1984,0,0,0,1.090473
40072,Spetters,1980-02-28,1980,0,0,0,2.222694
40074,Alucarda,1977-03-10,1977,0,0,0,2.363613
40075,"Ator, the Fighting Eagle",1982-10-07,1982,0,0,0,0.878669
40080,The Cutting Edge: Fire & Ice,2010-03-14,2010,0,0,0,5.749906
40081,Crippled Avengers,1978-12-20,1978,0,0,0,4.022324
40082,The Mambo Kings,1992-02-28,1992,0,6742168,6742168,4.705045
40083,Sometimes a Great Notion,1970-12-31,1970,0,0,0,1.985376
40084,Caligula and Messalina,1981-01-01,1981,0,0,0,2.88405
40085,"The Long, Hot Summer",1958-04-03,1958,0,0,0,12.158012
40087,Cheerleader Camp,1988-06-01,1988,0,0,0,1.33987
40090,Dirt! The Movie,2009-08-07,2009,0,0,0,0.126466
40092,The Secret Life of Walter Mitty,1947-09-01,1947,0,0,0,3.039934
40095,Dead Heat,1988-05-06,1988,5000000,0,-5000000,3.201914
40096,A Dog's Will,2000-09-10,2000,0,0,0,23.950396
40102,Don't Answer the Phone!,1980-02-29,1980,0,0,0,1.242731
40113,The Pentagon Papers,2003-03-09,2003,0,0,0,1.127757
40119,Drop,2009-03-20,2009,0,0,0,0.642808
40120,John Pinette: I Say Nay Nay,2005-01-25,2005,0,0,0,0.224245
40121,Cheer Cheer Cheer!,2008-10-11,2008,0,0,0,0.195913
40122,Gangster High,2006-10-19,2006,0,0,0,1.045262
40123,Genius Party,2007-07-07,2007,0,0,0,1.113388
40127,Art of the Devil,2004-05-14,2004,0,0,0,1.01079
40130,The Red Queen Kills Seven Times,1972-08-18,1972,0,0,0,1.01031
40139,Mansion of the Doomed,1976-10-01,1976,0,0,0,1.096474
40140,Marooned,1969-12-11,1969,0,0,0,1.785956
40141,Massacre Time,1966-08-10,1966,0,0,0,1.492622
40145,Murder-Rock: Dancing Death,1984-01-01,1984,0,0,0,0.006668
40146,Night of the Demon,1980-02-04,1980,0,0,0,0.758791
40149,Kuroneko,1968-02-24,1968,0,0,0,1.12463
40154,A Midwinter's Tale,1995-12-01,1995,0,0,0,0.513391
40156,Priest,1994-01-01,1994,0,4176932,4176932,1.881932
40160,Meteor,1979-10-19,1979,0,0,0,4.695793
40161,The Decoy Bride,2011-06-06,2011,0,0,0,11.033977
40162,Porno Holocaust,1981-01-01,1981,0,0,0,1.390499
40165,Salome,1953-03-24,1953,0,0,0,1.12554
40168,Scarecrows,1988-09-28,1988,425000,0,-425000,2.227278
40171,Woochi : The Demon Slayer,2009-12-23,2009,12000000,0,-12000000,3.03345
40172,"Man, Woman & the Wall",2006-10-30,2006,0,0,0,1.74964
40180,Fear Over the City,1975-04-09,1975,0,0,0,1.777789
40192,Je pr√©f√®re qu'on reste amis,2005-02-23,2005,0,0,0,0.900575
40194,Paris Express,2010-02-24,2010,0,0,0,2.689328
40205,16 Wishes,2010-06-25,2010,0,0,0,4.869925
40206,The Inspector General,1949-12-31,1949,0,0,0,0.896505
40208,Shock 'Em Dead,1991-01-31,1991,0,0,0,0.399834
40210,Straight on Till Morning,1972-07-09,1972,0,0,0,0.467991
40211,A Millionaire's First Love,2006-02-09,2006,0,0,0,1.007602
40213,New Dragon Gate Inn,1992-01-01,1992,0,0,0,3.677943
40214,Tarzan's Secret Treasure,1941-12-01,1941,0,0,0,1.290506
40215,The Betrayal (Nerakhoon),2008-11-21,2008,0,0,0,0.075737
40216,Tee for Two,1945-07-21,1945,0,0,0,0.306153
40217,Terminal Invasion,2002-01-01,2002,0,0,0,1.481442
40218,The Beast Must Die,1974-04-01,1974,0,0,0,0.996366
40219,The Beast Within,1982-01-01,1982,0,0,0,0.948859
40220,The Boogey Man,1980-11-07,1980,300000,0,-300000,2.241945
40221,The Borrower,1991-01-01,1991,0,0,0,0.944816
40222,The Brain,1988-11-03,1988,0,0,0,0.748217
40225,Confidence Reigns,2004-11-10,2004,0,0,0,0.173588
40226,The Era of Vampires,2002-01-01,2002,0,0,0,0.512034
40227,Playing for Keeps,1986-10-03,1986,0,0,0,0.076591
40229,The House on Sorority Row,1983-01-21,1983,425000,10604986,10179986,1.918891
40231,The Incredible Melting Man,1977-11-10,1977,250000,0,-250000,1.849651
40235,The Mouse Comes to Dinner,1945-01-01,1945,0,0,0,1.201802
40241,The Unseen,1980-09-01,1980,2000000,0,-2000000,0.86926
40243,Heavenly Forest,2006-10-28,2006,0,0,0,1.454763
40244,The Witches,1966-11-21,1966,0,0,0,1.014505
40246,Rudolph and Frosty's Christmas in July,1979-07-01,1979,0,0,0,0.003013
40247,Please Give,2010-01-22,2010,3000000,0,-3000000,5.630136
40249,They Nest,2000-01-01,2000,4000000,0,-4000000,1.590236
40251,Witchboard 2: The Devil's Doorway,1993-09-10,1993,0,168180,168180,0.960569
40252,Witchboard III: The Possession,1995-01-01,1995,0,0,0,0.350055
40254,Whispering Corridors,1998-05-30,1998,600000,0,-600000,1.219861
40258,Baby Blood,1990-01-01,1990,0,0,0,0.252805
40261,Watch Me When I Kill,1977-08-06,1977,0,0,0,0.207819
40264,Vampires Suck,2010-08-18,2010,20000000,80547866,60547866,8.129407
40341,Carnival of Souls,1998-08-21,1998,2000000,0,-2000000,2.957349
40342,Demons 2,1986-10-09,1986,1500000,0,-1500000,4.453477
40343,Death Weekend,1976-09-17,1976,500000,0,-500000,0.000308
40344,Balloon Farm,1999-03-28,1999,0,0,0,0.367452
40345,Delirium,1972-07-05,1972,0,0,0,1.679664
40346,All for the Winner,1990-01-01,1990,0,0,0,2.090285
40348,Black Emanuelle,1975-11-27,1975,0,0,0,1.479627
40350,Fright,1971-01-01,1971,0,0,0,0.100611
40352,Warriors of the Year 2072,1984-01-28,1984,0,0,0,0.3083
40353,"I, Madman",1989-01-01,1989,0,151203,151203,5.593601
40356,Hell,2005-01-01,2005,0,0,0,0.426947
40364,The Church,1989-03-10,1989,3500000,0,-3500000,3.117965
40365,The Blood Spattered Bride,1972-09-30,1972,0,0,0,1.076492
40368,Nightmare,1981-10-23,1981,0,0,0,3.562622
40373,Waiting for Godot,2001-01-01,2001,0,0,0,0.423981
40374,Breezy,1973-11-18,1973,0,0,0,2.090768
40378,Eggs,1995-05-26,1995,0,0,0,0.216155
40383,The Last Shark,1981-04-02,1981,0,0,0,1.74774
40387,Night Watch,1973-11-08,1973,0,0,0,1.20597
40394,Salon Kitty,1976-03-02,1976,0,0,0,3.947614
40417,Gangsters,2002-02-20,2002,0,0,0,0.27908
40419,Teen Spirit,2007-08-01,2007,0,0,0,0.190335
40420,Cop or Hood,1979-03-28,1979,0,0,0,2.927642
40423,Black Orpheus,1959-01-01,1959,0,0,0,1.888428
40427,Crimson Gold,2003-09-12,2003,0,0,0,1.276138
40428,8: The Mormon Proposition,2010-01-01,2010,0,0,0,0.252886
40430,Journey to the Far Side of the Sun,1969-08-27,1969,0,0,0,5.916841
40432,Planta 4¬™,2003-10-31,2003,0,0,0,0.685347
40435,Super Inframan,1975-01-01,1975,0,0,0,1.234899
40440,The Song Remains the Same,1976-11-05,1976,0,0,0,1.974016
40446,Sorority House Massacre II,1990-10-05,1990,0,0,0,0.763373
40448,The Dead Pit,1989-01-01,1989,350000,0,-350000,0.644665
40451,The Mutilator,1985-01-04,1985,0,0,0,1.159509
40452,Crying Fist,2005-03-31,2005,0,0,0,1.133475
40454,"Follow Me, Boys!",1966-12-01,1966,0,0,0,4.249146
40456,The Viking Queen,1967-03-25,1967,0,0,0,0.62076
40458,Welcome to the Jungle,2007-01-01,2007,0,0,0,1.451427
40460,A Crack in the Floor,2003-07-24,2003,0,0,0,0.332664
40461,Aenigma,1987-11-09,1987,0,0,0,0.800846
40465,Chain Reaction,2006-01-01,2006,1066480,0,-1066480,1.788295
40466,Crocodile,2000-12-26,2000,0,0,0,5.071511
40467,Dawn of the Mummy,1981-12-11,1981,500000,0,-500000,0.283443
40468,Opposing Force,1986-08-01,1986,0,0,0,0.635541
40469,Final Exam,1981-06-05,1981,0,0,0,0.686963
40470,Flirty Birdy,1945-09-22,1945,0,0,0,0.549645
40471,For Y'ur Height Only,1981-01-01,1981,0,0,0,0.015022
40474,Eyeball,1975-01-24,1975,0,0,0,1.013672
40476,Kadosh,1999-01-01,1999,0,0,0,0.186495
40478,Baby Doll,1956-12-18,1956,0,0,0,1.581449
40480,Bad Company,1995-01-20,1995,0,0,0,0.912415
40483,"You're a Good Sport, Charlie Brown",1975-10-28,1975,0,0,0,0.004425
40485,Hot Rods To Hell,1967-01-27,1967,0,0,0,0.71267
40487,Robot Wars,1993-01-01,1993,0,0,0,0.003553
40490,Man of the House,1995-03-03,1995,0,0,0,2.558118
40494,Trapeze,1956-05-30,1956,4000000,14400000,10400000,1.801071
40502,Newcastle,2008-04-25,2008,0,0,0,0.510191
40505,I Got the Hook Up,1998-05-27,1998,0,0,0,0.993716
40506,Meet Wally Sparks,1997-01-01,1997,0,0,0,0.576741
40507,Original Gangstas,1996-05-10,1996,4800000,3014000,-1786000,0.343579
40508,3 Ninjas Knuckle Up,1995-04-07,1995,0,0,0,2.544118
40509,Wrestling Ernest Hemingway,1993-12-17,1993,0,278720,278720,1.09014
40522,I‚Äôm Glad My Mother Is Alive,2009-09-30,2009,0,0,0,0.271272
40534,Jonas Brothers: The Concert Experience,2009-02-27,2009,0,0,0,1.191561
40537,Eyeborgs,2009-04-29,2009,3700000,0,-3700000,2.036393
40544,Ghibli: The Miyazaki Temple,2005-01-07,2005,0,0,0,0.211469
40555,Full Moon in Blue Water,1988-11-23,1988,0,0,0,0.240351
40562,Committed,2000-01-21,2000,3000000,0,-3000000,0.888545
40572,How Bruce Lee Changed the World,2009-05-17,2009,0,0,0,1.018958
40573,The Inheritance or Fuckoffguysgoodday,1992-12-01,1992,0,0,0,0.542265
40574,Girl Shy,1924-04-20,1924,0,0,0,1.153412
40577,Island in the Sky,1953-09-05,1953,0,0,0,6.285648
40578,The Sea Chase,1955-06-04,1955,0,0,0,0.891352
40585,We Will All Meet in Paradise,1977-11-09,1977,0,0,0,0.158781
40592,Loft,2005-10-07,2005,0,0,0,0.770476
40593,Goliath Awaits,1981-11-11,1981,0,0,0,0.455222
40594,Julia Sweeney - Letting Go of God,2008-11-21,2008,0,0,0,0.357063
40599,Red Canyon,2008-01-01,2008,1500000,0,-1500000,0.300118
40600,Hot Moves,1984-10-04,1984,0,0,0,0.78957
40618,Bedtime Story,1964-01-01,1964,0,0,0,0.341946
40619,Day & Night,2010-06-17,2010,0,0,0,6.345512
40623,A Town Called Panic,2009-06-17,2009,0,0,0,2.259456
40624,In the Shadows,2001-06-24,2001,0,0,0,1.310129
40627,Cuisine et d√©pendances,1993-04-06,1993,0,0,0,1.136488
40628,Two Bits,1995-10-22,1995,0,0,0,4.046208
40629,The Mikado,1987-01-01,1987,0,0,0,0.070858
40630,Cheyenne Autumn,1964-10-03,1964,0,0,0,4.248883
40633,Love Me or Leave Me,1955-06-10,1955,0,0,0,1.6561
40634,Nuts,1987-11-20,1987,25000000,0,-25000000,2.258245
40635,Just Desserts,2004-01-01,2004,0,0,0,0.482733
40636,The Rolling Stones: Stones in Exile,2010-05-14,2010,0,0,0,0.726745
40639,Dark Command,1940-04-15,1940,0,0,0,0.759791
40641,Lola,1961-03-03,1961,0,0,0,3.325461
40642,The Secret of Convict Lake,1951-08-03,1951,0,0,0,0.250617
40644,Zat√¥ichi: The Blind Swordsman,1989-02-04,1989,0,0,0,1.204298
40649,Demonic Toys,1992-03-12,1992,0,0,0,4.686159
40650,Le Silence de la Mer,1949-04-22,1949,0,0,0,1.125284
40651,"Institute Benjamenta, or This Dream People Call Human Life",1995-08-01,1995,0,0,0,0.543042
40652,The Married Woman,1964-12-04,1964,120000,0,-120000,0.998151
40653,Herostratus,1967-07-10,1967,0,0,0,0.506447
40655,The Bannen Way,2010-01-06,2010,0,0,0,1.209344
40657,All My Friends Are Funeral Singers,2010-05-25,2010,0,0,0,0.112749
40658,Starsuckers,2009-09-30,2009,0,0,0,0.387703
40660,If You Love,2010-01-06,2010,2000000,0,-2000000,0.368731
40661,Kickboxer 5: The Redemption,1995-08-01,1995,0,0,0,1.82717
40662,Batman: Under the Red Hood,2010-07-27,2010,0,6629178,6629178,7.039325
40663,Gasland,2010-01-24,2010,0,0,0,4.334953
40664,The Interrogation,2009-09-25,2009,0,0,0,0.156862
40669,Jump London,2003-09-03,2003,0,0,0,0.009164
40681,Jailbait!,2000-04-16,2000,0,0,0,0.802462
40682,The Train Robbers,1973-02-07,1973,0,0,0,5.077346
40683,Operation Pacific,1951-01-27,1951,0,0,0,4.02995
40685,In Old California,1942-05-31,1942,0,0,0,0.889252
40687,The Heartbreak Kid,1972-12-17,1972,0,0,0,1.165341
40688,Meet the Deedles,1998-03-27,1998,24000000,4562146,-19437854,7.336354
40690,Classic Albums: Black Sabbath - Paranoid,2010-06-28,2010,0,0,0,1.602628
40692,Ready? OK!,2008-04-17,2008,0,0,0,0.005851
40693,April in Paris,1952-12-24,1952,0,0,0,0.293045
40694,Bedrooms and Hallways,1998-08-01,1998,0,0,0,1.016117
40699,"Rock, Paper, Scissors: The Way of the Tosser",2007-01-01,2007,0,0,0,0.305066
40700,I Give My First Love to You,2009-10-24,2009,0,0,0,2.10293
40701,Love My Life,2006-12-09,2006,0,0,0,0.438354
40709,We Are From The Future,2008-01-01,2008,0,0,0,2.42363
40713,Sky Of Love,2007-11-03,2007,0,44038000,44038000,1.718237
40715,Big Jim McLain,1952-08-30,1952,0,0,0,0.822058
40716,Flame of Barbary Coast,1945-05-28,1945,0,0,0,0.633287
40717,Three Faces West,1940-07-03,1940,0,0,0,0.715666
40718,Wake of the Red Witch,1948-12-30,1948,0,0,0,0.989629
40719,War of the Wildcats,1943-12-06,1943,0,0,0,3.389994
40720,Twelve,2010-07-30,2010,0,0,0,6.782478
40721,The Love God?,1969-08-01,1969,0,0,0,1.02843
40722,How to Make Love to a Woman,2010-07-13,2010,0,0,0,2.291534
40723,Trouble Every Day,2001-07-11,2001,0,0,0,1.707091
40724,Anne of Green Gables: The Sequel,1987-05-19,1987,0,0,0,3.496181
40729,The Gate II: Trespassers,1990-05-24,1990,0,0,0,1.214091
40730,On Borrowed Time,1939-07-07,1939,0,0,0,0.328792
40732,The Emigrants,1971-03-08,1971,0,0,0,2.392021
40739,The Young Lions,1958-04-02,1958,0,0,0,12.654551
40740,Trancers II: The Return of Jack Deth,1991-08-22,1991,0,0,0,2.739095
40741,The Trail of Blood,1972-06-10,1972,0,0,0,0.002671
40743,Winds of the Wasteland,1936-07-06,1936,0,0,0,2.308029
40744,Wicked Woman,1953-12-09,1953,0,0,0,0.480136
40748,"Al Murray, The Pub Landlord - Glass of White Wine for the Lady",2004-11-22,2004,0,0,0,0.003506
40751,Ashes of Time,1994-09-16,1994,0,0,0,5.215992
40752,Walk Like a Man,1987-03-01,1987,0,0,0,0.927452
40760,Sorority House Massacre,1986-10-01,1986,0,0,0,1.872461
40761,Revenge of the Creature,1955-07-22,1955,0,0,0,1.74278
40765,The Ghost Ship,1943-12-24,1943,0,0,0,0.872846
40767,No Man of Her Own,1950-02-21,1950,0,0,0,0.32287
40768,Flag Wars,2003-05-01,2003,0,0,0,0.102116
40769,Mutual Appreciation,2005-03-01,2005,500000,0,-500000,0.3671
40770,Spirit Camp,2009-09-25,2009,0,0,0,0.461786
40771,Meatballs Part II,1984-07-27,1984,0,0,0,1.475532
40772,Meatballs III: Summer Job,1986-10-26,1986,0,0,0,1.667607
40773,Meatballs 4,1992-03-06,1992,0,0,0,0.921189
40774,Midgets Vs. Mascots,2009-05-25,2009,0,0,0,0.48109
40775,The Bostonians,1984-01-01,1984,0,0,0,0.182355
40777,I Hate Luv Storys,2010-07-02,2010,0,0,0,2.045046
40785,Suddenly,2006-12-22,2006,0,0,0,0.778744
40790,Secret of the Incas,1954-06-06,1954,0,0,0,0.657878
40793,The Nickel Ride,1975-01-15,1975,0,0,0,0.534836
40794,Loose Cannons,2010-02-12,2010,7000000,8220215,1220215,5.633243
40797,The Trail Beyond,1934-10-22,1934,0,0,0,0.651179
40798,Americano,2005-01-07,2005,0,0,0,1.116696
40799,West of the Divide,1934-02-15,1934,0,0,0,4.268264
40800,Alligator 2 - The Mutation,1991-12-18,1991,0,0,0,3.52572
40804,Gorgo,1961-02-02,1961,0,0,0,2.796049
40805,The Green Hornet,2011-01-12,2011,120000000,227817248,107817248,7.888013
40807,50/50,2011-09-30,2011,8000000,39187783,31187783,11.869481
40810,The Streetfighter,1974-02-02,1974,0,0,0,0.834969
40812,Return of the Street Fighter,1974-04-27,1974,0,0,0,0.905518
40814,Crimes of Passion,1984-10-19,1984,0,0,0,2.077602
40815,On Guard,1997-12-03,1997,0,0,0,2.264968
40817,Kiss Me Again,2010-01-29,2010,0,0,0,3.253024
40818,Pretty Bird,2008-08-08,2008,0,0,0,0.585128
40819,Best Worst Movie,2009-01-01,2009,0,0,0,0.98166
40820,Punchline,1988-10-07,1988,15000000,21032267,6032267,5.764399
40823,The Man Who Copied,2003-06-13,2003,0,0,0,3.954105
40824,So Dark the Night,1946-10-10,1946,0,0,0,0.181134
40826,Affair in Havana,1957-10-01,1957,0,0,0,0.537496
40829,Shaolin Wooden Men,1976-10-10,1976,0,0,0,7.205569
40833,King Cobra,1999-08-10,1999,0,0,0,0.926094
40836,Stealing Christmas,2003-11-30,2003,0,0,0,0.383945
40841,Roadside Prophets,1992-03-27,1992,0,157645,157645,3.190592
40842,Norma Rae,1979-03-02,1979,0,22228000,22228000,2.84023
40844,Comic Book Confidential,1988-01-01,1988,0,0,0,1.687838
40850,Cherrybomb,2009-02-08,2009,0,0,0,1.991189
40852,American Bandits: Frank and Jesse James,2010-05-18,2010,0,0,0,0.414768
40854,Pornography: A Thriller,2009-06-21,2009,0,0,0,0.631991
40855,Sex Positive,2009-06-12,2009,0,0,0,0.79658
40856,That Evening Sun,2009-11-06,2009,0,0,0,2.338398
40858,The Underworld Story,1950-07-26,1950,0,0,0,0.765829
40859,Dry Movie,2005-04-14,2005,0,0,0,0.155054
40860,Drained,2006-09-27,2006,0,0,0,0.623789
40862,Iraq for Sale: The War Profiteers,2006-01-01,2006,0,0,0,0.303529
40863,Jackie Chan: My Stunts,1999-03-30,1999,0,0,0,2.935717
40864,Last Cowboy Standing,2009-09-04,2009,2270000,0,-2270000,0.39307
40866,The Devil and Max Devlin,1981-03-06,1981,0,0,0,0.537292
40867,The Pajama Game,1957-08-29,1957,0,0,0,0.681871
40873,Pete Seeger: The Power of Song,2007-09-14,2007,0,0,0,0.038844
40874,Just for Kicks,2005-06-06,2005,0,0,0,0.178743
40876,Down to the Bone,2004-01-14,2004,0,0,0,1.325494
40878,The Crossing,2000-01-10,2000,0,0,0,1.236516
40879,Whiteboyz,1999-09-10,1999,0,0,0,1.483082
40880,Pandaemonium,2001-06-29,2001,0,0,0,0.660969
40881,The Pickle,1993-04-30,1993,0,0,0,0.911312
40882,The Mirror,1997-04-01,1997,0,0,0,0.578872
40885,Sayonara,1957-12-05,1957,0,0,0,1.384634
40886,Picnic,1996-06-15,1996,0,0,0,1.651635
40890,How the War Started on My Island,1997-08-31,1997,0,0,0,0.512604
40894,Lover Come Back,1961-11-20,1961,0,8,8,5.076113
40895,The Investigator,2008-07-10,2008,650000,0,-650000,0.225414
40897,Zat√¥ichi and the Chest of Gold,1964-03-14,1964,0,0,0,0.860258
40900,Elevator Girl,2010-02-13,2010,0,0,0,0.914774
40909,Vikramarkudu,2006-06-23,2006,0,0,0,0.345523
40911,Monga,2010-02-05,2010,0,0,0,0.993615
40913,Dance with a Stranger,1985-03-01,1985,0,0,0,2.050411
40916,Girl Crazy,1943-11-26,1943,0,0,0,0.743598
40920,The Business of Fancydancing,2002-01-14,2002,200000,0,-200000,0.102743
40922,Coffee Date,2006-11-10,2006,0,0,0,0.744276
40925,Dream Boy,2008-10-24,2008,0,0,0,2.021244
40926,Frisk,1996-03-22,1996,0,0,0,0.319215
40927,The Fruit Machine,1988-01-01,1988,0,0,0,0.660208
40929,Heaven Help Us,1985-02-08,1985,0,0,0,3.568487
40930,If You Only Knew,2000-03-05,2000,0,0,0,0.114487
40932,Can't Stop the Music,1980-06-20,1980,0,0,0,5.389616
40933,El bolero de Raquel,1957-10-09,1957,0,0,0,0.939338
40939,Alexandria‚Ä¶ Why?,1979-10-06,1979,0,0,0,0.036572
40945,The Event,2003-01-01,2003,0,0,0,0.213473
40946,Fixing Frank,2002-01-01,2002,0,0,0,0.073037
40947,Km. 0,2000-01-01,2000,0,0,0,0.678689
40950,The Naked Civil Servant,1975-12-17,1975,0,0,0,0.596933
40951,The Living Ghost,1942-08-11,1942,0,0,0,0.876165
40952,Alone in the Dark,1982-11-12,1982,20000000,8178569,-11821431,1.057387
40953,The Iron Petticoat,1957-01-07,1957,0,0,0,0.619332
40954,Beast from Haunted Cave,1959-10-30,1959,0,0,0,0.528089
40955,Blue Sunshine,1978-03-20,1978,0,0,0,0.951653
40957,It Happened to Jane,1959-08-05,1959,0,0,0,0.741555
40959,"Crosby, Stills & Nash: Long Time Comin'",1990-01-01,1990,0,0,0,8.8e-05
40961,The Ugly,1997-08-26,1997,0,0,0,0.774609
40962,Ironweed,1987-12-18,1987,0,0,0,2.601933
40969,Terror Train,1980-10-03,1980,3500000,0,-3500000,3.43877
40970,The Jolly Boys' Last Stand,2000-01-01,2000,0,0,0,0.001187
40973,Myra Breckinridge,1970-06-24,1970,5000000,3000000,-2000000,0.619657
40974,Green Tea,2003-08-18,2003,0,0,0,0.262584
40978,Emmanuelle 4,1984-02-15,1984,0,0,0,2.704921
40979,Seven Sinners,1940-10-25,1940,760000,0,-760000,0.792053
40983,Beware! The Blob,1972-06-21,1972,0,0,0,0.978293
40985,Arch of Triumph,1948-02-17,1948,0,0,0,0.652493
40990,The Keeper,2004-05-14,2004,4000000,0,-4000000,0.609043
40993,Szaffi,1985-04-11,1985,0,0,0,0.00022
40998,Kannathil Muthamittal,2002-02-14,2002,0,0,0,1.210001
41002,El Mago,1949-05-04,1949,0,0,0,0.505268
41003,White Palace,1990-10-19,1990,0,17487531,17487531,2.59282
41004,El se√±or doctor,1965-10-07,1965,0,0,0,1.020615
41006,A Good Man in Africa,1994-07-14,1994,0,0,0,5.22583
41007,A Month by the Lake,1995-09-11,1995,0,0,0,0.851078
41009,Perrier‚Äôs Bounty,2009-09-11,2009,0,0,0,8.196288
41012,Dollybirds,1997-02-20,1997,0,0,0,0.146763
41017,Gauche the Cellist,1982-01-23,1982,0,0,0,1.746238
41018,Man in the Attic,1953-12-23,1953,0,0,0,0.808202
41020,The Beast with Five Fingers,1946-12-25,1946,0,0,0,0.784734
41021,The Devil Bat,1940-12-13,1940,0,0,0,0.720269
41023,Dead Men Walk,1943-04-12,1943,0,0,0,0.48079
41025,Gargoyles,1972-11-21,1972,0,0,0,1.032154
41028,It's Only Money,1962-11-21,1962,0,0,0,0.149465
41030,The Snow Creature,1954-11-01,1954,0,0,0,0.369082
41032,The Stone Tape,1972-01-31,1972,0,0,0,0.48421
41034,Serial,1980-03-28,1980,0,0,0,0.448461
41035,Torture Garden,1967-11-01,1967,0,0,0,0.668281
41038,The Hideous Sun Demon,1958-08-28,1958,0,0,0,0.400823
41039,The World's Greatest Sinner,1962-06-01,1962,0,0,0,0.082675
41043,Window to Paris,1993-12-01,1993,0,0,0,0.345748
41044,I'm Reed Fish,2007-06-01,2007,0,0,0,3.305844
41050,La Notte,1961-01-23,1961,0,0,0,3.872462
41051,Permissive,1970-05-17,1970,0,0,0,0.040541
41053,Pyaasa,1957-02-19,1957,0,0,0,0.439683
41054,Il Grido,1957-06-22,1957,0,0,0,1.673129
41055,Slap-Jack,1992-02-21,1992,0,0,0,0.004974
41058,I Shot Jesse James,1949-02-26,1949,0,0,0,3.07047
41059,Make Way for Tomorrow,1937-05-09,1937,0,0,0,2.890527
41061,L√∫das Matyi,1977-04-06,1977,0,0,0,0.002001
41066,Professor Layton and the Eternal Diva,2009-12-01,2009,0,0,0,2.493721
41070,Dark Woods,2003-02-21,2003,0,0,0,2.342872
41073,The Wicked Lady,1945-11-15,1945,0,0,0,0.689703
41075,We Never Die!,1993-01-15,1993,0,0,0,0.012313
41076,Leif,1987-06-26,1987,0,0,0,0.007685
41077,Son of the White Mare,1981-10-22,1981,0,0,0,0.014473
41078,Johnny Corncob,1973-05-01,1973,0,0,0,2e-06
41084,Champagne For Caesar,1950-05-11,1950,0,0,0,0.503289
41089,Under the Volcano,1984-06-12,1984,0,0,0,1.55558
41090,Wisdom,1986-12-31,1986,0,0,0,1.710851
41091,...ing,2003-11-28,2003,0,0,0,0.630596
41093,Moszkva t√©r,2001-09-20,2001,0,0,0,0.366975
41097,The Seventh Brother,1991-01-25,1991,0,0,0,0.470742
41109,Don 2: The King is Back,2011-12-23,2011,0,0,0,4.94964
41110,I Am Love,2009-09-05,2009,0,0,0,6.309187
41115,Garage Olimpo,1999-05-16,1999,0,0,0,1.122466
41116,The Shock Doctrine,2009-09-01,2009,0,0,0,0.851836
41118,Scrooge,1935-11-30,1935,0,0,0,0.343141
41120,Rush: Beyond the Lighted Stage,2010-06-29,2010,0,0,0,0.835435
41121,Warm Spring,2003-04-01,2003,0,0,0,0.102529
41123,Lourdes,2009-09-11,2009,2500000,0,-2500000,6.509699
41125,We of the Never Never,1982-11-04,1982,0,0,0,0.142198
41127,Norma Jean & Marilyn,1996-05-18,1996,0,0,0,0.542943
41128,Snapdragon,1993-12-01,1993,0,0,0,1.400527
41131,The Search,1948-03-26,1948,0,0,0,2.214573
41135,Operation: Endgame,2010-07-20,2010,0,0,0,8.534211
41141,The Border,2007-11-30,2007,2691570,0,-2691570,0.652118
41142,Under the North Star,2009-12-04,2009,6153120,0,-6153120,0.320384
41144,To Save A Life,2009-11-05,2009,0,0,0,1.452356
41149,A Performance of Macbeth,1979-02-02,1979,0,0,0,0.398025
41153,I Bought a Vampire Motorcycle,1990-07-06,1990,0,0,0,1.080954
41154,Men in Black 3,2012-05-23,2012,225000000,624026776,399026776,10.684385
41156,I Am Comic,2010-01-10,2010,0,0,0,1.051781
41158,The Longest Nite,1998-01-01,1998,0,0,0,1.468044
41160,The Match,1999-08-13,1999,0,0,0,1.225636
41163,In a Day,2006-03-08,2006,0,0,0,0.989885
41164,Talent for the Game,1991-04-26,1991,0,0,0,0.261989
41165,Nora,2000-04-05,2000,0,0,0,1.129891
41166,Plenty,1985-09-20,1985,0,0,0,0.637248
41171,Noel,2004-11-12,2004,0,0,0,3.100853
41180,The Client List,2010-07-19,2010,0,0,0,3.723562
41182,The Boxer,2009-04-18,2009,0,0,0,0.571738
41183,Dallas 362,2003-09-12,2003,0,18928,18928,0.631613
41186,Love Now,2007-08-15,2007,0,0,0,0.201669
41187,Fate,2001-02-01,2001,0,0,0,0.468607
41188,Bhagam Bhag,2006-12-22,2006,0,0,0,0.524769
41189,The Dying Gaul,2005-01-01,2005,0,0,0,0.978741
41198,"Turn Left, Turn Right",2003-08-11,2003,0,0,0,1.005361
41201,The Illusionist,2010-02-16,2010,18000000,5602431,-12397569,6.971611
41203,Neighbor,2009-07-28,2009,0,0,0,0.657356
41204,On Moonlight Bay,1951-07-26,1951,0,0,0,0.435193
41205,The Unknown Soldier,1985-12-06,1985,0,0,0,0.770922
41206,A Double Life,1947-12-25,1947,0,0,0,0.818896
41209,WiseGirls,2002-12-06,2002,0,0,0,1.435948
41210,The Switch,2010-05-11,2010,19000000,49830607,30830607,5.695408
41211,Heartbreaker,2010-03-17,2010,8700000,47355187,38655187,5.546687
41212,Titicut Follies,1967-09-23,1967,0,0,0,1.484381
41213,The Fabulous Baron Munchausen,1962-09-21,1962,0,0,0,1.176231
41214,Knock on Any Door,1949-01-01,1949,900000,0,-900000,1.19379
41215,Black Death,2010-06-07,2010,0,265318,265318,12.183845
41216,Legend of the Guardians: The Owls of Ga'Hoole,2010-07-10,2010,80000000,140073390,60073390,17.674048
41225,Spirits of the Dead,1968-05-16,1968,0,0,0,1.794298
41227,A Place Called Chiapas,1998-02-20,1998,891000,229000,-662000,0.179246
41228,The Proud Princess,1952-09-26,1952,0,0,0,0.582532
41233,Step Up 3D,2010-08-04,2010,30000000,159291809,129291809,9.111782
41234,Blind Alley,1939-05-11,1939,0,0,0,0.735964
41235,Ritual,2002-01-01,2002,0,0,0,2.467616
41237,They Are Among Us,2004-05-14,2004,0,0,0,0.5258
41240,Bastard Out of Carolina,1996-12-15,1996,0,0,0,1.403309
41241,Hard Time: Hostage Hotel,1999-11-14,1999,0,0,0,0.159992
41242,Unresolved Sexual Tension,2010-03-18,2010,0,0,0,0.874916
41243,Creator,1985-09-20,1985,0,0,0,3.650143
41244,A Better Tomorrow III: Love and Death in Saigon,1989-10-20,1989,0,0,0,1.833422
41245,Peppermint Candy,1999-12-31,1999,0,0,0,1.785904
41248,The Girl on the Train,2009-03-18,2009,0,0,0,1.784251
41252,Raincoat,2004-12-24,2004,0,0,0,0.439862
41253,Damn Yankees!,1958-07-23,1958,0,0,0,0.882202
41261,1 Litre of Tears,2005-02-05,2005,0,0,0,0.60711
41263,The Brotherhood of Justice,1986-05-18,1986,0,0,0,0.843996
41264,"Africa, Goodbye",1966-02-11,1966,0,0,0,1.279431
41272,The Puzzle,2010-06-23,2010,0,0,0,0.167899
41273,On Tour,2010-06-30,2010,0,0,0,1.99304
41275,Python,2000-08-09,2000,0,0,0,1.764837
41276,The Life and Times of Hank Greenberg,2000-01-12,2000,0,0,0,0.136087
41277,Seducing Doctor Lewis,2003-05-20,2003,0,0,0,1.847074
41278,Alice in Wonderland,1903-10-17,1903,0,0,0,0.708323
41279,The Three Stooges Meet Hercules,1962-02-15,1962,0,0,0,0.484868
41280,Private Lessons,1981-08-21,1981,2800000,26279000,23479000,8.173864
41281,Moondance Alexander,2007-04-22,2007,0,37895,37895,0.896046
41282,Skipped Parts,2000-06-06,2000,0,0,0,1.975975
41283,Faster,2010-11-23,2010,24000000,23081726,-918274,9.014972
41288,Rocky Marciano,1999-05-15,1999,0,0,0,1.238427
41289,Bloodfight,1989-06-24,1989,0,0,0,0.255977
41291,One from the Heart,1982-02-12,1982,0,0,0,1.429843
41292,The World,2005-03-18,2005,0,0,0,0.80315
41294,¬°Por mis... pistolas!,1968-08-21,1968,0,0,0,0.549598
41298,El patrullero 777,1978-04-27,1978,0,0,0,0.315732
41301,Nature of the Beast,2007-10-21,2007,0,0,0,0.213997
41308,El padrecito,1964-09-03,1964,0,0,0,1.206366
41311,El analfabeto,1961-09-07,1961,0,0,0,0.25397
41312,Angels One Five,1952-03-19,1952,0,0,0,0.82721
41313,The Tune,1992-09-04,1992,0,0,0,0.014682
41316,Unprecedented: The 2000 Presidential Election,2002-09-17,2002,0,0,0,0.203125
41324,Fidel: The Untold Story,2001-08-02,2001,0,0,0,0.702597
41326,American Dream,1990-09-28,1990,0,269823,269823,0.075885
41331,The Garden,2008-08-17,2008,0,0,0,0.252797
41338,The President's Last Bang,2005-02-03,2005,0,0,0,0.406829
41339,Tapped,2009-07-31,2009,0,0,0,0.464271
41342,Baseline,2010-06-02,2010,0,0,0,0.352383
41343,The God of Cookery,1996-12-21,1996,0,0,0,1.880292
41345,Shank,2010-08-21,2010,0,0,0,2.792314
41347,The Cat's-Paw,1934-08-07,1934,0,0,0,0.328868
41348,Why Worry?,1923-09-09,1923,0,0,0,0.141528
41349,The Milky Way,1936-02-07,1936,0,0,0,0.480208
41355,The Memphis Belle: A Story of a Flying Fortress,1944-04-13,1944,0,0,0,0.057375
41357,Summer of '42,1971-04-09,1971,0,0,0,2.955581
41360,Hunter Prey,2009-01-01,2009,425000,0,-425000,2.25904
41365,Slayers Gorgeous,1998-01-01,1998,0,0,0,0.310286
41366,New World Disorder,1999-12-03,1999,0,0,0,0.685051
41368,The Rescue,1988-08-05,1988,0,0,0,0.453867
41371,#1 Cheerleader Camp,2010-07-27,2010,0,0,0,1.190427
41374,The First Power,1990-04-06,1990,10000000,22424195,12424195,1.942945
41377,The Clan of the White Lotus,1980-01-01,1980,0,0,0,0.54715
41378,Five Element Ninjas,1982-04-21,1982,0,0,0,2.453541
41380,The Prodigal Son,1981-11-10,1981,0,0,0,0.368264
41381,Pukar,2000-02-11,2000,0,0,0,0.142619
41382,Lottery Ticket,2010-08-20,2010,0,0,0,6.720886
41383,Five Shaolin Masters,1974-12-25,1974,0,0,0,0.991225
41384,The Grateful Dead,1977-06-02,1977,0,0,0,1.086537
41385,Final Approach,1991-12-06,1991,0,0,0,0.343687
41386,The Fearless Freaks,2005-05-25,2005,0,0,0,0.837483
41387,From Beijing with Love,1994-10-13,1994,0,0,0,2.278418
41391,Day of Wrath,1943-09-13,1943,0,0,0,3.11968
41393,Zyzzyx Road,2006-02-25,2006,2000000,30,-1999970,0.717595
41394,"The Looney, Looney, Looney Bugs Bunny Movie",1981-11-20,1981,0,0,0,1.02698
41397,Joan Rivers: A Piece of Work,2010-01-25,2010,0,0,0,0.756406
41400,Tiramisu,2002-03-28,2002,0,0,0,0.214171
41402,Let Me In,2010-10-01,2010,20000000,24145613,4145613,11.11946
41411,The Round Up,2010-03-10,2010,20000000,0,-20000000,6.951496
41413,Sorry if I Want to Marry You,2010-02-12,2010,0,0,0,6.994235
41415,The Shape of Things to Come,1979-05-04,1979,0,0,0,0.557096
41416,Au Revoir Taipei,2010-04-02,2010,0,0,0,1.574303
41417,Firestorm,1998-01-08,1998,19000000,0,-19000000,1.537212
41419,Mammoth,2006-04-22,2006,0,0,0,4.853067
41422,Water's Edge,2003-10-09,2003,0,0,0,0.235057
41423,Eighteen,2005-01-01,2005,0,0,0,0.57241
41426,Jubilee,1978-02-01,1978,0,0,0,1.115491
41427,Questo piccolo grande amore,2009-02-11,2009,0,0,0,1.143064
41428,Tetsuo: The Iron Man,1989-07-01,1989,0,0,0,5.456818
41434,Don't Look Up,2009-09-24,2009,0,0,0,1.894816
41436,Paranormal Activity 2,2010-10-20,2010,3000000,177512032,174512032,7.388933
41439,Saw: The Final Chapter,2010-10-21,2010,20000000,136150434,116150434,16.626655
41441,The Sword with No Name,2009-09-24,2009,0,0,0,1.008942
41443,Resurrecting the Street Walker,2009-01-01,2009,0,0,0,0.110642
41445,Psychosis,2010-07-19,2010,1200000,0,-1200000,0.963993
41446,Scream 4,2011-04-11,2011,40000000,97138686,57138686,10.000721
41453,The Sea Is Watching,2002-07-27,2002,0,0,0,1.550933
41454,Oldboys,2009-12-25,2009,0,0,0,0.304117
41461,The Iceman Cometh,1973-11-10,1973,0,0,0,0.544729
41462,The Hitch-Hiker,1953-10-16,1953,0,0,0,2.211742
41463,My Favorite Wife,1940-05-17,1940,0,0,0,2.063447
41464,Europe '51,1952-08-28,1952,0,0,0,1.149131
41465,Life with Father,1947-09-13,1947,0,0,0,0.880277
41468,Last of the Comanches,1953-02-01,1953,0,0,0,1.058964
41469,Next Stop Wonderland,1998-08-21,1998,0,0,0,0.798015
41471,Lone Wolf and Cub: Sword of Vengeance,1972-04-01,1972,0,0,0,1.839717
41472,Flower & Snake,2004-03-13,2004,0,0,0,2.05075
41474,Lone Wolf and Cub: Baby Cart to Hades,1972-08-01,1972,0,0,0,1.645563
41475,Bright Leaves,2004-04-28,2004,0,0,0,0.351823
41477,Lone Wolf and Cub: Baby Cart in Peril,1972-11-15,1972,0,0,0,1.609864
41478,Panther,1995-11-10,1995,0,6834525,6834525,7.160149
41479,The Joneses,2009-09-13,2009,10000000,7022728,-2977272,6.632194
41480,Sherman's March,1985-11-13,1985,0,0,0,0.003553
41482,Lone Wolf and Cub: Baby Cart in the Land of Demons,1973-01-01,1973,0,0,0,2.007844
41483,Here and There,2009-09-08,2009,0,0,0,0.183494
41486,Lone Wolf and Cub: White Heaven in Hell,1974-01-01,1974,0,0,0,2.11191
41487,Blonde Ice,1948-07-24,1948,0,0,0,0.401967
41488,The Statement,2003-12-12,2003,0,0,0,3.235594
41493,Karlsson on the Roof,2002-09-27,2002,0,0,0,0.554196
41495,Johnny Eager,1941-12-09,1941,0,0,0,1.671505
41496,A Dog Year,2009-09-03,2009,0,0,0,5.209694
41497,American Soldiers: A Day in Iraq,2005-05-11,2005,0,0,0,0.347004
41498,One Piece Film Strong World,2009-12-12,2009,0,53000000,53000000,4.958929
41499,Bluebeard,2009-10-06,2009,0,0,0,0.888024
41503,Three Coins in the Fountain,1954-05-01,1954,0,0,0,1.201898
41504,Henri Georges Clouzot's Inferno,2009-10-01,2009,0,0,0,0.766398
41505,Shelter,2010-03-27,2010,22000000,851517,-21148483,11.634377
41508,Fateless,2005-02-10,2005,0,0,0,5.824746
41513,The Smurfs,2011-07-29,2011,110000000,563749323,453749323,10.219758
41515,Yogi Bear,2010-12-11,2010,80000000,201584141,121584141,6.598296
41516,The Mole People,1956-12-01,1956,0,0,0,0.883306
41517,Ra.One,2011-10-24,2011,0,0,0,5.251132
41518,Guzaarish,2010-11-18,2010,0,0,0,2.175691
41520,Chico Xavier,2010-04-02,2010,0,0,0,1.051565
41521,Mr. Hobbs Takes a Vacation,1962-06-15,1962,2000000,0,-2000000,3.04045
41522,The Phantom,2009-12-20,2009,0,0,0,0.483201
41530,The Woman Who Dreamed of a Man,2010-01-21,2010,4000000,0,-4000000,0.311041
41536,Mercury Man,2006-08-09,2006,2000000,0,-2000000,0.216711
41545,Tsar,2009-11-04,2009,15000000,0,-15000000,2.183093
41551,Strange Bargain,1949-11-05,1949,0,0,0,0.385411
41552,Black Hand,1950-03-12,1950,0,0,0,0.614628
41553,Time Table,1956-02-08,1956,0,0,0,0.730286
41556,The Romantics,2010-09-10,2010,4500000,123820,-4376180,8.786269
41558,Separation City,2009-08-06,2009,0,0,0,0.442968
41559,The Job,2009-09-26,2009,0,0,0,1.322114
41566,New York Doll,2005-01-01,2005,0,0,0,0.329019
41568,Tales from the Crapper,2004-01-29,2004,0,0,0,1.587405
41569,The Nomi Song,2004-03-23,2004,0,0,0,0.468995
41571,The Heart of the World,2000-09-07,2000,0,0,0,1.071638
41574,Mosquito,1995-05-20,1995,0,0,0,1.350662
41577,Tokyo Fist,1995-01-01,1995,0,0,0,1.673946
41578,Floundering,1994-01-01,1994,0,0,0,0.457479
41579,Getting Even with Dad,1994-06-17,1994,30000000,0,-30000000,2.410545
41580,Colonel Chabert,1994-01-01,1994,0,0,0,0.934312
41581,Dunno on the Moon,1997-05-01,1997,0,0,0,0.507336
41582,Monkey Trouble,1994-03-18,1994,0,16453258,16453258,2.804503
41583,Marrakech Express,1989-11-01,1989,0,0,0,2.225285
41586,K-911,1999-12-07,1999,0,0,0,5.19009
41587,Mother's Boys,1994-03-17,1994,8000000,0,-8000000,2.101505
41588,The New Age,1994-09-16,1994,0,0,0,0.596207
41589,Trading Mom,1994-05-13,1994,0,0,0,1.356779
41590,Trial by Jury,1994-09-09,1994,0,0,0,0.85586
41591,The Scarf,1951-04-06,1951,0,0,0,0.52689
41592,StreetDance 3D,2010-05-19,2010,5773100,18144030,12370930,4.290276
41593,"Quo vadis, baby?",2005-05-27,2005,0,0,0,0.35975
41597,Night Train to Munich,1940-08-31,1940,0,0,0,1.505294
41599,Escape,1948-03-01,1948,0,0,0,0.151286
41602,Charlie Countryman,2013-02-09,2013,0,11650,11650,9.609726
41604,Grayeagle,1977-12-28,1977,0,0,0,0.737559
41605,Running the Sahara,2009-03-09,2009,0,0,0,0.421258
41608,God Forgives... I Don't!,1967-10-31,1967,0,0,0,4.038404
41609,The Three Musketeers,1948-10-10,1948,0,0,0,8.95072
41610,Fracchia The Human Beast,1981-12-22,1981,0,0,0,3.053669
41611,Jeopardy,1953-03-30,1953,0,0,0,0.791565
41613,Bomb the System,2002-08-02,2002,0,0,0,0.227369
41614,Jinnah,1998-11-07,1998,0,0,0,2.61248
41616,Formosa Betrayed,2010-02-26,2010,0,0,0,0.664745
41617,In Search of Mozart,2006-01-04,2006,0,0,0,0.119279
41619,Dinosaurier - Gegen uns seht ihr alt aus!,2009-12-23,2009,0,0,0,0.104217
41625,Head Office,1985-06-06,1985,0,0,0,0.647779
41628,Max Havoc: Curse Of The Dragon,2004-11-10,2004,0,0,0,0.004469
41630,No Strings Attached,2011-01-21,2011,25000000,147780440,122780440,8.88057
41636,Get Your Stuff,2000-06-17,2000,0,0,0,1.011466
41638,Broadway Damage,1997-08-26,1997,0,0,0,0.051128
41639,Magic & Bird: A Courtship of Rivals,2010-03-10,2010,0,0,0,0.810544
41645,Food of Love,2002-02-08,2002,0,0,0,0.508711
41647,"The Wonderful, Horrible Life of Leni Riefenstahl",1993-09-11,1993,0,449707,449707,0.568884
41648,Fiorile,1993-06-06,1993,0,0,0,1.087972
41651,Ghost in the Machine,1993-12-29,1993,0,0,0,2.404331
41653,The Slingshot,1993-09-24,1993,0,0,0,1.764582
41656,Octopus,2000-09-21,2000,0,0,0,1.699418
41659,My Life,1993-11-12,1993,0,27484464,27484464,3.987514
41660,The Making of '...And God Spoke',1994-09-23,1994,0,0,0,0.179149
41661,The Night We Never Met,1993-04-30,1993,0,1884814,1884814,1.132307
41662,3 Women,1977-04-03,1977,1500000,0,-1500000,3.18357
41663,Fantozzi Against the Wind,1980-11-20,1980,0,0,0,4.348083
41664,Fantozzi Retires,1988-12-22,1988,0,0,0,3.494861
41665,Fantozzi in Heaven,1993-01-01,1993,0,0,0,3.269031
41666,The Wrong Man,1993-09-05,1993,0,0,0,1.972377
41668,Fantozzi The Return,1996-12-20,1996,0,0,0,2.933271
41669,Fantozzi 2000 - La clonazione,1999-12-23,1999,0,0,0,2.354176
41670,A Stranger Among Us,1992-07-17,1992,0,0,0,8.900124
41671,Amityville: It's About Time,1992-07-16,1992,0,0,0,2.418256
41678,The Oak,1992-09-16,1992,3700000,0,-3700000,0.515354
41682,Christopher Columbus: The Discovery,1992-08-21,1992,40000000,8251071,-31748929,5.996407
41689,Abig√©l,1978-01-01,1978,0,0,0,0.156351
41703,Plus one,2008-08-21,2008,336029,927277,591248,0.562568
41709,Alchemy,2005-04-25,2005,0,0,0,0.752678
41714,The Beautiful Country,2004-03-13,2004,0,0,0,1.052618
41725,Captain Sindbad,1963-04-12,1963,0,0,0,0.951943
41730,Desert Blue,1999-06-06,1999,0,0,0,2.494188
41733,Due Date,2010-11-04,2010,65000000,211780824,146780824,11.73956
41738,After Alice,1999-10-28,1999,0,0,0,0.101767
41749,Hello Down There,1969-01-01,1969,0,0,0,0.236318
41756,30 YEARS TO LIFE,2003-09-04,2003,0,0,0,0.086622
41758,Empire Falls,2005-05-28,2005,0,0,0,5.234659
41759,Man's Best Friend,1993-11-19,1993,6000000,12974636,6974636,4.719295
41760,Author! Author!,1982-06-18,1982,0,0,0,3.727104
41762,Graffiti Bridge,1990-11-02,1990,0,0,0,0.907645
41764,The Best Intentions,1992-05-24,1992,0,0,0,1.189742
41768,Passion Fish,1992-12-11,1992,0,0,0,5.367604
41769,Prom Night IV: Deliver Us from Evil,1992-02-14,1992,0,0,0,2.190786
41771,Tale of a Vampire,1992-01-01,1992,0,0,0,0.010331
41774,The Playboys,1992-04-22,1992,0,0,0,1.044831
41776,This Is My Life,1992-02-21,1992,0,0,0,1.377577
41777,Tito and Me,1992-01-01,1992,0,0,0,0.445655
41778,Visions of Light,1992-09-17,1992,0,0,0,0.018596
41779,Used People,1992-12-16,1992,0,0,0,1.345197
41780,A Rage in Harlem,1991-05-03,1991,8000000,10400000,2400000,2.404818
41781,The Stranger,1991-05-07,1991,0,0,0,0.149418
41783,Life on a String,1991-09-08,1991,0,0,0,0.071589
41784,Black Robe,1991-09-05,1991,0,0,0,1.730199
41785,Cabeza de Vaca,1991-10-11,1991,0,0,0,1.348021
41787,Defenseless,1991-08-23,1991,0,0,0,0.694327
41791,Mississippi Masala,1991-09-18,1991,0,0,0,5.659326
41792,Rubin and Ed,1991-01-01,1991,0,0,0,0.523904
41796,The Adjuster,1992-05-29,1992,1000000,0,-1000000,1.901063
41799,"Distant Voices, Still Lives",1988-09-29,1988,0,0,0,1.402994
41800,Superman and the Mole-Men,1951-11-23,1951,275000,0,-275000,0.860528
41801,Female Perversions,1996-01-22,1996,0,0,0,2.273475
41804,All the Mornings of the World,1991-01-01,1991,0,0,0,1.861979
41805,V.I. Warshawski,1991-07-26,1991,0,0,0,2.08013
41806,"Ay, Carmela!",1990-03-16,1990,0,2000000,2000000,0.940509
41808,True Confessions of a Hollywood Starlet,2008-08-09,2008,0,0,0,1.154511
41809,Under the Radar,2004-01-01,2004,0,0,0,0.11795
41810,Alligator Eyes,1990-01-01,1990,0,0,0,0.000844
41811,Eating,1990-11-30,1990,0,0,0,2e-06
41816,Everybody Wins,1990-01-19,1990,0,0,0,0.304133
41817,Heart Condition,1990-02-02,1990,0,4100000,4100000,5.531486
41820,Till Human Voices Wake Us,2002-09-12,2002,0,0,0,0.410083
41821,Ju Dou,1990-04-21,1990,0,0,0,3.499907
41822,Song of the Exile,1990-04-27,1990,0,0,0,0.000578
41823,Mo' Better Blues,1990-08-03,1990,10000000,16153593,6153593,2.715137
41827,Red White & Blue,2010-10-08,2010,0,0,0,3.039909
41828,Prom Night III: The Last Kiss,1990-03-30,1990,0,0,0,1.506989
41831,True Heart,1999-02-17,1999,0,0,0,0.675361
41834,Journey of Hope,1990-08-01,1990,0,0,0,0.022568
41835,Very Young Girls,2007-09-11,2007,0,0,0,0.192947
41841,Tall Tale,1995-03-24,1995,32000000,0,-32000000,1.283015
41842,Taxi Blues,1990-09-07,1990,0,0,0,0.862404
41843,Surviving Picasso,1996-09-04,1996,16000000,1985001,-14014999,2.167132
41844,The Tichborne Claimant,1998-01-01,1998,0,0,0,0.001727
41845,Heaven and Earth,1990-11-24,1990,0,0,0,0.142154
41846,Super Sucker,2002-01-01,2002,0,0,0,0.367595
41847,Strip Search,2004-04-27,2004,0,0,0,1.900797
41848,The Amityville Curse,1989-12-01,1989,0,0,0,2.416489
41850,At the Death House Door,2008-03-09,2008,0,0,0,0.589611
41851,Everyday People,2004-01-18,2004,0,0,0,0.954568
41852,A Family Thing,1996-03-29,1996,0,0,0,6.207993
41857,Bandolero!,1968-06-01,1968,0,12000000,12000000,1.469044
41862,Freshman Orientation,2004-01-18,2004,0,0,0,1.065865
41863,Sundome,2007-11-20,2007,0,0,0,0.014339
41869,The George McKenna Story,1986-11-11,1986,0,0,0,0.345596
41870,Hey Happy,2001-01-01,2001,0,0,0,0.142296
41872,Girls in Prison,1994-08-19,1994,0,0,0,0.823208
41876,The Damned,1969-10-13,1969,0,0,0,2.212979
41878,Savage Nights,1992-08-19,1992,0,0,0,1.031556
41886,Not Your Typical Bigfoot Movie,2008-10-17,2008,0,0,0,0.075972
41889,Sorceress,1982-03-01,1982,0,0,0,1.467206
41890,Hometown Legend,2002-01-25,2002,0,0,0,0.146447
41894,Blood Done Sign My Name,2010-02-01,2010,0,0,0,0.518507
41897,Charleston,1974-09-10,1974,0,0,0,0.077444
41901,Ishq Vishk,2003-04-10,2003,0,0,0,0.39998
41902,Baadshah,1999-08-27,1999,0,0,0,1.464744
41903,Mr. India,1987-05-25,1987,0,0,0,0.784582
41913,Making Love,1982-02-12,1982,0,0,0,3.389796
41914,Mandragora,1997-10-23,1997,0,0,0,1.146125
41923,Outrageous!,1977-01-01,1977,0,0,0,0.005351
41924,Night Watch,2005-04-15,2005,0,0,0,1.036927
41925,The Comfort of Strangers,1990-01-01,1990,0,1244381,1244381,2.069497
41927,Tune in Tomorrow...,1990-01-01,1990,0,0,0,0.987034
41930,Uranus,1990-12-12,1990,0,0,0,0.689138
41932,Easy Wheels,1989-01-01,1989,0,0,0,0.077353
41934,Heavy Petting,1989-01-01,1989,0,0,0,0.153425
41936,Life and Nothing But,1989-09-06,1989,0,0,0,0.006668
41937,The Icicle Thief,1989-02-16,1989,0,0,0,0.02553
41938,Physical Evidence,1989-01-27,1989,0,0,0,1.138586
41939,Rikyu,1989-09-15,1989,0,0,0,0.280394
41940,Roadkill,1989-09-16,1989,250000,0,-250000,0.007963
41943,The Plot Against Harry,1989-09-13,1989,0,0,0,0.038081
41944,The Rachel Papers,1989-05-12,1989,0,0,0,1.348913
41945,The Rainbow,1989-05-05,1989,0,0,0,0.726268
41946,The Return of the Musketeers,1989-08-24,1989,0,0,0,6.587929
41949,A World Apart,1988-06-17,1988,0,0,0,6.410191
41950,Call Me,1988-05-20,1988,0,0,0,1.204285
41951,Chocolat,1988-05-18,1988,0,0,0,1.046127
41952,Criminal Law,1988-01-01,1988,0,0,0,2.040324
41954,H√¥tel Terminus: The Life and Times of Klaus Barbie,1988-11-01,1988,0,0,0,0.008673
41955,Antikiller,2002-08-01,2002,5000000,340312,-4659688,0.191539
41957,Antikiller 2: Antiterror,2003-12-12,2003,0,2685000,2685000,0.238166
41959,Jack's Back,1988-05-06,1988,0,0,0,2.06747
41961,Little Vera,1988-10-01,1988,0,0,0,1.139542
41962,A Taxing Woman's Return,1988-01-15,1988,0,0,0,0.301339
41963,Masquerade,1988-03-11,1988,0,0,0,7.058299
41965,Paperhouse,1988-01-01,1988,0,241,241,3.520171
41966,Pin,1988-11-25,1988,0,0,0,2.089317
41967,Tales from the Gimli Hospital,1988-04-15,1988,25000,0,-25000,0.003553
41968,The Deceivers,1988-09-02,1988,0,346297,346297,0.876297
41969,The Girl in a Swing,1988-09-29,1988,0,0,0,0.029194
41970,The Last of England,1987-08-23,1987,0,0,0,2.592915
41971,The Moderns,1988-04-15,1988,0,0,0,0.928494
41973,"Thelonious Monk: Straight, No Chaser",1988-10-25,1988,0,0,0,0.004137
41974,Track 29,1988-05-15,1988,5000000,0,-5000000,1.129645
41975,Story of Women,1988-09-14,1988,0,0,0,3.438009
41977,Magicians,1982-01-01,1982,0,0,0,0.00022
41978,High Security Vacation,2009-08-25,2009,5000000,17566040,12566040,0.824156
41979,The Elusive Revengers,1966-06-06,1966,0,0,0,1.432761
41980,Once a Gangster,2010-05-20,2010,2000000,0,-2000000,0.913271
41988,DC Showcase: Jonah Hex,2010-07-27,2010,0,0,0,3.356801
41992,Sophie's World,1999-08-06,1999,0,0,0,2.315688
41993,Love in a Puff,2010-03-25,2010,0,0,0,1.47831
41994,David Cross: Bigger and Blackerer,2010-05-25,2010,0,0,0,0.546988
41996,The Man in Grey,1943-08-06,1943,0,0,0,0.319581
41999,The Art of the Steal,2009-01-01,2009,0,0,0,1.2083
42000,The Great Yokai War,2005-08-06,2005,0,0,0,0.950391
42001,The Princess and the Goblin,1992-12-18,1992,0,0,0,1.914869
42002,Anguish,1987-11-10,1987,0,0,0,3.288353
42003,Chuck Berry: Hail! Hail! Rock 'n' Roll,1987-01-01,1987,0,0,0,0.471573
42005,A Hungarian Fairy Tale,1987-01-01,1987,0,0,0,0.043125
42006,Red Sorghum,1987-01-01,1987,0,0,0,2.045228
42008,The Family,1987-01-01,1987,0,0,0,2.602047
42010,Made in Heaven,1987-11-06,1987,0,0,0,1.403116
42011,A Taxing Woman,1987-02-07,1987,0,0,0,0.757468
42012,"No Retreat, No Surrender 2: Raging Thunder",1988-01-28,1988,0,108154,108154,0.699608
42013,Sammy and Rosie Get Laid,1987-10-30,1987,0,0,0,1.009328
42015,Swimming to Cambodia,1987-03-13,1987,0,0,0,0.225249
42017,Absolute Beginners,1986-01-01,1986,0,0,0,1.377893
42020,El Amor Brujo,1986-03-23,1986,0,0,0,0.185772
42021,Ginger and Fred,1986-01-01,1986,0,0,0,1.466097
42023,Heat,1986-01-01,1986,0,0,0,1.352232
42030,The Naked Cage,1986-03-01,1986,0,0,0,0.491114
42031,Hour of the Star,1985-01-01,1985,0,0,0,0.001586
42032,Angry Harvest,1986-01-09,1986,0,0,0,0.451351
42033,Def-Con 4,1985-03-15,1985,0,0,0,1.064151
42034,Dreamchild,1985-10-04,1985,0,0,0,1.412097
42035,Insignificance,1985-01-01,1985,0,0,0,1.431944
42039,All Tomorrow's Parties,2009-01-01,2009,0,0,0,0.413309
42040,King David,1985-03-29,1985,0,0,0,0.937702
42041,Noriko's Dinner Table,2005-06-04,2005,0,0,0,1.326198
42044,Shoah,1985-11-01,1985,0,0,0,1.978031
42045,Sweet Dreams,1985-10-02,1985,0,0,0,1.29382
42046,October Country,2009-06-01,2009,0,0,0,0.105412
42047,That's Dancing!,1985-01-01,1985,0,0,0,0.367168
42048,The Coca-Cola Kid,1985-07-14,1985,0,0,0,0.872855
42053,Witchville,2010-05-22,2010,0,0,0,1.016529
42057,It's a Wonderful Afterlife,2010-05-07,2010,0,0,0,1.513042
42062,Moontide,1942-05-29,1942,0,0,0,0.625346
42066,Ladies in Retirement,1941-09-09,1941,0,0,0,0.424025
42073,Gundress,1999-03-20,1999,0,0,0,0.281112
42077,My Name Is Julia Ross,1945-11-08,1945,0,0,0,1.088878
42078,Elf Bowling the Movie,2007-10-02,2007,6500000,0,-6500000,0.648653
42081,Sugarbaby,1985-10-01,1985,0,0,0,0.318622
42082,Another State of Mind,1984-03-01,1984,130000,0,-130000,0.106839
42084,Cal,1984-08-24,1984,0,0,0,0.736849
42085,Camila,1984-05-17,1984,0,0,0,0.265963
42086,Choose Me,1984-08-29,1984,700000,0,-700000,1.069152
42087,Country,1984-09-29,1984,0,0,0,0.84372
42090,After the Rehearsal,1984-04-09,1984,0,0,0,2.281167
42092,The Home and the World,1985-01-04,1985,0,0,0,0.209422
42093,Marlene,1984-10-01,1984,0,0,0,1e-06
42094,Micki & Maude,1984-12-21,1984,0,0,0,1.053524
42095,The Funeral,1984-11-17,1984,0,0,0,0.114527
42098,Streetwise,1984-12-07,1984,0,0,0,0.270879
42100,That Was Rock,1984-01-01,1984,0,0,0,0.0
42106,Carmen,1983-05-06,1983,0,0,0,1.093747
42107,Chicken Ranch,1983-01-01,1983,0,0,0,0.0742
42108,Entre Nous,1983-04-06,1983,0,0,0,1.137893
42112,L‚Äôargent,1983-09-24,1983,0,0,0,4.173803
42113,The Ballad of Narayama,1983-04-09,1983,0,0,0,1.925839
42114,Nightmares,1983-09-02,1983,0,6670680,6670680,3.861469
42115,Sugar Cane Alley,1983-09-21,1983,0,0,0,0.004425
42116,The Makioka Sisters,1983-12-30,1983,0,0,0,0.875383
42120,City on Fire,1987-02-13,1987,0,0,0,0.899631
42121,Tender Mercies,1983-04-02,1983,0,0,0,1.160488
42122,The Dresser,1983-12-06,1983,0,0,0,1.182646
42123,Utu,1984-09-13,1984,0,0,0,0.547061
42124,Burden of Dreams,1982-05-30,1982,0,0,0,2.712121
42128,I Ought to Be in Pictures,1982-03-26,1982,0,0,0,0.510177
42129,"Io, Chiara e lo scuro",1982-01-01,1982,0,0,0,0.001586
42130,The Night of the Shooting Stars,1982-09-16,1982,0,0,0,0.622531
42131,The Night of Varennes,1982-09-23,1982,0,0,0,1.171804
42132,Time Stands Still,1982-10-07,1982,0,0,0,0.000844
42134,Moonlighting,1982-09-18,1982,0,0,0,1.464085
42135,Querelle,1982-08-05,1982,0,0,0,1.29069
42136,The Grey Fox,1982-12-16,1982,0,0,0,0.192513
42137,Space Pirate Captain Harlock: Arcadia of My Youth,1982-01-01,1982,0,0,0,0.612085
42138,Agony: The Life and Death of Rasputin,1975-06-01,1975,0,0,0,0.810219
42139,Blood Wedding,1981-10-25,1981,0,0,0,0.004425
42140,The Boat Is Full,1981-04-25,1981,0,0,0,1.145024
42142,Marianne and Juliane,1981-09-04,1981,0,0,0,0.753306
42143,Why Not?,1981-01-08,1981,0,0,0,0.41307
42146,Only When I Laugh,1981-09-25,1981,0,0,0,0.695628
42147,Passion of Love,1981-09-16,1981,0,0,0,0.842088
42148,Pixote,1981-05-08,1981,0,0,0,2.112848
42149,The Hand,1981-04-24,1981,6500000,566736,-5933264,2.12989
42150,Three Brothers,1981-03-19,1981,0,0,0,0.576493
42151,Down Terrace,2009-09-01,2009,31192,10000,-21192,1.585713
42152,From the Life of the Marionettes,1980-10-08,1980,0,0,0,1.351003
42153,C√©leste,1981-09-18,1981,0,0,0,0.26558
42156,Lightning Over Water,1980-10-01,1980,0,0,0,0.000844
42157,One Trick Pony,1980-10-03,1980,0,0,0,0.149268
42158,The Competition,1980-12-03,1980,0,0,0,0.057987
42159,The Idolmaker,1980-11-14,1980,0,0,0,0.226827
42160,The Stunt Man,1980-06-27,1980,0,0,0,3.909063
42164,Camera Buff,1979-11-16,1979,0,0,0,1.882661
42165,Best Boy,1979-10-05,1979,0,0,0,0.035437
42167,Bye Bye Brasil,1980-02-08,1980,0,0,0,0.269354
42168,Chapter Two,1979-12-14,1979,0,0,0,0.706906
42170,Vengeance Is Mine,1979-04-21,1979,0,0,0,1.753258
42171,The Infidel,2009-09-16,2009,0,0,0,3.574031
42172,Hardcore,1979-02-09,1979,0,0,0,2.417741
42173,Chilly Scenes of Winter,1979-10-19,1979,0,0,0,0.009192
42175,The Europeans,1979-05-01,1979,0,0,0,0.657406
42176,The Main Event,1979-06-22,1979,0,0,0,2.467596
42178,Winter Kills,1979-05-11,1979,0,0,0,0.472698
42179,Wise Blood,1979-10-01,1979,0,0,0,1.323923
42182,Octopus 2: River of Fear,2001-12-06,2001,0,0,0,0.569466
42185,Shark Attack,1999-11-09,1999,0,0,0,0.661772
42186,Bluebeard,1944-11-11,1944,0,0,0,0.562477
42187,Shark Attack 2,2001-02-13,2001,0,0,0,0.73047
42188,Never Let Me Go,2010-09-15,2010,15000000,9455232,-5544768,8.278794
42189,Kevin Hart: Seriously Funny,2010-07-20,2010,0,0,0,2.584698
42191,Johnny Angel,1945-10-24,1945,0,0,0,0.51834
42193,The Charge of the Light Brigade,1968-04-10,1968,0,0,0,1.652755
42194,TEKKEN,2010-03-20,2010,30000000,967000,-29033000,12.17886
42195,The Testaments,2000-03-24,2000,0,0,0,0.614776
42196,The Bad Seed,1956-09-12,1956,0,0,0,7.975238
42200,Bye Bye Monkey,1978-02-24,1978,0,0,0,0.705365
42201,Comes a Horseman,1978-10-25,1978,0,0,0,2.516575
42203,Despair,1978-05-19,1978,0,0,0,8.830557
42204,FM,1978-04-20,1978,0,0,0,0.266786
42205,Good Guys Wear Black,1978-06-01,1978,1000000,18300000,17300000,2.261946
42206,In a Year with 13 Moons,1978-11-17,1978,0,0,0,0.563592
42211,Killer Nun,1979-05-09,1979,0,0,0,1.449553
42212,Thank God It's Friday,1978-05-19,1978,0,0,0,0.914133
42213,The Big Fix,1978-01-01,1978,0,0,0,1.247447
42215,The Legacy,1978-09-01,1978,0,0,0,2.309037
42216,Who Is Killing the Great Chefs of Europe?,1978-10-06,1978,0,0,0,1.199554
42217,Bobby Deerfield,1977-09-27,1977,0,0,0,5.792931
42218,Empire of the Ants,1977-06-29,1977,0,0,0,3.244027
42220,In nome del papa re,1977-12-03,1977,0,0,0,0.596011
42222,Julia,1977-10-02,1977,0,0,0,8.074031
42223,Madame Rosa,1977-11-02,1977,0,0,0,0.180579
42225,Padre Padrone,1977-05-20,1977,0,0,0,1.046594
42226,Coup de gr√¢ce,1976-10-21,1976,0,0,0,0.175357
42228,The Late Show,1977-02-10,1977,0,0,0,0.78483
42229,A Special Day,1977-08-11,1977,0,110,110,3.810981
42230,The Mighty Peking Man,1977-08-11,1977,0,0,0,1.867807
42231,You Light Up My Life,1977-08-31,1977,0,0,0,0.411176
42232,Bound for Glory,1976-12-05,1976,0,0,0,3.207471
42233,"Buffalo Bill and the Indians, or Sitting Bull's History Lesson",1976-01-01,1976,0,0,0,0.760215
42234,Dona Flor and Her Two Husbands,1976-11-22,1976,0,0,0,0.72351
42236,Fellini's Casanova,1976-12-07,1976,0,0,0,2.693281
42237,Jonah Who Will Be 25 in the Year 2000,1976-01-01,1976,0,0,0,0.007963
42238,Black and White in Color,1976-01-01,1976,0,0,0,0.8529
42241,Sebastiane,1976-12-17,1976,45000,0,-45000,1.070492
42242,Swashbuckler,1976-01-01,1976,0,0,0,5.519702
42243,The Bingo Long Traveling All-Stars & Motor Kings,1976-07-16,1976,0,0,0,0.588318
42244,The First Nudie Musical,1976-01-01,1976,0,0,0,0.096085
42245,The Food of the Gods,1976-06-18,1976,0,0,0,1.451687
42246,Tom and Jerry: The Fast and the Furry,2005-10-11,2005,0,0,0,2.619411
42247,Treasure Raiders,2007-04-20,2007,0,0,0,0.23908
42250,Python 2,2002-07-17,2002,0,0,0,1.294898
42251,Forbidden World,1982-05-07,1982,0,0,0,5.552958
42252,The Missouri Breaks,1976-05-19,1976,0,0,0,2.615078
42254,Fox and His Friends,1975-06-06,1975,0,0,0,2.82367
42257,Hester Street,1975-10-19,1975,0,0,0,0.528717
42258,Katie Tippel,1975-03-06,1975,0,0,0,0.347249
42260,Mother K√ºsters Goes to Heaven,1975-07-01,1975,0,0,0,1.307253
42261,Rancho Deluxe,1975-01-01,1975,0,0,0,1.211911
42262,Report to the Commissioner,1975-02-05,1975,0,0,0,0.515544
42264,Smile,1975-01-01,1975,0,0,0,3.444078
42266,The Romantic Englishwoman,1975-06-11,1975,0,0,0,1.759005
42267,White Line Fever,1975-07-16,1975,0,0,0,1.319118
42268,11 Harrowhouse,1974-09-26,1974,0,0,0,0.154133
42269,We All Loved Each Other So Much,1974-01-01,1974,0,0,0,2.156368
42273,Don't You Forget About Me,2010-07-13,2010,0,0,0,0.289631
42275,It Can't Be!,1975-10-23,1975,0,0,0,0.652075
42279,Bootleggers,1962-01-08,1962,0,0,0,1.567803
42286,Berlin Express,1948-05-01,1948,0,0,0,1.269783
42288,Guest in the House,1944-12-08,1944,0,0,0,0.554417
42290,In the Pope's Eye,1980-09-19,1980,0,0,0,0.599294
42291,The Buddha,2010-04-17,2010,0,0,0,0.386889
42293,The Hairdresser,2010-02-14,2010,0,0,0,0.228637
42295,The House on 92nd Street,1945-09-10,1945,0,0,0,0.485843
42296,Catfish,2010-09-17,2010,30000,3045943,3015943,5.174738
42297,Burlesque,2010-11-23,2010,55000000,89519773,34519773,9.276539
42298,Dressed to Kill,1941-08-08,1941,0,0,0,0.527663
42303,The Karate Dog,2004-05-05,2004,0,0,0,0.742452
42305,Who's Minding the Store?,1963-11-28,1963,0,0,0,1.925571
42306,Love at First Hiccup,2009-01-01,2009,0,0,0,1.530389
42307,Road Train,2010-05-28,2010,0,0,0,2.589064
42309,Fear Island,2009-09-08,2009,0,0,0,2.194041
42313,Tom Sawyer,2000-04-04,2000,0,0,0,0.298892
42314,Looking for Richard,1996-10-11,1996,0,0,0,2.653817
42316,The Referees,2009-08-10,2009,0,0,0,0.712104
42318,Hardcore,2004-03-12,2004,0,0,0,1.482892
42323,Tere Bin Laden,2010-07-16,2010,0,0,0,0.501363
42325,Bewitched,1945-07-04,1945,0,0,0,0.340366
42326,They Died with Their Boots On,1978-04-20,1978,0,0,0,0.15552
42328,Broken Lance,1954-09-25,1954,0,0,0,1.478505
42329,The Valley of Gwangi,1969-07-24,1969,0,0,0,2.082918
42332,Santa Who?,2000-12-03,2000,0,0,0,1.712441
42337,Beau Pere,1981-09-15,1981,0,0,0,3.873576
42341,Suspect X,2008-10-04,2008,0,0,0,1.453026
42342,The Egg and I,1947-05-01,1947,0,0,0,0.628683
42343,Geordie,1955-09-02,1955,0,0,0,0.231438
42345,The Molly Maguires,1970-01-27,1970,11000000,2200000,-8800000,2.27258
42346,The Last Days of Emma Blank,2009-05-07,2009,0,0,0,0.732102
42347,For Queen & Country,1988-05-17,1988,191051,0,-191051,1.199401
42354,House Party 4: Down to the Last Minute,2001-01-01,2001,0,0,0,0.233207
42355,Taipei Exchanges,2010-05-14,2010,0,0,0,0.905996
42358,Cold Sweat,1970-12-18,1970,0,0,0,2.525934
42359,The Freshman,1925-09-20,1925,0,0,0,0.932304
42362,From Hand to Mouth,1919-12-28,1919,0,0,0,0.229897
42363,Feet First,1930-11-08,1930,0,0,0,0.18969
42366,Dr. Jack,1922-11-26,1922,0,0,0,0.432437
42367,Hot Water,1924-10-26,1924,0,0,0,0.707239
42368,For Heaven's Sake,1926-04-05,1926,0,0,0,0.308677
42371,Take This Job and Shove It,1981-04-24,1981,0,0,0,1.343727
42377,Muhammad: Legacy of a Prophet,2002-01-01,2002,0,0,0,0.144806
42380,Gallants,2010-06-04,2010,0,0,0,1.436918
42383,XX/XY,2002-01-11,2002,0,0,0,1.479433
42384,A Tale of Legendary Libido,2008-04-30,2008,0,0,0,1.199077
42390,Boys Town,1938-09-09,1938,0,0,0,1.437573
42395,Generation 1000 Euros,2009-04-24,2009,0,1296000,1296000,1.562425
42399,The Friends at the Margherita Cafe,2009-04-03,2009,0,3006000,3006000,1.736532
42401,Since You Went Away,1944-07-20,1944,0,0,0,4.505452
42402,The Left Handed Gun,1958-05-07,1958,0,0,0,1.866255
42407,The Flim-Flam Man,1967-08-22,1967,0,0,0,0.51878
42409,Yes: 9012 live,1985-11-07,1985,0,0,0,0.100013
42411,The Girl by the Lake,2007-09-14,2007,0,0,0,1.069651
42413,The Workshop,2007-04-25,2007,0,0,0,0.2067
42416,Arrapaho,1984-01-01,1984,0,0,0,0.148651
42418,Young Black Stallion,2003-12-25,2003,0,0,0,1.269123
42420,The Keys to the House,2004-09-10,2004,0,0,0,1.722948
42424,Zeus & Roxanne,1997-01-24,1997,0,0,0,1.034602
42427,Fair Play,2006-09-06,2006,0,0,0,1.12325
42430,Symbol,2009-09-12,2009,0,0,0,2.273139
42436,Natale in crociera,2007-12-14,2007,0,0,0,2.002144
42438,Ricky e Barabba,1992-12-19,1992,0,0,0,1.796656
42441,Tifosi,1999-10-01,1999,0,0,0,3.003893
42444,Christmas Vacation '91,1991-12-20,1991,0,0,0,1.794023
42448,Harry and Tonto,1974-08-12,1974,0,0,0,1.848182
42449,Hearts and Minds,1974-01-01,1974,0,30000,30000,1.215723
42450,Macon County Line,1974-01-01,1974,0,0,0,0.250261
42451,The Apprenticeship of Duddy Kravitz,1974-04-11,1974,0,0,0,0.44984
42452,The House of Seven Corpses,1974-02-01,1974,0,0,0,0.978228
42453,The Island at the Top of the World,1974-01-01,1974,0,0,0,1.759153
42455,And Now The Screaming Starts,1973-04-26,1973,0,0,0,3.673082
42456,40 Carats,1973-06-28,1973,0,0,0,1.676035
42457,A Doll's House,1973-05-22,1973,0,0,0,1.180514
42458,A Touch of Class,1973-01-01,1973,0,0,0,1.11576
42459,Bang the Drum Slowly,1973-08-26,1973,0,0,0,0.834564
42460,The Pedestrian,1973-09-05,1973,0,0,0,0.066893
42461,The Scarlet Letter,1973-01-01,1973,0,0,0,0.24152
42463,Wedding in Blood,1973-04-12,1973,0,0,0,0.772616
42464,O Lucky Man!,1973-03-25,1973,0,0,0,1.028117
42466,Scream Blacula Scream,1973-06-27,1973,0,0,0,1.059192
42467,25 Fireman's Street,1973-09-27,1973,0,0,0,0.00022
42468,Tales That Witness Madness,1973-01-01,1973,0,0,0,0.682072
42469,The Creeping Flesh,1973-02-12,1973,0,0,0,1.870702
42470,The Day of the Dolphin,1973-12-19,1973,0,0,0,6.474497
42472,The Man Who Loved Cat Dancing,1973-06-28,1973,0,0,0,8.261115
42473,Tom Sawyer,1973-01-01,1973,0,0,0,1.490174
42476,Ben,1972-06-23,1972,0,0,0,0.37223
42477,Brain of Blood,1971-08-01,1971,0,0,0,0.023982
42478,Happiness Runs,2010-05-14,2010,0,0,0,0.724578
42479,Ciao! Manhattan,1973-04-19,1973,0,0,0,0.065306
42481,The Goalie's Anxiety at the Penalty Kick,1972-02-19,1972,410000,100,-409900,0.769053
42482,Elvis on Tour,1972-01-01,1972,0,0,0,0.0339
42483,Last of the Red Hot Lovers,1972-01-01,1972,0,0,0,0.257942
42485,Cat's Play,1974-05-10,1974,0,0,0,0.002001
42486,Napoleon and Samantha,1972-07-05,1972,0,0,0,0.832361
42487,Necromancy,1972-09-22,1972,0,0,0,0.299238
42488,The New Land,1972-01-01,1972,0,0,0,1.786742
42489,Sounder,1972-09-24,1972,0,0,0,0.684483
42491,Ulzana's Raid,1972-01-01,1972,0,0,0,6.349126
42492,Up the Sandbox,1972-12-21,1972,0,0,0,0.13845
42493,Cold Turkey,1971-02-19,1971,0,11000000,11000000,0.60908
42494,Glen and Randa,1971-09-19,1971,0,0,0,0.007963
42495,King Lear,1971-02-04,1971,0,0,0,0.187901
42495,King Lear,1971-02-04,1971,0,0,0,0.187901
42496,Millhouse,1971-01-01,1971,0,0,0,0.019523
42497,Pink Narcissus,1971-01-01,1971,27000,0,-27000,0.804439
42498,The Adversary,1970-10-27,1970,0,0,0,0.003553
42499,The Night Evelyn Came out of the Grave,1971-08-18,1971,0,0,0,0.801941
42500,Lawman,1971-01-01,1971,0,0,0,1.739038
42501,Murmur of the Heart,1971-04-27,1971,0,0,0,3.981996
42502,The Brute,1953-02-05,1953,0,0,0,0.367499
42506,The Housemaid,1960-11-03,1960,0,0,0,1.817185
42507,Bestseller,2010-04-15,2010,0,0,0,1.289258
42510,The Idle Class,1921-09-25,1921,0,0,0,0.941815
42511,Orphans of the Storm,1921-12-28,1921,0,0,0,1.526876
42512,Die Nibelungen: Kriemhild's Revenge,1924-04-25,1924,0,0,0,0.828949
42513,Two English Girls,1971-11-18,1971,0,0,0,1.66853
42514,Plaza Suite,1971-05-12,1971,0,0,0,4.597434
42515,The Man Called Flintstone,1966-08-03,1966,0,0,0,1.323822
42516,Love,1971-01-21,1971,0,0,0,0.624965
42517,The Big Doll House,1971-01-01,1971,0,0,0,1.554937
42518,Gulliver's Travels,1939-11-10,1939,0,0,0,2.059715
42519,The Brotherhood of Satan,1971-08-06,1971,0,0,0,0.403656
42521,Idiots and Angels,2008-04-26,2008,0,0,0,1.300214
42522,The Hired Hand,1971-08-11,1971,0,0,0,1.500499
42525,The Last Valley,1971-01-28,1971,0,0,0,5.729707
42526,The Nightcomers,1971-01-01,1971,0,0,0,6.577661
42527,The Projectionist,1971-01-17,1971,0,0,0,0.103888
42528,Long Live Death,1971-01-01,1971,0,0,0,0.008527
42529,W.R. - Mysteries of the Organism,1971-10-13,1971,0,0,0,1.721716
42530,What's the Matter with Helen?,1971-06-30,1971,0,0,0,3.644541
42531,Wild Rovers,1971-06-23,1971,0,0,0,0.869434
42532,Willard,1971-07-30,1971,0,0,0,0.793676
42533,Angels Die Hard,1970-07-08,1970,0,0,0,1e-06
42536,Napoleon,1927-11-14,1927,0,0,0,1.742727
42537,The Wedding March,1928-10-06,1928,0,0,0,0.451434
42538,Sadie Thompson,1928-01-07,1928,0,0,0,0.250166
42539,The Birch Wood,1970-11-10,1970,0,0,0,1.109159
42541,From the Terrace,1960-09-09,1960,0,0,0,0.578068
42542,Starship Invasions,1977-10-14,1977,0,0,0,0.790107
42548,The Secret Diaries of Miss Anne Lister,2010-03-01,2010,0,0,0,2.079269
42551,Sky Riders,1976-03-26,1976,0,0,0,0.838555
42552,Bloodfist,1989-09-22,1989,0,0,0,0.00195
42553,The Musketeers of Pig Alley,1912-10-31,1912,0,0,0,1.356251
42554,Accused at 17,2009-12-05,2009,0,0,0,0.477627
42560,American Fusion,2005-01-01,2005,0,0,0,0.002602
42561,Against the Current,2009-01-18,2009,3000000,0,-3000000,1.71344
42564,Land of the Pharaohs,1955-07-24,1955,0,0,0,1.323773
42565,Underworld,1927-08-20,1927,0,0,0,0.857462
42566,An Eye for an Eye,1981-08-14,1981,0,7496681,7496681,2.28638
42567,David and Bathsheba,1951-08-10,1951,0,0,0,2.162008
42569,Where‚Äôs Poppa?,1970-11-10,1970,0,0,0,3.351759
42570,By the Sword,1991-10-07,1991,0,0,0,0.460399
42571,The Double Hour,2009-10-09,2009,3906840,4300000,393160,2.382068
42576,Hercules and the Captive Women,1961-08-19,1961,0,0,0,0.635926
42579,Il figlio pi√π piccolo,2010-02-19,2010,0,0,0,0.855519
42580,Life With Mikey,1993-06-04,1993,0,0,0,6.446229
42581,Rock-a-Bye Baby,1958-07-23,1958,0,0,0,1.048805
42585,The Pleasure of Being Robbed,2008-10-03,2008,500000,0,-500000,0.545336
42586,Darling Lili,1970-01-01,1970,0,0,0,0.552281
42587,Chariots of the Gods,1970-01-01,1970,0,25,25,0.005351
42588,Getting Straight,1970-05-13,1970,0,13300000,13300000,0.787265
42589,"Hi, Mom!",1970-04-27,1970,0,0,0,2.455795
42590,The Clowns,1970-08-30,1970,0,0,0,1.103624
42591,The Bloody Judge,1970-02-05,1970,0,0,0,0.44225
42593,Lovers and Other Strangers,1970-08-12,1970,0,0,0,1.913071
42595,The Spider's Stratagem,1970-10-25,1970,0,0,0,0.62167
42597,The Owl and the Pussycat,1970-01-01,1970,0,0,0,1.589466
42599,There's a Girl in My Soup,1970-12-15,1970,0,0,0,6.627273
42600,Watermelon Man,1970-01-01,1970,0,0,0,0.000844
42601,Zat√¥ichi Meets Yojimbo,1970-01-15,1970,0,0,0,1.553736
42602,The Passion of Anna,1969-11-10,1969,0,0,0,2.575461
42603,Valentino,1977-09-07,1977,5000000,0,-5000000,1.387287
42604,"Goodbye, Columbus",1969-01-01,1969,0,0,0,0.954205
42605,Hamlet,1969-12-21,1969,0,0,0,0.873375
42606,Invocation of My Demon Brother,1969-01-01,1969,0,0,0,0.490584
42607,"Goodbye, Mr. Chips",1969-11-05,1969,9000000,0,-9000000,1.073128
42611,The Sorrow and the Pity,1969-09-18,1969,0,0,0,0.863949
42612,Medium Cool,1969-08-27,1969,0,0,0,1.080317
42614,Our Dancing Daughters,1928-09-01,1928,0,0,0,0.112326
42615,A Woman of Affairs,1928-12-15,1928,383000,0,-383000,0.227906
42616,The Virginian,1929-11-09,1929,0,0,0,0.037264
42617,Burn!,1969-12-21,1969,0,0,0,7.354711
42618,Sweet Charity,1969-01-01,1969,8000000,20000000,12000000,0.537378
42619,Tell Them Willie Boy Is Here,1969-10-31,1969,0,0,0,1.447031
42621,Winning,1969-05-22,1969,0,0,0,1.966696
42622,Finian's Rainbow,1968-10-09,1968,0,0,0,3.100523
42623,"I Love You, Alice B. Toklas!",1968-10-06,1968,0,0,0,3.285576
42626,Isadora,1968-09-14,1968,0,0,0,2.142332
42628,"Goke, Body Snatcher from Hell",1968-08-14,1968,0,0,0,0.464229
42630,Lady in Cement,1968-11-19,1968,0,0,0,3.40004
42632,Monterey Pop,1968-12-26,1968,0,0,0,8.003836
42633,No Way to Treat a Lady,1968-03-20,1968,0,0,0,0.7583
42634,Petulia,1968-06-10,1968,0,0,0,5.075434
42635,"Rachel, Rachel",1968-01-01,1968,0,0,0,1.464778
42636,The Detective,1968-05-28,1968,0,0,0,0.782194
42637,Diary of a Lost Girl,1929-09-27,1929,0,0,0,0.589726
42638,Queen Kelly,1929-01-01,1929,0,0,0,0.734839
42640,The Big Trail,1930-11-01,1930,0,0,0,3.192318
42641,Morocco,1930-11-14,1930,0,0,0,1.691796
42642,The Adventures of Prince Florisel,1979-01-01,1979,0,0,0,0.218615
42645,The Horse in the Gray Flannel Suit,1968-12-16,1968,0,0,0,0.506363
42647,The Twelve Months,1956-12-30,1956,0,0,0,0.597861
42648,The Night They Raided Minsky's,1968-12-22,1968,0,0,0,0.394843
42649,The Queen,1968-01-01,1968,0,0,0,0.03653
42650,The Savage Seven,1968-05-01,1968,0,0,0,0.369964
42651,Cinderella,1947-11-28,1947,0,0,0,0.486073
42652,The Prisoner of If Castle,1988-01-01,1988,0,0,0,0.243401
42655,Andromeda Nebula,1967-12-04,1967,0,0,0,0.056092
42657,The Mark of Zorro,1920-12-05,1920,0,0,0,0.336801
42658,Helen of Troy,1956-01-26,1956,0,0,0,5.489068
42659,Blonde Crazy,1931-12-03,1931,0,0,0,0.325885
42661,The Vikings,1958-06-28,1958,5000000,0,-5000000,3.684396
42664,The War Lord,1965-11-17,1965,0,0,0,7.704667
42668,Alexander the Great,1956-03-28,1956,0,0,0,2.327854
42669,Five Star Final,1931-09-26,1931,0,0,0,9.035549
42673,Santa Baby 2,2009-12-13,2009,0,0,0,1.057133
42674,Gallo cedrone,1998-10-16,1998,0,0,0,1.735198
42675,Genitori & figli:) - Agitare bene prima dell'uso,2010-02-26,2010,0,0,0,2.025901
42676,The Fifth Cord,1971-08-28,1971,0,0,0,0.524639
42678,The Shanghai Gesture,1941-12-25,1941,0,0,0,9.089542
42679,Giulia Doesn't Date at Night,2009-02-27,2009,0,0,0,0.899416
42683,Black Legion,1937-01-30,1937,235000,0,-235000,0.703532
42684,Skyline,2010-11-11,2010,10000000,66821036,56821036,7.676017
42685,The Stalking Moon,1968-12-25,1968,0,0,0,2.635436
42687,Where Were You When the Lights Went Out?,1968-01-01,1968,0,0,0,0.761123
42688,Wild in the Streets,1968-05-29,1968,1000000,0,-1000000,2.619751
42689,Berserk,1967-11-01,1967,0,0,0,1.321551
42690,Diabolically Yours,1967-12-22,1967,0,0,0,0.457716
42691,Oedipus Rex,1967-09-02,1967,0,0,0,2.425287
42692,Elvira Madigan,1967-04-24,1967,0,0,0,2.327934
42693,Enter Laughing,1967-01-01,1967,0,0,0,0.100626
42694,Who's That Knocking at My Door,1967-11-15,1967,0,0,0,1.488118
42695,I Am Curious (Yellow),1967-01-01,1967,0,0,0,1.478689
42696,"Love Affair, or the Case of the Missing Switchboard Operator",1967-09-22,1967,0,0,0,1.022493
42697,Mondo Hollywood,1967-06-30,1967,0,0,0,0.038659
42699,"Yongary, Monster from the Deep",1967-01-01,1967,0,0,0,2.31428
42700,The Night of the Generals,1967-01-29,1967,0,0,0,12.061386
42701,The Shooting,1966-10-23,1966,75000,0,-75000,2.760405
42702,The St. Valentine's Day Massacre,1967-06-30,1967,2175000,0,-2175000,1.764213
42703,The Way West,1967-05-24,1967,0,0,0,2.174215
42706,Frank & Jesse,1995-04-22,1995,0,0,0,0.982153
42707,Road to Nowhere,2011-04-13,2011,5000000,27046,-4972954,1.744659
42709,"Silent Night, Deadly Night III: Better Watch Out!",1989-11-17,1989,0,0,0,0.660055
42710,Silent Madness,1984-10-26,1984,0,0,0,0.037714
42711,The Slams,1973-09-26,1973,0,0,0,0.1029
42712,The X from Outer Space,1967-03-25,1967,0,0,0,0.368482
42713,Up the Down Staircase,1967-01-19,1967,0,0,0,0.604325
42714,Any Wednesday,1966-10-13,1966,0,0,0,0.509197
42716,Assault on a Queen,1966-06-15,1966,0,0,0,0.595186
42717,Circus of Fear,1966-04-29,1966,0,0,0,0.698245
42718,The Pornographers,1966-03-12,1966,0,0,0,0.937943
42719,Georgy Girl,1966-08-04,1966,0,0,0,1.981755
42720,Violence at Noon,1966-07-15,1966,0,0,0,1.101985
42721,Fighting Elegy,1966-09-09,1966,0,0,0,0.963536
42722,The Nun,1966-12-31,1966,0,0,0,1.196217
42724,Morgan: A Suitable Case for Treatment,1966-01-01,1966,0,0,0,1.207649
42725,The Wild Angels,1966-07-20,1966,0,0,0,5.808639
42726,A Man and a Woman,1966-01-01,1966,0,0,0,2.924112
42727,Women of the Prehistoric Planet,1966-04-14,1966,0,0,0,0.81459
42728,You're a Big Boy Now,1966-09-09,1966,0,0,0,2.134702
42729,A Study in Terror,1965-10-01,1965,0,0,0,1.02411
42731,A Thousand Clowns,1965-12-13,1965,0,0,0,0.345637
42732,Bad Girls Go to Hell,1965-12-24,1965,0,0,0,0.534341
42733,Love Meetings,1965-05-05,1965,0,0,0,0.474874
42734,Dear Brigitte,1965-01-01,1965,0,0,0,0.33418
42735,Die! Die! My Darling!,1965-03-21,1965,0,0,0,1.852079
42737,Morituri,1965-08-24,1965,0,0,0,0.545455
42738,Scorpio,1973-04-10,1973,0,0,0,2.265786
42739,The War Zone,1999-06-11,1999,0,0,0,3.46626
42740,The Collector,1965-06-17,1965,0,0,0,3.059377
42741,Un Flic,1972-09-30,1972,0,0,0,2.143949
42743,The Human Duplicators,1965-03-03,1965,0,0,0,0.134851
42744,The Knack... and How to Get It,1965-05-01,1965,0,0,0,1.299084
42748,Bo,2010-02-10,2010,0,0,0,1.196946
42750,Return of the Secaucus Seven,1980-09-05,1980,0,0,0,0.492593
42752,Midnight,1934-03-17,1934,0,0,0,0.521537
42754,Three Can Play That Game,2007-01-01,2007,1000000,0,-1000000,0.187308
42756,Angels Over Broadway,1940-10-02,1940,0,0,0,1.164564
42757,Everything Will Be Fine,2010-01-28,2010,0,0,0,1.135274
42758,Small Faces,1996-04-05,1996,1850000,0,-1850000,0.90913
42759,The Call of the Wild,1972-11-30,1972,0,0,0,1.023079
42762,Hillsborough,1996-09-11,1996,0,0,0,0.996787
42764,Jonathan of the Bears,1995-04-21,1995,0,0,0,0.55084
42767,Three Little Words,1950-07-12,1950,0,0,0,0.661981
42770,Devil's Island,1996-10-03,1996,0,0,0,0.223278
42772,Dana Carvey: Critics' Choice,1995-10-14,1995,0,0,0,0.26931
42779,Those Calloways,1965-01-28,1965,0,0,0,0.277806
42780,Village of the Giants,1965-10-20,1965,0,0,0,0.6148
42782,Circus World,1964-06-25,1964,0,0,0,1.447293
42783,Kissin' Cousins,1964-03-06,1964,0,0,0,2.377285
42786,Kitten with a Whip,1964-11-04,1964,0,0,0,0.20604
42787,Lady in a Cage,1964-01-01,1964,0,0,0,0.686717
42788,Before the Revolution,1964-05-13,1964,0,0,0,1.316212
42789,Ride the Wild Surf,1964-01-01,1964,0,0,0,0.597132
42790,Seduced and Abandoned,1964-01-30,1964,0,0,0,2.285155
42791,The Americanization of Emily,1964-10-27,1964,0,0,0,1.537428
42792,The Carpetbaggers,1964-04-08,1964,0,0,0,1.427019
42793,The Flesh Eaters,1964-03-18,1964,0,0,0,0.208676
42794,The Horror of Party Beach,1964-06-01,1964,0,0,0,0.430227
42795,The Moon-Spinners,1964-01-01,1964,0,0,0,0.985362
42796,The Strangler,1964-04-01,1964,0,0,0,0.09055
42797,The Unsinkable Molly Brown,1964-06-11,1964,0,0,0,5.139716
42798,A New Kind of Love,1963-10-10,1963,0,0,0,0.405717
42800,Heavens Above!,1963-05-20,1963,0,0,0,0.484307
42801,"Yesterday, Today and Tomorrow",1963-12-19,1963,0,0,0,6.98571
42802,The Dinner Guest,2007-09-19,2007,0,0,0,1.057585
42807,The Newton Boys,1998-03-26,1998,27000000,76000000,49000000,2.917013
42808,The Man Who Will Come,2009-10-16,2009,0,0,0,0.921548
42809,Kanto Wanderer,1963-11-23,1963,0,0,0,0.150875
42811,Free and Easy,1930-03-22,1930,0,0,0,0.984917
42812,Anna Christie,1930-02-21,1930,0,0,0,0.843203
42814,The Front Page,1931-04-04,1931,0,0,0,0.798285
42815,The Criminal Code,1931-01-03,1931,0,0,0,0.461284
42816,The Champ,1931-11-21,1931,0,0,0,1.328118
42818,Marius,1931-10-09,1931,0,0,0,0.858991
42819,The City of Your Final Destination,2009-03-21,2009,0,0,0,0.700028
42822,"20,000 Years in Sing Sing",1932-12-24,1932,0,0,0,1.530243
42825,Crossroads,1942-07-23,1942,0,0,0,0.256422
42832,The Boys,1997-12-12,1997,0,0,0,0.530702
42836,Comradeship,1931-11-17,1931,0,0,0,0.358455
42837,The 3 Penny Opera,1931-02-18,1931,0,0,0,1.164615
42839,The Girl Can't Help It,1956-12-01,1956,0,0,0,2.364634
42845,The Blade,1995-12-21,1995,0,0,0,0.74515
42848,Lulu on the Bridge,1998-09-06,1998,0,0,0,1.415493
42850,Children of Invention,2010-08-10,2010,0,0,0,0.220007
42852,"Goodbye, Mr. Chips",1939-07-28,1939,0,0,0,9.042737
42861,Cimarron,1931-02-09,1931,0,0,0,1.133556
42862,"Falco: Damn It, We're Still Alive!",2008-02-07,2008,0,0,0,0.518516
42863,No Distance Left to Run,2010-01-14,2010,0,0,0,0.346651
42870,Creatures from the Abyss,1994-01-01,1994,250000,0,-250000,0.539887
42871,Gunman's Walk,1958-07-01,1958,0,0,0,1.60834
42872,Alien 2: On Earth,1980-04-11,1980,0,0,0,0.686594
42879,The Miracle of Morgan‚Äôs Creek,1944-01-19,1944,0,0,0,1.432657
42881,Julien Donkey-Boy,1999-09-07,1999,0,0,0,1.34763
42884,Cinderella,1997-11-02,1997,0,0,0,2.102013
42885,Strangers in the Night,1944-09-12,1944,0,0,0,0.355895
42886,Best Foot Forward,1943-10-08,1943,0,0,0,0.007987
42888,How Do You Know,2010-12-17,2010,120000000,48668907,-71331093,5.458387
42889,The Virginity Hit,2010-09-10,2010,2000000,563706,-1436294,2.235068
42891,Tennessee,2008-04-26,2008,0,0,0,0.72589
42892,Happy Family,2010-03-26,2010,0,0,0,3.176441
42903,Category 7: The End of the World,2005-11-06,2005,0,0,0,3.621037
42904,Supernova,2005-09-05,2005,0,0,0,6.416966
42910,Lord Save Us,2008-06-13,2008,980000,0,-980000,0.005079
42911,Skyscraper,1996-02-29,1996,0,0,0,0.925896
42914,Three on a Match,1932-10-29,1932,0,0,0,0.75757
42916,Fading of the Cries,2011-07-08,2011,450000,0,-450000,2.514092
42918,Winnebago Man,2009-03-14,2009,0,178174,178174,1.215754
42934,Random Quest,2006-11-26,2006,0,0,0,0.121488
42938,The Clone Returns Home,2008-10-19,2008,0,0,0,0.534662
42939,H.P. Lovecraft's The Tomb,2007-06-19,2007,0,0,0,1.106868
42941,30 Days of Night: Dark Days,2010-10-04,2010,0,0,0,7.320221
42943,The Devil Is a Woman,1935-05-03,1935,0,0,0,0.660233
42944,Say Goodnight,2008-07-22,2008,0,0,0,0.175561
42949,Arthur 3: The War of the Two Worlds,2010-08-22,2010,70200000,0,-70200000,11.371222
42950,What if...,2010-08-20,2010,0,0,0,1.365366
42952,72 Meters,2004-02-12,2004,1600000,0,-1600000,0.62583
42960,Helsinki Napoli - All Night Long,1987-11-13,1987,0,0,0,0.002001
42966,Once Upon a Time in Mumbaai,2010-07-30,2010,10,0,-10,1.147502
42968,The Nun,2005-11-03,2005,0,0,0,1.163546
42971,Mrs. Ashboro's Cat,2003-01-01,2003,2800000,0,-2800000,0.304437
42973,Queen to Play,2009-08-05,2009,0,1056938,1056938,2.94798
42979,Robot Chicken: Star Wars,2007-07-17,2007,0,0,0,7.994542
42981,Frank and Ollie,1995-10-20,1995,0,0,0,0.142357
42983,A Lonely Woman,1987-03-15,1987,0,0,0,0.319984
42984,The Insect Woman,1963-11-16,1963,0,0,0,3.249537
42986,The Courtship of Eddie's Father,1963-03-27,1963,0,0,0,4.127528
42987,The Servant,1963-11-01,1963,0,0,0,6.071204
42988,The Wheeler Dealers,1963-01-01,1963,0,0,0,1.355896
42989,The Wrong Arm of the Law,1963-03-17,1963,0,0,0,0.677273
42990,40 Pounds of Trouble,1962-01-01,1962,0,0,0,0.682779
42991,Billy Rose's Jumbo,1962-12-06,1962,0,0,0,0.40595
42994,Memories,1995-12-23,1995,0,0,0,4.648211
42995,Experiment in Terror,1962-04-12,1962,0,0,0,14.209279
42996,Five Weeks in a Balloon,1962-01-01,1962,0,0,0,0.386074
42997,H.M.S. Defiant,1962-04-15,1962,0,0,0,0.525019
42998,The Horrible Dr. Hichcock,1962-01-01,1962,0,0,0,0.184277
42999,The Grim Reaper,1962-09-19,1962,0,0,0,0.690606
43000,The Elusive Corporal,1962-05-23,1962,0,0,0,0.655428
43001,Sundays and Cybele,1962-11-12,1962,0,0,0,0.833509
43002,Lonely Are the Brave,1962-05-24,1962,0,0,0,2.277618
43003,F for Fake,1973-03-13,1973,0,0,0,3.252225
43004,Long Day's Journey Into Night,1962-10-09,1962,0,0,0,1.351823
43006,My Geisha,1962-06-13,1962,0,0,0,0.14668
43007,Period of Adjustment,1962-10-31,1962,0,0,0,0.168755
43008,The Hanging Tree,1959-03-13,1959,0,0,0,3.931676
43009,Red Nightmare,1962-02-11,1962,0,0,0,0.001188
43011,Sodom and Gomorrah,1962-01-01,1962,0,0,0,0.639894
43012,Taras Bulba,1962-11-21,1962,0,0,0,1.308651
43013,The Counterfeit Traitor,1962-04-17,1962,0,0,0,0.817863
43015,Varan the Unbelievable,1962-12-07,1962,0,0,0,0.767422
43016,Waltz of the Toreadors,1962-01-01,1962,0,0,0,0.100951
43017,Back Street,1961-10-11,1961,0,0,0,0.219575
43018,Gidget Goes Hawaiian,1961-06-02,1961,0,0,0,0.207903
43020,The Colossus of Rhodes,1961-06-16,1961,0,0,0,4.80721
43021,Sex Galaxy,2008-08-22,2008,0,0,0,0.390554
43022,King of the Roaring 20's: The Story of Arnold Rothstein,1961-06-11,1961,0,0,0,0.021603
43023,Konga,1961-01-01,1961,0,0,0,0.337964
43026,Paris Belongs to Us,1961-12-13,1961,0,0,0,0.595496
43027,Teen Kanya,1961-05-05,1961,0,0,0,0.294809
43028,Victim,1961-08-01,1961,0,0,0,1.289505
43029,Bells Are Ringing,1960-06-23,1960,0,0,0,5.215541
43030,Cash McCall,1960-01-27,1960,0,0,0,0.362876
43031,The Goddess,1960-02-19,1960,0,0,0,0.241231
43034,Hell to Eternity,1960-08-01,1960,0,0,0,0.157003
43035,Heller in Pink Tights,1960-03-01,1960,0,0,0,2.743674
43036,Mill of the Stone Women,1960-08-30,1960,0,0,0,0.961691
43037,Kidnapped,1960-01-01,1960,0,0,0,2.532177
43039,Never on Sunday,1960-05-24,1960,151000,8000000,7849000,1.879162
43040,Sergeant Rutledge,1960-05-18,1960,0,0,0,4.972855
43041,The Adventures of Huckleberry Finn,1960-08-03,1960,0,0,0,0.918072
43042,The Story of Ruth,1960-06-17,1960,0,0,0,0.523622
43045,The Hypnotic Eye,1960-02-27,1960,365000,0,-365000,0.635717
43046,The Rise and Fall of Legs Diamond,1960-02-03,1960,0,0,0,0.48068
43047,The Sundowners,1960-12-08,1960,0,0,0,0.763723
43048,Tunes of Glory,1960-08-16,1960,0,0,0,1.336759
43049,Where the Boys Are,1960-12-28,1960,0,0,0,0.804731
43051,Al Capone,1959-01-01,1959,0,0,0,2.761631
43052,S√§g att du √§lskar mig,2006-08-25,2006,0,0,0,0.318888
43065,"Nightmares in Red, White and Blue",2009-08-06,2009,0,0,0,5.873644
43071,Corto Maltese in Siberia,2002-09-25,2002,0,0,0,1.5371
43074,Ghostbusters,2016-07-14,2016,144000000,229147509,85147509,17.162744
43075,The Cabin in the Cotton,1932-10-15,1932,0,0,0,0.296602
43077,Gordon's War,1973-08-09,1973,0,0,0,0.000785
43079,Mad About Mambo,2000-04-04,2000,0,0,0,4.51621
43083,This is Sodom,2010-08-05,2010,2745000,5850000,3105000,0.63535
43084,Deadly Species,2002-02-15,2002,0,0,0,0.222971
43085,Dead and Deader,2006-12-16,2006,0,0,0,5.015147
43088,Spider Lilies,2007-03-30,2007,0,0,0,0.974875
43089,Roadgames,1981-06-26,1981,1750000,100000,-1650000,4.291236
43090,Gunless,2010-04-30,2010,10000000,0,-10000000,2.726078
43092,Beat Girl,1960-08-21,1960,0,0,0,0.541296
43093,The Giant Behemoth,1959-03-03,1959,0,0,0,1.311197
43094,"Go, Johnny, Go!",1959-06-01,1959,0,0,0,0.189384
43095,Odd Obsession,1959-06-23,1959,0,0,0,0.849613
43096,Gidget,1959-04-09,1959,0,0,0,0.802364
43097,Girls Town,1959-10-05,1959,0,0,0,0.568897
43099,Mothman,2010-04-24,2010,0,0,0,0.706613
43100,General Della Rovere,1959-10-07,1959,0,0,0,3.566556
43101,Picnic on the Grass,1959-11-11,1959,0,0,0,0.551862
43102,Dangerous Liaisons,1959-09-09,1959,0,0,0,0.651211
43103,Room at the Top,1959-01-22,1959,0,0,0,1.876199
43105,The Alligator People,1959-07-01,1959,0,0,0,0.686882
43106,The Battle of the Sexes,1960-02-25,1960,0,0,0,0.586584
43109,The Killer Shrews,1959-06-25,1959,0,0,0,1.230246
43110,The Mating Game,1959-04-29,1959,0,0,0,0.352351
43111,The Young Philadelphians,1959-05-30,1959,0,0,0,1.162798
43112,Tiger Bay,1959-03-01,1959,0,0,0,1.133413
43113,The H-Man,1958-06-24,1958,0,0,0,0.268765
43114,Buchanan Rides Alone,1958-08-01,1958,0,0,0,0.787377
43115,Earth vs. the Spider,1958-09-01,1958,0,0,0,0.406202
43116,High School Confidential!,1958-05-30,1958,0,0,0,0.785257
43117,I Married a Monster from Outer Space,1958-10-01,1958,0,0,0,0.762256
43118,"Ivan the Terrible, Part II: The Boyars' Plot",1958-06-06,1958,0,0,0,1.701091
43119,Machine-Gun Kelly,1958-05-01,1958,0,0,0,1.493682
43120,Missile to the Moon,1958-11-15,1958,65000,0,-65000,0.565431
43121,The Rickshaw Man,1958-04-21,1958,0,0,0,0.554417
43122,The Private Life of Henry VIII,1933-08-17,1933,0,0,0,3.491337
43128,Sons of the Desert,1933-12-29,1933,0,0,0,4.305542
43130,Lady for a Day,1933-09-13,1933,0,0,0,1.9081
43131,Speak Easily,1932-08-13,1932,0,0,0,0.412714
43132,Rasputin and the Empress,1932-03-24,1932,0,0,0,0.431214
43135,Queen of Outer Space,1958-09-08,1958,0,0,0,0.259671
43136,Separate Tables,1958-12-18,1958,0,0,0,1.588943
43137,Teacher's Pet,1958-04-01,1958,0,0,0,2.092184
43138,The Brothers Karamazov,1958-02-20,1958,0,0,0,3.425142
43139,The Horse's Mouth,1958-11-11,1958,0,0,0,0.829756
43141,The Matchmaker,1958-08-12,1958,0,0,0,0.167778
43142,The Naked and the Dead,1958-08-06,1958,0,0,0,0.70288
43143,The Crawling Eye,1958-07-07,1958,0,0,0,0.93291
43144,The Wild Women of Wongo,1958-01-01,1958,0,0,0,0.599872
43145,One Hour with You,1932-03-22,1932,0,0,0,1.406699
43146,Fanny,1932-11-02,1932,0,0,0,0.507325
43147,Blessed Event,1932-09-10,1932,0,0,0,0.090803
43148,The Vampire Bat,1933-01-21,1933,0,0,0,1.279057
43149,The Son of Kong,1933-12-22,1933,250000,0,-250000,1.771424
43150,Little Miss Marker,1934-06-01,1934,0,0,0,1.113736
43151,Rosalie,1937-12-24,1937,0,0,0,0.891202
43153,Harvest,1937-10-28,1937,0,0,0,0.050314
43155,Test Pilot,1938-04-22,1938,0,0,0,0.585649
43157,Just Around the Corner,1938-11-11,1938,0,0,0,0.400777
43158,Godspell: A Musical Based on the Gospel According to St. Matthew,1973-03-21,1973,0,0,0,1.516959
43167,Andy Hardy's Double Life,1942-12-01,1942,0,0,0,0.144944
43172,Around the World,1943-11-27,1943,0,0,0,0.001177
43176,Ziegfeld Follies,1945-08-13,1945,0,0,0,0.852584
43177,Son of Lassie,1945-01-01,1945,0,0,0,0.631099
43187,That Forsyte Woman,1949-11-03,1949,0,0,0,0.054871
43188,The Pride of St. Louis,1952-01-01,1952,0,0,0,0.080581
43189,Million Dollar Mermaid,1952-12-04,1952,0,0,0,0.104231
43191,"Beware, My Lovely",1952-08-07,1952,0,0,0,0.770682
43192,Houdini,1953-07-02,1953,0,0,0,1.47243
43193,Dangerous When Wet,1953-07-03,1953,0,0,0,0.566233
43194,Ulysses,1954-10-06,1954,0,0,0,1.993626
43195,Senso,1954-09-02,1954,0,0,0,1.98483
43199,The Eddy Duchin Story,1956-01-01,1956,0,0,0,2.947023
43200,Basilicata coast to coast,2010-04-09,2010,0,0,0,3.107762
43205,Tarzan's Greatest Adventure,1959-07-08,1959,0,0,0,0.334816
43206,Pitbullterje,2005-11-04,2005,0,0,0,0.190787
43208,Snowball Effect: The Story of Clerks,2004-09-07,2004,0,0,0,0.378518
43209,Ong Bak 3,2010-05-05,2010,0,2340363,2340363,9.596685
43211,7 Kilos in 7 Days,1986-01-01,1986,0,0,0,2.125375
43212,My Dear Desperado,2010-05-20,2010,800000,4214668,3414668,1.049484
43213,Chicago Overcoat,2009-10-10,2009,3200000,0,-3200000,1.019869
43219,La Mission,2009-01-19,2009,2000000,0,-2000000,0.827387
43226,The Mysterians,1957-12-28,1957,0,0,0,1.138696
43228,I Was a Teenage Werewolf,1957-06-19,1957,82000,2000000,1918000,0.75684
43229,Johnny Tremain,1957-06-15,1957,0,0,0,1.403067
43230,Kronos,1957-03-31,1957,0,0,0,0.935835
43231,Le Notti Bianche,1957-07-06,1957,0,0,0,2.69067
43232,Les Girls,1957-01-01,1957,0,0,0,6.636057
43234,Man of a Thousand Faces,1957-10-01,1957,0,0,0,2.108187
43236,Peyton Place,1957-12-13,1957,0,0,0,1.990531
43239,Silk Stockings,1957-07-18,1957,0,0,0,2.690792
43240,Tammy and the Bachelor,1957-06-14,1957,0,0,0,0.922678
43241,The Amazing Colossal Man,1957-10-25,1957,0,0,0,0.870274
43248,The Brain from Planet Arous,1957-10-01,1957,0,0,0,0.598374
43250,The Lonely Man,1957-06-21,1957,0,0,0,0.127452
43252,The Story of Mankind,1957-11-08,1957,0,0,0,0.804527
43253,The Tall T,1957-04-02,1957,0,0,0,1.331762
43254,7th Cavalry,1956-01-01,1956,0,0,0,0.54068
43255,Street of Shame,1956-03-18,1956,0,0,0,1.861653
43256,Autumn Leaves,1956-08-01,1956,0,0,0,1.410229
43257,Bundle of Joy,1956-12-12,1956,0,0,0,0.441986
43258,Friendly Persuasion,1956-11-25,1956,0,0,0,1.45833
43259,Hollywood or Bust,1956-12-06,1956,0,0,0,0.695757
43260,Jubal,1956-04-06,1956,0,0,0,1.433165
43261,The Benny Goodman Story,1956-01-01,1956,0,0,0,0.830073
43263,Jesse Stone: No Remorse,2010-05-09,2010,0,0,0,6.171229
43266,How Green Was My Valley,1941-10-28,1941,1250000,6000000,4750000,9.058578
43267,29th Street,1991-11-01,1991,0,0,0,1.04741
43268,Poor Little Rich Girl,1936-07-24,1936,0,0,0,0.723765
43269,The Strange Affair of Uncle Harry,1945-08-17,1945,0,0,0,0.752893
43271,Unconscious,2004-08-27,2004,0,0,0,1.393311
43275,Roswell,1994-07-31,1994,0,0,0,1.241304
43277,The Great Ziegfeld,1936-04-08,1936,0,0,0,0.715129
43278,The Life of Emile Zola,1937-10-02,1937,0,0,0,1.142535
43279,Attack Force Z,1982-06-10,1982,0,88000,88000,1.021685
43281,Love Without Pity,1989-11-22,1989,0,0,0,0.002317
43292,Tutte le donne della mia vita,2007-04-13,2007,0,0,0,0.595967
43294,An American in Rome,1954-01-01,1954,0,0,0,3.249737
43303,Nora Roberts' Tribute,2009-04-11,2009,0,0,0,1.206291
43306,A Guy Named Joe,1944-03-01,1944,2627000,5363000,2736000,0.662665
43307,Mr. Skeffington,1944-05-25,1944,0,0,0,1.618199
43308,The Shepherd of the Hills,1941-07-18,1941,0,0,0,0.977858
43309,The Gamma People,1956-12-01,1956,0,0,0,0.155576
43310,The King and Four Queens,1956-12-21,1956,0,0,0,4.064491
43311,The Opposite Sex,1956-10-26,1956,0,0,0,0.485327
43312,The She-Creature,1956-08-01,1956,0,0,0,1.246874
43313,The Teahouse of the August Moon,1956-01-01,1956,0,0,0,0.678003
43314,A Lawless Street,1955-11-15,1955,0,0,0,0.910456
43316,All That Heaven Allows,1955-12-25,1955,0,3100000,3100000,3.922641
43317,Artists and Models,1955-11-07,1955,1500000,0,-1500000,3.2245
43318,Interrupted Melody,1955-07-01,1955,0,0,0,0.169481
43319,Man Without a Star,1955-03-24,1955,0,0,0,3.020363
43321,Pete Kelly's Blues,1955-07-31,1955,0,0,0,0.874713
43322,A Generation,1955-01-26,1955,0,0,0,0.832219
43323,Richard III,1955-12-13,1955,0,0,0,1.971284
43326,The Tender Trap,1955-11-04,1955,0,0,0,0.740862
43327,The Virgin Queen,1955-07-22,1955,0,0,0,0.728698
43329,Apache,1954-07-09,1954,0,0,0,1.607794
43332,Demetrius and the Gladiators,1954-06-16,1954,4500000,0,-4500000,1.108485
43333,D√©sir√©e,1954-11-16,1954,0,0,0,0.556292
43336,Executive Suite,1954-05-06,1954,0,0,0,2.171544
43337,Inauguration of the Pleasure Dome,1954-01-01,1954,0,0,0,0.588972
43338,Illusion Travels by Streetcar,1954-01-01,1954,0,0,0,0.282481
43339,Twenty-Four Eyes,1954-09-15,1954,0,0,0,0.617717
43340,Young at Heart,1954-12-01,1954,0,0,0,0.86603
43341,Cat-Women of the Moon,1953-09-03,1953,0,0,0,1.337813
43342,Donovan's Brain,1953-09-30,1953,0,0,0,1.327715
43343,Easy to Love,1953-12-25,1953,0,0,0,0.328907
43344,√âl,1953-07-09,1953,0,0,0,1.931894
43345,Old Gringo,1989-10-06,1989,0,0,0,1.582367
43346,Genevieve,1953-05-28,1953,0,0,0,1.152132
43347,Love & Other Drugs,2010-11-22,2010,30000000,102820008,72820008,7.575696
43348,Gun Fury,1953-10-30,1953,0,0,0,2.237684
43349,Gate of Hell,1953-10-30,1953,0,0,0,1.865846
43350,Lili,1953-07-10,1953,0,0,0,4.855811
43351,Pony Express,1953-01-01,1953,0,0,0,1.53743
43353,Robot Monster,1953-06-25,1953,16000,1000000,984000,0.892476
43354,The Captain's Paradise,1953-09-28,1953,0,0,0,0.945812
43355,The Master of Ballantrae,1953-01-01,1953,0,0,0,0.326214
43357,The Twonky,1953-01-01,1953,0,0,0,0.30079
43358,Carrie,1952-07-17,1952,0,0,0,3.415808
43360,Le Plaisir,1952-02-29,1952,0,0,0,1.051178
43361,The White Sheik,1952-09-20,1952,0,0,0,2.384287
43362,Love Is Better Than Ever,1952-02-23,1952,0,0,0,0.004869
43363,Lovely to Look At,1952-07-01,1952,0,0,0,0.002001
43364,The Life of Oharu,1952-01-01,1952,0,0,0,3.586218
43365,Stars and Stripes Forever,1952-01-01,1952,0,0,0,0.121661
43367,The Big Sky,1952-08-19,1952,140,0,-140,1.898482
43368,The Big Trees,1952-02-05,1952,0,0,0,0.966064
43369,The Card,1952-02-25,1952,0,0,0,0.806568
43370,The Lusty Men,1952-10-24,1952,0,0,0,0.620172
43371,Bedtime for Bonzo,1951-04-05,1951,0,0,0,0.077936
43372,Bellissima,1951-12-27,1951,0,0,0,1.928674
43373,Chained for Life,1952-01-01,1952,0,0,0,0.54733
43376,Diary of a Country Priest,1951-02-07,1951,0,0,0,2.957558
43378,Man in the Saddle,1951-12-02,1951,0,0,0,0.476306
43379,Miracle in Milan,1951-02-08,1951,0,0,0,1.607246
43380,Rawhide,1951-03-25,1951,0,0,0,1.495158
43381,Texas Carnival,1951-10-05,1951,0,0,0,0.05277
43384,Vengeance Valley,1951-02-06,1951,0,0,0,1.074432
43385,Born to Be Bad,1950-09-28,1950,0,0,0,9.743518
43386,Cyrano de Bergerac,1950-11-14,1950,0,0,0,4.617
43387,Francis,1950-01-01,1950,0,0,0,2.67732
43388,King Solomon's Mines,1950-11-09,1950,0,0,0,1.684532
43389,Variety Lights,1950-12-06,1950,0,0,0,0.679762
43390,Summer Stock,1950-08-31,1950,0,0,0,3.949985
43391,The Flying Saucer,1950-01-04,1950,0,0,0,0.432126
43392,The Jackie Robinson Story,1950-05-16,1950,0,0,0,0.58232
43394,Three Secrets,1950-10-20,1950,0,0,0,0.505205
43395,Two Weeks with Love,1950-01-01,1950,0,0,0,0.451601
43396,Union Station,1950-10-04,1950,0,0,0,1.497464
43397,Caught,1949-02-17,1949,0,0,0,1.580085
43398,Challenge to Lassie,1949-01-01,1949,0,0,0,1.017714
43407,None But the Brave,1965-02-24,1965,0,0,0,1.200662
43409,Traceless,2010-03-10,2010,0,0,0,1.426807
43410,Yuva,2004-05-22,2004,0,0,0,0.507051
43414,Rock n' Roll Nerd,2008-08-08,2008,0,0,0,0.236635
43417,The Magnificent Seven Ride!,1972-08-01,1972,3000000,0,-3000000,2.366529
43418,Beneath Hill 60,2010-04-15,2010,7347125,0,-7347125,5.661077
43419,Souls at Sea,1937-09-03,1937,0,0,0,0.627079
43422,Gringuito,1998-01-01,1998,0,0,0,0.001177
43423,The Wind Will Carry Us,1999-09-06,1999,0,0,0,1.301513
43429,Martin (Hache),1997-03-31,1997,0,0,0,2.435127
43430,"The Irony of Fate, or Enjoy Your Bath!",1975-12-31,1975,0,0,0,2.694572
43432,Roma,2004-04-15,2004,2763806,0,-2763806,0.420613
43434,Carlos,2010-05-19,2010,18000000,871279,-17128721,4.558075
43435,Jolson Sings Again,1949-08-17,1949,0,0,0,0.369118
43436,Little Women,1949-04-01,1949,0,0,0,5.551702
43437,Neptune's Daughter,1949-06-10,1949,0,0,0,0.400869
43438,The Rocking Horse Winner,1949-11-30,1949,0,0,0,0.486514
43439,The Secret Garden,1949-04-30,1949,0,0,0,0.273022
43440,The Stratton Story,1949-06-01,1949,0,0,0,0.713887
43441,Every Girl Should Be Married,1948-12-25,1948,0,0,0,0.593272
43442,I Remember Mama,1948-03-17,1948,0,0,0,1.595121
43443,Joan of Arc,1948-12-22,1948,0,0,0,1.083596
43444,Amore,1948-10-30,1948,0,0,0,0.341956
43445,La Terra Trema,1948-09-02,1948,0,0,0,1.148749
43448,Rachel and the Stranger,1948-09-20,1948,0,0,0,0.401971
43449,Romance on the High Seas,1948-06-25,1948,0,0,0,0.370227
43450,Scott of the Antarctic,1948-11-29,1948,0,0,0,0.485636
43451,Summer Holiday,1948-04-15,1948,0,0,0,0.165623
43452,The Babe Ruth Story,1948-09-16,1948,0,0,0,0.604675
43453,The Dark Past,1948-12-22,1948,0,0,0,0.513101
43454,The Fuller Brush Man,1948-06-01,1948,0,0,0,0.419152
43455,The Loves of Carmen,1948-08-23,1948,0,0,0,0.366948
43456,The Miracle of the Bells,1948-03-27,1948,0,0,0,0.317882
43457,Winter Meeting,1948-04-07,1948,0,0,0,0.006296
43458,Words and Music,1948-12-31,1948,0,0,0,1.023648
43459,The Pearl,1947-01-01,1947,0,0,0,0.720646
43460,Monsieur Vincent,1947-11-05,1947,0,0,0,0.507052
43461,Odd Man Out,1947-01-30,1947,0,0,0,3.017513
43462,Panic,1947-01-15,1947,0,0,0,0.072048
43463,Railroaded!,1947-09-25,1947,0,0,0,1.344363
43464,Sinbad il marinaio,1947-01-13,1947,0,0,0,1.846912
43466,The Farmer's Daughter,1947-01-01,1947,0,0,0,1.015109
43469,Shoeshine,1946-04-27,1946,0,0,0,3.11797
43470,A Stolen Life,1946-07-06,1946,0,0,0,1.39158
43471,Anna and the King of Siam,1946-08-11,1946,0,0,0,2.255925
43473,Dirty Gertie from Harlem U.S.A.,1946-01-01,1946,0,0,0,0.059193
43475,Gumby: The Movie,1995-12-01,1995,0,0,0,0.090452
43477,Shinbone Alley,1970-06-26,1970,0,0,0,3.8e-05
43481,Black River,2001-07-06,2001,0,0,0,0.607155
43485,Night and Day,1946-07-02,1946,0,0,0,0.62187
43486,Sylvia and the Ghost,1946-02-06,1946,0,0,0,0.004617
43487,No Regrets for Our Youth,1946-10-29,1946,0,0,0,0.463449
43488,A Walk in the Sun,1945-12-25,1945,0,0,0,8.85591
43489,Brewster's Millions,1945-04-07,1945,0,0,0,0.810032
43490,"Objective, Burma!",1945-02-17,1945,0,0,0,3.274326
43491,Rhapsody in Blue,1945-09-22,1945,0,0,0,0.078461
43492,The Corn Is Green,1945-07-14,1945,0,0,0,0.954383
43494,The Enchanted Cottage,1945-04-28,1945,0,0,0,0.457322
43495,The Seventh Veil,1945-10-18,1945,0,0,0,0.742283
43497,Tonight and Every Night,1945-01-09,1945,0,0,0,0.257605
43498,Yolanda and the Thief,1945-11-20,1945,0,0,0,0.120028
43499,Buffalo Bill,1943-12-31,1943,0,0,0,4.521805
43500,Here Come the Waves,1944-01-01,1944,0,0,0,0.180615
43501,Kismet,1944-10-01,1944,0,0,0,0.909065
43503,Step Lively,1944-07-26,1944,0,0,0,0.009344
43504,The Fighting Sullivans,1944-02-03,1944,0,0,0,0.521396
43506,Bataan,1943-06-03,1943,0,0,0,0.809567
43510,Guadalcanal Diary,1943-01-01,1943,0,0,0,0.204309
43511,Higher and Higher,1943-12-31,1943,0,0,0,0.041727
43512,Presenting Lily Mars,1943-04-29,1943,0,0,0,0.346945
43513,Stormy Weather,1943-07-21,1943,0,0,0,0.70239
43514,Thank Your Lucky Stars,1943-09-25,1943,0,0,0,6.037392
43515,The Sky's the Limit,1943-07-13,1943,0,0,0,0.176901
43516,The Song of Bernadette,1943-12-21,1943,0,0,0,1.171051
43517,This Is the Army,1943-08-14,1943,0,0,0,0.800156
43518,Thousands Cheer,1943-01-01,1943,0,0,0,0.275943
43522,Gentleman Jim,1942-11-14,1942,0,0,0,0.771401
43524,Iceland,1942-09-21,1942,0,0,0,0.004794
43525,In This Our Life,1942-05-16,1942,0,0,0,6.312577
43526,Journey for Margaret,1942-12-17,1942,0,0,0,0.263403
43529,Golden Boy,1939-09-05,1939,0,0,0,1.078091
43532,Summer Holiday,1963-02-18,1963,0,0,0,0.441386
43533,Two O'Clock Courage,1945-04-13,1945,0,0,0,0.510815
43535,A Simple Twist of Fate,1994-09-02,1994,0,0,0,4.13516
43539,The Next Three Days,2010-11-18,2010,30000000,51148651,21148651,9.591425
43542,The Rainmaker,1956-12-13,1956,0,0,0,1.469077
43544,Ma che colpa abbiamo noi,2003-01-10,2003,0,0,0,0.465185
43546,Bathing Beauty,1944-07-01,1944,2361000,6892000,4531000,0.789574
43548,Don't Play with Tigers,1982-01-15,1982,0,0,0,1.874153
43549,The Experiment,2010-07-15,2010,21800000,0,-21800000,9.662564
43550,My Last Five Girlfriends,2009-04-29,2009,0,0,0,7.04835
43551,A Date with the Falcon,1942-01-16,1942,0,0,0,0.280027
43552,Vanishing on 7th Street,2010-09-11,2010,10000000,1068682,-8931318,8.419427
43562,Along the Great Divide,1951-06-02,1951,0,0,0,0.79082
43566,Before and After,1996-02-23,1996,35000000,0,-35000000,2.938293
43571,Rich and Poor,1983-01-01,1983,0,0,0,0.033991
43580,The Cat in the Hat,1971-03-10,1971,0,0,0,0.451122
43584,Sacred Heart,2005-02-25,2005,0,0,0,2.266673
43585,Headless Horseman,2007-10-27,2007,0,0,0,0.54312
43592,Teeth,2000-10-13,2000,0,0,0,0.670968
43593,Piranha 3D,2010-08-20,2010,24000000,83188165,59188165,8.212132
43594,The Emperor Jones,1933-09-29,1933,0,0,0,0.309319
43595,She Done Him Wrong,1933-02-09,1933,200000,2200000,2000000,1.840758
43596,Liebelei,1933-03-10,1933,0,0,0,0.472479
43597,Lady Killer,1933-12-09,1933,0,0,0,0.513768
43598,Ladies They Talk About,1933-02-04,1933,0,0,0,1.528051
43599,Employees' Entrance,1933-02-11,1933,0,0,0,0.26519
43600,Dancing Lady,1933-11-24,1933,923,0,-923,6.232671
43601,Bombshell,1933-10-13,1933,0,0,0,0.668451
43603,Zouzou,1934-12-21,1934,0,0,0,0.04185
43604,Viva Villa!,1934-04-27,1934,0,0,0,0.331916
43605,Treasure Island,1934-08-17,1934,0,0,0,0.987212
43608,The Night Holds Terror,1955-07-13,1955,0,0,0,0.127079
43610,The Valley of Decision,1945-06-01,1945,2160000,9132000,6972000,0.230534
43612,Happiness Is in the Field,1995-01-31,1995,13365000,0,-13365000,1.254885
43614,Father of My Children,2009-12-16,2009,0,0,0,1.389502
43616,The King of Escape,2009-07-15,2009,0,0,0,0.917276
43618,Tokyo Olympiad,1965-09-24,1965,0,0,0,0.643658
43619,Leaving,2009-08-12,2009,7600000,0,-7600000,2.334013
43625,Heidi,2005-08-19,2005,0,0,0,0.64338
43626,Sword of Gideon,1986-09-01,1986,0,0,0,0.91119
43629,Doodlebug,1997-01-01,1997,0,0,0,3.729927
43634,Boys,1996-05-10,1996,0,0,0,1.579153
43635,My Rainy Days,2009-11-07,2009,0,0,0,2.034642
43637,Magnificent Warriors,1987-04-16,1987,0,0,0,0.921075
43638,Holly,2006-08-16,2006,0,0,0,0.820315
43641,Superman/Shazam!: The Return of Black Adam,2010-11-09,2010,0,0,0,3.566333
43642,Abandoned,2010-08-24,2010,0,0,0,2.085279
43643,White Fang 2: Myth of the White Wolf,1994-04-15,1994,0,0,0,1.819367
43645,The Little Devil,1988-07-01,1988,0,0,0,4.295593
43646,The Comics,1990-01-01,1990,0,0,0,2.520134
43648,The Comics 2,1991-10-19,1991,0,0,0,1.999079
43649,The New Comics,1994-01-01,1994,0,0,0,1.254781
43650,The Legend of Sleepy Hollow,1949-10-05,1949,0,0,0,1.192956
43651,Google Me,2008-04-25,2008,0,0,0,0.14608
43652,Beloved Berlin Wall,2009-11-19,2009,0,0,0,0.828537
43653,The Living Wake,2007-01-01,2007,0,0,0,0.102573
43654,Edward II,1991-09-03,1991,0,694438,694438,4.556825
43656,13 Moons,2002-08-30,2002,0,0,0,2.407001
43657,AKA,2002-01-19,2002,0,0,0,0.461501
43658,Apple Jack,2003-09-16,2003,0,0,0,0.020588
43664,"The Bread, My Sweet",2001-04-21,2001,600000,1023156,423156,0.958152
43670,Stateside,2004-05-23,2004,16000000,174318,-15825682,1.054438
43673,Sleeping Dogs Lie,2006-10-20,2006,0,0,0,5.381609
43678,The Champion,1915-03-11,1915,0,0,0,1.105624
43680,Heart of a Dog,1988-01-01,1988,0,0,0,2.870907
43681,The Perfect Human,1967-01-01,1967,0,0,0,0.74442
43685,Amphibian Man,1962-01-03,1962,0,0,0,1.372162
43687,The Rise of Catherine the Great,1934-01-01,1934,0,0,0,0.219576
43688,The Old Fashioned Way,1934-07-13,1934,0,0,0,0.367549
43689,The Merry Widow,1934-11-02,1934,0,0,0,0.498582
43691,The Count of Monte Cristo,1934-09-06,1934,0,0,0,0.573468
43692,The Clairvoyant,1934-01-01,1934,0,0,0,0.349145
43693,The Barretts of Wimpole Street,1934-09-21,1934,0,0,0,0.155582
43696,Sadie McKee,1934-05-09,1934,0,0,0,0.137664
43699,The Deal,2003-09-28,2003,0,0,0,0.970579
43700,Big Money Rustlas,2010-08-14,2010,0,0,0,0.252094
43701,The Triple Echo,1972-01-01,1972,0,0,0,0.207603
43705,The Great Lie,1941-04-12,1941,0,0,0,2.326138
43708,"Die, Mommie, Die!",2003-10-31,2003,0,320092,320092,0.950658
43710,Who's Minding The Mint?,1967-09-26,1967,0,0,0,0.111773
43711,Enid,2009-11-16,2009,0,0,0,0.660874
43713,Nightmare Detective,2006-01-01,2006,0,0,0,0.658977
43715,The Deadly Mantis,1957-05-01,1957,0,0,0,1.738062
43716,The Land Unknown,1957-08-01,1957,0,0,0,0.699475
43719,Small Island,2009-12-06,2009,0,0,0,0.662664
43721,Margaret,2009-03-26,2009,0,0,0,0.522679
43727,Jolene,2008-06-13,2008,0,0,0,2.060735
43734,Witch Hunt,2008-01-01,2008,0,0,0,0.305215
43735,The Nanny Express,2009-01-02,2009,0,0,0,0.52037
43738,Eastern Plays,2009-10-16,2009,0,0,0,1.1135
43739,Love Affair,1939-04-07,1939,0,0,0,3.251277
43740,The Little Traitor,2009-01-01,2009,0,0,0,0.851861
43741,Joe's Palace,2007-11-04,2007,0,0,0,1.502651
43742,Love Affair,1994-10-21,1994,60000000,0,-60000000,3.290192
43743,Fabled,2002-01-01,2002,0,0,0,0.006604
43749,Wolf Girl,2001-09-21,2001,0,0,0,1.179495
43750,Under the Yum-Yum Tree,1963-10-23,1963,0,0,0,0.83878
43751,Who Can Kill a Child?,1976-04-26,1976,0,0,0,3.330335
43752,The Wackiest Ship in the Army,1960-12-29,1960,0,0,0,0.95059
43753,Creature from Black Lake,1976-03-01,1976,0,0,0,0.280284
43754,The Killing Jar,2010-02-14,2010,400000,0,-400000,0.903425
43756,A Simple Curve,2005-01-01,2005,0,0,0,0.324569
43757,The Silver Stallion,1993-09-16,1993,0,0,0,1.024914
43759,The Boy with Green Hair,1948-11-16,1948,0,0,0,1.345564
43761,Hamoun,1990-01-01,1990,0,0,0,0.504825
43764,The Fish Fall in Love,2006-01-01,2006,0,0,0,0.145281
43765,Delbaran,2001-08-05,2001,0,0,0,0.100843
43766,Fireworks Wednesday,2006-02-08,2006,0,0,0,1.760561
43767,The Willow Tree,2005-01-01,2005,0,0,0,0.250574
43768,Border Caf√©,2005-11-03,2005,0,0,0,0.106831
43771,Gabbeh,1996-06-26,1996,0,0,0,1.052071
43772,Secret Ballot,2001-01-01,2001,0,0,0,0.221421
43773,The Deserted Station,2002-01-01,2002,0,0,0,0.972699
43774,Baran,2001-01-31,2001,0,0,0,2.528855
43775,Guantanamera,1995-01-01,1995,0,0,0,0.496315
43776,The Waiting List,2000-06-02,2000,0,0,0,0.581016
43777,Bitter Sugar,1996-02-10,1996,0,0,0,0.401227
43778,Death of a Bureaucrat,1966-07-24,1966,0,0,0,0.392533
43779,Once Upon a Honeymoon,1942-11-27,1942,0,0,0,1.806909
43780,One of Our Aircraft Is Missing,1942-04-24,1942,0,0,0,0.649117
43781,Orchestra Wives,1942-09-04,1942,0,0,0,0.737195
43783,Song of the Islands,1942-03-13,1942,0,0,0,0.00179
43785,The Spoilers,1942-05-08,1942,0,0,0,0.773289
43786,Wake Island,1942-08-11,1942,0,0,0,0.815547
43787,You Were Never Lovelier,1942-11-19,1942,0,0,0,0.788244
43788,Pimpernel Smith,1941-07-26,1941,0,0,0,1.523435
43789,Andy Hardy's Private Secretary,1941-02-21,1941,0,0,0,0.085842
43790,Babes on Broadway,1941-12-31,1941,0,0,0,1.285439
43791,The Man Who Never Was,1956-03-15,1956,0,0,0,1.210668
43792,Lady Be Good,1941-09-01,1941,0,0,0,0.107702
43793,Life Begins for Andy Hardy,1941-08-15,1941,0,0,0,0.215163
43795,Penny Serenade,1941-04-24,1941,0,0,0,2.446972
43797,Sun Valley Serenade,1941-08-29,1941,0,0,0,0.77811
43798,That Hamilton Woman,1941-04-03,1941,0,0,0,1.706833
43799,That Uncertain Feeling,1941-04-20,1941,0,0,0,1.195838
43800,The Corsican Brothers,1941-11-28,1941,0,0,0,0.696188
43801,The Devil and Miss Jones,1941-04-11,1941,0,0,0,0.837091
43802,The Little Foxes,1941-08-20,1941,0,0,0,1.745592
43804,Western Union,1941-02-21,1941,0,0,0,7.429147
43805,Northwest Passage,1940-02-23,1940,0,0,0,1.028599
43806,Abe Lincoln in Illinois,1940-02-12,1940,0,0,0,0.793627
43807,"All This, and Heaven Too",1940-07-13,1940,0,0,0,0.976563
43808,Andy Hardy Meets Debutante,1940-07-05,1940,0,0,0,0.159417
43809,Broadway Melody of 1940,1940-02-09,1940,0,0,0,0.974162
43810,Down Argentine Way,1940-10-11,1940,0,0,0,0.777769
43811,"Edison, the Man",1940-05-10,1940,0,0,0,1.551537
43812,Knute Rockne All American,1940-10-05,1940,0,0,0,0.908996
43817,White Lightnin',2009-01-19,2009,0,0,0,2.072948
43818,Pride and Prejudice,1940-07-26,1940,0,0,0,2.323028
43819,Strike Up the Band,1940-09-27,1940,0,0,0,0.812147
43821,The Return of Frank James,1940-08-16,1940,0,0,0,0.654195
43822,The Stars Look Down,1940-01-22,1940,0,0,0,0.703699
43823,Tom Brown's School Days,1940-07-19,1940,0,0,0,0.039299
43824,Waterloo Bridge,1940-05-17,1940,0,0,0,2.034638
43825,Allegheny Uprising,1939-11-10,1939,0,0,0,0.457611
43828,Destry Rides Again,1939-11-30,1939,0,0,0,5.507383
43829,Jesse James,1939-01-14,1939,1600000,0,-1600000,9.067078
43832,Only Angels Have Wings,1939-05-15,1939,0,0,0,2.611512
43833,Q Planes,1939-06-20,1939,0,0,0,0.441487
43836,The Man in the Iron Mask,1939-07-13,1939,0,0,0,0.838302
43837,Union Pacific,1939-05-05,1939,0,0,0,1.378422
43838,Young Mr. Lincoln,1939-06-09,1939,0,0,0,2.062713
43839,Alexander's Ragtime Band,1938-05-24,1938,2000000,4000000,2000000,0.632261
43841,Block-Heads,1938-08-18,1938,0,0,0,1.440106
43844,The Baker's Wife,1938-09-07,1938,0,0,0,0.491306
43845,La Marseillaise,1938-02-02,1938,0,0,0,0.150504
43846,Love Finds Andy Hardy,1938-07-22,1938,0,0,0,0.899034
43847,Marie Antoinette,1938-08-26,1938,0,0,0,1.632643
43849,Sweethearts,1938-12-30,1938,0,0,0,0.127728
43850,The Divorce of Lady X,1938-01-15,1938,0,0,0,0.167229
43852,The Drum,1938-09-29,1938,0,0,0,0.798128
43853,The Girl of the Golden West,1938-03-18,1938,0,0,0,0.502239
43855,The Mad Miss Manton,1938-10-21,1938,0,0,0,0.734029
43856,The Rage of Paris,1938-06-09,1938,0,0,0,0.203707
43857,Broadway Melody of 1938,1937-08-20,1937,0,0,0,0.113383
43858,Elephant Boy,1937-04-05,1937,0,0,0,0.074642
43860,King Solomon's Mines,1937-01-01,1937,0,0,0,0.357832
43862,Maytime,1937-03-26,1937,0,0,0,0.109677
43863,Personal Property,1937-03-19,1937,0,0,0,0.116248
43864,Stage Door,1937-10-08,1937,0,0,0,0.937566
43865,Stella Dallas,1937-08-06,1937,0,0,0,3.526385
43866,The Firefly,1937-11-05,1937,0,0,0,0.207589
43867,The Prisoner of Zenda,1937-09-03,1937,0,0,0,5.272355
43868,Thin Ice,1937-09-03,1937,0,0,0,0.119526
43869,Wee Willie Winkie,1937-07-30,1937,0,0,0,0.53802
43871,Beloved Enemy,1936-12-25,1936,0,0,0,0.668008
43872,Born to Dance,1936-11-27,1936,0,0,0,0.370507
43873,C√©sar,1936-01-01,1936,0,0,0,0.349258
43874,Camille,1936-12-12,1936,0,0,0,2.583764
43875,Mary of Scotland,1936-08-28,1936,864000,1276000,412000,4.466335
43876,Mayerling,1936-01-31,1936,0,0,0,0.415978
43877,Osaka Elegy,1936-05-28,1936,0,0,0,0.648007
43878,A Day in the Country,1936-05-05,1936,0,0,0,1.535632
43879,Romeo and Juliet,1936-09-03,1936,0,0,0,1.951353
43880,Rose Marie,1936-01-31,1936,0,0,0,0.773081
43881,San Francisco,1936-06-26,1936,1300000,5273000,3973000,0.770164
43882,No Highway in the Sky,1951-09-21,1951,0,0,0,0.619084
43884,The Charge of the Light Brigade,1936-10-20,1936,1200000,2736000,1536000,5.39865
43885,The Plainsman,1936-11-16,1936,0,0,0,1.159273
43886,Alice Adams,1935-08-23,1935,0,0,0,1.282491
43887,Annie Oakley,1935-11-15,1935,0,0,0,1.517112
43888,Becky Sharp,1935-06-28,1935,0,0,0,0.490274
43889,Bonnie Scotland,1935-08-23,1935,0,0,0,1.047941
43890,Broadway Melody of 1936,1935-09-20,1935,0,0,0,0.785211
43891,Crime and Punishment,1935-11-22,1935,0,0,0,1.095264
43892,Gold Diggers of 1935,1935-03-14,1935,0,0,0,1.384824
43893,Les Mis√©rables,1935-04-02,1935,0,0,0,2.556791
43894,Naughty Marietta,1935-03-29,1935,0,0,0,0.69545
43895,Our Little Girl,1935-01-01,1935,0,0,0,0.273561
43896,The Informer,1935-05-09,1935,243000,950000,707000,2.000496
43897,The Littlest Rebel,1935-11-22,1935,0,0,0,0.672074
43898,The Lives of a Bengal Lancer,1935-01-11,1935,0,0,0,0.40855
43899,David Copperfield,1935-01-18,1935,0,0,0,1.132759
43900,Angele,1934-10-26,1934,0,0,0,0.270098
43901,Anne of Green Gables,1934-11-23,1934,0,0,0,0.246075
43902,Cleopatra,1934-10-05,1934,0,0,0,0.630823
43903,Dames,1934-09-01,1934,0,0,0,0.26615
43904,L'Atalante,1934-04-24,1934,0,0,0,4.265314
43905,Of Human Bondage,1934-07-20,1934,0,0,0,1.831221
43908,Kosmos,2010-02-17,2010,0,0,0,0.748276
43911,A Letter from Death Row,1998-11-17,1998,0,0,0,0.152449
43912,Courage Mountain,1990-02-14,1990,0,0,0,0.128722
43913,Postmortem,1998-06-20,1998,0,0,0,1.027651
43915,Fathom,1967-12-13,1967,0,0,0,0.531514
43919,Hatchet II,2010-08-26,2010,2500000,52604,-2447396,12.525758
43920,Dog Pound,2010-04-24,2010,0,430041,430041,5.059285
43922,Legendary,2010-09-09,2010,0,0,0,11.374555
43923,It's Kind of a Funny Story,2010-07-06,2010,8000000,6491240,-1508760,8.172013
43924,The Tillman Story,2010-08-22,2010,0,0,0,1.509056
43925,O Diabo a Quatro,2005-07-08,2005,0,0,0,0.565814
43930,"Tomorrow, When the War Began",2010-08-08,2010,27000000,16504936,-10495064,4.983475
43931,My Soul to Take,2010-10-08,2010,25000000,19829957,-5170043,5.282976
43933,Monsters,2010-06-18,2010,500000,4242978,3742978,6.154375
43935,Dylan Dog: Dead of Night,2011-03-16,2011,20000000,4634062,-15365938,12.763976
43936,S21: The Khmer Rouge Death Machine,2003-05-17,2003,0,0,0,0.55558
43937,Like Dandelion Dust,2009-02-05,2009,2500000,352810,-2147190,1.659692
43938,Nice Guy Johnny,2010-11-04,2010,0,25,25,2.166081
43939,I'm Still Here,2010-09-10,2010,0,0,0,5.268636
43942,Freakonomics,2010-10-01,2010,3000000,103735,-2896265,2.444847
43943,Jack Goes Boating,2010-09-23,2010,0,538000,538000,3.581434
43947,I Spit on Your Grave,2010-06-17,2010,2000000,572809,-1427191,12.805294
43949,Flipped,2010-08-06,2010,14000000,1755212,-12244788,10.279685
43950,Amer,2009-09-23,2009,0,0,0,4.847639
43953,War of the Birds,1990-07-01,1990,0,0,0,0.565231
43956,Tom and Jerry Meet Sherlock Holmes,2010-08-24,2010,0,0,0,2.149829
43959,Soul Surfer,2011-04-08,2011,18000000,47088990,29088990,11.009053
43960,Drake And Josh Go Hollywood,2006-01-01,2006,0,0,0,3.982532
43961,Carbine Williams,1952-05-01,1952,0,0,0,0.746151
43962,Malaya,1949-12-27,1949,0,0,0,1.289968
43967,Urusei Yatsura 2: Beautiful Dreamer,1984-02-11,1984,0,0,0,2.310297
43968,Fiesta,1947-06-12,1947,0,0,0,0.329837
43969,At Five in the Afternoon,2003-05-16,2003,0,0,0,0.336821
43970,Iron Island,2005-01-01,2005,0,0,0,0.765523
43973,Stray Dogs,2004-09-08,2004,0,0,0,0.143835
43974,The Silence,1998-09-06,1998,0,0,0,0.552003
43976,A Moment of Innocence,1996-08-13,1996,0,37598,37598,1.342194
43978,The Apple,1998-01-01,1998,0,0,0,0.561987
43980,"Bashu, the Little Stranger",1989-01-01,1989,0,0,0,0.478812
43981,Salaam Cinema,1995-01-01,1995,0,0,0,0.35931
43984,The Cow,1969-01-01,1969,0,0,0,0.406759
43985,Half Moon,2006-09-01,2006,0,0,0,0.74318
43987,No Mercy for the Rude,2006-08-24,2006,3,4,1,1.486349
43989,Sud,1993-10-17,1993,0,0,0,0.985921
43990,Lost Angels,1989-05-05,1989,0,1247946,1247946,0.882065
43995,That Riviera Touch,1966-03-29,1966,0,0,0,0.238579
43997,Divorcing Jack,1998-10-01,1998,0,0,0,0.817974
44000,Trog,1970-10-24,1970,0,0,0,0.504767
44001,The Unseen,1945-05-12,1945,0,0,0,0.385475
44004,Hero at Large,1980-02-08,1980,0,15934737,15934737,1.221702
44005,The Great Texas Dynamite Chase,1976-07-01,1976,0,0,0,0.153267
44006,Othello,1965-12-15,1965,0,0,0,0.377325
44008,The Victim,2011-06-06,2011,0,0,0,1.795228
44009,Another Year,2010-11-05,2010,8000000,18124262,10124262,5.000657
44010,Logan,2010-09-10,2010,135000,10474,-124526,0.588872
44012,"Jeanne Dielman, 23, Quai du Commerce 1080 Bruxelles",1975-05-14,1975,0,0,0,2.160001
44014,Groupie,2010-01-01,2010,0,0,0,0.471047
44015,The Prime Gig,2000-01-01,2000,0,0,0,1.112059
44018,Vagabond,1985-12-04,1985,0,0,0,2.073938
44022,Bandido!,1956-09-01,1956,0,0,0,0.47236
44023,Make Mine Mink,1960-08-09,1960,0,0,0,0.555422
44025,Mr. Denning Drives North,1952-09-02,1952,0,0,0,0.311483
44026,Mr. Arkadin,1955-03-01,1955,0,0,0,4.358523
44027,"My Son, My Son, What Have Ye Done",2009-09-06,2009,0,0,0,3.349413
44028,Suck,2009-09-11,2009,0,0,0,2.944431
44032,Bending The Rules,2012-03-09,2012,0,0,0,10.518
44037,Lake Placid 3,2010-08-21,2010,2500000,0,-2500000,7.030888
44038,Lovecraft: Fear of the Unknown,2008-07-24,2008,0,0,0,0.833687
44040,Devil,2010-01-13,2010,10000000,33583175,23583175,7.094276
44041,The Dark Mirror,1946-10-17,1946,0,0,0,2.044264
44043,Cloak and Dagger,1946-09-28,1946,0,0,0,2.018295
44046,Wicked,1998-01-17,1998,4000000,0,-4000000,2.045542
44047,Wildflowers,2000-03-04,2000,0,0,0,0.112468
44048,Unstoppable,2010-11-04,2010,100000000,167805466,67805466,12.697059
44049,Matching Jack,2010-08-19,2010,0,0,0,4.707311
44052,Black Widow,1954-10-28,1954,0,0,0,0.678793
44053,Bustin' Down the Door,2008-07-25,2008,0,0,0,0.004709
44054,The Killing of John Lennon,2007-12-07,2007,0,0,0,0.455902
44055,LoveDeath,2006-02-24,2006,0,0,0,0.049268
44059,Baton Baton Mein,1979-04-13,1979,0,0,0,0.032319
44065,The House Is Black,1963-01-01,1963,0,0,0,1.911168
44066,Daughters of the Sun,2000-01-01,2000,0,0,0,0.089705
44069,The Day I Became a Woman,2000-09-01,2000,0,0,0,0.53871
44072,The Cyclist,1987-02-01,1987,0,0,0,0.831747
44076,"Smell of Camphor, Fragrance of Jasmine",2000-09-08,2000,0,0,0,0.036477
44081,Under the Skin of the City,2001-02-04,2001,0,0,0,0.072402
44085,The Yacoubian Building,2006-06-01,2006,0,0,0,0.719249
44087,The Way to the Stars,1945-06-16,1945,0,0,0,0.255576
44092,Reign of Assassins,2010-09-01,2010,12000000,0,-12000000,3.442786
44095,A Map For Saturday,2007-08-07,2007,0,0,0,0.356735
44098,Undercurrent,1946-11-28,1946,0,0,0,2.936232
44099,Temptation,1946-12-02,1946,0,0,0,0.497273
44103,Priest Daens,1992-09-01,1992,0,0,0,0.755047
44104,Private,2004-08-12,2004,0,0,0,0.419714
44105,Destiny,2006-01-01,2006,0,0,0,0.836285
44113,Stone,2010-10-07,2010,22000000,9479718,-12520282,11.275132
44114,Paper Castles,2009-10-25,2009,0,0,0,1.192361
44115,127 Hours,2010-11-05,2010,18000000,35692920,17692920,11.176797
44117,Without Warning,1994-10-30,1994,0,0,0,0.678068
44119,Born Killers,2005-01-01,2005,0,0,0,0.474015
44123,Sam Kinison: Breaking the Rules,1987-04-17,1987,0,0,0,0.028043
44124,The Strange Saga of Hiroshi the Freeloading Sex Machine,2005-10-07,2005,0,0,0,0.563879
44125,From Beginning to End,2009-11-12,2009,0,0,0,2.386729
44126,Sinbad of the Seven Seas,1989-04-01,1989,0,0,0,1.525287
44129,The Company Men,2010-10-21,2010,15000000,4882577,-10117423,5.858803
44131,The Beaver Trilogy,2000-12-31,2000,0,0,0,0.319682
44132,The Beast,1975-08-20,1975,0,0,0,4.080387
44133,Turning Point,2009-08-13,2009,1680000,0,-1680000,0.399817
44134,Barnacle Bill,1957-12-17,1957,0,0,0,0.774232
44135,The Diplomat,2009-01-11,2009,0,0,0,1.40147
44140,Miss Sadie Thompson,1953-12-23,1953,0,0,0,0.776443
44142,Ginger & Cinnamon,2003-04-04,2003,0,0,0,0.755274
44147,Wild Target,2010-06-17,2010,8000000,3453043,-4546957,6.712894
44154,A Touch of Zen,1971-11-17,1971,0,0,0,2.056312
44155,The Italian,2010-07-07,2010,0,0,0,3.157512
44157,How To Frame A Figg,1971-02-01,1971,0,0,0,0.871477
44158,This Movie Is Broken,2010-06-25,2010,0,0,0,0.187161
44159,Women Without Men,2009-09-11,2009,0,0,0,1.530601
44160,Honey,2010-04-09,2010,0,0,0,1.258706
44162,The Blue Kite,1994-02-02,1994,0,0,0,2.16468
44163,A Story of Floating Weeds,1934-11-23,1934,0,0,0,0.542256
44164,Chaos,2001-10-03,2001,0,0,0,0.405032
44165,Kenji Mizoguchi: The Life of a Film Director,1975-05-24,1975,0,0,0,0.041681
44173,The Falcon Takes Over,1942-05-29,1942,0,0,0,0.333905
44181,National Lampoon's Gold Diggers,2003-06-15,2003,0,527000,527000,0.625659
44184,Venomous,2002-01-22,2002,0,0,0,0.722512
44190,They Live by Night,1948-08-06,1948,0,0,0,1.760634
44191,Loose Screws,1985-07-19,1985,945000,0,-945000,1.589406
44192,Timebomb,1991-03-01,1991,0,0,0,0.804283
44203,Ju-on: The Curse 2,2000-03-25,2000,0,0,0,2.246011
44208,Angel,1937-10-29,1937,0,0,0,0.5667
44211,Draquila - L'Italia che trema,2010-03-07,2010,0,0,0,0.128608
44214,Black Swan,2010-12-02,2010,13000000,327803731,314803731,12.989056
44216,Downstream,2010-02-24,2010,1000000,0,-1000000,0.673473
44217,Jasmine Women,2004-06-13,2004,0,0,0,0.723176
44219,The Chosen One,2010-09-03,2010,0,0,0,1.241028
44220,Patton Oswalt: No Reason to Complain,2006-04-04,2006,0,0,0,0.184999
44221,Group Sex,2010-08-24,2010,0,0,0,2.321234
44222,Four Stories of St. Julian,2010-08-24,2010,0,0,0,0.041232
44223,Happy Ever Afters,2009-10-09,2009,0,0,0,0.540311
44224,Bear,2010-01-01,2010,0,0,0,0.741144
44233,P.S. Your Cat Is Dead!,2002-01-01,2002,0,0,0,0.296765
44238,World of Glory,1991-01-01,1991,0,0,0,1.541725
44239,The Alphabet,1968-01-01,1968,0,0,0,1.906062
44244,Camp Rock 2: The Final Jam,2010-06-06,2010,0,0,0,4.834304
44245,Triple Tap,2010-06-30,2010,0,0,0,1.199366
44246,When We Leave,2010-02-13,2010,0,0,0,2.356342
44247,The Prowler,1981-11-06,1981,1000000,0,-1000000,2.887538
44249,The Legend Is Born: Ip Man,2010-06-24,2010,0,0,0,1.191096
44250,Cruel World,2005-09-01,2005,2000000,16344,-1983656,0.262437
44251,Dragon Ball Z: Broly - Second Coming,1994-03-12,1994,0,0,0,6.12929
44255,Off and Running,2009-04-22,2009,0,0,0,0.049404
44256,Razzia,1955-04-16,1955,0,0,0,0.626395
44257,Industrial Symphony No. 1: The Dream of the Brokenhearted,1990-01-01,1990,0,0,0,1.132574
44258,Marat/Sade,1967-01-01,1967,0,0,0,0.448733
44260,Lake of Fire,2006-09-09,2006,0,25,25,0.91505
44263,City Under Siege,2010-08-11,2010,0,0,0,1.087389
44264,True Grit,2010-12-22,2010,38000000,252276927,214276927,10.730765
44265,Lurking Fear,1994-07-27,1994,0,0,0,0.48767
44268,Superfantozzi,1986-12-23,1986,0,0,0,3.49331
44269,All That Glitters,2010-03-24,2010,0,0,0,4.930447
44281,Halfaouine: Boy of the Terraces,1990-01-01,1990,0,0,0,1.983301
44282,Plan B,2009-03-27,2009,0,0,0,1.463661
44283,Happily Ever After,1990-06-20,1990,0,0,0,0.875785
44284,The Silences of the Palace,1994-09-30,1994,0,0,0,0.406754
44287,Lost Junction,2003-02-14,2003,0,0,0,0.438382
44289,Octane,2003-05-16,2003,11500000,0,-11500000,1.632632
44296,Fireworks,1947-01-01,1947,0,0,0,0.411937
44297,Besieged,1998-09-14,1998,0,0,0,5.435716
44303,Higglety Pigglety Pop! or There Must Be More to Life,2010-03-02,2010,0,0,0,0.498117
44308,A Price Above Rubies,1998-03-26,1998,0,1081957,1081957,2.783205
44320,Clandestinos,2007-01-01,2007,0,0,0,0.891025
44321,Our Lady of the Assassins,2000-09-01,2000,0,0,0,0.985777
44322,East Palace West Palace,1996-01-01,1996,0,0,0,1.108362
44323,Belle of the Yukon,1944-12-27,1944,0,0,0,0.036946
44324,The Untameable Whiskers,1904-03-05,1904,0,0,0,0.213973
44326,Extremities,1986-08-22,1986,0,13418091,13418091,10.273979
44328,The Mermaid,1904-01-01,1904,0,0,0,0.484001
44330,The Scheming Gambler's Paradise,1905-01-01,1905,0,0,0,0.21926
44333,The Living Playing Cards,1905-01-01,1905,0,0,0,0.208349
44334,The Tales of Hoffmann,1951-04-04,1951,0,0,0,5.423814
44338,Balance,1989-01-01,1989,0,0,0,0.026351
44340,Wendigo,2001-01-23,2001,0,0,0,0.910772
44341,Life of an American Fireman,1903-01-21,1903,0,0,0,0.35504
44342,The Black Imp,1905-01-01,1905,0,0,0,0.472362
44345,The Cutting Edge: The Magic of Movie Editing,2004-01-01,2004,0,0,0,1.197861
44349,The Christmas Wish,1998-12-06,1998,0,0,0,0.231911
44351,Rabbits,2002-01-01,2002,0,0,0,2.607215
44357,Seasons of the Year,1975-01-01,1975,0,0,0,0.000844
44361,Mother and Son,1997-02-20,1997,0,0,0,1.046963
44363,Frozen,2010-02-05,2010,0,3065860,3065860,10.245682
44369,Boy,2009-01-01,2009,0,0,0,0.138737
44373,New Best Friend,2002-04-12,2002,0,0,0,5.258167
44375,Twist,2003-09-07,2003,0,0,0,1.997575
44379,The Gleaners & I,2000-07-07,2000,0,0,0,0.647007
44381,Napoleon,1995-10-10,1995,0,0,0,0.863567
44383,Sherlock Holmes in Washington,1943-04-30,1943,0,0,0,5.165507
44385,Werewolf: The Devil's Hound,2007-05-17,2007,0,0,0,0.334555
44386,Pretty as a Picture: The Art of David Lynch,1997-10-14,1997,0,0,0,0.241231
44388,It Had to Be You,2000-01-01,2000,0,0,0,0.608227
44389,Highball,1997-01-01,1997,0,0,0,0.311732
44398,The Black Rose,1950-09-01,1950,0,0,0,0.478484
44399,Blood and Sand,1941-05-30,1941,0,0,0,4.618566
44405,Never Weaken,1921-10-22,1921,0,0,0,0.443542
44407,The Edge of the World,1937-09-10,1937,0,0,0,0.354044
44408,Carnage,2002-05-17,2002,0,0,0,0.100901
44409,"Number, Please?",1920-12-26,1920,0,0,0,0.176743
44411,Eccentricities of a Blonde-Haired Girl,2009-02-10,2009,2500000,0,-2500000,0.853938
44412,Company Man,2000-03-09,2000,0,0,0,1.261369
44413,The Holy Girl,2004-05-06,2004,1400000,0,-1400000,0.669179
44414,Liebestraum,1991-09-13,1991,0,0,0,4.198128
44415,Benji: Off the Leash!,2004-03-26,2004,0,0,0,0.305638
44417,Hector,1987-01-01,1987,0,0,0,1.105248
44425,Dabangg,2010-09-09,2010,9370000,0,-9370000,4.810413
44432,The Dungeon Masters,2008-09-08,2008,0,0,0,0.436356
44434,LOL,2006-03-13,2006,0,0,0,0.630599
44435,Trauma,1993-03-12,1993,0,0,0,4.77663
44436,Oddsac,2010-08-04,2010,0,0,0,0.364854
44439,Lazybones,1925-11-06,1925,0,0,0,0.038661
44441,Different from the Others,1919-05-28,1919,0,0,0,0.289991
44442,Four Nights with Anna,2008-07-17,2008,0,0,0,1.095759
44443,Lynch,2007-01-01,2007,0,0,0,0.334601
44444,Werewolf In A Girls' Dormitory,1961-01-01,1961,0,0,0,0.894471
44445,At Land,1944-01-01,1944,0,0,0,0.535346
44449,The Monster,1903-08-14,1903,0,0,0,0.208779
44450,Angelique,1964-01-01,1964,0,0,0,4.004188
44458,Perhaps Love,2005-12-01,2005,0,0,0,2.180285
44459,Cinderella,1957-03-31,1957,0,0,0,0.209552
44461,Charlotte and Her Boyfriend,1960-10-21,1960,0,0,0,0.537572
44463,The Miracle Woman,1931-07-17,1931,0,0,0,0.93383
44465,The Rich Man's Wife,1996-09-13,1996,0,8538318,8538318,6.746475
44470,Ice Cream Man,1995-05-09,1995,2000000,0,-2000000,0.849457
44472,Wasp,2003-01-01,2003,0,0,0,2.179676
44473,Entr'acte,1924-12-04,1924,0,0,0,0.931283
44478,"Taxi, Trailer and Bullfight",1958-11-22,1958,0,0,0,0.676519
44479,The Watermelon Woman,1996-09-07,1996,0,0,0,0.090481
44480,Education for Death,1943-01-15,1943,0,0,0,1.008346
44486,Mars,2010-11-03,2010,0,0,0,0.423425
44488,The Prince and the Pauper,2000-01-01,2000,0,0,0,0.401176
44489,Ice Men,2004-01-01,2004,0,0,0,0.03765
44490,Chuck & Buck,2000-01-21,2000,0,0,0,1.520011
44494,Zero for Conduct,1933-04-07,1933,0,0,0,1.880791
44495,A Very Natural Thing,1974-01-01,1974,0,0,0,0.147662
44497,Hustler White,1996-07-19,1996,0,127251,127251,1.068288
44502,The Piano Tuner of Earthquakes,2005-09-09,2005,0,27953,27953,2.933613
44503,Blow Job,1964-03-16,1964,0,0,0,0.393037
44507,Red Riding Hood,2006-06-27,2006,0,0,0,1.589347
44508,Spin the Bottle,2000-05-04,2000,0,0,0,0.113458
44510,The Grandmother,1970-01-01,1970,0,0,0,0.172883
44511,Noodle,2007-07-26,2007,0,0,0,0.262792
44513,Father and Son,2003-09-12,2003,0,0,0,1.559697
44516,"Same Love, Same Rain",1999-01-01,1999,0,0,0,1.004653
44517,Loco Fever,2001-10-04,2001,0,0,0,0.31291
44519,Mughal-e-Azam,1960-01-01,1960,0,0,0,0.283219
44522,The Gentleman from Epsom,1962-10-03,1962,0,0,0,0.551331
44524,Kings and Queen,2004-09-03,2004,0,0,0,0.889366
44527,Villa Amalia,2009-04-08,2009,0,0,0,0.729211
44528,The Matthew Shepard Story,2002-03-16,2002,0,0,0,0.708303
44533,Prince of Foxes,1949-11-11,1949,0,0,0,0.34033
44534,Captain from Castile,1947-12-25,1947,0,0,0,1.057092
44535,Somebody to Love,1994-09-27,1994,0,0,0,0.970688
44536,Sailor of the King,1953-06-11,1953,0,0,0,0.072067
44539,An Amazing Couple,2002-09-12,2002,0,0,0,0.108259
44540,Virginia's Run,2002-01-01,2002,0,0,0,0.35477
44541,Reformat the Planet,2008-01-01,2008,0,0,0,0.041642
44545,The Werewolf,1956-07-01,1956,0,0,0,0.327657
44546,Lathe of Heaven,2002-09-08,2002,500000,0,-500000,0.197684
44548,Vipers,2008-01-01,2008,0,0,0,1.028443
44549,PEEPLI [Live],2010-08-13,2010,2270000,6900000,4630000,2.927226
44552,Bit by Bit,2002-09-27,2002,0,0,0,0.244149
44554,A Man Called Hero,1999-07-17,1999,0,0,0,1.17946
44555,"A Woman, a Gun and a Noodle Shop",2009-12-11,2009,0,0,0,1.352447
44559,Carve Her Name with Pride,1958-02-18,1958,0,0,0,4.681055
44560,Aftershock,2010-07-22,2010,25000000,0,-25000000,2.467618
44562,Ed and His Dead Mother,1993-06-04,1993,0,0,0,1.633558
44563,"Semen, a Love Sample",2005-01-01,2005,0,0,0,0.247769
44564,The Dilemma,2011-01-13,2011,70000000,67112664,-2887336,7.513067
44565,Khatta Meetha,2010-07-23,2010,7500000,10000000,2500000,0.494047
44566,Anjaana Anjaani,2010-09-24,2010,6400000,5900000,-500000,1.82294
44570,Autohystoria,2007-01-27,2007,0,0,0,0.111555
44571,The King of Fighters,2009-11-04,2009,12000000,0,-12000000,1.4954
44578,"Moonshot, the Flight of Apollo 11",2009-06-20,2009,0,0,0,1.18327
44585,Attack of the Puppet People,1958-04-01,1958,0,0,0,0.475441
44588,Hellphone,2007-03-28,2007,0,0,0,1.748059
44589,The Clan - Tale of the Frogs,1984-11-30,1984,0,0,0,0.002317
44591,The Black Scorpion,1957-10-11,1957,0,0,0,0.748812
44592,Lost Continent,1951-08-17,1951,0,0,0,1.027404
44593,Perfect Opposites,2004-02-06,2004,700000,0,-700000,4.052418
44594,Barry Munday,2010-03-13,2010,0,0,0,2.476706
44603,Hereafter,2010-10-15,2010,50000000,105197635,55197635,7.942766
44606,Goin' Down the Road,1970-07-02,1970,0,0,0,0.204145
44617,Arlette,1997-04-19,1997,0,0,0,0.550036
44618,The Man Who Quit Smoking,1972-12-16,1972,0,0,0,0.54479
44625,Dead Man's Curve,1998-01-24,1998,1000000,0,-1000000,1.753232
44626,The Long Night,1947-05-28,1947,0,0,0,1.780882
44629,Animal Kingdom,2010-06-03,2010,5000000,1000000,-4000000,9.649312
44630,Aces High,1976-05-19,1976,0,0,0,1.733978
44631,Against All Flags,1952-12-24,1952,0,0,0,0.999504
44634,Woman Thou Art Loosed,2004-09-30,2004,3000000,6804016,3804016,0.129004
44635,Just a Kiss,2002-06-15,2002,0,0,0,1.739704
44637,Trevor Noah: The Daywalker,2009-11-05,2009,0,0,0,0.437904
44639,Inside Job,2010-10-08,2010,2000000,7871522,5871522,10.30535
44641,Men with Guns,1997-01-01,1997,0,0,0,0.407747
44645,Bruce Lee: The Legend,1984-01-01,1984,0,0,0,3.475895
44646,The Last Seven,2010-08-24,2010,1850000,0,-1850000,0.719257
44647,Rock Slyde,2010-05-01,2010,0,0,0,1.169769
44655,Susana,1951-04-11,1951,0,0,0,1.299286
44656,My Little Bride,2004-01-01,2004,0,0,0,2.024035
44657,Chang: A Drama of the Wilderness,1927-09-03,1927,0,0,0,0.242682
44658,Dark Eyes,1987-02-01,1987,0,0,0,1.912647
44661,Storm,1999-09-11,1999,0,0,0,0.774415
44662,47 Samurai,1962-11-03,1962,0,0,0,5.127806
44663,Moscow Chill,2007-01-01,2007,0,0,0,0.561806
44664,Reckless Kelly,1994-05-04,1994,0,0,0,1.05661
44666,Surprise,1996-02-21,1996,0,0,0,0.001252
44668,She Had to Say Yes,1933-07-15,1933,0,0,0,0.064785
44669,Johnny Allegro,1949-05-26,1949,0,0,0,0.084702
44671,Racing Dreams,2010-05-14,2010,0,0,0,0.890254
44672,Breaking All the Rules,1985-04-01,1985,0,0,0,0.120896
44673,The Matrimony,2007-02-08,2007,2500000,0,-2500000,1.05298
44674,After Life,2002-09-12,2002,0,0,0,0.097876
44678,Altitude,2010-10-10,2010,0,0,0,4.715525
44680,The Wild Hunt,2009-09-09,2009,0,0,0,1.847803
44682,Resurrection County,2008-10-19,2008,0,0,0,1.186517
44683,Tinker Bell and the Great Fairy Rescue,2010-08-13,2010,0,0,0,5.963431
44685,Love Hina Spring Special - I Wish Your Dream,2001-03-31,2001,0,0,0,1.785708
44687,The Lost Skeleton Returns Again,2010-08-17,2010,600,0,-600,0.618465
44688,Day One,1989-03-05,1989,0,0,0,0.156843
44690,J.D.'s Revenge,1976-08-25,1976,0,0,0,0.003244
44691,The Scarlet and the Black,1983-02-02,1983,0,0,0,3.522699
44692,The Magnetic Monster,1953-02-18,1953,0,0,0,0.764046
44693,The Astounding She-Monster,1958-04-10,1958,0,0,0,0.115448
44694,Big Time,1988-09-15,1988,0,148426,148426,1e-06
44695,The Born Losers,1967-08-18,1967,360000,36000000,35640000,1.345165
44697,Take a Hard Ride,1975-10-29,1975,0,0,0,1.255885
44698,The Evil,1978-05-05,1978,0,0,0,1.06686
44705,Twelfth Night,1996-10-31,1996,0,0,0,4.69668
44706,The Bet,1997-10-15,1997,0,0,0,4.058546
44708,Blue Gate Crossing,2002-09-27,2002,0,0,0,2.389238
44710,Welcome to the Roses,2003-04-02,2003,0,0,0,3.169514
44711,Young Bess,1953-05-29,1953,0,0,0,0.376565
44716,In a Better World,2010-08-26,2010,15000000,0,-15000000,7.671851
44718,Get Low,2010-01-22,2010,7500000,0,-7500000,4.678848
44720,Blackout,2010-03-31,2010,0,0,0,0.313159
44721,Little Fauss and Big Halsy,1970-10-21,1970,0,0,0,0.923613
44732,Spring Break Shark Attack,2005-03-20,2005,0,0,0,0.626131
44734,Eden of the East Movie II: Paradise Lost,2010-08-04,2010,0,0,0,0.694959
44736,The Long Ships,1964-06-24,1964,0,0,0,1.835475
44737,Babies,2010-05-07,2010,0,0,0,2.667622
44741,Malicious,1973-03-29,1973,0,0,0,2.840037
44745,Beatdown,2010-08-31,2010,1000000,0,-1000000,4.476116
44746,My Family and Other Animals,2005-12-27,2005,0,0,0,1.822718
44747,The Caddy,1953-08-10,1953,0,0,0,0.969886
44749,Race 2,2013-01-25,2013,0,0,0,1.84199
44750,The Winning Season,2009-01-19,2009,0,0,0,2.045782
44751,Dossier K.,2009-12-09,2009,0,0,0,0.960954
44752,The Wrath of Cain,2010-11-16,2010,0,0,0,0.161612
44754,Margaret,2011-09-30,2011,14000000,46495,-13953505,5.113573
44756,Is It Fall Yet?,2000-08-27,2000,0,0,0,1.14641
44762,Short Track,2008-08-30,2008,0,0,0,0.105753
44766,The Law and Jake Wade,1958-06-06,1958,0,0,0,5.106816
44768,Warm Water Under a Red Bridge,2001-11-03,2001,0,0,0,1.49206
44769,Caprice,1967-04-18,1967,0,0,0,6.311574
44770,The Exploding Girl,2009-04-22,2009,0,0,0,0.568777
44772,No Small Affair,1984-11-09,1984,0,0,0,8.895355
44773,The 7 Adventures of Sinbad,2010-01-01,2010,0,0,0,1.599535
44775,Pack Up Your Troubles,1932-09-16,1932,0,0,0,1.087814
44781,Electrical Girl,2001-04-26,2001,0,0,0,0.001803
44783,Symbiopsychotaxiplasm: Take One,1968-10-28,1968,0,0,0,0.697838
44785,Afraid to Die,1960-03-22,1960,0,0,0,0.521263
44787,Native Land,1942-05-11,1942,0,0,0,0.109565
44789,Kenny Rogers as The Gambler,1980-04-08,1980,0,0,0,0.426405
44793,Soft Shell Man,2001-09-07,2001,0,0,0,0.115602
44796,Arena,1989-03-29,1989,0,0,0,0.773352
44800,The Gambler,1974-10-02,1974,0,0,0,1.405267
44801,Real Men,1987-09-25,1987,0,0,0,1.144734
44804,Mexican Bus Ride,1952-01-01,1952,0,0,0,0.725708
44805,Loose Shoes,1980-08-01,1980,0,0,0,0.113603
44806,12th & Delaware,2010-04-01,2010,0,0,0,0.155882
44807,Forever Fever,1998-05-28,1998,1070000,570000,-500000,0.170074
44808,Sweepers,1999-03-23,1999,0,0,0,1.059873
44811,Mongolian Death Worm,2010-04-08,2010,0,0,0,0.604059
44813,The Hawk Is Dying,2007-03-30,2007,0,0,0,0.209747
44814,Maiko Haaaan!!!,2007-06-16,2007,0,0,0,0.300401
44823,Jerry Springer: The Opera,2005-11-14,2005,0,0,0,0.455013
44826,Hugo,2011-11-22,2011,170000000,185770160,15770160,14.046164
44827,Dor,2006-09-22,2006,0,0,0,0.585421
44833,Battleship,2012-04-11,2012,209000000,303025485,94025485,13.106966
44835,Hesher,2010-01-22,2010,7000000,382946,-6617054,5.886972
44839,–Æ–ª–µ–Ω—å–∫–∞,2009-02-19,2009,5000000,0,-5000000,0.690526
44848,The Decline of Western Civilization Part III,1998-01-01,1998,0,0,0,0.836602
44850,Please Teach Me English,2003-01-01,2003,0,0,0,0.763051
44853,The Claim,2000-12-29,2000,0,0,0,1.417827
44857,Molly,1999-10-22,1999,0,0,0,7.697
44859,Mortuary,1983-09-02,1983,0,0,0,1.808013
44862,Once Fallen,2010-11-02,2010,0,0,0,6.128473
44864,The Magic Flute,1975-01-01,1975,650000,0,-650000,0.658086
44865,The Grandmaster,2013-01-08,2013,3860000,64076736,60216736,8.959821
44868,Moss Rose,1947-05-30,1947,0,0,0,0.568144
44869,Adventure,1945-12-28,1945,0,0,0,0.370546
44874,Barbie: A Fashion Fairytale,2010-09-14,2010,0,0,0,4.287613
44875,Topper Returns,1941-03-21,1941,0,0,0,1.000254
44877,4.3.2.1,2010-06-02,2010,4600000,1163967,-3436033,5.805666
44878,Sleep Furiously,2009-05-29,2009,0,0,0,0.233582
44885,Kite Liberator,2008-03-21,2008,0,0,0,1.721301
44886,You and I,2006-03-08,2006,0,0,0,0.213072
44888,Soldier of Fortune,1955-01-01,1955,0,0,0,0.080373
44890,The Frogmen,1951-01-25,1951,0,0,0,4.411709
44892,The Music Box,1932-04-16,1932,0,0,0,2.186467
44895,Poor White Trash,2000-06-16,2000,1200000,1404,-1198596,0.584397
44896,Rango,2011-03-02,2011,135000000,245724603,110724603,10.581925
44898,The Time That Remains,2009-08-12,2009,6500000,753808,-5746192,0.635053
44899,The Challenge,2003-01-24,2003,0,0,0,3.094476
44900,Bailey's Billion$,2005-08-05,2005,9000000,0,-9000000,0.810772
44902,Footsteps in the Fog,1955-09-14,1955,0,0,0,0.550094
44909,Ghoulies III: Ghoulies Go to College,1991-09-18,1991,0,0,0,1.540257
44912,Green Lantern,2011-06-16,2011,200000000,219851172,19851172,13.985631
44916,Spencer's Mountain,1963-05-16,1963,0,0,0,5.477087
44918,Titanic 2,2010-08-07,2010,0,0,0,4.359886
44919,The Old Maid,1939-09-02,1939,0,0,0,2.603629
44921,The Last Wagon,1956-09-21,1956,0,0,0,1.209918
44925,Sister My Sister,1994-07-14,1994,0,0,0,1.336506
44932,Without Warning,1980-09-26,1980,150000,0,-150000,2.218273
44933,A Chinese in a Coma,2000-03-01,2000,0,0,0,1.234936
44936,Don't Go In the Woods,1981-09-05,1981,0,0,0,1.294959
44937,Am√©lie au pays des Bodin's,2010-05-26,2010,0,0,0,0.217743
44940,Hell Drivers,1957-07-23,1957,0,0,0,2.115739
44941,Year of the Comet,1992-04-24,1992,0,0,0,0.720374
44943,Battle: Los Angeles,2011-03-08,2011,70000000,202466756,132466756,6.753746
44944,For Colored Girls,2010-11-05,2010,0,37000000,37000000,2.216959
44945,Trust,2010-09-10,2010,9500000,120000,-9380000,7.778097
44946,Knucklehead,2010-10-22,2010,0,0,0,1.334026
44947,The King Is Dancing,2000-12-06,2000,21000000,0,-21000000,1.792826
44950,A Horrible Way to Die,2010-09-14,2010,0,0,0,1.286687
44951,Beneath the Blue,2010-11-16,2010,2500000,0,-2500000,0.99845
44952,Last Day of Summer,2009-10-24,2009,0,0,0,0.665979
44960,The Clown Murders,1976-09-17,1976,0,0,0,2.9e-05
44963,Shogun's Ninja,1980-11-15,1980,0,0,0,0.977162
44966,The Freebie,2010-09-17,2010,0,0,0,0.588846
44967,Strike,1925-04-28,1925,0,0,0,1.576387
44968,Born Yesterday,1993-03-26,1993,0,0,0,1.863936
44969,From the Earth to the Moon,1958-11-26,1958,0,0,0,0.279504
44974,Kettle of Fish,2006-10-15,2006,0,0,0,0.124766
44977,Dhoom 3,2013-12-18,2013,19500000,91000000,71500000,5.326716
44978,Golmaal 3,2010-11-05,2010,10000000,0,-10000000,0.910979
44982,13,2010-03-12,2010,0,3317662,3317662,14.67986
44986,The Great Ecstasy of Robert Carmichael,2005-08-14,2005,0,0,0,0.370733
44988,Grown Up Movie Star,2009-10-20,2009,0,0,0,0.677394
44989,The Paranoids,2008-10-23,2008,0,0,0,0.151925
44990,Breaking Upwards,2009-03-14,2009,0,0,0,1.10475
44991,The Four-Faced Liar,2010-01-01,2010,2000000,0,-2000000,0.776951
44992,Hubble 3D,2010-03-19,2010,0,0,0,3.774768
44997,Phyllis and Harold,2010-02-19,2010,0,0,0,0.041177
44998,The Dry Land,2010-07-30,2010,0,12000,12000,0.118135
44999,Casino Jack and the United States of Money,2010-05-09,2010,0,0,0,0.616048
45000,Les Visiteurs du Soir,1942-12-05,1942,0,0,0,0.82687
45002,Chamatkar,1992-07-08,1992,0,0,0,0.033125
45004,The New Monsters,1977-12-15,1977,0,0,0,1.74251
45005,The Monsters,1963-10-26,1963,0,0,0,0.976684
45006,Interceptor,1992-10-13,1992,0,0,0,0.50153
45007,The Hunting Party,1971-07-16,1971,0,0,0,8.523318
45009,Shark in Venice,2008-10-06,2008,0,0,0,1.236186
45013,Burning Palms,2010-04-23,2010,5800000,0,-5800000,1.165191
45014,Anton Chekhov's The Duel,2010-04-28,2010,0,0,0,1.22775
45017,Uninhabited,2010-05-14,2010,0,0,0,1.084162
45019,Washington Square,1997-10-10,1997,0,1,1,1.301573
45020,Mercy,2009-11-11,2009,0,0,0,1.10573
45022,Holy Rollers,2010-05-21,2010,0,0,0,1.747257
45029,Fit to Kill,1993-10-27,1993,0,0,0,1.092445
45031,Raiders of the Living Dead,1986-01-01,1986,0,0,0,0.124544
45033,20 Seconds of Joy,2012-01-01,2012,0,0,0,0.085317
45035,King and the Clown,2005-12-29,2005,0,0,0,2.793366
45037,High School Record,2005-01-25,2005,0,0,0,0.038488
45041,Dana Gould: Let Me Put My Thoughts in You,2009-03-14,2009,0,0,0,0.07068
45042,The Girl Next Door,1999-06-16,1999,0,0,0,1.061409
45043,Lies,1999-09-04,1999,0,0,0,0.410813
45044,Friday Night,2002-09-11,2002,0,0,0,0.326438
45046,The Second Civil War,1997-03-15,1997,0,0,0,0.14974
45047,The Seduction of Inga,1968-10-18,1968,0,0,0,0.086545
45048,Felicity,1978-10-09,1978,0,0,0,1.96696
45052,The Pumpkin Karver,2006-10-31,2006,0,0,0,0.72015
45054,There Be Dragons,2011-03-25,2011,0,0,0,9.531143
45057,Screamers,2006-12-08,2006,0,0,0,0.011568
45064,Hata G√∂teborg,2007-05-04,2007,0,0,0,0.884324
45069,Hysterical Blindness,2002-01-01,2002,0,0,0,5.003372
45075,Blades of Blood,2010-04-28,2010,0,0,0,1.471126
45077,Every Day,2010-01-14,2010,0,18000,18000,1.954863
45079,4th Period Mystery,2009-08-12,2009,0,0,0,0.911718
45083,A Million,2009-08-06,2009,0,0,0,0.495593
45089,Blood Rain,2005-05-04,2005,0,0,0,0.478004
45094,Conviction,2010-09-11,2010,12500000,6732980,-5767020,11.024462
45096,Eve of Destruction,1991-01-18,1991,13000000,0,-13000000,2.277758
45098,More Than Blue,2009-03-11,2009,0,0,0,1.103791
45099,Cops and Robbers,1951-11-29,1951,0,0,0,1.021232
45103,Richard Pryor: Live and Smokin',1971-04-29,1971,0,0,0,0.180575
45109,Between Sheets,2008-12-05,2008,0,0,0,0.44424
45115,A Certain Kind of Death,2003-01-01,2003,0,0,0,0.388139
45120,Elvis Meets Nixon,1997-08-12,1997,0,0,0,0.721504
45126,Regular Lovers,2005-09-14,2005,0,0,0,0.913632
45127,A Matador's Mistress,2008-09-06,2008,28000000,0,-28000000,2.430763
45129,Salaam Bombay!,1988-08-24,1988,0,2080046,2080046,2.533455
45130,Gregoire Moulin vs. Humanity,2001-09-26,2001,0,0,0,0.98004
45132,Super,2010-09-09,2010,2500000,324138,-2175862,8.309635
45133,Sebbe,2010-03-12,2010,0,0,0,0.626312
45136,A Man Called Peter,1955-03-31,1955,0,0,0,0.438298
45138,Machine Gun McCain,1969-04-01,1969,0,0,0,0.441622
45139,Jesus,1979-10-19,1979,0,0,0,0.762672
45145,Johnny Suede,1991-08-18,1991,500000,0,-500000,2.010262
45147,Strictly Business,1991-11-08,1991,0,7683267,7683267,0.841588
45148,Michael Laudrup: A Football Player,1993-10-11,1993,0,0,0,0.049423
45153,Eve's Bayou,1997-09-07,1997,0,0,0,1.461772
45156,A Little Bit of Heaven,2011-02-03,2011,0,1296937,1296937,7.174869
45161,The Delicate Art of Parking,2003-08-23,2003,0,0,0,0.079204
45162,Superman/Batman: Apocalypse,2010-09-28,2010,3500000,0,-3500000,5.860115
45166,All My Sons,1948-05-01,1948,0,0,0,0.744989
45167,Pumzi,2009-10-20,2009,35000,0,-35000,0.187654
45169,Quintet,1979-02-09,1979,0,0,0,1.012883
45174,Easy,2003-09-10,2003,0,0,0,0.866653
45176,Enthusiasm,1931-04-02,1931,0,0,0,0.693172
45179,Xuxa in Crystal Moon,1990-06-22,1990,0,0,0,0.64592
45181,Chile Can Do It,2008-01-03,2008,0,0,0,0.020184
45184,Madame Bovary,1949-08-25,1949,0,0,0,0.555556
45186,Big Bad Mama,1974-09-19,1974,0,0,0,4.204629
45189,Sube y baja,1959-01-01,1959,0,0,0,0.171546
45190,Su excelencia,1967-01-01,1967,0,0,0,0.142853
45191,El barrendero,1982-05-05,1982,0,0,0,0.311993
45192,El profe,1971-04-07,1971,0,0,0,1.15292
45197,Big and Little Wong Tin Bar,1962-12-05,1962,0,0,0,0.812949
45202,The Housemaid,2010-05-13,2010,4000000,0,-4000000,4.26424
45203,Once in the Life,2000-10-27,2000,0,0,0,0.241579
45204,Stages,2007-11-08,2007,0,0,0,0.179226
45205,Wool 100%,2006-01-01,2006,0,0,0,0.129738
45210,Striped Trip,1961-06-06,1961,0,0,0,0.767747
45211,Face to Face,1967-11-23,1967,0,0,0,0.688316
45212,The Diary of a Chambermaid,1946-02-15,1946,0,0,0,0.319716
45213,French Cancan,1954-12-27,1954,0,0,0,0.764523
45215,Swamp Water,1941-10-23,1941,0,0,0,0.458247
45218,The River,1951-09-10,1951,0,0,0,1.758317
45219,The Southerner,1945-04-30,1945,0,0,0,0.860984
45220,This Land Is Mine,1943-05-07,1943,0,0,0,1.718128
45221,"Delphine 1, Yvan 0",1996-06-19,1996,0,0,0,0.349689
45225,The Big Picture,1989-09-15,1989,5000000,117463,-4882537,6.69473
45226,The Pursuit of D.B. Cooper,1981-11-13,1981,0,0,0,0.520743
45227,A Man from Boulevard des Capucines,1987-06-23,1987,0,0,0,1.479456
45232,Eat My Dust,1976-04-01,1976,0,0,0,1.044354
45233,Women's Prison Massacre,1983-08-31,1983,0,0,0,0.925862
45235,Pickup Alley,1957-08-13,1957,0,0,0,0.392625
45239,Storm Center,1956-07-31,1956,0,0,0,0.358537
45241,"Take Her, She's Mine",1963-01-01,1963,0,0,0,0.226531
45243,The Hangover Part II,2011-05-25,2011,80000000,254455986,174455986,21.893532
45244,"Life, Above All",2010-05-19,2010,0,0,0,0.433497
45247,Light in the Piazza,1962-02-07,1962,0,0,0,0.685069
45249,Not Quite Human II,1989-09-23,1989,0,0,0,0.0339
45256,Do Not Disturb,1965-01-01,1965,0,5275000,5275000,0.868796
45261,(Untitled),2009-10-25,2009,0,230600,230600,4.976918
45266,Behind Enemy Lines,1997-05-23,1997,0,0,0,0.517479
45267,Boccaccio '70,1962-02-22,1962,0,0,0,4.29255
45269,The King's Speech,2010-09-06,2010,15000000,414211549,399211549,11.260387
45272,Country Strong,2010-12-22,2010,15000000,20529194,5529194,4.582024
45273,The Bleeding,2009-11-02,2009,7000000,0,-7000000,0.653979
45274,Client 9: The Rise and Fall of Eliot Spitzer,2010-11-05,2010,0,0,0,0.420078
45284,Outrage,2010-05-17,2010,0,0,0,6.355452
45301,Outrage,2003-06-01,2003,0,0,0,0.113644
45302,The Chaos Factor,2000-01-01,2000,0,0,0,0.286411
45303,Running Out of Time 2,2001-12-27,2001,0,0,0,0.939864
45314,The Seafarers,1953-10-15,1953,0,0,0,1.372294
45316,Udaan,2010-06-17,2010,0,0,0,1.971658
45317,The Fighter,2010-12-17,2010,25000000,93617009,68617009,14.141837
45318,Isle of Flowers,1989-09-06,1989,0,0,0,0.300881
45320,Picture Me,2010-09-19,2010,0,11000,11000,0.535931
45322,She-Wolf of London,1946-05-17,1946,0,0,0,4.575792
45324,Casino Jack,2010-09-16,2010,12500000,1083683,-11416317,8.5508
45325,Tom and Huck,1995-12-22,1995,0,0,0,2.561161
45326,Legion,1998-04-18,1998,0,0,0,1.280285
45330,Agent Aika,1997-04-25,1997,0,0,0,0.111056
45335,Double Trouble,1967-04-05,1967,0,1600000,1600000,0.535616
45336,The Employment,2008-01-01,2008,0,0,0,0.798955
45341,Metastases,2009-01-01,2009,0,0,0,0.411397
45347,The Bleeding House,2011-04-20,2011,0,0,0,1.732076
45360,Dr. Bronner's Magic Soapbox,2007-06-29,2007,0,18,18,0.186225
45368,Comme les 5 doigts de la main,2010-04-28,2010,0,0,0,1.909648
45371,The Special Relationship,2010-05-29,2010,0,0,0,1.753332
45377,Death Sentence,1974-10-02,1974,0,0,0,0.005351
45379,Chinese Odyssey 2002,2002-02-06,2002,0,0,0,0.961434
45380,Crazy Stone,2006-01-01,2006,0,0,0,1.086502
45384,Ashura,2005-01-01,2005,0,0,0,1.597434
45397,My Left Eye Sees Ghosts,2002-01-01,2002,0,0,0,0.696557
45398,The McKenzie Break,1970-10-28,1970,0,0,0,1.564115
45407,Spy Girl,2004-01-30,2004,0,0,0,0.873116
45408,The Protector,1985-07-11,1985,0,0,0,7.106226
45417,Wu yen,2001-01-18,2001,0,0,0,0.802743
45418,Needing You...,2000-06-22,2000,0,0,0,1.077559
45431,Devil in the Flesh,1998-01-04,1998,0,0,0,0.993645
45438,Tokyo Raiders,2000-01-28,2000,0,0,0,6.159032
45441,DRIVE,2002-01-01,2002,0,0,0,0.335441
45452,Out of the Dark,1995-07-06,1995,0,0,0,1.872941
45458,The Romance of Astrea and Celadon,2007-09-01,2007,0,0,0,0.92477
45485,I Knew It Was You: Rediscovering John Cazale,2009-01-16,2009,0,0,0,5.621509
45489,Sukeban Deka The Movie,1987-02-14,1987,0,0,0,0.050485
45490,Okinawa Rendez-vous,2000-07-28,2000,0,0,0,0.018393
45491,Sex and Zen,1991-11-30,1991,0,396003,396003,1.824275
45492,Sukeban Deka the Movie 2: Counter-Attack from the Kazama Sisters,1988-02-11,1988,0,0,0,2.1e-05
45505,Moonlight Express,1999-01-01,1999,0,0,0,0.177791
45509,Beyond Hypothermia,1996-09-20,1996,0,0,0,3.004471
45511,Devil In The Flesh 2,2000-09-08,2000,0,0,0,0.15228
45512,Pocket Money,1972-01-01,1972,0,0,0,0.567506
45514,8,2008-10-23,2008,0,0,0,0.009226
45515,The Color of Lies,1999-01-13,1999,0,0,0,1.320519
45520,The Hunters,1958-09-01,1958,0,0,0,0.655544
45522,Castle Keep,1969-10-01,1969,0,0,0,1.810531
45523,Louis C.K.: Hilarious,2010-01-26,2010,0,0,0,3.882248
45527,The Final Storm,2010-01-01,2010,0,0,0,1.270832
45528,Naoko,2008-12-16,2008,0,0,0,0.156022
45533,Pyaar Kiya To Darna Kya,1998-03-27,1998,0,0,0,0.375371
45537,La vie est √† nous,1936-04-07,1936,0,0,0,0.149962
45538,Shackleton's Antarctic Adventure,2001-02-05,2001,0,0,0,0.507237
45549,Shopping,1994-12-06,1994,0,0,0,2.657647
45554,Kill,2008-12-06,2008,0,0,0,0.165694
45555,God's Angry Man,1980-01-01,1980,0,0,0,0.000844
45556,Arctic Blast,2010-05-30,2010,5000000,0,-5000000,5.270343
45560,Berlin Alexanderplatz,1980-08-28,1980,0,0,0,2.255785
45562,An Ungentlemanly Act,1992-01-01,1992,0,0,0,0.448514
45565,"I Love You, I Love You Not",1996-08-28,1996,0,0,0,0.380405
45568,Legacy,2010-10-15,2010,0,0,0,4.866221
45569,Red Hill,2010-11-05,2010,0,0,0,3.320135
45572,Resurrection of The Little Match Girl,2002-09-13,2002,0,0,0,0.228888
45576,Last Train Home,2009-06-06,2009,0,288,288,0.719517
45577,Three Cases of Murder,1955-03-15,1955,0,0,0,0.829563
45578,A Letter to Three Wives,1949-01-20,1949,0,0,0,1.538302
45579,The World's Greatest Lover,1977-12-18,1977,0,0,0,0.868948
45585,Kill Me Please,2010-11-03,2010,0,0,0,1.472867
45588,Angels in the Outfield,1951-10-19,1951,0,0,0,0.58196
45590,There Will Be No Leave Today,1959-05-09,1959,0,0,0,1.239331
45592,Film,1965-09-04,1965,0,0,0,0.576055
45593,Roman,2006-07-07,2006,250000,0,-250000,0.842907
45595,Miral,2010-10-01,2010,0,852336,852336,4.435032
45598,The Trouble with Girls,1969-09-03,1969,0,0,0,0.813685
45599,The Tunnel of Love,1958-11-21,1958,0,0,0,0.469335
45602,Disappearing Acts,2000-12-09,2000,0,0,0,1.15989
45608,The World of Suzie Wong,1960-11-10,1960,0,0,0,1.549436
45609,The Wings of the Dove,1997-11-07,1997,0,0,0,3.377578
45610,Machine Gun Preacher,2011-09-23,2011,30000000,2527904,-27472096,5.87767
45612,Source Code,2011-03-30,2011,32000000,147332697,115332697,9.796962
45615,Reindeerspotting - Escape From Santaland,2010-04-09,2010,0,0,0,0.879714
45622,"Manson, My Name Is Evil",2009-09-14,2009,0,0,0,0.838298
45627,This Side of the Law,1950-06-17,1950,0,0,0,0.403762
45628,Casbah,1948-04-01,1948,0,0,0,0.910975
45649,Rubber,2010-07-09,2010,500000,98017,-401983,5.305905
45650,The Hole,2009-09-09,2009,0,0,0,5.873597
45657,The Ward,2010-09-13,2010,10000000,498974,-9501026,5.727987
45658,Everything Must Go,2010-10-15,2010,5000000,2614773,-2385227,4.779994
45662,Space Chimps 2: Zartog Strikes Back,2010-05-26,2010,0,0,0,1.585311
45663,The Dunwich Horror,2009-12-13,2009,0,0,0,0.431157
45664,Who the #$&% Is Jackson Pollock?,2006-11-09,2006,0,0,0,0.247659
45665,Plane Crazy,1928-05-14,1928,0,0,0,0.578292
45671,Rough Magic,1995-09-07,1995,0,0,0,0.476919
45675,Calvin Marshall,2009-10-01,2009,0,0,0,0.809801
45677,7 Years,2006-01-01,2006,0,0,0,0.045413
45679,The System,1953-04-18,1953,0,0,0,0.453348
45682,Looking for Jackie,2009-07-03,2009,0,0,0,4.625697
45690,I Am Curious (Blue),1968-03-11,1968,0,0,0,0.732605
45691,The Adventures of Picasso,1978-05-20,1978,0,0,0,1.255319
45692,Paid in Full,1950-02-15,1950,0,0,0,0.148739
45693,Lucky 7,2003-07-20,2003,0,0,0,1.495753
45694,Young T√∂rless,1966-05-20,1966,0,0,0,1.626312
45695,A Wedding,1978-08-29,1978,0,0,0,0.88473
45697,A Christmas Carol,1977-12-24,1977,0,0,0,0.611892
45698,The Hourglass Sanatorium,1973-12-11,1973,0,0,0,0.138278
45699,The Butterfly,2002-12-18,2002,0,0,0,1.468247
45706,Tokyo Drifter,1966-04-10,1966,0,0,0,2.357111
45708,Play the Game,2009-08-29,2009,3200000,0,-3200000,1.275859
45712,Gloria,1999-01-22,1999,30000000,0,-30000000,1.807605
45713,Double Suicide,1969-05-24,1969,0,0,0,1.160174
45714,Night of the Eagle,1962-04-25,1962,0,0,0,1.663645
45715,The Kings of Mykonos,2010-05-20,2010,0,0,0,0.864925
45716,Sakura Killers,1987-01-01,1987,0,0,0,0.01476
45722,Don't Look Down,2008-03-07,2008,0,0,0,1.855275
45725,Adventures of a Teenage Dragonslayer,2010-04-16,2010,3250000,0,-3250000,1.13577
45726,Julie,1956-10-17,1956,0,0,0,0.535572
45729,Dark House,2009-04-19,2009,0,0,0,0.553298
45736,Shaolin Temple,1976-12-22,1976,0,0,0,0.648964
45739,Tube Tales,1999-01-01,1999,0,0,0,0.717378
45745,Sintel,2010-09-30,2010,550000,0,-550000,4.874409
45752,Scooby-Doo! Camp Scare,2010-09-14,2010,0,0,0,2.138263
45756,Saint,2010-10-31,2010,0,0,0,1.947114
45757,Saving Sarah Cain,2007-08-19,2007,2349352,0,-2349352,0.717755
45759,Helter Skelter,2004-07-23,2004,0,0,0,1.486812
45760,The Chatterley Affair,2006-03-20,2006,0,0,0,0.392811
45763,Herakles,1962-01-01,1962,0,0,0,0.319229
45764,Handicapped Future,1971-01-01,1971,0,0,0,0.488379
45765,Me Too,2009-10-16,2009,0,0,0,1.090502
45767,Time Changer,2002-10-25,2002,0,0,0,1.153239
45772,Gnomeo & Juliet,2011-01-13,2011,36000000,189712432,153712432,9.244469
45774,Midnight Crossing,1988-05-13,1988,0,1328001,1328001,1.043994
45777,The Beautiful Story,1992-03-18,1992,0,0,0,0.395425
45778,Camp Hell,2010-08-13,2010,3000000,0,-3000000,0.980913
45779,Mindwarp,1992-05-25,1992,1000000,0,-1000000,3.839936
45780,I Am Slave,2010-01-01,2010,0,0,0,0.662742
45782,Jeff Foxworthy: Totally Committed,1998-05-16,1998,0,0,0,0.002544
45783,Anders Matthesen: Tal For Dig Selv,2004-08-26,2004,0,0,0,0.714567
45791,When Did You Last See Your Father?,2007-10-05,2007,0,92,92,1.040302
45792,Amish Grace,2010-03-28,2010,0,0,0,1.040278
45793,Man of La Mancha,1972-12-20,1972,0,0,0,7.63776
45799,Everybody's Fine,1990-05-20,1990,0,0,0,1.263396
45800,Saratoga,1937-07-23,1937,0,0,0,0.251738
45801,Joan of Paris,1942-01-20,1942,0,0,0,0.166837
45802,The Lower Depths,1936-12-11,1936,0,0,0,0.816702
45803,Svengali,1931-05-22,1931,0,0,0,0.193959
45806,Nothing Personal,2009-08-14,2009,0,0,0,2.045691
45807,The Balloonatic,1923-01-22,1923,0,0,0,1.701368
45817,The Kremlin Letter,1970-02-01,1970,0,0,0,0.906391
45823,Treading Water,2001-06-15,2001,0,0,0,0.21688
45824,Smile,2005-04-08,2005,0,0,0,0.682578
45827,One Little Indian,1973-06-20,1973,0,0,0,0.469293
45838,The Bell Boy,1918-03-18,1918,0,0,0,0.214742
45839,FRED: The Movie,2010-09-18,2010,0,0,0,2.483323
45840,Best Friends,1982-12-17,1982,0,0,0,4.771286
45852,Harvard Beats Yale 29-29,2008-11-19,2008,0,268431,268431,0.626528
45861,Happy Times,2000-12-31,2000,1900000,240093,-1659907,0.653271
45862,Hangman's Curse,2003-09-12,2003,0,0,0,0.965268
45864,Extreme Days,2001-09-28,2001,0,1,1,0.266895
45871,The Mission,1999-11-19,1999,0,0,0,1.531916
45873,Cannabis,1970-09-02,1970,0,0,0,0.069109
45874,Posse,1975-06-04,1975,0,0,0,1.064604
45875,Trilogy of Terror II,1996-10-30,1996,0,0,0,1.15884
45877,Nemesis Game,2003-01-01,2003,0,0,0,1.13964
45878,Return to Horror High,1987-01-28,1987,0,0,0,3.048608
45881,The Bridge of San Luis Rey,2004-01-01,2004,0,0,0,1.192451
45882,Bab'Aziz,2005-01-01,2005,0,0,0,1.753255
45884,Kapo,1960-09-27,1960,0,0,0,0.930115
45886,Days of Eclipse,1988-01-01,1988,0,0,0,1.411653
45887,Alive in Joburg,2005-01-01,2005,0,0,0,1.954502
45891,The Ten Lives of Titanics the Cat,2007-10-31,2007,0,0,0,0.039312
45899,Leila,1997-04-25,1997,0,0,0,0.465891
45905,The Opportunists,2000-05-17,2000,0,0,0,0.168378
45921,Haunted Echoes,2008-11-20,2008,0,0,0,0.381248
45926,Victory,1996-12-13,1996,0,0,0,1.064921
45928,Incognito,1997-11-14,1997,0,0,0,0.961088
45929,Titanica,1995-04-01,1995,0,0,0,0.826021
45930,American Anthem,1986-06-27,1986,0,0,0,0.262531
45935,Flowers of Shanghai,1998-10-01,1998,0,0,0,1.409888
45938,Sunday Bloody Sunday,1971-07-01,1971,0,0,0,2.454107
45939,President,2006-09-20,2006,0,0,0,0.474205
45940,Company Limited,1971-09-24,1971,0,0,0,0.278459
45943,Taurus,2001-01-01,2001,0,0,0,0.495781
45945,Radio On,1979-11-30,1979,0,0,0,0.107973
45948,A Story of Water,1961-01-01,1961,0,0,0,1.127513
45949,The Days Between,2001-08-01,2001,0,0,0,0.158414
45952,Wild Flowers,2000-12-07,2000,0,0,0,0.575941
45958,Biutiful,2010-10-20,2010,0,25147786,25147786,7.131568
45960,Blind Spot,1947-02-06,1947,0,0,0,0.114769
45961,Rosencrantz and Guildenstern Are Undead,2009-01-19,2009,600000,0,-600000,0.518825
45964,When a Stranger Calls,1979-10-26,1979,0,0,0,9.133206
45965,Sanshiro Sugata Part Two,1945-05-03,1945,0,0,0,0.879112
45966,Day of the Fight,1951-04-26,1951,3900,0,-3900,1.206349
45967,One Wonderful Sunday,1947-06-25,1947,0,0,0,1.111592
45970,Flying Padre,1951-03-23,1951,0,0,0,1.814277
45971,You and Me,1938-06-03,1938,0,0,0,0.517539
45974,The Halloween Tree,1993-10-31,1993,0,0,0,0.374639
45978,The 47 Ronin,1941-12-08,1941,0,0,0,0.628223
45987,Taira Clan Saga,1955-09-21,1955,0,0,0,0.392361
45988,1066: The Battle for Middle Earth,2009-05-18,2009,0,0,0,0.133927
45990,Christmas Rematch,2004-01-30,2004,0,0,0,1.006004
45993,The Woman in the Rumor,1954-06-20,1954,0,0,0,1.338043
45996,Dust in the Wind,1986-01-01,1986,0,0,0,0.000844
45997,Who Killed Pasolini?,1995-09-03,1995,0,0,0,0.839786
45999,"A Time to Live, a Time to Die",1985-08-03,1985,0,0,0,1.004464
46001,Delitto al ristorante cinese,1981-11-19,1981,0,0,0,0.098906
46004,The Luck of the Irish,2001-03-09,2001,0,0,0,1.390906
46007,Anything Goes,1956-04-27,1956,0,0,0,0.228249
46010,Old Men: Robbers,1971-01-01,1971,0,0,0,0.127571
46011,Call Me Madam,1953-03-25,1953,0,0,0,0.078792
46014,Just for You,1952-09-27,1952,0,0,0,0.002496
46016,Road to Redemption,2001-09-28,2001,0,0,0,0.040854
46018,Willie Dynamite,1974-01-23,1974,0,0,0,0.805515
46020,Sharktopus,2010-09-25,2010,0,0,0,2.429777
46021,A Handful of Dust,1988-06-24,1988,0,0,0,3.699787
46025,Mal√©fique,2002-11-09,2002,1500000,0,-1500000,2.24948
46026,Our Relations,1936-10-30,1936,400000,0,-400000,1.551992
46027,Night Falls on Manhattan,1996-10-22,1996,0,0,0,1.626239
46028,Puerto Escondido,1992-12-17,1992,110,0,-110,0.643316
46029,Two Much,1996-02-14,1996,0,0,0,1.620174
46040,Tees Maar Khan,2010-12-24,2010,0,0,0,1.754362
46041,The Quiller Memorandum,1966-11-10,1966,0,0,0,8.415216
46043,Miss Oyu,1951-06-22,1951,0,0,0,0.497952
46059,The Hot Rock,1972-01-26,1972,0,0,0,2.787865
46063,Last Dance,1996-05-02,1996,0,5,5,1.196686
46067,"Mary, Queen of Scots",1971-12-22,1971,0,0,0,5.143399
46068,Bud Abbott and Lou Costello in Hollywood,1945-10-05,1945,0,0,0,0.554625
46069,The Story of the Last Chrysanthemum,1939-10-13,1939,0,0,0,1.247035
46076,Invasion of the Star Creatures,1962-05-03,1962,0,0,0,0.419399
46081,If a Man Answers,1962-10-10,1962,0,0,0,0.773261
46088,Dangerous Moves,1984-04-15,1984,0,0,0,0.762348
46094,The Air Up There,1994-01-07,1994,17080000,21011500,3931500,1.896273
46095,Criminal Court,1946-11-20,1946,0,0,0,0.33594
46096,The Small Back Room,1949-02-21,1949,0,0,0,0.751207
46101,United Red Army,2007-08-26,2007,2391200,0,-2391200,1.20049
46103,Born to Raise Hell,2010-10-19,2010,10000000,0,-10000000,6.407803
46105,American: The Bill Hicks Story,2010-04-10,2010,0,90275,90275,1.550254
46106,Caterpillar,2010-08-14,2010,0,0,0,0.633298
46111,The Killer Meteors,1976-08-21,1976,0,0,0,0.703363
46112,Dawg,2002-02-21,2002,0,0,0,2.025646
46114,The 36 Crazy Fists,1977-01-01,1977,0,0,0,0.459802
46119,Crime + Punishment in Suburbia,2000-01-01,2000,0,26394,26394,5.062928
46121,The Capture of the Green River Killer,2008-03-30,2008,0,0,0,0.108464
46124,Dragon Fist,1979-04-21,1979,0,0,0,2.021844
46127,Sorority Wars,2009-01-02,2009,0,0,0,11.079075
46128,La bella societ√†,2009-05-21,2009,0,0,0,0.700823
46136,The Blank Generation,1976-01-13,1976,0,0,0,0.141541
46138,Made in Dagenham,2010-09-11,2010,7200000,0,-7200000,4.326838
46145,"Invasion, U.S.A.",1952-12-10,1952,0,0,0,0.272838
46146,Troll Hunter,2010-10-29,2010,3500000,4159678,659678,6.097684
46147,"Happy, Happy",2010-11-05,2010,0,0,0,0.550861
46149,Stolen Desire,1958-09-30,1958,0,0,0,0.58057
46158,Holocaust 2000,1977-11-25,1977,0,0,0,0.584734
46159,Stand Up and Cheer!,1934-05-04,1934,0,0,0,0.29391
46164,Retribution,2006-09-03,2006,0,0,0,1.40622
46169,Twitches Too,2007-10-12,2007,0,0,0,2.574399
46175,Daughters of Darkness,1971-05-28,1971,0,0,0,1.843332
46178,Bytte Bytte K√∏bmand,2010-09-27,2010,0,0,0,0.366064
46184,Destiny,1944-12-22,1944,0,0,0,0.697164
46187,The Thief,1997-08-31,1997,0,0,0,1.212375
46189,The Wings of Eagles,1957-02-22,1957,0,0,0,4.162219
46190,These Wilder Years,1956-08-17,1956,0,0,0,0.457454
46193,"Ride, Vaquero!",1953-07-17,1953,0,0,0,0.33575
46195,Rio,2011-04-03,2011,90000000,484635760,394635760,10.403228
46196,Hollywood Story,1951-06-01,1951,0,0,0,0.114236
46197,White Lion,2010-02-19,2010,0,0,0,0.32166
46198,My Girlfriend's Boyfriend,2010-04-22,2010,1400000,0,-1400000,3.521957
46203,Jane Eyre,1997-03-09,1997,0,0,0,0.848757
46207,White Material,2010-03-24,2010,0,0,0,2.775816
46212,Dragon's Return,1968-05-10,1968,0,0,0,0.036472
46217,Darfur,2009-11-06,2009,0,0,0,0.928631
46221,The Tunnel,2011-05-19,2011,135000,0,-135000,4.863972
46223,Dangerous Davies,1981-01-04,1981,0,0,0,0.012313
46226,The Goddess of 1967,2000-09-08,2000,0,0,0,0.834103
46227,Susie Q,1996-09-30,1996,0,0,0,3.882923
46228,Love that Boy,2003-09-01,2003,0,0,0,0.416676
46230,Pale Blood,1990-10-01,1990,0,0,0,0.025088
46240,Christmas Comes but Once a Year,1936-01-01,1936,0,0,0,0.109407
46247,No Time for Nuts,2006-10-23,2006,0,0,0,2.980621
46258,The House in Montevideo,1951-11-08,1951,0,0,0,0.071476
46260,Saps at Sea,1940-05-03,1940,0,0,0,0.691018
46261,Don't Be Afraid of the Dark,2010-11-06,2010,25000000,36993168,11993168,8.67817
46278,Iphigenia,1977-09-10,1977,0,0,0,0.826244
46280,The Ring Finger,2005-06-08,2005,0,0,0,2.469114
46286,The Suburbans,1999-10-29,1999,0,0,0,1.73986
46302,Drive Thru,2007-05-29,2007,0,0,0,1.777051
46314,Hugo the Movie Star,1996-12-20,1996,0,0,0,0.53166
46315,Valerie and Her Week of Wonders,1970-10-10,1970,0,0,0,2.682013
46326,Port of Shadows,1938-05-18,1938,0,0,0,2.428278
46332,Of Gods and Men,2010-05-18,2010,4000000,41424067,37424067,4.476836
46333,Pervert!,2005-02-12,2005,0,0,0,1.05556
46334,Captain Conan,1996-10-16,1996,0,0,0,1.705362
46335,Don't Touch the Axe,2007-03-28,2007,0,0,0,0.222668
46336,Four Eyed Monsters,2005-01-21,2005,250000,245000,-5000,0.634211
46338,The Leading Man,1996-12-12,1996,0,0,0,0.004686
46341,El pr√≥ximo Oriente,2006-08-14,2006,0,0,0,0.131963
46342,Evilenko,2004-04-16,2004,9700000,0,-9700000,1.796637
46343,Oktapodi,2007-01-01,2007,0,0,0,1.895026
46351,Great Guy,1936-12-01,1936,0,0,0,0.771948
46359,Demons of the Mind,1972-11-05,1972,0,0,0,1.068124
46360,Guns,1990-11-09,1990,0,0,0,0.665062
46364,Inseminoid,1981-01-23,1981,2000000,0,-2000000,1.794332
46368,The Rig,2010-10-05,2010,3000000,0,-3000000,1.677714
46373,Bade Miyan Chote Miyan,1998-10-06,1998,0,0,0,0.38647
46375,Barsaat,1995-09-29,1995,0,0,0,0.195461
46383,Dus Kahaniyaan,2007-12-07,2007,0,0,0,0.232919
46387,Hum Aapke Hain Koun,1994-08-05,1994,0,26900000,26900000,1.172228
46391,Prodigal Sons,2008-08-29,2008,0,0,0,0.079954
46403,Main Khiladi Tu Anari,1994-09-23,1994,0,0,0,1.201935
46406,Mission Kashmir,2000-10-27,2000,0,0,0,0.627427
46409,MP3: Mera Pehla Pehla Pyaar,2007-06-08,2007,0,0,0,0.214509
46420,The Loved Ones,2009-09-13,2009,0,0,0,5.624576
46421,Please Murder Me,1956-03-01,1956,0,0,0,0.542403
46423,Lucky: No Time for Love,2005-04-08,2005,0,0,0,0.204307
46426,Traffic Signal,2007-02-07,2007,0,0,0,0.044429
46428,Gangaajal,2003-08-29,2003,0,0,0,0.628507
46429,Gallowwalkers,2012-10-27,2012,17000000,0,-17000000,5.643051
46430,Jodi No.1,2001-04-13,2001,0,0,0,1.000858
46431,The Education Of Shelby Knox,2005-06-21,2005,0,0,0,0.002353
46432,Woh Lamhe,2006-09-26,2006,0,0,0,0.429974
46434,The Man in the Net,1959-06-10,1959,0,0,0,0.665042
46435,Topsy-Turvy,1999-09-03,1999,0,0,0,5.902126
46436,Virtual Weapon,1997-08-25,1997,0,0,0,0.445127
46439,Daughters of Satan,1972-11-17,1972,0,0,0,0.901392
46441,Mirrors 2,2010-10-18,2010,0,0,0,5.936241
46442,Keep Surfing,2009-06-25,2009,0,0,0,0.086672
46443,"Django, Prepare a Coffin",1968-01-27,1968,0,0,0,1.911459
46445,Buddy goes West,1981-05-14,1981,0,0,0,8.755413
46448,Charleston,1977-03-05,1977,0,0,0,0.71648
46451,All American Orgy,2010-08-10,2010,0,0,0,0.7402
46458,Map of the Sounds of Tokyo,2009-12-02,2009,0,0,0,0.919483
46460,Wanda Nevada,1979-06-01,1979,0,2411145,2411145,1.267946
46466,The Children of the Century,1999-09-13,1999,0,0,0,2.522402
46469,Proteus,2003-09-07,2003,0,0,0,0.695867
46473,Home Sweet Home,2008-11-19,2008,0,0,0,0.127259
46492,Sound of the Mountain,1954-01-15,1954,0,0,0,0.980417
46493,Flowing,1956-11-20,1956,0,0,0,1.118328
46494,Four Boys and a Gun,1957-01-01,1957,0,0,0,0.040593
46495,The Night of the Following Day,1968-12-26,1968,0,0,0,1.355567
46498,Candy,1968-12-17,1968,3000000,0,-3000000,4.640419
46500,The Warrior and the Sorceress,1984-09-07,1984,0,0,0,1.650324
46503,All Good Things,2010-12-03,2010,0,0,0,11.691146
46504,Guy and Madeline on a Park Bench,2009-04-23,2009,0,0,0,0.433573
46510,The High Sign,1921-04-18,1921,0,0,0,0.908985
46513,The Shadow in the North,2007-09-15,2007,0,0,0,0.743813
46521,Tintin and the Mystery of the Golden Fleece,1961-12-06,1961,0,0,0,2.197506
46522,The Aftermath,1982-01-01,1982,250000,0,-250000,0.364806
46523,New Kids Turbo,2010-12-09,2010,1500000,8786756,7286756,4.330658
46525,Back from Eternity,1956-09-07,1956,0,0,0,0.453886
46526,The Christmas Card,2006-12-02,2006,0,0,0,0.260102
46528,The Warrior's Way,2010-12-02,2010,42000000,11087569,-30912431,5.510805
46529,I Am Number Four,2011-02-18,2011,50000000,144492830,94492830,9.388376
46531,Borderline,1950-03-01,1950,0,0,0,4.58306
46534,Sweet Karma,2009-01-01,2009,0,0,0,2.211321
46537,Dark and Stormy Night,2009-10-10,2009,0,0,0,0.280575
46541,Game of Death,2010-11-27,2010,13000000,0,-13000000,4.145285
46548,Header,2006-08-12,2006,349999,0,-349999,0.153376
46558,Sins of My Father,2009-12-10,2009,0,0,0,0.549618
46562,The Last Rites of Ransom Pride,2010-06-17,2010,0,0,0,1.516498
46563,Saratoga Trunk,1945-11-21,1945,1750000,0,-1750000,0.379884
46564,A Marine Story,2010-11-05,2010,0,0,0,1.31098
46565,Torino nera,1972-05-22,1972,0,0,0,0.474736
46567,"It Can Be Done, Amigo",1972-03-31,1972,0,0,0,0.975488
46568,Crazy Westerners,1967-08-11,1967,0,0,0,0.048647
46570,"Today We Kill, Tomorrow We Die!",1968-03-28,1968,0,0,0,1.402856
46572,Big Man - An Unusual Insurance,1988-11-25,1988,0,0,0,0.062275
46578,Cheerleaders' Wild Weekend,1979-09-01,1979,0,0,0,1.004865
46580,Time Limit,1957-10-23,1957,0,0,0,0.085585
46581,Immoral Tales,1974-08-17,1974,0,0,0,2.55183
46584,The Trotsky,2009-09-11,2009,6400000,0,-6400000,1.517105
46586,The Gambler and the Lady,1952-12-26,1952,0,0,0,0.192303
46588,Zigzag of Success,1968-01-01,1968,0,0,0,0.171137
46591,Fists in the Pocket,1965-10-31,1965,0,0,0,1.399107
46592,Ballad of a Soldier,1959-12-01,1959,0,0,0,3.434242
46594,Earth,1930-04-08,1930,0,0,0,1.289409
46595,The Great Ecstasy of Woodcarver Steiner,1974-01-01,1974,22500,0,-22500,0.801549
46612,Nature's Great Events,2009-02-25,2009,0,0,0,1.150246
46614,The Story of G.I. Joe,1945-07-13,1945,0,0,0,0.897699
46615,Darby's Rangers,1958-02-12,1958,0,0,0,0.250186
46616,Joy of Living,1938-05-06,1938,0,0,0,0.041484
46617,Having Wonderful Time,1938-07-01,1938,0,0,0,0.663617
46623,Cimarron,1960-12-01,1960,0,0,0,2.000936
46625,The End of Violence,1997-09-12,1997,5000000,0,-5000000,1.621193
46626,Gang Busters,1955-06-17,1955,0,0,0,0.162739
46629,On Board,1998-12-04,1998,0,0,0,0.390652
46632,Long Live Ghosts!,1977-11-01,1977,0,0,0,0.284167
46636,Nanga Parbat,2010-01-14,2010,0,0,0,0.917536
46641,Today's Special,2009-10-14,2009,0,400654,400654,5.959911
46651,Romance,2008-11-14,2008,0,0,0,0.480346
46658,Night of the Sharks,1989-01-01,1989,0,0,0,0.110781
46660,I Love You Too,2010-05-06,2010,0,0,0,2.027757
46661,Warm Springs,2005-04-30,2005,0,0,0,0.515715
46663,Night Nurses,2007-11-29,2007,0,0,0,0.449747
46665,Triple Dog,2010-05-10,2010,0,0,0,7.021114
46667,Superdad,1973-12-14,1973,0,0,0,1.421788
46681,Terror in a Texas Town,1958-09-01,1958,0,0,0,0.83621
46686,Third World Cop,1999-09-14,1999,0,40717,40717,0.003626
46688,The Dawn Patrol,1938-12-24,1938,0,0,0,0.95462
46689,Waste Land,2010-01-24,2010,1500000,187716,-1312284,2.627643
46691,Joe,1970-07-15,1970,106000,19319254,19213254,0.345862
46695,Witchcraft,1989-05-02,1989,0,0,0,0.554587
46696,"Private Vices, Public Virtues",1976-05-06,1976,0,0,0,1.532738
46697,Hated:  GG Allin & the Murder Junkies,1994-01-01,1994,0,0,0,0.822172
46702,Why Do Fools Fall In Love,1998-08-28,1998,0,12413650,12413650,0.897413
46705,Blue Valentine,2010-12-27,2010,3500000,16566240,13066240,11.107914
46712,Blue Eyelids,2007-04-02,2007,0,0,0,0.289054
46713,Hunt to Kill,2010-11-06,2010,2300000,0,-2300000,6.043774
46717,Intersection,1994-01-21,1994,45000000,21355893,-23644107,8.295437
46718,DC Showcase: Green Arrow,2010-09-28,2010,0,0,0,1.5528
46724,The League of Gentlemen,1960-04-05,1960,0,0,0,3.033652
46725,Indictment: The McMartin Trial,1995-01-01,1995,0,0,0,0.51695
46727,Speedway Junky,1999-02-11,1999,1000000,0,-1000000,1.19861
46729,Fetching Cody,2005-10-01,2005,1,0,-1,0.320755
46732,The Grass Harp,1995-09-10,1995,0,0,0,0.365418
46734,Eva,2010-08-01,2010,3383700,0,-3383700,0.607009
46737,Passenger Side,2009-10-28,2009,0,0,0,0.423559
46738,Incendies,2010-09-04,2010,6800000,7103838,303838,8.596012
46740,Monty Python's Fliegender Zirkus,1971-01-01,1971,0,0,0,0.140018
46741,The Forty-First,1956-10-15,1956,0,0,0,1.458763
46743,Out of Bounds,1986-07-25,1986,0,5099316,5099316,0.779829
46744,1812,1912-01-01,1912,0,0,0,0.071565
46748,See the Sea,1997-12-03,1997,0,0,0,0.892546
46754,The Other Side of Sunday,1996-02-09,1996,0,0,0,0.275472
46756,The Temptation of St. Tony,2009-10-10,2009,0,0,0,1.677375
46757,The Last Sunset,1961-06-06,1961,0,0,0,1.917804
46758,Richard III,1912-10-15,1912,0,0,0,0.05131
46760,Float,2007-01-01,2007,0,0,0,0.003534
46761,Sitcom,1998-05-27,1998,0,0,0,1.800582
46767,In a Glass Cage,1987-03-03,1987,0,0,0,1.247317
46768,Conspiracy of Torture,1969-11-13,1969,0,0,0,0.568565
46769,Vingt-quatre heures de la vie d'un clown,1945-01-01,1945,0,0,0,0.036615
46770,Sur,1988-01-01,1988,0,0,0,0.122466
46772,"Electra, My Love",1974-12-12,1974,0,0,0,0.00195
46773,The Blossoming of Maximo Oliveros,2005-07-13,2005,0,0,0,0.798398
46774,Chapayev,1934-11-07,1934,0,0,0,0.472296
46776,The Bliss of Mrs. Blossom,1968-01-01,1968,0,0,0,0.308475
46780,Kustom Kar Kommandos,1965-01-01,1965,0,0,0,0.21384
46781,Puce Moment,1949-01-01,1949,0,0,0,0.617421
46783,Fiona,1998-01-01,1998,0,0,0,0.700147
46784,Rabbit's Moon,1971-01-02,1971,0,0,0,0.002001
46785,The White Balloon,1995-01-01,1995,0,0,0,1.196256
46786,Homer and Eddie,1989-08-17,1989,0,0,0,1.027011
46787,Scorpio Rising,1964-01-01,1964,0,0,0,0.973352
46788,Trash Humpers,2009-09-12,2009,0,0,0,1.215143
46789,Submarino,2010-09-01,2010,0,0,0,2.898859
46793,Shadows of a Hot Summer,1978-09-13,1978,0,0,0,0.070239
46797,Tom & Viv,1994-04-15,1994,0,0,0,0.704204
46798,The City,1999-10-22,1999,0,0,0,0.467303
46799,The Third Part of the Night,1971-12-17,1971,0,0,0,1.030329
46804,The Idiot Returns,1999-02-25,1999,0,0,0,0.21384
46806,Eloise at the Plaza,2003-01-01,2003,0,0,0,0.79789
46808,Darkness in Tallinn,1993-06-06,1993,0,0,0,0.156614
46809,Spring,1969-12-20,1969,0,0,0,0.583519
46812,Lost Boys: The Thirst,2010-05-12,2010,4400000,0,-4400000,2.058133
46813,Don Quixote,1933-01-01,1933,0,0,0,0.100463
46814,Elina: As If I Wasn't There,2003-01-03,2003,0,0,0,0.219561
46817,The Class Trip,1998-09-23,1998,0,0,0,0.46812
46820,Madeinusa,2006-01-26,2006,0,0,0,0.486036
46821,Blood,1989-12-07,1989,0,0,0,0.470815
46825,Lila Says,2004-11-01,2004,0,0,0,1.874371
46827,Rasputin,1996-03-23,1996,0,0,0,3.142663
46828,Son of the Pink Panther,1993-01-01,1993,25000000,2438031,-22561969,3.372523
46829,Barney's Version,2010-10-26,2010,30000000,8454301,-21545699,7.524794
46830,Poison Ivy,1985-02-10,1985,0,0,0,1.086477
46831,Human Resources,1999-11-20,1999,0,0,0,0.978585
46835,Santitos,1999-01-23,1999,0,0,0,0.28762
46836,Willy/Milly,1986-11-14,1986,0,235262,235262,0.05627
46837,Kaboom,2010-08-22,2010,0,539957,539957,5.44702
46838,Tucker and Dale vs Evil,2010-01-22,2010,5000000,5476793,476793,6.771868
46845,Man in the Wilderness,1971-11-24,1971,0,0,0,1.867242
46847,Autumn Ball,2007-09-13,2007,0,0,0,1.379473
46849,Eye of the Dolphin,2007-08-24,2007,2500000,71904,-2428096,0.46335
46853,Playing with Love,1977-05-17,1977,0,0,0,6.543051
46857,Somnambulance,2003-09-19,2003,0,0,0,0.353023
46863,The Bells Toll for the Barefooted,1965-01-01,1965,0,0,0,0.03652
46869,Love on the Side,2004-09-30,2004,0,0,0,0.607125
46871,Eve and the Fire Horse,2005-09-09,2005,1500000,0,-1500000,0.079412
46872,The Steel Helmet,1951-02-02,1951,0,0,0,5.112386
46875,Fixed Bayonets!,1951-11-21,1951,0,0,0,3.183964
46878,The Swarm,1978-07-14,1978,0,0,0,3.955633
46879,Films to Keep You Awake: Spectre,2006-07-01,2006,0,0,0,0.343522
46883,Quiet City,2007-03-12,2007,2500,15425,12925,0.404753
46884,They Came to Cordura,1959-06-01,1959,0,0,0,0.913419
46885,Visiting Hours,1982-05-21,1982,0,0,0,2.544855
46886,Disco and Atomic War,2009-04-10,2009,0,0,0,0.08079
46888,The One Percent,2006-04-29,2006,0,0,0,0.258838
46889,Living Out Loud,1998-10-30,1998,12000000,12902790,902790,1.575026
46891,Find Love,2006-01-01,2006,500000,0,-500000,0.013657
46897,The Mark of Cain,2000-01-01,2000,0,0,0,0.144446
46898,Malcolm X,1972-05-24,1972,0,0,0,0.103144
46902,The Treatment,2006-04-08,2006,900000,82701,-817299,2.78291
46909,Skeletons,2010-07-16,2010,0,0,0,1.064684
46910,The Lost Patrol,1934-02-16,1934,0,0,0,1.406966
46914,Pleasure Factory,2007-10-18,2007,0,0,0,1.361779
46915,King Lear,1983-04-03,1983,0,0,0,0.645505
46916,Samurai Spy,1965-07-10,1965,0,0,0,1.315014
46917,Sword of the Beast,1965-09-18,1965,0,0,0,1.459686
46918,Floating Weeds,1959-11-17,1959,0,0,0,1.774766
46919,Daisies,1966-12-30,1966,0,0,0,4.892157
46920,La nostra vita,2010-05-21,2010,0,0,0,3.4068
46923,Men Don't Cry,1968-01-01,1968,0,0,0,0.142296
46924,Being Human,1994-05-06,1994,40000000,0,-40000000,2.783872
46925,Six Pack,1982-07-16,1982,0,20225989,20225989,0.700777
46927,I Was Here,2008-09-12,2008,0,0,0,0.285214
46929,Fun & Fancy Free,1947-09-27,1947,0,0,0,4.590576
46930,Magnus,2007-05-18,2007,0,0,0,0.221895
46931,Georg,2007-10-05,2007,0,0,0,0.152572
46932,Seven Days to Noon,1950-10-30,1950,0,0,0,0.493914
46934,Mr. Nice,2010-10-07,2010,0,850994,850994,2.611337
46941,Love and Pain and the Whole Damn Thing,1973-04-19,1973,0,0,0,0.080589
46943,The Point Men,2001-09-07,2001,0,0,0,2.256398
46948,Power,1986-01-31,1986,0,0,0,1.828322
46953,Behind Blue Skies,2010-09-10,2010,0,0,0,4.200146
46963,The Grinch Grinches the Cat in the Hat,1982-05-20,1982,0,0,0,0.123535
46967,Bill Burr: Let It Go,2010-09-18,2010,0,0,0,1.296848
46971,Wild Geese II,1985-10-18,1985,0,0,0,1.265037
46972,Big Girls Don't Cry... They Get Even,1992-05-08,1992,0,0,0,0.466287
46973,The Man Who Saw Tomorrow,1981-01-09,1981,0,0,0,0.281928
46975,The Secret Garden,1987-11-30,1987,0,0,0,1.871616
46976,Wish You Were Here,1987-07-24,1987,0,0,0,0.290331
46978,Mistress,1975-04-25,1975,0,0,0,1.140189
46979,Le amiche,1955-11-18,1955,0,0,0,0.695748
46982,Black Peter,1964-04-16,1964,0,0,0,0.953547
46983,Le chant du Styr√®ne,1959-09-30,1959,0,0,0,0.177854
46986,Flirt,1995-09-14,1995,0,0,0,1.663948
46989,Blue Car,2002-01-11,2002,1000000,464000,-536000,2.154226
46991,An Affair of Love,1999-09-04,1999,0,0,0,1.782247
46992,Hilary and Jackie,1998-12-30,1998,0,0,0,6.387602
46993,Madame Sat√£,2002-01-01,2002,0,0,0,0.621761
46995,Madeleine,1950-02-14,1950,0,0,0,0.91292
46997,The Magic Voyage of Sinbad,1952-12-20,1952,0,0,0,0.791297
46998,Evil - In the Time of Heroes,2009-10-01,2009,0,0,0,0.22947
47001,The Thing That Couldn't Die,1958-06-27,1958,0,0,0,0.909133
47002,Love Letter,1995-03-25,1995,0,0,0,2.737425
47003,The Deadly Bees,1966-12-23,1966,0,0,0,0.688748
47007,Deep Crimson,1996-01-01,1996,0,0,0,0.324979
47011,Voyage in Time,1983-01-01,1983,0,0,0,0.538122
47018,Carrington,1995-11-08,1995,0,0,0,1.493361
47033,Day of the Full Moon,1998-08-29,1998,0,0,0,0.183931
47034,The Cherry Orchard,1999-01-01,1999,5,135,130,0.00188
47038,The Pit,1981-10-23,1981,1000000,0,-1000000,1.318185
47045,She's Out of Control,1989-04-14,1989,0,12065892,12065892,1.685918
47046,Blissfully Yours,2002-10-08,2002,0,0,0,4.995545
47055,Cool It,2010-11-08,2010,0,0,0,0.294104
47057,The Appointments Of Dennis Jennings,1988-01-01,1988,0,0,0,0.078166
47059,Boxing Gym,2010-10-22,2010,0,0,0,0.191114
47060,The Hole,1998-09-14,1998,0,0,0,0.578245
47065,Tales of an Ancient Empire,2010-07-31,2010,1000000,0,-1000000,0.887971
47070,Brenda Starr,1989-05-15,1989,0,0,0,6.561712
47072,Final Cut,1998-11-13,1998,0,0,0,0.468304
47075,Samson and Delilah,2009-05-07,2009,0,0,0,0.727165
47084,Little Dorrit,2008-10-26,2008,0,0,0,0.583234
47088,The Extra Man,2010-08-01,2010,7000000,453079,-6546921,3.18614
47089,The Middle of the World,2003-09-12,2003,0,0,0,1.31979
47090,The Pit and the Pendulum,1991-06-27,1991,2000000,0,-2000000,2.252625
47095,House of Cards,1993-06-25,1993,0,0,0,4.946028
47096,One Way or Another,1976-04-30,1976,0,0,0,0.478076
47099,Killer,1998-01-01,1998,0,0,0,0.105725
47100,The Father,1996-01-01,1996,0,0,0,0.597149
47104,Through the Olive Trees,1994-01-01,1994,0,0,0,1.291484
47105,Latcho Drom,1993-06-06,1993,0,0,0,1.034063
47108,I Come,2000-10-04,2000,0,124994,124994,0.264672
47110,Afstiros katallilo,2008-10-23,2008,0,0,0,0.234066
47112,A Further Gesture,1997-01-01,1997,0,0,0,0.814147
47115,A Gentleman's Game,2002-01-01,2002,0,0,0,0.332667
47116,The Winner,1979-03-09,1979,0,0,0,0.0
47119,Le Gar√ßu,1995-10-31,1995,0,0,0,0.125882
47120,Antares,2004-12-03,2004,500000,0,-500000,0.927134
47121,The Priest,1978-05-01,1978,0,302553,302553,0.924511
47122,Flaming Creatures,1963-04-29,1963,300,0,-300,0.674241
47139,"Blood, Guts, Bullets and Octane",1998-10-16,1998,7300,13674,6374,0.137676
47140,Midnight,1998-01-01,1998,0,0,0,0.00413
47143,The Intruder,2005-05-04,2005,0,0,0,0.988415
47144,Cabaret Balkan,1998-08-01,1998,0,0,0,0.569218
47149,Highway Dragnet,1954-01-27,1954,0,0,0,0.17056
47150,The Last Relic,1969-01-01,1969,0,0,0,0.812546
47155,Nazi Agent,1942-03-01,1942,0,0,0,0.094354
47156,It's a Wonderful World,1939-05-19,1939,0,0,0,0.287051
47158,The Good Father,1985-11-01,1985,0,0,0,0.535098
47161,Djomeh,2000-01-01,2000,0,0,0,0.400015
47166,Ferdinand the Bull,1938-11-23,1938,66260,0,-66260,1.113052
47168,The Wind in the Willows,1996-10-16,1996,12,1,-11,1.410322
47171,48 Shades,2006-08-31,2006,0,0,0,0.333211
47177,Devil's Playground,2010-08-21,2010,2400000,0,-2400000,2.436746
47182,Here Comes Peter Cottontail,1971-04-04,1971,0,0,0,1.127039
47184,Repast,1951-11-23,1951,0,0,0,0.732005
47186,Claire Dolan,1998-11-18,1998,0,0,0,1.233785
47189,Capricious Summer,1968-05-24,1968,0,0,0,0.78751
47190,Father Sergius,1918-05-14,1918,0,0,0,0.041727
47194,Blood Night: The Legend of Mary Hatchet,2009-10-10,2009,3000000,0,-3000000,1.233097
47197,The Lion Has Wings,1939-11-03,1939,0,0,0,0.049691
47199,The Secret Agent,1996-11-08,1996,0,0,0,2.943911
47200,Schizo,2004-01-01,2004,0,0,0,0.47589
47201,High Risk,1981-01-01,1981,0,0,0,0.809031
47208,Freedom Song,2000-02-27,2000,0,0,0,0.027255
47211,"Faster, Faster",1981-03-25,1981,0,0,0,0.434845
47212,China Girl,1987-09-25,1987,0,1262091,1262091,0.180898
47215,Journey to the Sun,1999-02-16,1999,0,0,0,0.469435
47218,Happythankyoumoreplease,2010-01-20,2010,0,215576,215576,9.668784
47219,The Foreigner,1978-01-01,1978,0,0,0,0.015022
47226,Waiting for Happiness,2002-05-19,2002,0,7406,7406,0.35233
47231,Little Blond Death,1993-03-11,1993,0,0,0,0.872157
47232,Hotel,2001-01-01,2001,0,0,0,0.763339
47234,No Budget Story,1997-01-01,1997,0,0,0,0.143834
47237,Intimate Affairs,2002-04-18,2002,8000000,0,-8000000,0.912493
47238,The Corridor,1994-12-12,1994,0,0,0,0.478934
47239,Fear of Fear,1975-07-08,1975,0,0,0,0.171746
47240,The Assassin,1961-03-27,1961,0,0,0,0.431102
47241,Mia melissa ton Avgousto,2007-01-01,2007,0,0,0,0.0856
47245,Journey with Papa,1982-01-01,1982,0,0,0,2.002687
47246,Ladies & Gentlemen,1973-12-01,1973,0,0,0,0.373309
47247,Extended Play,2006-10-19,2006,0,0,0,0.660521
47249,America America,1963-12-15,1963,0,0,0,1.099317
47250,The Big House,1930-06-14,1930,0,0,0,0.267404
47251,Indian Summer,1972-10-27,1972,0,0,0,1.592693
47252,The Linguini Incident,1991-01-01,1991,0,0,0,0.073196
47256,The Hoodlum,1951-07-05,1951,0,0,0,0.193396
47257,A Christmas Carol,1997-01-01,1997,0,0,0,1.473486
47259,Cherry Tree Lane,2010-08-28,2010,0,0,0,1.318859
47260,Caught,1996-01-24,1996,0,0,0,1.625873
47261,Carancho,2010-05-06,2010,0,0,0,1.916629
47263,"Easy Come, Easy Go",1967-03-22,1967,0,0,0,1.033187
47273,Campus Radio,2011-01-01,2011,0,0,0,0.008916
47278,Sex & the Other Man,1995-06-13,1995,0,0,0,0.174274
47282,Little Dorrit,1987-12-11,1987,0,0,0,0.424104
47288,The King and I,1999-03-19,1999,25000000,12000000,-13000000,1.466461
47291,Chicken and Duck Talk,1988-07-14,1988,0,0,0,0.072873
47292,Pok√©mon: Giratina and the Sky Warrior,2008-07-19,2008,0,0,0,2.197789
47295,Better Living Through Circuitry,1999-01-01,1999,0,0,0,0.076126
47302,Stardom,2000-10-13,2000,0,0,0,1.641105
47310,Invitation to the Dance,1956-05-22,1956,0,0,0,0.550932
47312,The Good Die Young,1954-03-02,1954,0,0,0,1.171976
47313,Sister Street Fighter,1974-08-31,1974,0,0,0,0.616558
47320,Cherry,2011-10-01,2011,0,0,0,1.62383
47324,Cairo Station,1958-07-31,1958,0,0,0,0.561462
47325,Casanegra,2009-05-09,2009,0,0,0,0.110661
47327,Drive Angry,2011-02-24,2011,50000000,28931401,-21068599,7.668829
47329,Stella,1990-02-02,1990,0,20240128,20240128,6.175627
47330,"Stewart Lee: If You Prefer a Milder Comedian, Please Ask for One",2010-10-11,2010,0,0,0,0.489615
47331,Black Kiss,2004-10-01,2004,0,0,0,0.167467
47333,Jane Eyre,1996-02-09,1996,0,0,0,2.420301
47340,Dead End Drive-In,1986-08-13,1986,0,0,0,1.054406
47342,Radioactive Dreams,1986-09-19,1986,0,0,0,0.317742
47345,She,1984-07-12,1984,0,0,0,0.767505
47350,Return to Lonesome Dove,1993-11-14,1993,0,0,0,0.782922
47352,Mr. Lucky,1943-05-28,1943,0,0,0,0.507874
47354,K-9: P.I.,2002-07-30,2002,0,0,0,7.704213
47359,Racing with the Moon,1984-03-23,1984,9000000,6045657,-2954343,10.941991
47360,Deathstalker and the Warriors from Hell,1988-01-01,1988,0,0,0,1.148894
47363,Deathstalker IV: Match of Titans,1991-07-13,1991,0,0,0,0.320246
47364,Metalstorm: The Destruction of Jared-Syn,1983-08-19,1983,0,0,0,1.996342
47365,Stormheart,2008-08-01,2008,0,0,0,0.430867
47367,According to Pereira,1996-01-01,1996,0,0,0,2.287102
47369,Avenger,2006-04-09,2006,0,0,0,0.949628
47370,Japan's Longest Day,1967-08-12,1967,0,0,0,0.271087
47383,The Man Next Door,2009-11-10,2009,0,0,0,0.727819
47386,YellowBrickRoad,2010-01-23,2010,500000,0,-500000,2.554659
47397,Anita,1972-12-30,1972,0,0,0,5.899929
47401,Sky Murder,1940-09-27,1940,0,0,0,0.331435
47404,"Nick Carter, Master Detective",1939-12-15,1939,0,0,0,0.081235
47405,Shameless,2010-10-08,2010,0,0,0,0.184769
47406,Arabian Nights,1974-06-20,1974,0,0,0,2.586007
47407,Milf,2010-10-17,2010,500000,0,-500000,2.576011
47408,Rampo Noir,2005-05-11,2005,0,0,0,1.125509
47410,Trapped,1982-05-28,1982,2000000,0,-2000000,1.067135
47412,Trapped in Space,1994-02-01,1994,0,0,0,0.836658
47413,After the Apocalypse,2004-03-12,2004,0,0,0,0.002624
47423,Once a Thief,1991-02-02,1991,0,4303351,4303351,7.625338
47426,South of the Border,2009-09-07,2009,0,0,0,0.733388
47430,Korczak,1990-01-01,1990,0,0,0,0.654686
47432,The Suspended Step of the Stork,1991-01-01,1991,0,0,0,0.586789
47434,A Couch in New York,1996-01-01,1996,0,0,0,0.479296
47435,St. George Shoots the Dragon,2009-03-11,2009,5000000,0,-5000000,0.182169
47437,Tom Thumb,2001-10-16,2001,0,0,0,1.386224
47439,Time Regained,1999-05-19,1999,0,0,0,1.548837
47444,Time of the Apes,1987-01-01,1987,0,0,0,0.000809
47446,The Trojan Women,1971-09-26,1971,0,0,0,0.444508
47447,Electra,1962-01-01,1962,0,0,0,0.844574
47448,Remonstrance,1972-11-09,1972,0,0,0,0.03541
47449,Denise Calls Up,1995-05-17,1995,0,0,0,0.466476
47452,Love and Death on Long Island,1997-01-01,1997,0,0,0,0.785094
47453,Sodoma's Ghost,1988-01-01,1988,0,0,0,0.024675
47454,"Presentation, or Charlotte and Her Steak",1960-01-01,1960,0,0,0,0.122594
47455,A Modern Coed,1966-01-01,1966,0,0,0,0.001177
47459,Dorian Gray,1970-04-24,1970,0,0,0,0.30233
47462,Everyone,2004-09-30,2004,0,0,0,1.311293
47466,The Fly,1980-09-05,1980,0,0,0,0.300037
47467,Kill Speed,2010-07-02,2010,0,0,0,1.033163
47473,Summer Interlude,1951-10-01,1951,0,0,0,1.442357
47474,The Serpent's Egg,1977-10-28,1977,0,0,0,2.055321
47475,Mr. Wrong,1996-02-16,1996,0,0,0,3.329264
47477,The Beast,1996-04-28,1996,0,0,0,2.026374
47479,The Last Play at Shea,2010-04-25,2010,0,0,0,0.216136
47481,Marie from the Bay of Angels,1998-06-19,1998,0,0,0,0.171616
47488,HellBent,2004-01-01,2004,0,0,0,1.300187
47489,The Moon in the Gutter,1983-05-12,1983,0,0,0,1.0988
47491,The Beales of Grey Gardens,2006-07-21,2006,400000,0,-400000,0.640882
47493,To Kill a Priest,1988-01-01,1988,0,0,0,0.239498
47496,The Grand Dukes,1996-02-21,1996,0,0,0,1.222556
47497,Expecting Love,2008-02-29,2008,3,0,-3,0.793633
47499,Small Cuts,2003-02-12,2003,0,0,0,0.224955
47500,Pipe Dream,2002-02-20,2002,0,0,0,0.302487
47501,Six Ways to Sunday,1997-09-01,1997,0,0,0,5.204937
47502,Faithful,1996-04-03,1996,13000000,9789900,-3210100,1.296862
47504,Little Odessa,1994-10-27,1994,0,0,0,1.861292
47507,Caf√© au Lait,1993-01-01,1993,0,0,0,1.040873
47508,The Wizard of Oz,1925-01-01,1925,0,0,0,0.41048
47510,The Guatemalan Handshake,2006-01-23,2006,0,0,0,0.21442
47517,Quicksand,2003-01-08,2003,0,0,0,8.878927
47518,The Tortured,2010-06-15,2010,8500000,0,-8500000,3.436769
47525,The Magic of Ordinary Days,2005-01-30,2005,0,0,0,0.32662
47533,Scooby-Doo! Curse of the Lake Monster,2010-10-15,2010,0,0,0,9.844083
47535,U Be Dead,2009-09-25,2009,0,0,0,0.009464
47536,Hitler: The Last Ten Days,1973-04-19,1973,0,0,0,0.954185
47540,Keep Your Distance,2005-09-02,2005,2500000,0,-2500000,5.558013
47542,Peter-No-Tail,1981-12-25,1981,48740,955401,906661,0.545722
47553,Twice-Told Tales,1963-09-01,1963,0,0,0,1.18542
47554,Ethan Mao,2004-11-14,2004,0,0,0,0.412259
47555,Flying Leathernecks,1951-08-28,1951,0,0,0,0.807745
47559,The First Grader,2010-09-04,2010,0,0,0,2.536406
47561,Firepower,1979-04-27,1979,0,0,0,0.51834
47562,Chasing Freedom,2004-01-19,2004,0,0,0,0.060736
47570,Maid in Sweden,1971-11-03,1971,0,0,0,1.705971
47571,Behind That Curtain,1929-06-28,1929,0,0,0,0.190654
47574,The Monkey's Mask,2000-09-27,2000,0,0,0,0.417273
47576,Memories of Underdevelopment,1968-05-17,1968,0,0,0,1.459828
47578,Legend of the Eight Samurai,1983-12-10,1983,0,0,0,0.875774
47582,Castle of Purity,1973-05-10,1973,0,0,0,1.202765
47585,The Five Senses,1999-05-18,1999,0,0,0,0.625332
47587,Suite 16,1994-11-24,1994,0,0,0,0.447431
47588,Signs & Wonders,2001-02-09,2001,0,0,0,0.064355
47590,The Girl with the Hat Box,1927-01-01,1927,0,0,0,0.222519
47595,Faithless,2000-09-15,2000,0,0,0,0.887037
47596,Snow days,1999-01-01,1999,0,0,0,0.046139
47605,War of the Planets,1977-09-23,1977,0,0,0,0.406617
47607,Tiny Furniture,2010-11-12,2010,65000,416498,351498,2.799356
47608,Mad Love,1995-05-26,1995,0,15453274,15453274,2.624771
47610,Gravity,2010-03-24,2010,0,0,0,0.594783
47612,Au bonheur des dames,1930-07-03,1930,0,0,0,0.368185
47614,Sexual Dependency,2003-08-31,2003,0,0,0,0.381774
47615,Orgy of the Dead,1965-01-01,1965,0,0,0,0.99861
47616,The Yellow Rolls-Royce,1964-12-31,1964,0,0,0,1.564403
47620,Poison,1991-04-05,1991,250000,609524,359524,1.924535
47626,Legend of the BoneKnapper Dragon,2010-10-15,2010,0,0,0,6.816869
47628,Trancers 3: Deth Lives,1992-10-14,1992,0,0,0,2.651906
47631,Bride of Boogedy,1987-04-12,1987,0,0,0,0.21102
47638,The River Rat,1984-09-28,1984,0,1142944,1142944,0.57743
47643,Lilies,1996-09-07,1996,0,0,0,4.433239
47646,The Grasshopper,1970-05-27,1970,0,0,0,0.351061
47647,Fight Back to School,1991-12-31,1991,0,0,0,1.671627
47648,King of Beggars,1992-12-17,1992,0,0,0,2.978087
47650,Easy Street,1917-01-22,1917,0,0,0,1.795202
47653,The Immigrant,1917-06-17,1917,0,0,0,3.933922
47655,Hisss,2010-10-22,2010,10000000,0,-10000000,0.403939
47657,The Last Minute,2001-01-01,2001,0,0,0,0.689795
47658,John Waters: This Filthy World,2006-11-24,2006,0,0,0,0.640139
47670,The Christmas Toy,1986-12-06,1986,0,0,0,0.923952
47675,The Kidnappers,1953-12-01,1953,0,0,0,0.502356
47676,"Bodies, Rest & Motion",1993-01-10,1993,2500000,764083,-1735917,2.296734
47680,The Wall,1983-01-01,1983,0,0,0,0.001586
47682,Dead on Time,1983-01-01,1983,0,0,0,1.1e-05
47683,Love at 16,2004-11-25,2004,0,0,0,0.041196
47684,Man of Aran,1934-04-24,1934,0,0,0,0.587342
47686,Dream with the Fishes,1997-01-01,1997,0,0,0,0.684192
47692,Felicia's Journey,1999-11-24,1999,0,0,0,1.850056
47694,Temptress Moon,1996-05-09,1996,0,0,0,1.136222
47695,Juno and the Paycock,1930-06-29,1930,0,0,0,1.783776
47697,Othello,1951-11-27,1951,0,0,0,2.698585
47699,Mourning Rock,2000-01-01,2000,0,0,0,0.071812
47703,Glumov's Diary,1923-01-01,1923,0,0,0,0.300576
47713,The Counterfeit Coin,1955-01-01,1955,0,0,0,0.142747
47714,The Stolen Children,1992-01-01,1992,0,0,0,1.231096
47715,Intervista,1987-01-01,1987,0,0,0,1.022275
47717,The Ogre of Athens,1956-03-05,1956,0,0,0,0.557528
47718,I Don't Kiss,1991-11-20,1991,0,0,0,1.177
47721,Sawdust and Tinsel,1953-09-14,1953,0,0,0,2.119501
47723,In the Presence of a Clown,1997-11-01,1997,0,0,0,0.460518
47724,Up at the Villa,2000-04-14,2000,0,0,0,0.555311
47735,Summer with Monika,1953-02-09,1953,0,0,0,3.180818
47736,Rembetiko,1983-01-01,1983,0,0,0,0.569754
47737,Gold,1974-06-08,1974,0,0,0,1.99751
47739,Illegal,1955-10-28,1955,0,0,0,1.930301
47745,Southside 1-1000,1950-11-16,1950,0,0,0,0.229936
47747,The Garden of Sinners: Epilogue,2011-02-02,2011,0,0,0,0.897662
47748,Old Partner,2008-10-04,2008,0,0,0,0.539451
47753,William S. Burroughs: A Man Within,2010-11-05,2010,160000,0,-160000,0.687732
47755,Strange Powers: Stephin Merritt and the Magnetic Fields,2011-10-27,2011,0,0,0,0.158886
47758,The Good Fairy,1935-02-18,1935,0,0,0,0.842381
47759,The Monkey King,1964-12-07,1964,0,0,0,0.702008
47760,Restless,2011-09-16,2011,8000000,163265,-7836735,6.140556
47761,The Witches of Oz,2011-01-01,2011,0,0,0,5.501794
47762,Scenes from a Mall,1991-02-22,1991,3000000,9563393,6563393,1.739182
47763,The Shrine,2010-10-14,2010,0,0,0,16.544322
47771,Superpower,2008-08-28,2008,0,0,0,0.081203
47774,DJ Q.bert's Wave Twisters,2001-01-23,2001,0,0,0,0.199296
47778,Stella,1955-04-04,1955,0,0,0,0.266835
47790,The Red Lanterns,1963-12-02,1963,0,0,0,0.309019
47792,Voyage to Cythera,1984-04-21,1984,0,0,0,0.906002
47794,Blood Relatives,1978-02-01,1978,0,0,0,2.176251
47795,Landscape in the Mist,1988-01-01,1988,0,0,0,2.127594
47796,Mamma Roma,1962-08-31,1962,0,0,0,2.481885
47798,The New Tenants,2009-01-01,2009,0,0,0,0.330757
47802,Simple Men,1992-10-14,1992,0,0,0,1.595591
47808,Sahara,1983-12-01,1983,0,0,0,1.634923
47812,Love and the City 2,2010-02-25,2010,0,10198357,10198357,0.318437
47813,Waking Sleeping Beauty,2009-09-05,2009,0,80,80,0.908184
47816,3 Strikes,2000-03-01,2000,6000000,9000000,3000000,0.651625
47817,1969,1988-08-18,1988,0,5979011,5979011,2.238458
47818,A Night in the Life of Jimmy Reardon,1988-07-21,1988,0,6264058,6264058,1.355189
47819,Americathon,1979-08-10,1979,0,0,0,0.942425
47821,City of Joy,1992-04-15,1992,27000000,14683921,-12316079,1.408176
47825,Flashpoint,1984-04-19,1984,0,0,0,0.564342
47831,√Ä propos de Nice,1930-05-28,1930,0,0,0,0.957608
47837,The Fugitive Kind,1960-04-14,1960,0,0,0,3.310593
47841,In Between Days,2007-06-27,2007,0,0,0,0.827035
47845,12 Paces without a Head,2009-12-10,2009,8500000,0,-8500000,0.723258
47848,Scent of a Woman,1974-12-25,1974,0,0,0,1.96765
47850,Orchestra Rehearsal,1978-10-01,1978,0,0,0,1.277491
47851,Five Evenings,1978-12-04,1978,0,0,0,1.674575
47854,Legend of the Fist: The Return of Chen Zhen,2010-09-01,2010,0,48398,48398,6.183418
47855,Bear's Kiss,2002-01-01,2002,0,0,0,1.040661
47860,"Things I Like, Things I Don't Like",1989-01-01,1989,0,0,0,1.606076
47863,Punching the Clown,2010-10-22,2010,0,0,0,0.988841
47866,Gas Food Lodging,1992-07-10,1992,0,1345236,1345236,1.072438
47867,Gordy,1995-05-12,1995,0,3992809,3992809,0.398924
47868,The First Men in the Moon,2010-10-19,2010,0,0,0,1.435661
47869,Hidden Agenda,1990-11-21,1990,0,1030938,1030938,1.75515
47870,High Hopes,1988-09-01,1988,0,1192322,1192322,1.369216
47871,Honky Tonk Freeway,1981-08-21,1981,24000000,939423,-23060577,0.420615
47874,Irreconcilable Differences,1984-09-28,1984,0,12384120,12384120,1.704114
47876,Little Miss Marker,1980-03-21,1980,0,6321392,6321392,1.014961
47878,Lookin' to Get Out,1982-10-08,1982,17000000,946461,-16053539,0.963345
47880,Mrs Palfrey at The Claremont,2005-11-25,2005,750000,1720953,970953,2.6982
47881,My Giant,1998-04-10,1998,0,7985929,7985929,6.422711
47882,Nancy Drew and the Hidden Staircase,1939-09-09,1939,0,0,0,0.153571
47883,Nancy Drew: Detective,1938-11-19,1938,0,0,0,0.150389
47884,Nancy Drew... Trouble Shooter,1939-06-17,1939,0,0,0,0.270507
47886,Pieces,1982-08-23,1982,0,1198346,1198346,3.896297
47888,Rollover,1981-10-11,1981,0,10217873,10217873,5.692818
47889,Ruby in Paradise,1993-10-08,1993,800000,1001437,201437,0.941994
47890,Sphinx,1981-02-11,1981,14000000,439564,-13560436,0.627368
47891,Cyrus: Mind of a Serial Killer,2010-10-01,2010,0,0,0,0.771924
47892,Strange Invaders,1983-09-16,1983,0,1362303,1362303,2.430068
47893,Giving It Up,1999-03-16,1999,0,0,0,0.438214
47898,The Gun in Betty Lou's Handbag,1992-08-21,1992,13000000,3721911,-9278089,1.386549
47900,"Birds, Orphans and Fools",1969-09-26,1969,0,0,0,0.7095
47901,The One and Only,1978-02-03,1978,0,16928137,16928137,0.43491
47902,Meskada,2010-10-03,2010,0,0,0,0.78079
47904,Outside the Law,2010-09-21,2010,30000000,0,-30000000,1.170864
47906,The Seduction of Joe Tynan,1979-08-17,1979,0,0,0,0.180571
47907,The Spitfire Grill,1996-08-23,1996,6000000,12643776,6643776,1.19589
47908,The Trip to Bountiful,1985-12-20,1985,0,7218340,7218340,1.210627
47909,Poetry,2010-05-13,2010,0,349899,349899,2.706614
47911,"Bo Burnham: Words, Words, Words",2010-10-19,2010,0,0,0,0.856871
47912,Smash His Camera,2010-07-30,2010,0,0,0,0.261439
47913,King of Texas,2002-06-02,2002,0,0,0,0.410787
47914,The White Buffalo,1977-05-01,1977,0,0,0,2.930324
47920,Magnificent Obsession,1935-12-30,1935,0,0,0,0.049158
47921,Imitation of Life,1934-11-26,1934,0,0,0,1.473452
47924,Home Movie,2001-01-01,2001,0,0,0,0.040593
47925,The Story on Page One,1959-12-01,1959,0,0,0,0.003682
47931,Elite Squad: The Enemy Within,2010-10-08,2010,0,63027681,63027681,12.334357
47933,Independence Day: Resurgence,2016-06-22,2016,165000000,389681935,224681935,16.993841
47934,Independence Day 3,,,0,0,0,0.642294
47939,Three Wishes,1995-10-27,1995,0,7025496,7025496,11.002046
47940,Padayappa,1999-04-01,1999,0,0,0,1.135828
47941,Under the Rainbow,1981-07-31,1981,20000000,2297493,-17702507,0.69162
47942,When Time Ran Out...,1980-03-28,1980,20000000,3763988,-16236012,2.284384
47943,"Harry, He's Here To Help",2000-08-15,2000,0,3818452,3818452,2.042116
47944,Without a Trace,1983-02-04,1983,0,0,0,0.38443
47945,Daybreak,1993-05-08,1993,0,0,0,2.252772
47946,Body Rock,1984-09-28,1984,0,0,0,0.108463
47947,Young Doctors in Love,1982-07-16,1982,0,30688860,30688860,1.768854
47951,The Adventures of Milo and Otis,1986-06-27,1986,0,0,0,2.500605
47952,Two Men Went To War,2002-01-01,2002,0,0,0,0.196537
47953,Harem suare,1999-11-24,1999,0,0,0,1.582675
47955,White Dog,1982-07-07,1982,8000000,0,-8000000,2.849356
47956,The Norseman,1978-10-05,1978,0,0,0,0.48975
47957,Madman,1982-01-01,1982,0,0,0,1.812505
47959,Callas Forever,2002-09-18,2002,0,0,0,1.115895
47962,Dirkie - Lost in the Desert,1969-11-06,1969,0,0,0,0.422408
47963,Fanny Hill,2007-10-22,2007,0,0,0,0.972227
47964,A Good Day to Die Hard,2013-02-06,2013,92000000,304654182,212654182,12.471865
47971,xXx: Return of Xander Cage,2017-01-13,2017,85000000,346147658,261147658,17.918269
47975,The Spaghetti West,2005-01-01,2005,0,0,0,0.073602
47979,Vincent Wants to Sea,2010-04-21,2010,0,0,0,2.921322
47980,Jesus Christ Superstar,2000-10-16,2000,0,0,0,0.224789
47985,Assa,1987-11-01,1987,0,0,0,1.027002
47993,The Golden Age of Comedy,1957-12-26,1957,0,0,0,0.036643
48000,M√©nilmontant,1926-01-02,1926,0,0,0,1.595356
48003,Gigot,1962-11-01,1962,0,0,0,0.285559
48008,Diverted,2009-03-08,2009,0,0,0,0.594784
48009,Loup,2009-12-09,2009,0,0,0,1.330703
48011,Such Hawks Such Hounds,2008-01-01,2008,75000,0,-75000,0.155224
48014,From Beyond the Grave,1974-02-23,1974,0,0,0,4.347358
48015,13Hrs,2010-08-28,2010,0,0,0,6.156071
48016,The Maze,2010-10-19,2010,200,0,-200,1.280497
48034,Little White Lies,2010-10-20,2010,25000000,48531470,23531470,7.594334
48035,Ordet,1955-01-09,1955,0,0,0,3.132172
48038,Evolver,1994-12-31,1994,0,0,0,1.64424
48109,Our Song,2000-01-21,2000,0,0,0,0.546957
48110,Phaedra,1962-01-01,1962,0,0,0,0.594261
48116,Love Sick,2006-03-16,2006,0,0,0,1.142721
48118,The Cold Light of Day,1996-08-20,1996,0,0,0,0.956887
48119,Retrieval,2006-11-17,2006,0,0,0,0.227356
48121,Mondovino,2004-01-01,2004,0,0,0,0.558816
48122,Loafing and Camouflage: Sirens in the Aegean,2005-12-08,2005,0,0,0,0.624186
48125,The Valiants of Samothrace,2003-10-24,2003,0,0,0,0.405838
48127,The North Star,1943-11-04,1943,0,0,0,0.142965
48128,Straight Story,2006-12-21,2006,0,0,0,0.258855
48129,Run,1991-02-01,1991,16000000,4409328,-11590672,5.857368
48130,Edges of the Lord,2001-01-01,2001,7500000,0,-7500000,1.070223
48131,The Shout,1978-01-01,1978,0,0,0,4.906256
48132,Kevin Smith: Too Fat For 40,2010-10-22,2010,0,0,0,0.928368
48133,Aventure Malgache,1944-01-01,1944,0,0,0,0.593997
48135,Jules Verne's Rocket to the Moon,1967-07-13,1967,0,0,0,0.816253
48136,Two on a Guillotine,1965-01-13,1965,0,0,0,0.926923
48138,Unknown,2011-02-16,2011,30000000,130786397,100786397,14.443599
48139,El Sur,1983-05-18,1983,0,0,0,1.152642
48144,The Day the Sun Turned Cold,1994-01-01,1994,0,0,0,0.076062
48145,The Devil's Eye,1960-10-17,1960,0,0,0,1.41737
48149,"Good Morning, Babylon",1987-05-13,1987,0,183700,183700,1.077673
48150,A Heart in Winter,1992-09-02,1992,0,1666511,1666511,2.319313
48153,The Outside Man,1972-12-21,1972,0,0,0,0.237773
48155,The Big Knife,1955-10-25,1955,0,0,0,0.719732
48156,House of Numbers,1957-09-12,1957,0,0,0,0.49789
48161,Hold Up,2010-10-01,2010,0,0,0,1.062198
48169,The Mercenary,1968-08-28,1968,0,0,0,1.06013
48171,The Rite,2011-01-28,2011,37000000,96047633,59047633,7.128117
48180,Amazons,1986-10-26,1986,0,0,0,0.007963
48186,The Boy Who Cried Werewolf,2010-10-22,2010,0,0,0,5.686871
48193,Ator the Iron Warrior,1987-01-09,1987,0,0,0,1.691841
48197,The Town That Dreaded Sundown,1976-09-26,1976,0,0,0,4.876494
48199,Woyzeck,1994-02-07,1994,0,0,0,0.226192
48202,Creature from the Haunted Sea,1961-06-01,1961,0,0,0,0.297889
48203,The Desert of the Tartars,1976-01-01,1976,0,0,0,1.103233
48204,Nights and Weekends,2008-01-01,2008,0,0,0,1.803615
48205,The Marquise of O,1976-05-19,1976,0,0,0,1.559108
48207,Melody,1971-03-28,1971,0,0,0,1.152521
48209,"Hamlet, Prince of Denmark",1961-01-01,1961,0,0,0,0.052466
48210,The Beekeeper,1986-01-01,1986,0,0,0,1.033872
48211,Sacco & Vanzetti,1971-03-16,1971,0,0,0,1.560752
48213,The Ogre,1996-01-01,1996,0,0,0,1.545354
48214,The Merry Jail,1917-11-30,1917,0,0,0,0.215726
48215,The Dagger of Kamui,1985-01-01,1985,0,0,0,1.267756
48216,Season's Beatings,1999-11-24,1999,0,0,0,1.414306
48217,The Widow of Saint-Pierre,2000-01-01,2000,0,0,0,1.4414
48227,La Soufri√®re,1977-01-01,1977,30000,0,-30000,0.353671
48231,A Dangerous Method,2011-09-30,2011,15000000,27462041,12462041,9.865944
48232,Twin Sitters,1994-10-01,1994,0,0,0,2.094195
48233,The Terrorist,1998-09-12,1998,24554,140021,115467,0.154526
48242,Hundra,1983-01-01,1983,0,0,0,0.030576
48243,Essential Killing,2010-09-06,2010,3167000,0,-3167000,2.972178
48249,Tempest,1982-08-13,1982,0,0,0,4.65767
48250,Fascisti su Marte,2006-10-27,2006,0,0,0,0.79326
48254,Ovosodo,1997-09-12,1997,0,0,0,3.216563
48259,Crimes of the Heart,1986-12-12,1986,0,22905522,22905522,2.524937
48260,Butterfly Kiss,1995-08-18,1995,0,0,0,0.877853
48263,I Don't Want to Be a Man,1918-10-01,1918,0,0,0,0.999418
48266,Ma M√®re,2004-05-19,2004,0,0,0,2.934065
48267,The American Soldier,1970-10-09,1970,0,0,0,0.923108
48268,Hungarian Rhapsody,1979-01-01,1979,0,0,0,0.149236
48273,Bob's Birthday,1994-01-01,1994,0,0,0,0.178989
48281,Before You Say 'I Do',2009-02-14,2009,0,0,0,0.820594
48287,The Baby-Sitters Club,1995-08-18,1995,0,0,0,2.15805
48288,Small Town Gay Bar,2007-03-31,2007,0,0,0,0.87638
48289,The Debt,2010-04-11,2010,20000000,45636368,25636368,8.426611
48297,Invincible Shaolin,1978-11-19,1978,0,0,0,1.898671
48300,Return of the One-Armed Swordsman,1969-02-28,1969,0,0,0,0.730459
48301,Return to the 36th Chamber,1980-08-24,1980,0,0,0,2.609107
48303,Certified Copy,2010-05-18,2010,0,0,0,10.701501
48309,Prison,1988-03-04,1988,1300000,354704,-945296,11.582419
48311,Parasite,1982-03-12,1982,800000,7000000,6200000,0.577976
48313,Tag: The Assassination Game,1982-04-20,1982,0,0,0,0.740913
48315,Time Runner,1993-03-17,1993,0,0,0,0.706342
48318,Family Nest,1979-01-25,1979,0,0,0,0.116928
48319,Joyride,1997-01-01,1997,0,0,0,1.05181
48329,Ryan,2004-01-01,2004,0,0,0,0.950414
48333,Hammerhead,2005-06-18,2005,0,0,0,0.632582
48336,Lumi√®re and Company,1995-01-01,1995,0,0,0,2.30961
48339,Niceland (Population. 1.000.002),2004-01-01,2004,0,0,0,0.621442
48340,Sanctum,2011-02-03,2011,30000000,108609310,78609310,7.000775
48341,License to Live,1999-01-23,1999,0,0,0,1.049946
48345,Nobody's Baby,2001-01-01,2001,0,0,0,0.8724
48346,Special Delivery,1978-01-01,1978,0,0,0,0.114527
48347,The Old Lady and the Pigeons,1997-06-02,1997,0,0,0,1.314881
48350,Psychomania,1973-01-05,1973,0,0,0,1.421706
48358,The Canterville Ghost,1996-10-03,1996,0,0,0,1.533726
48364,The Man in the Glass Booth,1975-01-27,1975,0,0,0,0.528522
48365,Boudu Saved from Drowning,1932-11-11,1932,0,0,0,1.378177
48369,H√¥tel du Nord,1938-12-19,1938,0,0,0,1.195247
48373,Listen to Your Heart,2010-08-14,2010,0,0,0,2.984894
48374,Piranha,1995-10-01,1995,0,0,0,1.044199
48375,Brother's Justice,2010-10-22,2010,0,0,0,0.201927
48376,Severe Clear,2010-03-12,2010,0,0,0,0.150115
48382,"The Book of Mormon Movie, Volume 1: The Journey",2003-09-12,2003,2000000,1672730,-327270,0.079856
48385,Indestructible Man,1956-03-24,1956,0,0,0,3.692449
48392,Sound of Noise,2010-12-25,2010,4466000,0,-4466000,1.600787
48393,Kidnapped,2010-06-17,2010,0,0,0,2.936334
48395,Rare Exports: A Christmas Tale,2010-12-03,2010,1948000,0,-1948000,4.51319
48397,Beyond Loch Ness,2008-01-05,2008,0,0,0,1.602897
48405,Zone of the Enders: Idolo,2001-03-01,2001,0,0,0,0.081801
48406,A Hazard of Hearts,1987-12-27,1987,0,0,0,0.386408
48407,The Last Page,1952-01-25,1952,0,0,0,0.441423
48408,Dirty Dingus Magee,1970-11-18,1970,0,0,0,1.066117
48409,The Hangman,1959-06-17,1959,0,0,0,0.843987
48411,Love Exposure,2007-10-18,2007,0,0,0,0.03935
48412,Battle of the Coral Sea,1959-11-01,1959,0,0,0,0.134917
48414,Alamar,2009-12-16,2009,0,0,0,1.027124
48415,Welcome to the South,2010-10-01,2010,4000000,65584679,61584679,6.700081
48417,The Stool Pigeon,2010-08-26,2010,4000000,0,-4000000,1.123992
48419,God Speed You! Black Emperor,1976-07-01,1976,0,0,0,0.041066
48426,The Pleasure Is All Mine,2004-08-18,2004,0,0,0,0.003945
48431,Trouble,2005-03-09,2005,0,0,0,0.09851
48443,The Hearts of Age,1934-01-01,1934,0,0,0,0.179142
48448,Across the Tracks,1991-02-14,1991,0,0,0,1.437157
48449,The Pocket-knife,1992-10-15,1992,0,0,0,0.486142
48451,Strange Bedfellows,1965-02-09,1965,0,0,0,1.067539
48453,The Contestant,2007-03-15,2007,0,0,0,0.768621
48457,Platoon Leader,1988-10-01,1988,0,0,0,0.854669
48458,The Secret Glory,2001-09-04,2001,0,0,0,0.213018
48463,Incident at Loch Ness,2004-12-17,2004,1,0,-1,1.725759
48464,All the Little Animals,1999-07-09,1999,0,0,0,1.745282
48466,Scared Shrekless,2010-10-28,2010,0,0,0,4.739649
48471,Walt & El Grupo,2008-09-08,2008,0,0,0,0.21679
48481,Five,1951-04-25,1951,0,0,0,0.261219
48482,Thief of Hearts,1984-10-19,1984,9000000,10364904,1364904,0.941383
48486,The Monk and the Fish,1994-01-01,1994,0,0,0,0.459924
48488,Strange Invaders,2002-01-01,2002,0,0,0,0.152888
48489,The Sin,2004-05-14,2004,0,0,0,0.416474
48490,The New Barbarians,1983-06-10,1983,0,0,0,1.740832
48492,Detective Dee and the Mystery of the Phantom Flame,2010-09-18,2010,13000000,51723285,38723285,7.17548
48495,Double Wedding,2010-07-20,2010,104002432,0,-104002432,1.674862
48496,Tango,1981-05-01,1981,0,0,0,1e-06
48502,El Estudiante,2010-10-10,2010,0,170000,170000,0.318437
48504,The Big Snit,1985-01-01,1985,0,0,0,0.001393
48508,A Brand New Life,2009-10-29,2009,0,0,0,1.332736
48515,Japanese Summer: Double Suicide,1967-09-02,1967,0,0,0,0.484749
48522,The Periwig-Maker,2000-01-01,2000,0,0,0,0.620529
48524,Too Beautiful for You,1989-10-21,1989,0,0,0,2.036657
48561,La traviata,1982-10-07,1982,0,0,0,0.329373
48564,Villa Rides,1968-05-29,1968,0,0,0,1.188777
48567,Scary Godmother: Halloween Spooktakular,2003-10-22,2003,0,0,0,0.769432
48572,Red State,2011-08-19,2011,4000000,1104682,-2895318,6.340655
48573,Lope,2010-09-03,2010,0,0,0,0.912608
48580,A Self-Made Hero,1996-01-01,1996,0,0,0,0.585679
48584,Spermula,1976-07-07,1976,0,0,0,3.494968
48585,Ward 13,2003-01-01,2003,0,0,0,0.17899
48587,Living Death,2006-12-12,2006,0,0,0,0.479963
48591,The Oyster Princess,1919-06-16,1919,0,0,0,0.352892
48594,The Uninvited Guest,2004-10-21,2004,0,0,0,2.753646
48596,Ana and the Others,2003-04-21,2003,0,0,0,0.214229
48598,Free Radicals,2003-01-01,2003,0,0,0,0.287048
48599,Audition/Talent Competition,1964-02-28,1964,0,0,0,0.743089
48601,Clement,2001-06-06,2001,0,0,0,2.359027
48609,A Fine Mess,1986-08-08,1986,0,6029824,6029824,0.765825
48612,The Arrangement,1969-01-01,1969,0,0,0,1.353072
48613,The Devil's Veil,1989-01-02,1989,0,0,0,0.219358
48615,Devotion,2003-02-08,2003,0,0,0,0.518612
48617,Father and Daughter,2000-01-01,2000,0,0,0,1.000408
48620,The Mighty Macs,2009-10-21,2009,7000000,0,-7000000,2.045158
48623,One Hundred Days After Childhood,1975-12-01,1975,0,0,0,0.74439
48627,Room for One More,1952-01-10,1952,0,0,0,0.74029
48635,Isi/Disi - Amor a lo bestia,2004-07-23,2004,0,0,0,1.437794
48636,Nekromantik 2,1991-05-07,1991,0,0,0,2.099329
48643,Piccadilly Jim,2005-04-22,2005,0,0,0,0.802403
48645,Pagan Love Song,1950-12-26,1950,0,0,0,0.521697
48646,Androcles and the Lion,1952-12-01,1952,0,0,0,0.186005
48650,Room in Rome,2010-05-07,2010,0,0,0,6.206694
48654,Puckoon,2002-01-01,2002,0,0,0,0.026354
48660,The Kindred,1987-01-09,1987,0,0,0,0.710875
48661,The Dog of Flanders,1997-03-15,1997,0,0,0,0.172011
48669,Terror Trap,2010-09-22,2010,0,0,0,1.466318
48675,Small Town Folk,2007-01-01,2007,0,0,0,0.55401
48676,The First Teacher,1965-10-31,1965,0,0,0,0.610588
48677,Cloak & Dagger,1984-08-10,1984,0,0,0,9.735023
48678,Falling Angels,2003-09-08,2003,0,0,0,0.686426
48686,Assassination,1987-01-09,1987,0,0,0,3.143618
48688,Pigsty,1969-09-28,1969,0,0,0,1.578564
48689,Curtain Call,1998-12-05,1998,0,0,0,0.791622
48691,Goodbye Uncle Tom,1971-09-30,1971,0,0,0,1.305563
48693,The Mother and the Whore,1973-05-01,1973,0,0,0,2.301664
48706,Josh and S.A.M.,1993-11-24,1993,18000000,1528163,-16471837,0.768367
48707,Ninja 2,1963-08-06,1963,0,0,0,0.294923
48709,My Man,1996-01-31,1996,0,0,0,1.25783
48714,The Big Shave,1968-01-01,1968,0,0,0,2.116885
48717,What's a Nice Girl Like You Doing in a Place Like This?,1963-01-01,1963,0,0,0,0.612494
48719,Illegally Yours,1988-01-01,1988,0,0,0,0.674285
48730,Bj√∂rk at the Royal Opera House,2002-06-04,2002,0,0,0,0.416801
48732,America's Heart and Soul,2004-07-04,2004,0,0,0,0.108422
48734,Liberty,1929-01-26,1929,0,0,0,0.260752
48737,The Maidens' Conspiracy,2006-03-30,2006,19600000,0,-19600000,2.282189
48742,Mein Kampf,2009-08-01,2009,0,0,0,0.843295
48745,Mindwalk,1990-09-09,1990,0,0,0,0.1223
48746,The Christmas Party,2009-11-13,2009,3000000,0,-3000000,0.818698
48747,Jekyll & Hyde,1990-01-06,1990,0,0,0,0.834238
48748,Klown,2010-12-16,2010,0,0,0,2.521782
48750,Les Miserables,1995-03-22,1995,0,0,0,1.479446
48751,Deep Gold,2011-04-22,2011,0,0,0,0.634779
48752,2012: Time for Change,2010-10-08,2010,0,0,0,0.130351
48753,Cannibal,2006-12-05,2006,0,0,0,0.871517
48761,Catch That Girl,2002-01-25,2002,2600000,0,-2600000,1.317583
48763,Eyyvah Eyvah,2010-02-26,2010,0,0,0,1.806372
48764,The Trial of Joan of Arc,1962-05-30,1962,0,0,0,1.633231
48770,Tom & Thomas,2002-01-23,2002,0,0,0,0.497549
48773,Game of Death II,1981-03-21,1981,0,0,0,3.790978
48775,The Killers,1956-01-01,1956,0,0,0,1.322345
48778,That Day,2003-06-04,2003,0,0,0,0.822422
48780,Boat,2007-01-30,2007,0,0,0,0.479388
48781,Never Talk to Strangers,1995-10-20,1995,6400000,6,-6399994,7.506958
48784,Six Men Getting Sick,1967-01-01,1967,200,0,-200,3.517714
48787,Mute Witness,1995-09-28,1995,2,1,-1,2.466066
48791,Royal Deceit,1994-02-23,1994,0,0,0,3.709507
48797,Man Facing Southeast,1986-09-09,1986,0,0,0,1.011919
48798,Love and Distrust,2010-08-16,2010,0,0,0,1.213417
48805,L'allenatore nel pallone 2,2008-01-11,2008,0,10743767,10743767,1.773828
48831,My Night at Maud's,1969-06-04,1969,0,0,0,3.914283
48833,Night Catches Us,2010-12-03,2010,0,0,0,1.437125
48834,Liam,2000-09-04,2000,0,0,0,1.54417
48836,Kill Katie Malone,2010-10-10,2010,0,0,0,2.369012
48837,Midnight Son,2011-03-04,2011,0,0,0,1.575009
48838,London Boulevard,2010-11-10,2010,25000000,4644108,-20355892,11.421915
48841,Vengeance: The Story of Tony Cimo,1986-11-01,1986,0,0,0,0.037644
48842,Anthrax,2001-01-01,2001,0,0,0,0.592997
48843,The Barber,2001-08-01,2001,0,0,0,0.590398
48844,The Search for Santa Paws,2010-10-12,2010,0,0,0,3.049589
48845,Soula Ela Xana,2009-03-19,2009,0,0,0,0.892252
48846,The Sweet House of Horrors,1989-01-01,1989,0,0,0,0.138582
48847,The Amputee,1974-01-01,1974,0,0,0,1.828178
48848,12 Dicembre,1972-01-01,1972,0,0,0,8e-06
48852,The Choirboys,1977-12-23,1977,0,0,0,0.29126
48854,Sansa,2004-01-29,2004,0,0,0,0.056129
48855,Four of the Apocalypse,1975-08-12,1975,0,0,0,0.619874
48856,Gun-shy,2003-01-01,2003,0,0,0,0.758908
48862,Unhook the Stars,1996-09-04,1996,0,0,0,5.52185
48864,Where the Heart Is,1990-02-23,1990,0,0,0,1.449361
48871,Red: Werewolf Hunter,2010-10-30,2010,0,0,0,3.330769
48874,A Flintstones Christmas Carol,1994-11-24,1994,0,0,0,0.872875
48880,The Life & Adventures of Santa Claus,1985-12-17,1985,0,0,0,0.005351
48882,Wounded Game,1977-06-20,1977,0,0,0,0.358253
48885,The Gruesome Twosome,1967-08-28,1967,0,0,0,0.370349
48894,The Saltmen of Tibet,1997-04-25,1997,0,0,0,0.113565
48918,Shadow of the Wolf,1992-03-05,1992,0,0,0,0.775108
48929,Shree 420,1955-01-07,1955,0,0,0,0.529872
48935,Viuuulentemente mia,1982-03-15,1982,0,0,0,0.009192
48937,"Venice, the Moon and You",1958-10-03,1958,0,0,0,0.984315
48943,Young and Dangerous 5,1998-01-01,1998,0,0,0,3.953902
48946,Chatroom,2010-08-11,2010,0,0,0,13.382622
48949,Hide in Plain Sight,1980-03-21,1980,0,0,0,1.229098
48954,The 'Maggie',1954-02-25,1954,0,0,0,0.907863
48955,Everybody Go Home,1960-10-27,1960,0,0,0,0.756513
48958,My Life So Far,1999-08-25,1999,0,0,0,1.786841
48959,Up 'n' Under,1998-01-23,1998,0,0,0,0.219999
48962,A Bela e o Paparazzo,2010-01-28,2010,0,0,0,0.725071
48967,I'll Be There,2003-06-13,2003,0,0,0,0.336765
48988,Hall Pass,2011-02-25,2011,36000000,83160734,47160734,9.13273
48992,I Like It Like That,1994-10-14,1994,0,1777020,1777020,0.289295
48993,The Human Comedy,1943-03-02,1943,0,0,0,0.814727
48994,Smash-Up: Story of a Woman,1947-03-01,1947,0,0,0,0.553727
48995,The Democratic Terrorist,1992-08-21,1992,0,3142763,3142763,0.473471
48996,Den enskilde medborgaren,2006-01-09,2006,0,0,0,0.105024
49001,Black Heaven,2010-07-14,2010,0,0,0,2.888787
49004,Beneath the Dark,2010-11-05,2010,0,0,0,5.415284
49007,Iron Jawed Angels,2004-01-16,2004,0,0,0,9.771121
49009,The Way Back,2010-09-03,2010,30000000,20348249,-9651751,9.402082
49010,Hobo with a Shotgun,2011-05-06,2011,3000000,748453,-2251547,10.926038
49012,Arthur,2011-04-08,2011,40000000,45735397,5735397,9.698075
49013,Cars 2,2011-06-11,2011,200000000,559852396,359852396,13.693002
49014,Cosmopolis,2012-05-25,2012,20500000,6063556,-14436444,6.087109
49017,Dracula Untold,2014-10-01,2014,70000000,215529201,145529201,16.316318
49018,Insidious,2010-09-13,2010,1500000,97009150,95509150,17.24814
49020,Submarine,2011-03-18,2011,0,864659,864659,7.346099
49021,Killer Elite,2011-09-23,2011,66000000,57777106,-8222894,8.046632
49022,Something Borrowed,2011-05-05,2011,35000000,59901913,24901913,5.47309
49026,The Dark Knight Rises,2012-07-16,2012,250000000,1084939099,834939099,20.58258
49028,Rakht Charitra,2010-10-21,2010,390000,0,-390000,0.253908
49029,Saamy,2003-05-05,2003,1,3,2,0.43849
49035,Alaipayuthey,2000-04-14,2000,2000000,6000000,4000000,0.570021
49036,Mr. Mike's Mondo Video,1979-09-20,1979,0,0,0,0.219714
49037,Hellevator,2004-02-28,2004,0,0,0,0.988355
49038,Beauty and the Beast,1987-04-01,1987,0,0,0,1.326803
49040,The Bourne Legacy,2012-08-08,2012,130000000,276572938,146572938,14.89499
49041,Pee-Wee's Playhouse Christmas Special,1988-12-25,1988,0,0,0,1.379004
49047,Gravity,2013-09-27,2013,105000000,716392705,611392705,18.50194
49049,Dredd,2012-09-07,2012,50000000,41037742,-8962258,12.1524
49050,Oblivion,1994-06-06,1994,0,0,0,0.502075
49051,The Hobbit: An Unexpected Journey,2012-11-26,2012,250000000,1021103568,771103568,23.253089
49057,The Trial,2010-09-10,2010,0,0,0,1.124287
49060,Tempo,2003-06-17,2003,0,0,0,0.263738
49069,The Apple,1980-11-21,1980,0,0,0,1.11581
49070,The Keeper: The Legend of Omar Khayyam,2005-06-10,2005,0,0,0,0.568838
49073,Just Like Me,2010-08-12,2010,0,0,0,0.218236
49074,Baasha,1995-01-15,1995,0,15000000,15000000,0.704162
49081,The Rocket: The Legend of Rocket Richard,2005-10-25,2005,8000000,2019009,-5980991,0.860734
49082,Adventures in Dinosaur City,1991-08-28,1991,0,0,0,0.638019
49084,Steak,2007-06-20,2007,0,0,0,2.669195
49087,Moss,2010-07-14,2010,0,0,0,1.434476
49092,Who Done It?,1942-11-06,1942,0,0,0,0.584151
49095,Eye For An Eye,2008-07-31,2008,0,0,0,1.036579
49096,Empire of Passion,1978-01-01,1978,0,0,0,1.185074
49097,The Office,1966-01-01,1966,0,0,0,0.21565
49098,Talking Heads,1980-01-01,1980,0,0,0,0.00195
49099,Images of a Relief,1982-06-30,1982,0,0,0,0.380644
49104,Chronicle of a Disappearance,1996-01-01,1996,0,0,0,0.361472
49106,The Dawns Here Are Quiet,1972-06-06,1972,0,0,0,1.867193
49110,'R Xmas,2001-10-04,2001,0,0,0,0.946443
49112,Tramway,1966-01-01,1966,0,0,0,0.325041
49125,Allonsanfan,1974-12-08,1974,0,0,0,0.761845
49126,Audrey Rose,1977-04-06,1977,0,0,0,5.862098
49131,Spiderman: The Ultimate Villain Showdown,2002-08-11,2002,0,0,0,0.362957
49133,Lamerica,1994-01-01,1994,0,0,0,1.361286
49152,La rabbia,1963-01-01,1963,0,0,0,0.212541
49158,Tentacles,1977-02-25,1977,750000,3000000,2250000,0.950176
49160,The Time Travelers,1964-10-29,1964,250000,0,-250000,1.118899
49162,Alice Upside Down,2007-10-06,2007,0,0,0,0.737691
49167,Ali Zaoua: Prince of the Streets,2000-01-01,2000,0,0,0,0.76225
49168,Wedding in Galilee,1988-01-01,1988,0,0,0,0.000308
49169,Hitchcocked!,2006-08-11,2006,0,0,0,0.017893
49172,Public Enemies,1996-04-19,1996,0,0,0,0.647803
49183,The Vengeance of Fu Manchu,1967-05-25,1967,0,0,0,0.355908
49184,West Beyrouth,1998-09-01,1998,0,0,0,0.219485
49186,Latitude Zero,1969-07-26,1969,0,0,0,2.679758
49190,Antarctic Journal,2005-05-19,2005,0,6500000,6500000,1.089218
49199,The Legend of Speed,1999-12-18,1999,0,0,0,1.853975
49207,R,2010-04-22,2010,0,0,0,0.866556
49212,Black Demons,1991-01-05,1991,0,0,0,0.206271
49214,Once Upon a Time in High School,2004-01-15,2004,0,0,0,1.083314
49216,Big Bird in China,1983-05-29,1983,0,0,0,0.036071
49218,The Trouble with Dee Dee,2005-10-16,2005,0,0,0,0.002374
49220,Zozo,2005-08-05,2005,5600000,0,-5600000,0.58851
49225,Age of Consent,1969-05-13,1969,0,0,0,4.472825
49230,InAlienable,2008-01-19,2008,0,0,0,0.436864
49235,Squeeze,1997-06-06,1997,500000,10300,-489700,0.321515
49237,Fair Game,1986-07-24,1986,0,0,0,0.869355
49239,The Boxer's Omen,1983-10-23,1983,0,0,0,1.402112
49249,A Tale of Two Cities,1980-12-02,1980,0,0,0,0.272284
49250,Drones,2010-01-23,2010,500000,0,-500000,0.328804
49256,Habana Blues,2005-03-18,2005,0,0,0,0.881634
49258,Quill:  The Life of a Guide Dog,2004-03-13,2004,0,0,0,0.807425
49261,Locked Down,2010-11-09,2010,0,0,0,1.110275
49264,The Beautiful Truth,2008-11-14,2008,0,0,0,0.288359
49270,A Corner in Wheat,1909-12-13,1909,0,0,0,0.61161
49271,The Devilish Tenant,1909-01-01,1909,0,0,0,0.725084
49273,The Melomaniac,1903-08-15,1903,0,0,0,1.046782
49275,Bluebeard,1901-01-01,1901,0,0,0,0.680448
49277,The Hilarious Posters,1906-01-01,1906,0,0,0,0.148131
49279,The Man with the Rubber Head,1901-01-01,1901,0,0,0,1.618458
49280,The One-Man Band,1900-01-01,1900,0,0,0,1.109068
49291,Time and Tide,2000-10-19,2000,0,0,0,2.587753
49295,An Up-to-Date Conjurer,1899-01-01,1899,0,0,0,0.594163
49296,The Four Troublesome Heads,1898-01-01,1898,0,0,0,0.966366
49299,Dangerous Game,1993-11-19,1993,0,0,0,2.70097
49308,That Night's Wife,1930-07-06,1930,0,0,0,0.184671
49314,Dominick and Eugene,1988-03-18,1988,0,0,0,2.818797
49320,Ambush,1999-01-22,1999,0,0,0,0.999465
49321,Brancaleone alle crociate,1970-03-08,1970,0,0,0,2.680601
49322,1944 The Final Defence,2007-12-07,2007,0,0,0,0.493879
49323,Filmpje!,1995-05-06,1995,0,0,0,0.303564
49326,City Beneath the Sea,1971-01-25,1971,0,0,0,0.498753
49334,They Made Me a Fugitive,1947-06-24,1947,0,0,0,0.555885
49338,National Lampoon's Last Resort,1994-04-29,1994,0,0,0,0.575108
49341,Exhibit A,2007-01-01,2007,0,0,0,0.66572
49343,Dream Demon,1988-10-06,1988,0,0,0,0.078806
49347,Needle,2010-06-04,2010,3500000,0,-3500000,3.242613
49350,Harriet the Spy: Blog Wars,2010-01-01,2010,0,0,0,5.765804
49352,Night Train to Terror,1985-05-01,1985,0,0,0,0.029194
49353,Snowbeast,1977-04-28,1977,0,0,0,0.408121
49354,Moon of the Wolf,1972-09-26,1972,0,0,0,0.607379
49355,Goyokin,1969-05-01,1969,0,0,0,0.538421
49360,Who Killed Nancy?,2009-02-06,2009,0,0,0,0.213093
49361,Don't Torture a Duckling,1972-09-29,1972,0,0,0,3.056552
49363,Samurai Banners,1969-03-01,1969,0,0,0,0.622677
49365,Lady in White,1988-04-22,1988,0,0,0,1.19789
49367,Two Sons of Francisco,2005-08-19,2005,0,0,0,1.96214
49370,Perfect,1985-06-07,1985,19000000,12918858,-6081142,1.289698
49375,Rough Cut,1980-06-19,1980,14000000,16656125,2656125,0.825638
49379,Terror from the Year 5000,1958-01-01,1958,0,0,0,0.116681
49381,Jimmy Carr: Making People Laugh,2010-11-08,2010,0,0,0,0.579694
49391,From Time to Time,2009-01-01,2009,0,0,0,5.03926
49393,Favela Rising,2005-04-24,2005,0,0,0,0.400375
49396,The Haunted,1991-05-06,1991,0,0,0,0.694405
49397,Death Rides a Horse,1967-08-31,1967,0,0,0,4.08089
49398,Quarter to Two Before Jesus Christ,1982-10-05,1982,0,0,0,1.564678
49409,Starstruck,1982-04-08,1982,0,0,0,0.039514
49410,Motorama,1991-09-10,1991,0,0,0,1.147517
49411,WUSA,1970-08-19,1970,0,0,0,1.038115
49418,Return to Treasure Island,1988-01-01,1988,0,0,0,1.276059
49426,The Fog,2010-05-09,2010,0,0,0,0.367403
49429,Older Than America,2008-03-08,2008,0,0,0,0.96119
49431,My Gun Is Quick,1957-08-01,1957,0,0,0,0.114334
49444,Kung Fu Panda 2,2011-05-25,2011,150000000,665692281,515692281,11.481921
49445,Ride the Divide,2010-04-15,2010,0,0,0,0.008414
49446,You Wont Miss Me,2009-01-16,2009,0,0,0,0.623463
49452,The Smiling Madame Beudet,1923-11-09,1923,0,0,0,0.833618
49453,Fast Food Fast Women,2000-05-15,2000,0,0,0,1.166622
49455,The Short & Curlies,1987-01-01,1987,0,0,0,0.351367
49456,Love and Anger,1969-05-29,1969,0,0,0,0.662422
49462,Career Girls,1997-06-01,1997,0,0,0,3.459251
49467,Little Hamlet,1960-01-01,1960,0,0,0,0.036472
49471,Get on the Bus,1996-10-16,1996,2400000,5731103,3331103,5.230661
49474,Go Now,1995-09-16,1995,0,0,0,0.153884
49475,Porn Theater,2002-01-01,2002,0,0,0,1.75109
49477,Gendernauts: A Journey Through Shifting Identities,1999-06-12,1999,0,0,0,0.073744
49478,Warriors of Virtue,1997-05-02,1997,0,0,0,0.719444
49481,3 Blind Mice,2003-10-08,2003,0,0,0,2.963648
49483,Oliver Twist,1982-03-23,1982,0,0,0,0.609667
49491,101 Rent Boys,2000-06-07,2000,0,0,0,0.084178
49492,Jogwa - The Awakening,2009-09-25,2009,0,0,0,0.00499
49494,The Eagle,2011-02-08,2011,25000000,27122040,2122040,6.196929
49496,Aashiq Banaya Aapne,2005-09-02,2005,0,0,0,0.802008
49497,Camp Cucamonga,1990-09-23,1990,0,0,0,1.79831
49498,The Crooked Web,1955-11-30,1955,0,0,0,0.443842
49500,Comrades,1987-08-23,1987,0,0,0,0.465688
49502,So Evil My Love,1948-03-03,1948,0,0,0,0.802808
49503,A Dangerous Profession,1949-12-10,1949,0,0,0,0.220933
49505,Jim Jefferies: Alcoholocaust,2010-11-08,2010,0,0,0,2.410982
49508,I Was a Communist for the FBI,1951-05-05,1951,0,0,0,0.129965
49511,Chinese Coffee,2000-09-02,2000,0,0,0,1.51655
49514,Gen-Y Cops,2000-11-17,2000,0,0,0,0.485748
49517,Tinker Tailor Soldier Spy,2011-09-16,2011,30000000,0,-30000000,7.728737
49518,Aap Mujhe Achche Lagne Lage,2002-01-01,2002,0,0,0,0.105846
49519,The Croods,2013-03-20,2013,135000000,585178928,450178928,14.757874
49520,The Change-Up,2011-08-05,2011,52000000,75450437,23450437,6.906145
49521,Man of Steel,2013-06-12,2013,225000000,662845518,437845518,18.538834
49522,Nativity!,2009-11-27,2009,0,0,0,3.717752
49524,R.I.P.D.,2013-07-18,2013,130000000,61648500,-68351500,9.369679
49526,Premium Rush,2012-08-24,2012,35000000,31083599,-3916401,5.654784
49527,Man on a Ledge,2012-01-13,2012,42000000,46221189,4221189,10.528173
49529,John Carter,2012-03-07,2012,260000000,284139100,24139100,14.670353
49530,In Time,2011-10-27,2011,40000000,173930596,133930596,10.324613
49538,X-Men: First Class,2011-05-24,2011,160000000,353624124,193624124,0.738633
49542,Wartorn: 1861-2010,2010-11-11,2010,0,0,0,0.581084
49559,Secret Defense,1998-03-18,1998,0,0,0,0.471383
49565,The Man Who Planted Trees,1987-05-13,1987,0,0,0,2.107199
49571,Intentions of Murder,1964-06-28,1964,0,0,0,2.292668
49574,Cloud Heaven,1990-12-04,1990,0,0,0,0.001021
49577,Free Floating,2006-06-10,2006,0,0,0,0.144899
49578,The Alive and the Dead,1963-06-06,1963,0,0,0,0.056531
49579,Help Gone Mad,2009-06-10,2009,0,0,0,0.23179
49580,Two Comrades Were Serving,1968-01-01,1968,0,0,0,1.338192
49583,Dossier 51,1978-08-30,1978,0,0,0,0.119379
49584,Strange Planet,1999-10-06,1999,0,0,0,0.789681
49585,Russia 88,2009-01-28,2009,0,0,0,0.532993
49588,Trick,2010-02-12,2010,0,0,0,0.625962
49594,Snowblind,2010-11-11,2010,300000,0,-300000,0.535184
49597,Vampires: The Turning,2005-01-02,2005,0,0,0,0.918841
49600,The Last Movie,1971-09-29,1971,1000000,0,-1000000,0.14217
49609,A Yank in the R.A.F.,1941-09-26,1941,0,0,0,0.596991
49616,The Miracle of Our Lady of Fatima,1952-08-20,1952,0,0,0,0.100372
49622,The Passion of Ayn Rand,1999-01-27,1999,0,0,0,0.791025
49633,The King of Kings,1927-01-01,1927,2500000,0,-2500000,1.487999
49634,Blaise Pascal,1972-05-16,1972,0,0,0,0.04557
49635,The Rosa Parks Story,2002-02-24,2002,0,0,0,0.068012
49636,Master of the Flying Guillotine,1976-04-24,1976,0,0,0,1.863293
49637,The Wild and Wonderful Whites of West Virginia,2009-04-01,2009,0,0,0,1.378839
49640,The Lawless Frontier,1934-11-22,1934,0,0,0,2.775911
49642,Drunken Master Part II - Dance of the Drunk Mantis,1979-06-26,1979,0,0,0,0.588505
49645,Ayn Rand: A Sense of Life,1998-02-13,1998,0,0,0,0.13785
49653,Roads to Koktebel,2003-09-25,2003,0,0,0,0.472617
49671,Paragraph 175,2000-01-22,2000,0,0,0,1.095428
49672,Inside Hana's Suitcase,2012-04-18,2012,0,0,0,0.011542
49680,Late Marriage,2001-01-01,2001,0,0,0,0.916098
49681,Lost Embrace,2004-03-14,2004,0,0,0,0.776863
49683,Inside Daisy Clover,1966-02-17,1966,4500000,0,-4500000,7.761122
49684,It's Alive III: Island of the Alive,1987-01-01,1987,0,0,0,1.317322
49685,I'm Going Home,2001-01-01,2001,0,0,0,1.789982
49687,Marriage Italian Style,1964-12-18,1964,0,0,0,4.479003
49688,Johnny 100 Pesos,1993-01-01,1993,0,0,0,0.149107
49689,Broken Wings,2002-10-24,2002,0,0,0,1.046869
49691,Mortal Transfer,2001-01-01,2001,0,0,0,0.260296
49693,The Reader,1988-08-17,1988,0,0,0,1.032773
49695,Grass Labyrinth,1979-01-01,1979,0,0,0,0.079542
49696,Monday Morning,2002-01-01,2002,0,0,0,0.51239
49697,Girl with a Suitcase,1961-02-09,1961,0,0,0,1.187802
49701,Le coup du berger,1956-01-01,1956,0,0,0,0.066343
49704,Love in Disguise,2010-08-12,2010,5532496,0,-5532496,0.274655
49706,Dream Home,2010-04-25,2010,0,0,0,3.26531
49709,Kippur,2000-09-07,2000,0,0,0,1.010085
49711,The Laboratory of Fear,1971-01-01,1971,0,0,0,0.000578
49712,Man on Fire,1987-09-04,1987,0,0,0,1.76158
49717,God Save the King,2005-09-16,2005,0,0,0,0.635704
49719,Zeppelin,1971-10-06,1971,0,0,0,0.422943
49721,Me Myself I,2000-04-20,2000,0,369975,369975,0.727837
49722,"Continental, a Film Without Guns",2007-11-09,2007,0,0,0,0.125624
49725,Tigers in Lipstick,1979-03-16,1979,0,0,0,1.404752
49728,Office Killer,1997-01-01,1997,0,0,0,0.582559
49729,Les Aiguilles rouges,2006-05-10,2006,7677765,0,-7677765,0.382908
49730,Red Riding Hood,2011-03-11,2011,42000000,89162162,47162162,10.174298
49733,The Waiting City,2010-07-15,2010,0,0,0,0.212182
49742,Mr. Magoo's Christmas Carol,1962-12-18,1962,0,0,0,0.972587
49745,The 4th Floor,1999-07-31,1999,0,0,0,1.737961
49754,Kickassia,2010-05-31,2010,0,0,0,0.880826
49760,Justice: A Cross The Universe,2008-11-11,2008,0,0,0,0.080368
49762,Where the Rivers Flow North,1993-06-14,1993,0,0,0,0.177709
49763,Bad Moon,1996-11-01,1996,7000000,1100000,-5900000,2.661026
49767,Fade to Black,2006-03-09,2006,0,0,0,1.11251
49776,"Stay Away, Joe",1968-03-08,1968,0,0,0,0.144382
49781,Story of a Love Affair,1950-10-01,1950,0,0,0,0.908594
49782,Night Games,1966-09-12,1966,0,0,0,0.378035
49785,Backdoor,2000-01-01,2000,0,0,0,0.731959
49787,The Reef,2010-05-15,2010,0,0,0,8.377115
49788,Slaves of New York,1989-03-18,1989,0,0,0,0.684803
49789,Priest of Love,1981-10-11,1981,0,0,0,0.007809
49792,Queens Logic,1991-02-01,1991,0,0,0,6.24172
49797,I Saw the Devil,2010-08-12,2010,0,0,0,8.435562
49798,Regeneration,1997-08-27,1997,0,0,0,1.214894
49799,Somebody Is Waiting,1996-12-19,1996,0,0,0,0.016374
49802,The Secret of the Third Planet,1981-01-01,1981,0,0,0,1.559882
49803,Safe Passage,1994-12-01,1994,0,0,0,4.931565
49805,The Browning Version,1994-10-12,1994,0,0,0,3.727644
49806,The Daytrippers,1996-01-01,1996,0,0,0,9.664735
49807,The Perfect Circle,1997-08-24,1997,0,0,0,0.23842
49813,Sue,1997-01-01,1997,0,0,0,0.72343
49814,The Escapist,2002-01-01,2002,0,0,0,0.92004
49815,The Whales of August,1987-10-14,1987,0,0,0,2.070503
49823,The Lightship,1986-09-26,1986,0,0,0,0.262317
49828,Police,2007-02-16,2007,0,0,0,0.984592
49830,Bio Slime,2010-03-29,2010,50000,0,-50000,1.574947
49833,Ay Lav Yu,2010-03-12,2010,0,0,0,0.950561
49834,Beynelmilel,2006-12-29,2006,0,0,0,0.851274
49835,Cinematographer Style,2006-06-25,2006,3000000,0,-3000000,0.188393
49837,South,1919-01-01,1919,0,0,0,0.4731
49842,Quai des Orf√®vres,1947-10-03,1947,0,152961,152961,4.72304
49843,The Naked Truth,1957-12-03,1957,0,0,0,0.59292
49844,The Notorious Landlady,1962-04-01,1962,0,0,0,0.894307
49845,Les Dames du Bois de Boulogne,1945-09-21,1945,0,0,0,1.153856
49846,Un Dimanche √† Kigali,2006-04-03,2006,0,0,0,0.133962
49847,The Possession of David O'Reilly,2010-01-01,2010,0,0,0,0.630731
49848,"Little Fish, Strange Pond",2009-10-23,2009,485000,0,-485000,1.511958
49849,Cowboys & Aliens,2011-07-29,2011,163000000,174822325,11822325,10.958669
49850,A Quiet Life,2010-11-05,2010,0,1700000,1700000,1.462024
49852,The Nutcracker: The Untold Story,2010-11-24,2010,90000000,16178959,-73821041,3.394928
49853,Same Same But Different,2009-08-13,2009,0,0,0,0.985158
49855,End of the Line,1987-08-28,1987,0,0,0,0.384187
49857,Love's Unfolding Dream,2007-12-15,2007,0,0,0,0.554615
49863,The Singing Nun,1966-04-02,1966,0,0,0,2.553483
49870,The Power of Nightmares,2004-10-19,2004,0,0,0,1.249407
49872,Hansel & Gretel,2002-10-16,2002,0,100477,100477,2.186679
49874,Kommissarie Sp√§ck,2010-06-04,2010,0,0,0,0.294844
49876,The Mouse on the Moon,1963-05-07,1963,0,0,0,2.421473
49877,Locusts: The 8th Plague,2005-11-12,2005,0,0,0,0.295443
49890,Song For a Raggy Boy,2003-01-19,2003,0,0,0,1.675184
49901,Rammbock: Berlin Undead,2010-09-09,2010,0,0,0,2.343663
49907,We Want the Colonels,1973-03-05,1973,0,0,0,0.000308
49908,Pleasant Days,2002-06-06,2002,0,0,0,0.277267
49913,Bolivia,2001-09-22,2001,0,0,0,0.217402
49914,W.C. Fields and Me,1976-03-31,1976,0,0,0,0.255053
49920,Acts of Worship,2001-01-01,2001,0,0,0,0.207332
49922,Whatever Happened to Harold Smith?,2000-03-10,2000,0,0,0,0.954525
49927,The Days,1994-02-19,1994,0,0,0,0.201823
49928,Au Pair,1999-08-22,1999,0,0,0,0.623328
49929,When Brendan Met Trudy,2000-01-01,2000,0,0,0,0.00656
49934,Do You Remember Dolly Bell?,1981-09-02,1981,0,0,0,1.08751
49935,Thieves,1996-08-21,1996,0,0,0,0.365078
49940,Breaking Out,1999-02-19,1999,0,0,0,1.371217
49941,Silent Storm,2001-01-01,2001,0,0,0,0.001177
49943,Sisters,2001-05-10,2001,0,0,0,0.643076
49948,Fantasia 2000,1999-12-17,1999,80000000,90874570,10874570,14.972573
49950,The Roommate,2011-02-04,2011,16000000,40492759,24492759,8.453293
49953,A Turtle's Tale: Sammy's Adventures,2010-08-03,2010,0,0,0,11.031851
49954,Orson Welles: The One-Man Band,1995-10-08,1995,0,0,0,0.051547
49956,The Long Day Closes,1992-05-22,1992,0,0,0,1.190292
49957,Carts of Darkness,2008-01-01,2008,0,0,0,0.004942
49958,Primal,2010-08-26,2010,0,0,0,1.851557
49960,Kiss the Abyss,2012-11-14,2012,0,0,0,0.121757
49961,A Song of Lisbon,1933-11-07,1933,0,0,0,1.050862
49963,Walking and Talking,1996-07-17,1996,0,0,0,0.913281
49964,Where Is My Friend's House?,1987-01-01,1987,0,0,0,2.050506
49967,The One-Armed Boxer,1972-08-02,1972,0,0,0,0.903488
49971,Love in the Time of Hysteria,1991-09-09,1991,0,0,0,0.868401
49974,God's Comedy,1995-01-01,1995,0,0,0,0.44005
49978,My Twentieth Century,1989-01-01,1989,0,0,0,0.398808
49980,Ladybird Ladybird,1994-02-18,1994,0,0,0,0.84508
49981,Goodbye Lover,1998-05-01,1998,20000000,0,-20000000,8.661415
49982,A City of Sadness,1989-09-04,1989,0,0,0,1.21693
49991,The Devil At Your Heels,1981-03-13,1981,300000,0,-300000,1e-06
49992,Lucky and Zorba,1998-12-22,1998,0,0,0,3.882888
50001,Lady of Burlesque,1943-06-01,1943,0,0,0,0.264695
50004,Paper Birds,2010-03-12,2010,0,0,0,0.952196
50006,The Karlsson Brothers,2010-06-30,2010,0,0,0,0.511214
50008,RKO 281,1999-11-20,1999,0,0,0,5.170505
50010,Innocent Steps,2005-04-28,2005,0,0,0,1.318593
50011,Look Back in Anger,1959-05-28,1959,0,0,0,1.490532
50012,King Lear,1987-05-17,1987,0,0,0,0.707819
50013,Wings,1966-01-01,1966,0,0,0,0.935968
50014,The Help,2011-08-09,2011,25000000,124272124,99272124,7.486118
50021,Cornelis,2010-11-12,2010,0,0,0,0.439923
50023,Dead Awake,2010-12-03,2010,3500000,0,-3500000,1.058119
50025,Kolpa√ßino,2009-11-29,2009,2000000,0,-2000000,0.95907
50028,Saving Grace B. Jones,2009-03-28,2009,0,0,0,0.107949
50030,La Ronde,1950-09-27,1950,0,0,0,1.016039
50031,Rembrandt,1936-11-06,1936,0,0,0,0.281903
50032,Stuart: A Life Backwards,2007-09-23,2007,0,0,0,4.815961
50034,Secret Honor,1984-09-15,1984,0,0,0,0.650732
50035,Lovely & Amazing,2001-08-31,2001,250000,4186931,3936931,2.605409
50036,Easier with Practice,2009-06-12,2009,0,0,0,0.480643
50037,Beyond the Black Rainbow,2010-12-03,2010,1100000,0,-1100000,4.441525
50042,The Lightkeepers,2009-12-18,2009,4500000,0,-4500000,0.296989
50043,Cousin Bette,1998-06-12,1998,0,0,0,1.304145
50053,2010: Moby Dick,2010-11-23,2010,0,0,0,1.931324
50066,Mrs. Parkington,1944-10-12,1944,0,0,0,0.236065
50069,Yoo Hoo Mrs Goldberg,2009-07-10,2009,0,1131688,1131688,0.047875
50070,The Sign of the Cross,1932-11-30,1932,0,0,0,1.166429
50071,Sweetgrass,2009-02-04,2009,0,206728,206728,0.492745
50072,Forbidden,1932-01-09,1932,0,0,0,0.37014
50073,Wild Boys of the Road,1933-09-22,1933,0,0,0,1.021472
50075,The Black Pirate,1926-03-08,1926,0,0,0,1.570282
50076,Confessions from a Holiday Camp,1977-01-01,1977,0,0,0,0.883532
50077,Berlin '36,2009-09-09,2009,0,0,0,0.727165
50078,Jewel Robbery,1932-08-13,1932,0,0,0,0.745458
50079,Chained,1934-08-31,1934,0,0,0,0.366378
50081,Born to Be Wild,2011-04-08,2011,0,7732325,7732325,2.92387
50085,Ruby Gentry,1952-12-25,1952,525000,0,-525000,1.342177
50086,Nymph,2009-05-20,2009,0,0,0,0.546513
50087,Pok√©mon: Zoroark: Master of Illusions,2010-07-10,2010,0,0,0,3.686067
50090,Secret Reunion,2010-02-04,2010,0,0,0,1.209968
50091,Boys Life 2,1997-03-07,1997,0,532654,532654,0.060645
50106,A Trick of the Light,1995-11-28,1995,0,0,0,0.468846
50107,The House on 56th Street,1933-12-23,1933,0,0,0,0.136997
50108,Sars Wars: Bangkok Zombie Crisis,2004-12-16,2004,0,0,0,0.400305
50113,Malice@Doll,2004-10-29,2004,0,0,0,0.143197
50114,Tyson,1995-04-29,1995,0,0,0,3.877556
50116,Simpatico,1999-09-15,1999,10000000,929606,-9070394,3.143748
50117,We Were Strangers,1949-04-27,1949,0,0,0,0.736384
50119,Cool Dog,2011-01-04,2011,0,0,0,1.587201
50123,Skins,2002-01-14,2002,0,249204,249204,0.914404
50124,Monella,1998-01-21,1998,0,0,0,5.712154
50125,AC/DC- Let There Be Rock,1980-09-14,1980,0,0,0,0.15164
50126,Fallen,2006-07-23,2006,0,0,0,5.376538
50135,Animals United,2010-10-07,2010,0,0,0,8.193149
50153,The Man from Planet X,1951-04-27,1951,50000,0,-50000,1.199625
50155,Can't Help Singing,1944-12-25,1944,0,0,0,0.2644
50158,No and Me,2010-11-17,2010,0,0,0,1.806222
50161,Dolphins,2007-07-24,2007,0,0,0,0.390896
50162,964 Pinocchio,1991-09-14,1991,0,0,0,1.15526
50166,Lucky Luke: The Ballad of the Daltons,1978-03-10,1978,0,0,0,1.30451
50173,Jigoku,1960-07-30,1960,0,0,0,1.612618
50177,Foreign Intrigue,1956-07-12,1956,0,0,0,0.384574
50179,Die Abrafaxe - Unter schwarzer Flagge,2001-10-25,2001,0,0,0,0.848021
50181,L'argent,1928-12-25,1928,0,0,0,0.511658
50182,La Roue,1923-02-17,1923,0,0,0,0.303726
50183,The Ascent,1977-04-02,1977,0,0,0,2.113171
50185,Diary of a Hitman,1991-11-20,1991,0,31815,31815,0.781841
50186,Gypsies Are Found Near Heaven,1976-04-04,1976,0,0,0,0.925606
50189,Geppo il folle,1978-12-01,1978,0,0,0,0.011574
50196,Rugantino,1973-01-01,1973,0,0,0,0.613299
50197,Serafino,1968-12-16,1968,0,0,0,0.86112
50201,The Journey to Melonia,1989-12-15,1989,0,0,0,0.117806
50203,Sweet Hearts Dance,1988-09-23,1988,0,3790493,3790493,0.656215
50204,Burke & Hare,2010-10-29,2010,10000000,4349187,-5650813,7.787593
50210,Man of Vendetta,2010-07-01,2010,0,0,0,1.057285
50213,Une √âpoque Formidable...,1991-06-19,1991,0,0,0,1.047295
50217,From Prada to Nada,2011-01-28,2011,93,2500000,2499907,11.096527
50220,The Seat Filler,2004-08-05,2004,0,0,0,0.353665
50221,Mugabe and the White African,2009-08-07,2009,0,4542,4542,0.14603
50225,A Rumor of Angels,2000-09-08,2000,0,0,0,3.278211
50227,The Fear of Speed,2002-08-02,2002,0,0,0,0.15591
50231,The FBI Story,1959-10-01,1959,0,0,0,1.380434
50241,Saving Shiloh,2006-04-05,2006,0,0,0,0.836976
50247,Early Summer,1951-10-03,1951,0,0,0,3.932169
50253,Saint Seiya Heaven Chapter: Overture,2004-02-14,2004,0,0,0,1.337121
50254,Edvard Munch,1974-11-12,1974,0,0,0,0.103347
50268,Love & Passion,1987-02-25,1987,0,0,0,3.409258
50271,Strange Cargo,1940-03-01,1940,0,0,0,0.7369
50272,We Are What We Are,2010-11-12,2010,0,0,0,1.881046
50275,The Pirate Bay: Away From Keyboard,2013-02-08,2013,0,34664,34664,4.02059
50277,Two Guys Talkin' About Girls,1995-01-01,1995,0,0,0,0.121323
50285,Siam Sunset,1999-09-09,1999,0,0,0,0.595602
50288,House of Bones,2010-01-16,2010,0,0,0,4.347087
50291,Alien Nation: Millennium,1996-01-02,1996,0,0,0,1.787853
50294,Kooky,2010-05-19,2010,0,0,0,0.563405
50295,Crack House,1989-11-10,1989,0,0,0,4e-05
50299,A Lesson Before Dying,1999-05-22,1999,0,0,0,4.043659
50307,Soup to Nuts,1930-09-28,1930,0,0,0,0.082617
50314,My Architect,2003-11-12,2003,0,0,0,0.466477
50317,Head Trauma,2006-06-24,2006,126000,0,-126000,0.003939
50318,Go Go Tales,2007-05-23,2007,4000000,907456,-3092544,4.382184
50321,Mars Needs Moms,2011-03-09,2011,150000000,38992758,-111007242,7.24717
50326,How The West Was Fun,1994-11-19,1994,0,0,0,2.725497
50327,To Grandmother's House We Go,1992-12-06,1992,0,0,0,0.909592
50329,The Sea Hawk,1924-06-14,1924,0,0,0,0.261897
50332,Snow,2004-12-13,2004,0,0,0,0.799403
50338,The Wedding Song,2008-11-24,2008,0,0,0,0.359923
50339,Little Jerusalem,2005-05-16,2005,0,0,0,0.77666
50340,Why Did You Come to My House,2009-04-09,2009,0,0,0,0.367665
50341,The Divine Weapon,2008-09-04,2008,0,0,0,0.54013
50346,Kickboxer 4: The Agresor,1994-07-27,1994,400000,0,-400000,1.85208
50348,The Lincoln Lawyer,2011-03-17,2011,40000000,85412898,45412898,6.807442
50350,And Now... Ladies and Gentlemen...,2002-05-29,2002,0,0,0,0.991888
50356,Susan Slept Here,1954-07-14,1954,0,0,0,0.154947
50357,Apollo 18,2011-07-20,2011,5000000,25562924,20562924,10.711742
50359,Hop,2011-03-30,2011,63000000,183953723,120953723,8.904488
50363,Summertime,1955-01-01,1955,0,0,0,2.577128
50364,The Bad Mother's Handbook,2007-01-01,2007,0,0,0,0.314837
50365,Our Day Will Come,2010-09-15,2010,4500000,0,-4500000,5.208243
50372,C.C. and Company,1970-10-14,1970,0,0,0,0.350216
50374,Black Sunday,1977-03-11,1977,0,0,0,4.05337
50379,One on One,1977-06-28,1977,0,0,0,0.638642
50380,Lockdown,2000-09-15,2000,0,0,0,0.359979
50382,Monster in the Closet,1986-05-15,1986,0,0,0,2.398954
50387,Grimm,2003-01-01,2003,0,0,0,0.924874
50388,King of Thorn,2009-10-09,2009,0,0,0,9.849854
50392,Ghost Son,2007-04-05,2007,0,0,0,0.783219
50393,Kung Fu Panda Holiday,2010-11-26,2010,0,0,0,10.749145
50400,Mission London,2010-04-16,2010,1850000,0,-1850000,0.939136
50401,Pursuit to Algiers,1945-10-26,1945,0,0,0,1.174046
50416,Grizzly Falls,1999-11-05,1999,0,0,0,0.658374
50420,Countdown to Zero,2010-01-25,2010,271323,0,-271323,0.436199
50425,Murder Obsession,1981-02-24,1981,0,0,0,0.484645
50435,Bilitis,1977-03-16,1977,0,0,0,3.253556
50441,Boulevard,1994-12-28,1994,0,0,0,0.303971
50451,Micro Men,2009-10-08,2009,0,0,0,0.597776
50454,Christmas Angel,2009-11-10,2009,0,0,0,0.389144
50456,Hanna,2011-04-07,2011,30000000,63782078,33782078,8.071196
50458,Yoga,2009-08-20,2009,0,0,0,0.987326
50461,Liar Game: The Final Stage,2010-03-06,2010,0,0,0,0.611003
50463,The Favor,1994-04-29,1994,0,0,0,1.344876
50467,Miranda,2002-01-18,2002,0,0,0,0.871444
50474,The Four Horsemen of the Apocalypse,1962-02-07,1962,0,0,0,0.7701
50475,No Mercy,2010-01-07,2010,0,0,0,2.636798
50479,Avalon High,2010-11-12,2010,0,0,0,4.96893
50489,Mais Uma Vez Amor,2005-04-21,2005,0,0,0,0.003449
50492,Large,2001-10-05,2001,0,0,0,0.665745
50497,When the Lights Went Out,2012-01-31,2012,0,0,0,2.923193
50503,Pistol: The Birth of a Legend,1991-09-29,1991,0,0,0,0.47349
50506,Mrs. Miracle,2009-12-05,2009,0,0,0,1.418224
50507,Crazy Safari,1991-07-05,1991,0,0,0,1.749808
50512,Anna Karenina,1997-04-04,1997,35000000,791830,-34208170,5.660835
50526,Beats of Freedom,2009-03-12,2009,0,0,0,0.005386
50530,The New Year's Rate Plan,2008-12-04,2008,3200000,3877492,677492,0.314167
50531,Chiedimi se sono felice,2000-12-15,2000,0,0,0,4.288138
50535,Strella,2009-02-10,2009,0,0,0,1.856718
50536,Twenty Bucks,1993-10-21,1993,0,0,0,2.324847
50541,Ice Castles,1978-12-31,1978,0,0,0,3.335968
50542,Under the Hawthorn Tree,2010-09-15,2010,0,0,0,0.923702
50544,Friends with Benefits,2011-07-21,2011,35000000,150483765,115483765,10.009007
50546,Just Go with It,2011-02-10,2011,80000000,214918407,134918407,9.267959
50549,Belles on their Toes,1952-05-01,1952,0,0,0,0.875278
50553,Sherlock Holmes Faces Death,1943-09-17,1943,0,0,0,1.454775
50560,Picasso Trigger,1988-02-01,1988,0,0,0,0.629329
50562,Porn Star: The Legend of Ron Jeremy,2001-01-01,2001,0,0,0,0.794916
50571,Disciples of the 36th Chamber,1985-05-17,1985,0,0,0,1.426625
50573,Little Secrets,2001-10-17,2001,0,0,0,1.917878
50578,Amongst White Clouds,2005-01-01,2005,0,0,0,0.112978
50583,Red Eagle,2010-10-07,2010,0,0,0,1.175345
50587,Too Young to Marry,2007-07-09,2007,2,0,-2,0.772947
50590,Norman,2010-06-11,2010,0,0,0,4.62403
50600,A Free Soul,1931-06-02,1931,0,0,0,0.674208
50601,5 Days of War,2011-04-14,2011,20000000,17479,-19982521,3.174512
50618,Fortress of War,2010-11-04,2010,8500000,0,-8500000,4.134328
50619,The Twilight Saga: Breaking Dawn - Part 1,2011-03-15,2011,110000000,712171856,602171856,25.9725
50620,The Twilight Saga: Breaking Dawn - Part 2,2012-11-13,2012,120000000,829000000,709000000,26.080995
50627,The King of Marvin Gardens,1972-10-12,1972,0,0,0,1.58885
50641,The End of Poverty?,2008-05-19,2008,1000000,57,-999943,0.075176
50646,"Crazy, Stupid, Love.",2011-07-29,2011,50000000,142851197,92851197,10.246173
50647,Wanderlust,2012-02-23,2012,35000000,24159934,-10840066,9.295078
50650,Night and Fog,2009-05-14,2009,0,0,0,0.306845
50652,A Nanny for Christmas,2010-11-23,2010,2000000,0,-2000000,1.449353
50656,The Early Years: Erik Nietzsche Part 1,2007-12-25,2007,0,0,0,1.294067
50658,Bella Bettien,2002-04-17,2002,0,0,0,0.207304
50662,South Of Pico,2007-10-25,2007,0,0,0,0.014623
50669,The Mugger,1958-11-01,1958,0,0,0,0.31682
50670,Sir Henry at Rawlinson End,1980-11-07,1980,0,0,0,0.210368
50671,The Resident,2011-02-10,2011,20000000,0,-20000000,5.47578
50673,Life in Flight,2008-09-12,2008,2000000,0,-2000000,1.141224
50674,The Lost Future,2010-11-13,2010,0,0,0,3.099622
50675,Fog Over Frisco,1934-06-02,1934,0,0,0,0.21091
50677,Eyes of an Angel,1991-07-26,1991,0,0,0,0.572387
50687,Maniac Cop 3: Badge of Silence,1993-02-01,1993,0,0,0,2.18104
50688,Isle of the Snake People,1971-03-01,1971,0,0,0,0.178013
50696,Profound Desires of the Gods,1968-11-22,1968,0,0,0,0.470183
50697,Nowhere to Go,1958-12-02,1958,0,0,0,0.741189
50698,Grave Encounters,2011-09-09,2011,1000000,0,-1000000,5.324419
50699,Trancers 6: Life After Deth,2002-07-23,2002,0,0,0,0.496081
50700,Hey Hey It's Esther Blueburger,2008-04-10,2008,6000000,0,-6000000,0.481348
50701,How to Seduce Difficult Women,2009-10-30,2009,0,0,0,0.718617
50704,The Boat,1921-11-10,1921,0,0,0,0.634836
50714,Reflections,2008-06-24,2008,0,0,0,1.145595
50715,SoulBoy,2010-06-04,2010,0,0,0,3.569699
50717,Davy Crockett and the River Pirates,1956-07-18,1956,0,0,0,1.173254
50719,"Silent Night, Deadly Night II",1987-04-10,1987,250000,154323,-95677,1.225871
50722,Vision ‚Äì From the Life of Hildegard von Bingen,2009-09-24,2009,0,0,0,1.021195
50724,My Brother's Wife,2005-11-04,2005,0,0,0,3.346139
50725,Take Me Home Tonight,2011-03-04,2011,19000000,6928068,-12071932,8.132811
50730,Winky's Horse,2005-11-01,2005,0,0,0,0.562058
50737,Hunting Season,2010-12-02,2010,0,0,0,1.59006
50754,7 Plus Seven,1970-01-01,1970,0,0,0,0.001021
50758,Squadra antitruffa,1977-04-21,1977,0,0,0,0.144542
50759,An Autumn Afternoon,1962-11-18,1962,0,0,0,2.357072
50761,Our Man In Marrakesh,1966-07-22,1966,0,0,0,0.797557
50765,Ticking Clock,2011-01-04,2011,6000000,0,-6000000,1.819803
50767,American Cyborg: Steel Warrior,1994-01-07,1994,0,447784,447784,0.56257
50775,A Jitney Elopement,1915-04-01,1915,0,0,0,1.596403
50779,And Everything Is Going Fine,2010-06-04,2010,0,0,0,0.652975
50780,The Beaver,2011-02-11,2011,21000000,970816,-20029184,5.484379
50785,Le Petit Soldat,1963-01-25,1963,180000,0,-180000,2.394441
50787,Going to Pieces: The Rise and Fall of the Slasher Film,2006-10-13,2006,0,0,0,7.429735
50789,Sympathy for the Devil,1968-11-30,1968,500000,0,-500000,1.019206
50794,The Even Stevens Movie,2003-06-13,2003,0,0,0,3.352237
50797,Burnt by the Sun,1994-05-01,1994,2800000,2616503,-183497,2.486073
50812,Unfaithfully Yours,1984-02-10,1984,0,0,0,0.650914
50819,American Adobo,2001-09-29,2001,344,4,-340,0.158651
50834,Rooster's Breakfast,2007-11-17,2007,0,0,0,0.271715
50835,Below Utopia,1997-09-26,1997,0,0,0,1.056673
50837,Martha Marcy May Marlene,2011-10-21,2011,0,3538446,3538446,7.665011
50838,Wrecked,2010-12-04,2010,0,8020,8020,5.053905
50839,Margin Call,2011-09-28,2011,3500000,19504039,16004039,8.340757
50845,The Clink of Ice,2010-08-25,2010,0,0,0,3.010211
50848,The Names of Love,2010-11-24,2010,4600000,0,-4600000,4.786783
50849,The Biggest Battle,1978-02-07,1978,0,0,0,0.017521
50850,The Second Jungle Book: Mowgli & Baloo,1997-05-16,1997,0,479099,479099,0.285487
50855,Angora Love,1929-12-14,1929,0,0,0,0.274571
50861,Berth Marks,1929-06-01,1929,0,0,0,0.797932
50868,Do Detectives Think?,1927-11-20,1927,0,0,0,0.10367
50875,Higher Ground,2011-08-26,2011,2000000,841733,-1158267,1.137468
50900,Raja,2003-09-03,2003,0,0,0,0.402466
50916,Two Tars,1928-11-03,1928,0,0,0,0.570278
50922,You're Darn Tootin',1928-04-21,1928,0,0,0,0.548443
50926,The Great Rupert,1950-03-01,1950,0,0,0,0.206341
50934,Pinocchio's Christmas,1980-12-03,1980,0,0,0,0.040999
50936,Moon Warriors,1992-12-19,1992,0,0,0,1.17823
50938,Hello Stranger,2010-08-19,2010,0,0,0,1.649488
50942,Creature,1998-05-17,1998,0,0,0,6.243385
50950,Ingmar Bergman Makes a Movie,1963-01-01,1963,0,0,0,0.930353
50953,The Great Scout & Cathouse Thursday,1976-06-23,1976,0,0,0,1.069445
50958,Deadly Weapons,1974-04-04,1974,0,0,0,1.023037
50977,Nude on the Moon,1961-01-01,1961,0,0,0,0.223436
50988,Young Gods,2003-10-24,2003,0,0,0,0.566025
50990,Bad Family,2010-01-29,2010,0,0,0,0.332206
51000,Mia and the Migoo,2008-09-06,2008,0,0,0,0.348916
51010,Sweet Rush,2009-04-23,2009,0,0,0,0.404583
51017,Madea's Big Happy Family,2011-04-22,2011,25000000,53213633,28213633,2.503594
51021,Lure: Teen Fight Club,2010-11-16,2010,3000000,0,-3000000,0.47162
51022,The Wounds,1998-05-27,1998,10000,150000,140000,0.732884
51036,MadHouse,1990-02-16,1990,0,0,0,1.766022
51038,Kivenpy√∂ritt√§j√§n kyl√§,1995-02-17,1995,0,0,0,0.161568
51039,Kites Over Helsinki,2001-09-07,2001,0,0,0,0.34698
51043,Loch Ness,1996-08-23,1996,0,0,0,2.610615
51044,Carmen Jones,1954-10-27,1954,750000,0,-750000,3.552627
51049,Pontiac Moon,1994-11-03,1994,0,0,0,0.690606
51052,Arthur Christmas,2011-02-22,2011,0,0,0,8.453796
51054,The Slender Thread,1965-12-23,1965,0,0,0,0.378345
51059,"Palo Alto, CA",2007-04-29,2007,0,0,0,0.403144
51066,Dope Mania,1987-01-01,1987,0,0,0,0.105882
51069,I Like Killing Flies,2004-01-01,2004,0,14000,14000,0.829
51071,The Big Picture,2010-11-03,2010,0,0,0,2.03027
51072,Beautiful Lies,2010-12-08,2010,0,0,0,3.405305
51078,Getting Out,1994-04-25,1994,0,0,0,0.071764
51079,Piccadilly,1929-02-01,1929,0,0,0,0.807057
51083,Word of Honor,2003-12-06,2003,0,0,0,0.054575
51090,With Love... from the Age of Reason,2010-07-28,2010,8000000,0,-8000000,2.410173
51091,Annie's Point,2005-01-22,2005,0,0,0,0.06591
51092,The Organizer,1963-10-23,1963,0,0,0,10.625787
51104,"Krakatoa, East of Java",1969-03-17,1969,0,0,0,1.053818
51106,You're Under Arrest: The Movie,1999-04-29,1999,0,0,0,0.468714
51120,Peter Pan,1960-01-01,1960,0,0,0,0.257941
51122,Make-Out with Violence,2008-04-12,2008,150000,0,-150000,0.41111
51129,The Master and Margarita,2005-12-19,2005,5000000,0,-5000000,1.491124
51136,Paid to Kill,1954-06-25,1954,0,0,0,0.316603
51138,The Moment After 2: The Awakening,2006-05-28,2006,0,0,0,0.460791
51141,Port of Call,1948-10-11,1948,0,0,0,0.573899
51143,Thirst,1949-10-17,1949,0,0,0,0.404751
51144,Torment,1944-10-02,1944,0,0,0,2.228627
51145,Spring Forward,1999-09-01,1999,0,0,0,1.409447
51162,Winnie the Pooh,2011-04-13,2011,30000000,14460000,-15540000,7.357682
51166,La Parisienne,1957-12-16,1957,0,0,0,0.206748
51167,According to Spencer,2001-08-15,2001,0,0,0,0.514363
51170,Open Season 3,2010-01-25,2010,0,0,0,10.567325
51175,Shaka Zulu: The Last Great Warrior,2005-05-03,2005,0,0,0,0.327513
51177,Bigger Than the Sky,2005-02-18,2005,0,0,0,1.529786
51179,Circus,2000-05-05,2000,0,0,0,0.652784
51182,Sex: The Annabel Chong Story,1999-02-11,1999,0,0,0,0.119021
51190,Run Sister Run!,2010-10-12,2010,1552334,0,-1552334,0.36802
51191,Guardian Angels,1995-11-11,1995,0,0,0,2.990881
51195,The Thirst for Gold,1993-08-31,1993,0,0,0,0.945839
51196,La vengeance d'une blonde,1994-01-26,1994,0,0,0,0.835104
51200,71: Into the Fire,2010-06-16,2010,10400000,20967660,10567660,3.106814
51205,Joy of Learning,1969-07-12,1969,0,0,0,0.074827
51209,Kill the Irishman,2011-03-10,2011,0,1188194,1188194,5.981634
51210,Prancer Returns,2001-11-20,2001,0,0,0,0.811395
51212,I'm Losing My Temper,1974-10-09,1974,0,0,0,0.443538
51213,The Body of My Enemy,1976-10-13,1976,0,0,0,0.662019
51215,The Breed,2001-07-19,2001,0,0,0,1.355844
51216,Ghulam,1998-06-19,1998,0,0,0,3.732919
51227,King Richard And The Crusaders,1954-08-07,1954,0,0,0,0.719713
51230,Cinemania,2002-07-06,2002,0,0,0,0.446688
51239,Paradox,2010-01-01,2010,0,0,0,1.585493
51241,Heartbeats,2010-05-16,2010,0,62985,62985,5.483163
51242,Bread and Chocolate,1974-05-05,1974,0,0,0,1.306628
51245,Inseparable,2011-10-08,2011,0,0,0,1.548808
51247,Blackadder's Christmas Carol,1988-01-01,1988,0,0,0,1.986334
51248,11-11-11,2011-11-11,2011,0,0,0,3.99161
51249,Alabama Moon,2009-09-27,2009,0,0,0,5.751436
51250,Gun,2010-06-10,2010,10000000,0,-10000000,2.834545
51259,The Prize of Peril,1983-01-25,1983,0,0,0,0.672756
51260,The Crawling Hand,1963-09-04,1963,100000,0,-100000,0.405798
51261,National Lampoon's The Legend of Awesomest Maximus,2014-03-07,2014,0,0,0,3.389921
51263,The Strong Man,1926-11-19,1926,0,0,0,0.195632
51267,Out Of Order,2010-06-06,2010,2200000,0,-2200000,0.45997
51268,The Ransom of Red Chief,1998-01-01,1998,0,0,0,0.630423
51270,The Shift,2009-01-01,2009,1200000,0,-1200000,0.432551
51272,Wolfy,2009-10-01,2009,0,0,0,0.301323
51273,Dark World,2010-10-07,2010,0,0,0,1.453293
51275,The Priest,2009-04-04,2009,0,1708837,1708837,1.061297
51276,Silent Souls,2010-06-06,2010,0,0,0,1.935128
51277,Now and Forever,1934-08-31,1934,0,0,0,0.557452
51281,The Ugly Duckling,2010-09-16,2010,1,0,-1,0.10425
51284,Morphine,2008-11-27,2008,3600000,766075,-2833925,0.652747
51285,PG 16...,2010-09-16,2010,0,0,0,1.168623
51290,Artois the Goat,2009-09-01,2009,50000,0,-50000,0.166944
51298,Disney's Very Merry Christmas Sing Along Songs,2002-11-05,2002,0,0,0,1.043798
51299,Life Cycles,2010-10-02,2010,0,0,0,1.784965
51300,The Barber of Siberia,1998-10-13,1998,35000000,0,-35000000,1.928011
51302,The Muppet Musicians of Bremen,1972-01-01,1972,0,0,0,0.561556
51303,Spite Marriage,1929-03-24,1929,0,0,0,0.942242
51306,Lost on Journey,2010-06-04,2010,0,0,0,0.998342
51309,The Dhamma Brothers,2007-01-31,2007,0,0,0,0.14527
51311,Wheel of Time,2003-10-30,2003,0,0,0,0.572948
51317,Placido,1961-10-20,1961,0,0,0,1.005974
51321,Permanent Record,1988-04-22,1988,8000000,1893139,-6106861,1.194377
51322,The Child's Eye,2010-10-13,2010,4500000,0,-4500000,0.574123
51330,"You're a Good Man, Charlie Brown",1985-11-06,1985,0,0,0,0.013026
51333,Love's Labour's Lost,2000-03-31,2000,13000000,299792,-12700208,5.867426
51334,Be≈ü ≈ûehir,2010-04-09,2010,0,0,0,1.016026
51349,Little Longnose,2003-03-19,2003,0,0,0,1.300771
51352,Anne Frank Remembered,1995-06-08,1995,0,1,1,0.243986
51355,The Rough House,1917-06-25,1917,0,0,0,0.885458
51357,The Scarecrow,1920-12-22,1920,0,0,0,0.708982
51358,Neighbors,1920-12-22,1920,0,0,0,0.835182
51359,The Haunted House,1921-02-21,1921,0,0,0,0.325674
51360,The Goat,1921-05-14,1921,0,0,0,1.495106
51362,The Play House,1921-10-26,1921,0,0,0,1.930445
51363,When Will I Be Loved,2004-06-06,2004,0,159429,159429,1.500214
51364,The Frozen North,1922-08-28,1922,0,0,0,1.223097
51365,The Door,2009-11-26,2009,0,0,0,2.223551
51366,The Electric House,1922-10-01,1922,0,0,0,1.134656
51367,The Love Nest,1923-03-01,1923,0,0,0,0.639966
51370,The Cool School,2008-03-07,2008,0,0,0,0.10942
51371,Battling Butler,1926-09-19,1926,0,0,0,1.09569
51374,Allez Oop,1934-05-25,1934,0,0,0,0.041806
51384,"Lovely, Still",2008-01-01,2008,0,0,0,0.931286
51389,Excuse My Dust,1951-06-29,1951,0,0,0,0.06915
51391,Murder on a Sunday Morning,2001-09-14,2001,0,0,0,1.010752
51392,The Saphead,1920-09-01,1920,0,0,0,0.291058
51393,White Night,2009-11-19,2009,0,0,0,0.974446
51394,Night Nurse,1931-07-15,1931,0,0,0,1.521412
51395,Hold Back the Dawn,1941-09-26,1941,0,0,0,2.845429
51402,WikiRebels: The Documentary,2010-12-12,2010,0,0,0,0.76254
51403,Biblioth√®que Pascal,2010-06-08,2010,0,0,0,0.368638
51406,Neighbours,1952-01-01,1952,0,0,0,0.937717
51409,The Tree,2010-05-23,2010,0,0,0,2.288156
51411,Ma and Pa Kettle Go to Town,1950-01-04,1950,0,0,0,0.307504
51413,No One Knows About Persian Cats,2009-05-14,2009,0,0,0,0.931142
51416,Escape from Crime,1942-07-25,1942,0,0,0,0.005536
51422,Agent Red,2000-01-01,2000,0,0,0,1.124954
51423,Beyond,2010-12-10,2010,3000000,4800080,1800080,0.702712
51424,Tomorrow I'll Wake Up and Scald Myself with Tea,1977-06-01,1977,0,0,0,1.180615
51426,Battle Cry,1955-02-02,1955,0,0,0,0.91269
51428,Ghost Writer,2007-03-09,2007,3000000,0,-3000000,0.194801
51429,Female Yakuza Tale,1973-06-06,1973,0,0,0,1.041534
51434,The Fourth War,1990-03-08,1990,0,1305887,1305887,0.91273
51438,MVP 2: Most Vertical Primate,2001-10-05,2001,0,0,0,1.323182
51442,American Gothic,1988-06-03,1988,0,0,0,2.412785
51443,Moonlight & Mistletoe,2008-11-29,2008,0,0,0,0.69807
51444,The Secret of Nikola Tesla,1980-09-12,1980,0,0,0,0.734659
51447,Trophy Wife,2010-11-10,2010,0,1611000,1611000,5.899325
51450,Santa's Apprentice,2010-11-24,2010,0,0,0,0.354486
51452,The Century of the Self,2002-03-17,2002,0,0,0,0.998672
51472,The Garage,1920-01-11,1920,0,0,0,0.355919
51476,Shoot to Kill,1947-03-15,1947,0,0,0,0.16192
51481,Mean Girls 2,2011-01-23,2011,0,0,0,7.515436
51484,July Rhapsody,2002-03-14,2002,0,0,0,0.233491
51485,Delhi Safari,2012-10-19,2012,0,0,0,1.354611
51486,Jean-Michel Basquiat: The Radiant Child,2010-01-25,2010,0,0,0,0.823678
51490,On the Inside,2011-12-31,2011,4000000,0,-4000000,1.407371
51497,Fast Five,2011-04-20,2011,125000000,626137675,501137675,1.420361
51501,Stripper Academy,2007-04-29,2007,1000000,0,-1000000,0.534743
51505,The Christmas Hope,2009-12-13,2009,0,0,0,0.217647
51507,Walking Too Fast,2010-02-04,2010,0,0,0,0.182427
51511,The Immaculate Conception of Little Dizzle,2010-05-12,2010,0,0,0,0.915893
51512,Dear Mr. Gacy,2010-05-10,2010,0,0,0,2.671647
51515,At Play in the Fields of the Lord,1991-12-06,1991,36000000,1345903,-34654097,2.151436
51520,Blind Mountain,2007-05-19,2007,0,0,0,0.772501
51521,My Demon Lover,1987-04-24,1987,0,0,0,0.559319
51522,I Need That Record,2008-05-03,2008,10,0,-10,0.189111
51531,Grandma Got Run Over by a Reindeer,2000-10-31,2000,0,0,0,0.371819
51533,Let the Bullets Fly,2010-12-16,2010,0,0,0,3.877376
51540,Horrible Bosses,2011-07-08,2011,35000000,117000000,82000000,9.856955
51548,The Invisible Eye,2010-08-19,2010,0,0,0,0.588512
51549,All Around Us,2008-06-07,2008,0,0,0,0.128822
51560,Oz,1976-07-29,1976,0,0,0,0.031002
51571,Sister Kenny,1946-10-10,1946,0,0,0,0.359871
51572,I Love Lucy: The Movie,1953-01-01,1953,0,0,0,0.104308
51576,Darkside Blues,1994-10-08,1994,0,0,0,0.557918
51578,Happy End,1967-09-01,1967,0,0,0,1.663297
51581,"Sumo Do, Sumo Don't",1992-01-15,1992,0,0,0,0.537545
51588,Prom,2011-04-29,2011,8000000,10130000,2130000,6.167646
51590,Assault of the Sasquatch,2010-03-01,2010,0,0,0,0.445468
51592,A Christmas Romance,1994-12-18,1994,0,0,0,0.209165
51594,The Statue of Liberty,1985-10-26,1985,0,0,0,0.036448
51601,San Quentin,1937-05-24,1937,0,0,0,0.475803
51604,The Rain Fairy,2010-02-11,2010,0,0,0,0.166355
51608,The Man from Nowhere,2010-08-04,2010,0,43059790,43059790,9.023244
51617,This Happy Breed,1944-06-01,1944,0,0,0,1.363484
51618,The Passionate Friends,1949-01-26,1949,0,0,0,0.905887
51619,The Sound Barrier,1952-12-21,1952,0,0,0,2.852338
51620,Death Race 2,2010-11-12,2010,7000000,0,-7000000,11.086032
51649,Colt Comrades,1943-06-18,1943,0,0,0,0.006208
51675,Escape from Suburbia: Beyond the American Dream,2007-01-01,2007,0,0,0,0.038858
51679,The Source,1999-01-01,1999,0,360895,360895,0.447313
51681,Playing for Time,1980-09-30,1980,0,0,0,0.61972
51707,Girlhood,2003-10-13,2003,0,0,0,0.190009
51722,Children Underground,2001-09-19,2001,0,0,0,0.851458
51730,Royal Tramp,1992-07-30,1992,0,0,0,1.512583
51735,The Dust of Time,2008-11-22,2008,0,0,0,0.747628
51736,Bloomington,2010-06-23,2010,0,0,0,2.312106
51739,The Secret World of Arrietty,2010-07-16,2010,37000000,145570827,108570827,8.636052
51743,Stewardess School,1986-08-01,1986,0,0,0,0.373913
51759,The Love Parade,1929-11-19,1929,0,0,0,0.579705
51763,The Long Walk Home,1990-12-21,1990,0,0,0,4.636786
51765,Dead Man's Walk,1996-05-12,1996,0,0,0,0.228108
51768,Rough Riders,1997-07-20,1997,0,0,0,0.481577
51780,Pretty Cool,2005-06-21,2005,0,0,0,0.253802
51786,Kim Possible: A Sitch in Time,2004-10-21,2004,0,0,0,1.789375
51787,British Intelligence,1940-01-29,1940,0,0,0,0.233318
51791,The Adventures of Tartu,1943-10-01,1943,0,0,0,1.149061
51792,Aerial Gunner,1943-03-20,1943,0,0,0,0.056336
51794,Five Minarets in New York,2010-03-09,2010,12000000,0,-12000000,5.92925
51795,The War You Don't See,2010-12-14,2010,0,0,0,0.732773
51800,The Dolphin: Story of a Dreamer,2009-10-08,2009,3000000,0,-3000000,0.647019
51802,Of Mice and Men,1939-12-30,1939,0,0,0,0.995919
51806,To Catch a Killer,1992-05-15,1992,0,0,0,0.612263
51808,Six in Paris,1965-05-19,1965,0,0,0,0.229159
51817,Zamfir's Zona,2002-10-31,2002,0,0,0,0.769203
51822,Love Hurts,2002-11-08,2002,5000000,0,-5000000,1.138867
51823,Across the Line: The Exodus of Charlie Wright,2010-12-28,2010,0,0,0,2.761004
51824,2gether,2000-02-21,2000,0,0,0,0.736215
51828,One Day,2011-03-02,2011,15000000,59389433,44389433,11.239012
51831,The Minion,1998-09-26,1998,0,0,0,0.483399
51832,The Matchmaker,2010-06-23,2010,2150000,0,-2150000,0.300574
51836,Snow 2: Brain Freeze,2008-08-08,2008,0,0,0,0.580174
51839,Zadelpijn,2007-04-15,2007,0,0,0,0.313874
51844,After Him,2007-05-23,2007,0,0,0,0.612802
51848,A Golden Christmas,2009-12-13,2009,0,0,0,5.648219
51851,Change of Address,2006-06-21,2006,0,0,0,0.848437
51853,Accomplices,2010-01-20,2010,0,0,0,0.693926
51854,The Shepherd,1999-01-01,1999,0,0,0,0.041951
51856,Privilege,1967-07-24,1967,0,0,0,0.330594
51857,Cr√≠a Cuervos,1975-01-26,1975,0,0,0,4.881051
51859,Trigun: Badlands Rumble,2010-04-02,2010,0,0,0,1.959207
51863,Seven Up!,1964-05-05,1964,0,0,0,1.046864
51865,Little Lili,2003-08-27,2003,0,0,0,1.222277
51871,Rumba,2008-09-10,2008,0,0,0,0.584246
51873,The One And Only,2002-10-04,2002,0,0,0,0.495431
51875,Miss Nobody,2010-06-10,2010,0,0,0,0.774843
51876,Limitless,2011-03-08,2011,27000000,161849455,134849455,12.114955
51878,9 Deaths of the Ninja,1985-04-15,1985,0,0,0,0.956302
51880,Oscar and the Lady in Pink,2009-11-15,2009,0,0,0,2.044952
51881,The Parent Trap II,1986-07-26,1986,0,0,0,0.917734
51883,Toutes les Filles sont Folles,2003-03-30,2003,0,0,0,0.062527
51885,The Sun Also Rises,2007-09-20,2007,0,0,0,0.905196
51890,Battlefield Baseball,2003-07-19,2003,0,0,0,0.552181
51902,The Tale of John and Marie,1980-11-01,1980,0,0,0,0.222443
51911,Night of the Running Man,1995-01-19,1995,0,0,0,2.621768
51912,The Overtaxed,1959-06-06,1959,0,0,0,0.915016
51917,A Whole Life Ahead,2008-03-28,2008,5940000,4250000,-1690000,3.372144
51927,Stevie,2002-09-09,2002,0,97000,97000,0.489997
51929,The Emperor's Naked Army Marches On,1987-08-01,1987,222000,0,-222000,0.151224
51933,Handsome Harry,2009-04-25,2009,1000000,0,-1000000,0.834019
51935,House of Boys,2009-11-20,2009,2500000,0,-2500000,0.667991
51938,Inside Out,2006-04-22,2006,0,0,0,0.480656
51939,The Hire: Beat the Devil,2002-11-22,2002,0,0,0,0.872822
51942,I Married a Strange Person!,1998-08-28,1998,250,203,-47,0.817002
51945,Not on the Lips,2003-12-03,2003,0,0,0,1.8138
51946,Bittersweet,2008-07-23,2008,50000,0,-50000,0.354576
51947,Shake Hands with the Devil,1959-06-24,1959,0,0,0,0.4724
51949,Toni,1935-02-22,1935,0,0,0,0.329735
51953,15 F√©vrier 1839,2001-01-26,2001,0,0,0,0.173369
51955,Hav Plenty,1997-09-11,1997,0,0,0,0.017501
51956,The Strawberry Statement,1970-08-28,1970,0,0,0,0.93611
51959,The Princess with the Golden Star,1959-12-18,1959,0,0,0,0.956983
51962,My Good Enemy,2010-06-03,2010,0,0,0,0.676825
51971,Hideaway (Le refuge),2009-09-19,2009,0,0,0,2.245929
51976,Brother,2010-07-02,2010,0,0,0,0.409433
51980,Germinal,1993-09-29,1993,0,0,0,2.759302
51985,An All Dogs Christmas Carol,1998-11-17,1998,0,0,0,4.602352
51986,Tangled,2001-11-02,2001,0,0,0,2.177699
51991,Romantics Anonymous,2010-12-22,2010,0,0,0,10.243224
51992,And Soon the Darkness,1970-09-10,1970,0,0,0,1.306094
51993,Terri,2011-07-01,2011,0,144633,144633,2.69722
51994,The Deep Blue Sea,2011-09-11,2011,0,1126525,1126525,3.674758
51995,Salvation Boulevard,2011-07-15,2011,8000000,0,-8000000,3.033375
51996,Thin Ice,2011-01-24,2011,0,790421,790421,9.64235
51997,No Name on the Bullet,1959-02-01,1959,0,0,0,1.819554
51999,Perfect Sense,2011-01-24,2011,0,908000,908000,11.047948
52001,Citadel,2012-07-11,2012,0,0,0,9.189238
52009,Norwegian Ninja,2010-08-13,2010,0,0,0,0.409606
52010,"Ultramarines: A Warhammer 40,000 Movie",2010-12-10,2010,0,0,0,2.88558
52011,The Thirteen Assassins,1963-12-07,1963,6,0,-6,1.161105
52013,Marwencol,2010-03-12,2010,0,58,58,0.827035
52015,Stake Land,2010-09-30,2010,650000,33245,-616755,7.814255
52017,Bloodstone: Subspecies II,1993-05-26,1993,0,0,0,0.924228
52021,Bloodlust: Subspecies III,1994-02-16,1994,0,0,0,1.192999
52022,Subspecies 4: Bloodstorm,1998-12-08,1998,0,0,0,0.657037
52032,My Dog Tulip,2009-01-01,2009,0,246574,246574,1.733716
52034,Tetsuo: The Bullet Man,2009-09-05,2009,0,0,0,1.658163
52035,The Mystery of the Leaping Fish,1916-06-11,1916,0,0,0,0.436214
52036,The Company,2003-09-10,2003,15000000,2281585,-12718415,7.803563
52038,A Man of No Importance,1994-12-22,1994,0,953,953,0.406113
52039,Don't Let Me Drown,2009-01-01,2009,0,0,0,0.371407
52044,Insane,2010-02-09,2010,750000,0,-750000,1.097638
52045,Libre √©change,2010-12-22,2010,0,0,0,0.453212
52046,Haunted Changi,2010-09-02,2010,0,0,0,0.207794
52047,The Only Son,1936-09-15,1936,0,0,0,0.482102
52048,Last Stop for Paul,2006-04-01,2006,0,0,0,0.110236
52049,Comedy of Innocence,2000-09-01,2000,0,0,0,0.571607
52050,The Princess of Nebraska,2008-06-20,2008,0,0,0,0.664931
52051,Seventeen Again,2000-11-12,2000,0,0,0,1.203718
52058,The Nature of Existence,2010-01-01,2010,0,0,0,0.081143
52059,The Gate of Heavenly Peace,1995-01-01,1995,0,0,0,0.10705
52060,Christmas Cupid,2010-12-12,2010,0,0,0,6.622907
52067,Cedar Rapids,2011-02-11,2011,0,6861102,6861102,4.84886
52072,Clouds of May,1999-12-10,1999,0,0,0,0.294108
52073,La maison,2007-08-22,2007,0,0,0,0.179017
52077,Nothing to Declare,2010-12-15,2010,32000000,0,-32000000,8.371842
52083,The Missionary,1982-11-02,1982,0,7241180,7241180,1.196669
52088,Intoxicating,2003-07-01,2003,0,0,0,0.219621
52103,Pickpocket,1997-01-01,1997,0,0,0,0.350365
52105,Husbands,1970-12-08,1970,1000000,0,-1000000,1.336219
52106,I Won the New Year's Lottery,1989-06-06,1989,0,0,0,0.194407
52109,Love Streams,1984-02-20,1984,0,0,0,5.041865
52111,The Small Town,1997-11-28,1997,0,0,0,0.274671
52113,Delitto sull'autostrada,1982-07-31,1982,0,0,0,0.014895
52116,Hands off Mississippi,2007-03-22,2007,0,0,0,0.900245
52117,Hamburger: The Motion Picture,1986-05-05,1986,0,0,0,0.975652
52122,The Family Jewels,1965-07-01,1965,0,0,0,1.15502
52143,Battle Arena Toshinden,1996-06-21,1996,0,0,0,0.038182
52147,Ulak,2008-02-25,2008,0,0,0,0.909691
52150,Zincirbozan,2007-04-13,2007,0,0,0,0.146772
52183,Gecenin Kanatlarƒ±,2009-01-01,2009,0,0,0,0.447144
52188,The Waiting Room,2004-02-27,2004,0,0,0,0.209595
52199,Invasion of the Saucer-Men,1957-06-01,1957,0,0,0,0.360866
52203,The Flesh and the Fiends,1960-02-02,1960,0,0,0,3.367599
52204,The Brain Eaters,1958-09-01,1958,0,0,0,0.100607
52207,Halloween is Grinch Night,1977-10-29,1977,0,0,0,0.690099
52208,Nude Nuns With Big Guns,2010-09-24,2010,0,0,0,7.31941
52212,Miranda,1985-10-15,1985,0,0,0,4.327196
52216,Let's Get Those English Girls,1976-01-07,1976,0,0,0,0.261408
52221,Loving Leah,2009-01-25,2009,0,0,0,0.449706
52225,Majesty,2010-10-28,2010,0,0,0,0.086291
52228,Ex-Lady,1933-05-14,1933,0,0,0,0.542628
52229,Kid Galahad,1937-05-29,1937,0,0,0,0.86193
52236,First Ascent: The Series,2010-01-01,2010,0,0,0,0.008397
52237,Quality Street,1937-03-26,1937,0,0,0,0.656902
52238,Squadra antigangsters,1979-10-10,1979,0,0,0,0.462348
52239,Possessed,1931-11-21,1931,0,0,0,1.123125
52247,The Herb of the Rat,2008-06-26,2008,0,0,0,0.076349
52249,The Red Chapel,2009-05-04,2009,0,0,0,0.181175
52251,Hotel,2004-07-25,2004,0,0,0,0.579155
52252,Ricky Gervais: Out of England 2 - The Stand-Up Special,2010-12-18,2010,0,0,0,0.668146
52254,David Wants to Fly,2010-05-06,2010,0,0,0,0.185056
52255,"Bi, Don't Be Afraid",2010-05-19,2010,0,0,0,0.430238
52256,1612: Chronicles of the Dark Time,2007-10-28,2007,12000000,0,-12000000,1.225282
52258,The Emperor's New Clothes,2001-01-01,2001,0,0,0,0.901594
52260,De Leeuw van Vlaanderen,1985-03-14,1985,0,0,0,1e-06
52263,Amityville: Dollhouse,1996-10-02,1996,0,0,0,2.357522
52264,A Cat in Paris,2010-12-13,2010,0,309973,309973,3.40682
52270,Cluny Brown,1946-05-01,1946,0,0,0,3.008224
52273,Hidden Agenda,2001-05-12,2001,5000000,0,-5000000,0.685233
52274,Julia's Eyes,2010-10-29,2010,0,12884923,12884923,5.020398
52277,The Seagull's Laughter,2001-10-20,2001,0,0,0,0.853764
52278,That Lady in Ermine,1948-08-24,1948,0,0,0,0.826372
52279,The Dentist,1932-12-09,1932,0,0,0,0.646004
52280,The Fatal Glass of Beer,1933-03-03,1933,0,0,0,0.366676
52286,The Student,1988-10-05,1988,0,0,0,3.282591
52297,Alaska: Silence And Solitude,2005-09-06,2005,0,0,0,0.824483
52302,Matango: Attack of the Mushroom People,1963-08-11,1963,0,0,0,1.066454
52304,Archie To Riverdale and Back Again,1990-05-06,1990,0,0,0,0.045173
52311,Candles on Bay Street,2006-11-26,2006,0,0,0,1.961356
52314,Chain of Command,1994-01-01,1994,0,0,0,0.297097
52315,Chained Heat 2,1993-08-25,1993,0,0,0,2.381582
52318,Alien Predators,1985-01-01,1985,0,0,0,0.679484
52320,Home for Christmas,2010-11-12,2010,0,0,0,0.472903
52323,Touching Home,2008-04-29,2008,2000000,0,-2000000,0.457416
52333,Astral City: A Spiritual Journey,2010-05-10,2010,0,0,0,1.466605
52337,Pride of the Marines,1945-08-24,1945,0,0,0,0.366377
52338,Waiting for Forever,2010-02-10,2010,0,0,0,9.679653
52345,Lisbela and the Prisoner,2003-08-22,2003,0,0,0,1.98441
52349,In Gold We Trust,2010-03-07,2010,0,0,0,0.919874
52350,Wandering Streams,2010-01-02,2010,0,0,0,0.771145
52355,Hot Saturday,1932-10-28,1932,0,0,0,0.148579
52358,Suzy,1936-07-20,1936,0,0,0,2.199117
52359,The Toast of New York,1937-07-30,1937,0,0,0,0.516739
52360,The Howards of Virginia,1940-09-19,1940,0,0,0,0.482353
52362,None But the Lonely Heart,1944-10-17,1944,0,0,0,1.038789
52364,Crisis,1950-07-07,1950,0,0,0,0.442558
52365,Dream Wife,1953-06-19,1953,0,0,0,1.185885
52366,Lucie Aubrac,1997-02-26,1997,0,458557,458557,1.122218
52367,Kiss Them for Me,1957-12-10,1957,0,0,0,0.786831
52369,The Pack,2010-09-29,2010,0,0,0,3.732458
52371,LelleBelle,2010-10-09,2010,0,0,0,4.653678
52395,Fear,1990-07-15,1990,0,0,0,0.861893
52400,Yoroi: Samurai zombie,2008-06-30,2008,0,0,0,0.040003
52406,Fresh,2009-05-26,2009,412000,0,-412000,0.086169
52415,Crush and Blush,2008-10-16,2008,0,0,0,0.954434
52416,4 Horror Tales - Roommates,2006-08-03,2006,0,0,0,0.686167
52418,Fate,2008-03-20,2008,0,0,0,0.919395
52429,Theodora Goes Wild,1936-11-12,1936,0,0,0,0.702752
52432,"High, Wide, and Handsome",1937-07-21,1937,0,0,0,0.025823
52437,Invitation to Happiness,1939-06-07,1939,0,0,0,0.005404
52440,The White Cliffs of Dover,1944-05-11,1944,0,0,0,0.485309
52441,Parallel Life,2010-02-18,2010,0,0,0,0.364937
52444,Seducing Mr. Perfect,2006-12-07,2006,2800000,0,-2800000,0.732452
52445,Soo,2007-03-22,2007,0,1275162,1275162,0.911459
52448,Witch's Night Out,1978-10-27,1978,0,0,0,0.085039
52449,Bad Teacher,2011-05-16,2011,20000000,216197492,196197492,7.310686
52451,The Three Musketeers,2011-08-31,2011,75000000,132274484,57274484,6.303466
52452,Johnny Was,2006-09-19,2006,4300000,0,-4300000,0.647692
52454,Mega Shark vs. Crocosaurus,2010-12-21,2010,0,0,0,7.006573
52457,Daisy-Head Mayzie,1995-02-05,1995,0,0,0,0.00177
52458,The Butter Battle Book,1989-11-13,1989,0,0,0,0.036572
52461,Carrie Fisher: Wishful Drinking,2010-12-10,2010,0,0,0,1.104944
52462,The Pet,2006-05-17,2006,0,0,0,1.854367
52470,My Man Godfrey,1957-10-11,1957,0,0,0,0.193758
52472,Bandwagon,1996-01-08,1996,0,0,0,0.071847
52473,Allegro,2005-09-30,2005,1500000,0,-1500000,0.462846
52474,I Love You Very Much,2010-11-10,2010,0,0,0,0.407816
52475,Young Goethe in Love,2010-10-14,2010,0,0,0,2.981081
52477,Alien Cargo,1999-01-28,1999,0,0,0,0.616191
52480,Texas Across the River,1966-10-26,1966,0,0,0,0.3214
52485,Further Adventures of the Wilderness Family,1978-11-15,1978,0,0,0,0.484788
52488,A More Perfect Union,1989-01-07,1989,0,0,0,0.035522
52505,The Other Woman,2010-10-28,2010,30000000,102000000,72000000,6.212898
52512,Caf√© Lumi√®re,2004-09-01,2004,0,0,0,0.906583
52517,State Fair,1933-02-10,1933,0,0,0,0.246824
52520,Underworld: Awakening,2012-01-19,2012,70000000,160112671,90112671,12.345348
52528,Bloodbath at the House of Death,1984-03-29,1984,0,0,0,0.33909
52531,The Blind Menace,1960-09-01,1960,0,0,0,0.331624
52537,Twisted,1996-11-14,1996,0,0,0,0.516097
52538,Mariages !,2004-04-21,2004,0,0,0,1.803989
52555,Chronicle of the Years of Fire,1975-11-26,1975,0,0,0,0.074829
52556,The Road,1982-09-01,1982,0,0,0,1.460634
52557,Banzai,1983-03-23,1983,0,0,0,1.505466
52560,Book of Love,1990-08-03,1990,0,0,0,0.603549
52561,The Whole Town's Talking,1935-02-22,1935,0,0,0,0.887774
52587,We Are the Night,2010-10-28,2010,0,0,0,4.767937
52589,Tokyo Tower,2005-01-15,2005,0,0,0,0.863877
52593,Home in Oklahoma,1946-10-18,1946,0,0,0,0.012918
52605,Strapped,2010-09-24,2010,0,0,0,1.307499
52608,Z.P.G.,1972-05-25,1972,0,0,0,3.835168
52612,Le cr√©ateur,1999-06-16,1999,0,0,0,0.971657
52615,Meltdown: Days of Destruction,2006-02-27,2006,0,0,0,0.863706
52616,Pavilion of Women,2001-03-16,2001,0,0,0,0.501948
52620,Little Fugitive,1953-10-06,1953,30000,0,-30000,1.062743
52622,Total Western,2000-06-13,2000,0,0,0,0.236453
52623,Missing,2007-01-01,2007,0,1,1,0.229233
52627,Knights,1993-04-19,1993,0,0,0,0.508868
52628,Cartagena,2009-11-18,2009,0,0,0,1.304441
52629,El Infierno,2010-09-03,2010,0,0,0,3.030907
52633,Switchblade Sisters,1975-01-05,1975,0,0,0,6.035166
52637,Yuki & Nina,2009-11-27,2009,0,0,0,0.113018
52639,Blood of the Vampire,1958-08-25,1958,0,0,0,0.881563
52653,Jinn,2014-04-04,2014,0,149337,149337,4.907797
52654,The Luzhin Defence,2000-08-21,2000,0,0,0,0.879721
52655,Shooters,2001-11-17,2001,0,0,0,0.420283
52660,Cast a Deadly Spell,1991-01-01,1991,0,0,0,2.662262
52661,99 and 44/100% Dead,1974-08-29,1974,0,0,0,0.07852
52663,The Foul King,2000-02-04,2000,0,0,0,1.21143
52666,The Debt,1999-11-19,1999,0,0,0,0.319215
52677,The Crime of Monsieur Lange,1936-01-24,1936,0,0,0,0.573137
52679,The Last Command,1928-01-22,1928,0,0,0,4.030927
52681,"September 30, 1955",1978-01-06,1978,0,0,0,0.000463
52685,Chill,2007-02-15,2007,850000,0,-850000,0.190974
52686,The Little Norse Prince,1968-07-24,1968,0,0,0,1.228767
52696,Band Baaja Baaraat,2010-12-10,2010,0,0,0,1.253675
52701,A Humble Life,1997-05-22,1997,0,0,0,0.081326
52702,Superstition,1982-08-26,1982,0,0,0,1.693107
52705,Les Carabiniers,1963-05-31,1963,0,0,0,2.008603
52710,Detective,1985-05-10,1985,0,0,0,0.532973
52713,"Oh, Woe Is Me",1993-09-08,1993,0,0,0,1.017083
52717,In Praise of Love,2001-05-16,2001,0,0,0,0.525668
52721,Blackie the Pirate,1971-03-12,1971,0,0,0,1.268232
52725,Fierce Light: When Spirit Meets Action,2008-01-01,2008,1180000,0,-1180000,0.00353
52726,Gervaise,1956-09-05,1956,0,0,0,0.443843
52728,Gamera vs. Gyaos,1967-03-15,1967,0,0,0,0.878849
52734,Hard to Hold,1984-06-29,1984,0,0,0,0.006668
52735,Love in the Time of Money,2002-11-01,2002,0,0,0,0.72422
52736,Hardbodies,1984-05-04,1984,0,0,0,1.645408
52738,A perfect match,2007-08-08,2007,0,0,0,0.006527
52741,Side Out,1990-03-30,1990,0,0,0,0.131923
52744,Falling in Love,1984-11-21,1984,0,11129057,11129057,5.289075
52745,The Leech Woman,1960-05-01,1960,0,0,0,0.600283
52748,The Skin Game,1931-02-26,1931,0,0,0,1.775534
52758,You Only Live Once,1937-01-29,1937,575,0,-575,1.543832
52761,Daisy Town,1971-11-01,1971,0,0,0,2.795347
52762,The Mysterious Geographic Explorations of Jasper Morello,2005-01-19,2005,0,0,0,0.688867
52764,Sugarhouse,2007-08-24,2007,0,0,0,0.768302
52767,The Hunter,2010-04-08,2010,0,0,0,0.876263
52770,Things Change,1988-10-21,1988,0,0,0,6.272716
52772,Shoot the Moon,1982-01-22,1982,0,8100000,8100000,1.194891
52775,Fanfare,1958-10-04,1958,0,0,0,0.682221
52776,72 Tenants of Prosperity,2010-02-11,2010,0,0,0,0.882086
52777,Split Image,1982-11-04,1982,0,263635,263635,0.185169
52778,Until September,1984-09-21,1984,0,4100000,4100000,0.489054
52779,Glass,1958-01-01,1958,0,0,0,0.476676
52780,The Glass Menagerie,1987-10-23,1987,0,0,0,0.64701
52782,Downhill,1927-10-24,1927,0,0,0,1.646779
52784,His and Hers,2001-09-02,2001,0,0,0,0.281208
52788,Sisters,2006-11-10,2006,60000,0,-60000,1.241769
52794,Baxter,1989-01-18,1989,0,0,0,0.005568
52796,Winter Solstice,2004-01-29,2004,0,0,0,0.438299
52799,Undertow,2009-09-23,2009,0,0,0,2.21023
52803,Sebastian's Voodoo,2008-06-07,2008,2000,0,-2000,0.942521
52805,The Truth About Jane,2000-08-07,2000,0,0,0,0.492987
52808,"Rome, Armed to the Teeth",1976-10-10,1976,0,0,0,0.039473
52809,Brothers Till We Die,1978-08-17,1978,0,0,0,1.154675
52810,"The Cynic, the Rat & the Fist",1977-02-03,1977,0,0,0,0.896682
52817,Bitter Feast,2010-07-08,2010,0,0,0,1.194121
52826,Nothing Lasts Forever,1984-09-06,1984,0,0,0,0.626202
52827,Thunderhead - Son of Flicka,1945-03-15,1945,0,0,0,0.37161
52837,Warrior of the Lost World,1983-01-01,1983,500000,0,-500000,0.432254
52841,Bachelor in Paradise,1961-11-01,1961,0,0,0,1.261728
52844,It Happened on Fifth Avenue,1947-04-19,1947,0,0,0,1.27534
52846,The Lady Is Willing,1942-02-17,1942,0,0,0,0.286405
52847,The Toast of New Orleans,1950-08-24,1950,0,0,0,0.108856
52848,The West Point Story,1950-11-25,1950,0,0,0,0.293671
52849,A Bell From Hell,1973-10-01,1973,0,0,0,1.123296
52850,Toast,2010-12-30,2010,0,0,0,4.456701
52853,Rio Rita,1942-04-01,1942,0,0,0,0.216012
52854,Black Magic,1975-10-02,1975,0,0,0,1.441442
52855,Dangerous Ground,1997-02-12,1997,0,3028094,3028094,1.463219
52856,Unstrung Heroes,1995-09-15,1995,0,0,0,2.881689
52857,The Prisoner,1955-04-19,1955,0,0,0,0.735358
52859,The Long Voyage Home,1940-11-11,1940,0,0,0,5.72178
52863,Dangerous,1935-12-25,1935,0,0,0,2.365103
52864,Special Agent,1935-09-14,1935,0,0,0,0.560858
52867,Lord Love a Duck,1966-02-21,1966,0,0,0,0.533987
52868,House IV,1992-01-21,1992,0,0,0,0.821998
52870,Parade,2010-02-20,2010,0,0,0,0.580973
52873,My Favorite Season,1993-05-14,1993,0,0,0,0.516924
52874,"The Yakuza Papers, Vol. 3: Proxy War",1973-09-25,1973,0,0,0,0.092295
52885,The Red and the White,1967-11-03,1967,0,0,0,1.660758
52886,Castaway,1986-03-05,1986,0,0,0,1.540592
52891,Hitler's Kaput!,2008-09-18,2008,3000000,9713500,6713500,0.878255
52894,Thunder Alley,1985-08-01,1985,0,0,0,0.071829
52903,Steam of Life,2010-03-26,2010,580000,0,-580000,0.982331
52906,Goodbye Charlie,1964-11-18,1964,0,0,0,1.260757
52907,Waltzes from Vienna,1934-01-31,1934,0,0,0,0.751957
52912,Destruction Force,1977-10-01,1977,0,0,0,0.146747
52913,Little Italy,1978-10-10,1978,0,0,0,0.27124
52914,Squadra antifurto,1976-10-29,1976,0,0,0,0.222772
52916,Sabata,1969-09-16,1969,0,0,0,1.447975
52918,The Oath,2010-05-09,2010,0,0,0,0.66481
52920,What Will You Do When You Catch Me?,1978-12-08,1978,0,0,0,0.004974
52925,Recipe for a Perfect Christmas,2005-12-05,2005,0,0,0,0.322377
52936,In the Soup,1992-10-23,1992,0,256249,256249,1.272864
52939,Tri bogatyrya i Shamakhanskaya tsaritsa,2010-12-29,2010,3000000,19010585,16010585,1.412333
52941,"I, Monster",1971-11-01,1971,0,0,0,1.069442
52943,The Phone Box,1972-12-13,1972,0,0,0,1.487562
52947,Kung Fu Mahjong,2005-10-10,2005,0,0,0,0.434269
52949,An Evening of Edgar Allan Poe,1970-01-01,1970,0,0,0,0.301566
52954,Rabbit Seasoning,1952-09-20,1952,0,0,0,1.648768
52959,Star!,1968-07-18,1968,14320000,14000000,-320000,0.585397
52960,The Tamarind Seed,1974-07-11,1974,0,0,0,1.436002
52961,That's Life!,1986-10-10,1986,0,0,0,1.390361
52970,Ninja Wars,1982-12-18,1982,0,0,0,0.301613
52979,"The Yakuza Papers, Vol. 4: Police Tactics",1974-01-15,1974,0,0,0,0.005984
52980,"The Yakuza Papers, Vol. 2: Deadly Fight in Hiroshima",1973-04-28,1973,0,0,0,1.492582
52989,How the Toys Saved Christmas,1996-12-05,1996,0,0,0,0.266335
52991,My Son John,1952-04-08,1952,0,0,0,0.135091
52996,A Fistful of Fingers,1995-11-24,1995,0,0,0,0.720637
52998,El Dorado,1988-04-20,1988,0,0,0,0.000578
52999,The Adversary,2002-08-28,2002,0,0,0,2.056752
53000,Soul Assassin,2001-08-23,2001,0,0,0,0.239635
53010,La Chance de ma vie,2011-01-05,2011,5000000,0,-5000000,4.105063
53019,Der var engang,1966-10-01,1966,0,0,0,0.673009
53021,"Kiss Me, Stupid",1964-12-22,1964,3500000,0,-3500000,2.126174
53023,Le Bonheur,1965-02-10,1965,0,0,0,0.792486
53027,Mystery Date,1991-08-16,1991,0,6166819,6166819,1.784133
53031,Living Free,1972-12-16,1972,0,0,0,0.441099
53033,Poppy Shakespeare,2008-03-31,2008,0,0,0,0.592315
53034,Legend of Lemnear,1987-07-24,1987,0,0,0,0.50694
53035,Kevorkian,2010-06-28,2010,2500000,0,-2500000,0.041316
53042,Alice,2005-05-16,2005,0,0,0,0.355953
53045,Hands of the Ripper,1971-10-17,1971,0,0,0,0.649984
53048,Bartleby,2001-03-10,2001,0,0,0,1.215051
53049,Claire of the Moon,1992-09-18,1992,130000,799674,669674,0.59091
53050,Ghost of Dragstrip Hollow,1959-07-01,1959,0,0,0,0.558394
53061,The Expert,1995-08-15,1995,0,0,0,0.12784
53063,Forced to Kill,1994-05-18,1994,0,0,0,0.042391
53064,Midori,1992-05-02,1992,0,0,0,2.093161
53074,Mafalda - La Pelicula,1981-01-01,1981,0,0,0,0.100978
53079,Who Is Harry Nilsson (And Why Is Everybody Talkin' About Him?),2010-10-26,2010,0,28200,28200,3.063163
53080,Malibu Shark Attack,2009-07-25,2009,3000000,0,-3000000,1.13806
53085,Piranha Hunt,2006-04-06,2006,0,0,0,0.784854
53086,Paragraph 78: Film One,2007-02-21,2007,0,0,0,0.934723
53092,"Niagara, Niagara",1997-08-30,1997,0,168462,168462,0.782772
53094,World on a Wire,1973-10-14,1973,0,0,0,5.168563
53100,Bringing Up Bobby,2011-11-25,2011,0,0,0,1.239118
53101,Manborg,2011-09-22,2011,0,0,0,2.274115
53103,My Queen Karo,2009-10-28,2009,0,0,0,0.656156
53104,Orgasm Inc.,2009-05-02,2009,0,0,0,0.633993
53113,One True Thing,1998-09-18,1998,0,0,0,2.586355
53116,Between Your Legs,1999-01-22,1999,0,0,0,1.821541
53117,Don't Tell Anyone,1998-07-16,1998,0,0,0,0.802286
53119,Left Luggage,1998-03-30,1998,0,100544,100544,0.444226
53121,Barking Water,2009-01-17,2009,0,0,0,0.410945
53128,With Heart & Soul,2009-10-22,2009,0,0,0,0.120467
53129,The Turkish Gambit,2005-02-22,2005,0,0,0,0.963791
53144,Heldorado,1946-12-15,1946,0,0,0,0.210934
53146,The Debt,2007-11-29,2007,0,0,0,0.501715
53150,C.H.U.D. II: Bud the Chud,1989-05-05,1989,0,0,0,4.980211
53151,Joe the King,1999-10-17,1999,0,0,0,1.487046
53155,Free Hand for a Tough Cop,1976-08-27,1976,0,0,0,0.57288
53156,Elena and Her Men,1956-09-12,1956,0,0,0,0.767679
53157,The Park is Mine,1985-10-06,1985,4500000,0,-4500000,4.476443
53161,White Shadows in the South Seas,1928-11-11,1928,0,0,0,0.136278
53163,Love on Delivery,1994-02-04,1994,0,0,0,0.8825
53168,King of Comedy,1999-02-13,1999,0,0,0,3.139003
53172,Henry's Crime,2010-01-14,2010,12000000,204940,-11795060,5.145185
53174,Kokowaah,2011-02-02,2011,5650000,43000000,37350000,5.24461
53178,The Cat's Out,1931-07-28,1931,11087,0,-11087,0.092377
53179,Le ma√Ætre d'√©cole,1981-10-28,1981,0,0,0,0.27202
53182,300: Rise of an Empire,2014-03-05,2014,110000000,337580051,227580051,12.904677
53185,Wide Eyed and Legless,1993-09-05,1993,0,0,0,0.00015
53187,The Return of Dracula,1958-04-01,1958,0,0,0,0.65617
53190,The Two Escobars,2010-06-22,2010,0,0,0,0.758472
53191,Crazy Sexy Cancer,2007-03-11,2007,0,0,0,0.041164
53194,Triumph Over Violence,1965-12-31,1965,0,0,0,1.307804
53196,Before Flying Back to Earth,2005-10-10,2005,0,0,0,0.212159
53197,A Grin Without a Cat,1977-11-23,1977,0,0,0,0.107892
53198,My Voyage to Italy,1999-09-11,1999,0,0,0,0.875175
53200,Lessons of Darkness,1992-02-21,1992,0,0,0,1.733134
53202,The T.A.M.I. Show,1964-12-29,1964,0,0,0,0.409958
53204,Amazing Journey: The Story of The Who,2007-09-14,2007,0,0,0,0.05157
53206,Happy Days,1978-01-01,1978,0,0,0,0.001021
53209,The Patsy,1928-04-22,1928,0,0,0,0.425882
53210,Duck Amuck,1953-02-28,1953,0,0,0,1.988946
53211,One Froggy Evening,1955-12-30,1955,0,0,0,2.033049
53214,Signs,2008-03-10,2008,0,0,0,1.11608
53215,Kiwi!,2006-01-01,2006,0,0,0,1.994703
53216,Validation,2007-01-01,2007,0,0,0,1.508679
53217,"What's Opera, Doc?",1957-07-06,1957,0,0,0,2.129326
53218,An Occurrence at Owl Creek Bridge,1962-05-01,1962,0,0,0,0.76162
53219,Mickey's Trailer,1938-05-06,1938,0,0,0,2.196177
53220,Rabbit Fire,1951-05-19,1951,0,0,0,0.864909
53222,Skhizein,2008-06-09,2008,0,0,0,1.327341
53223,Powers of Ten,1977-01-01,1977,0,0,0,0.002317
53229,Requiem for a Heavyweight,1962-10-16,1962,0,0,0,1.199649
53230,The Merry Widow,1925-08-26,1925,592,1,-591,0.286719
53231,Beyond the Rocks,1922-05-07,1922,0,0,0,0.107236
53232,Five and Ten,1931-06-13,1931,0,0,0,0.051534
53234,Identification of a Woman,1982-10-21,1982,0,0,0,1.350133
53237,The Last Lovecraft: Relic of Cthulhu,2009-10-03,2009,0,0,0,1.0971
53244,Sex Is Comedy,2002-06-05,2002,0,0,0,1.562703
53245,Yeti: Curse of the Snow Demon,2008-11-08,2008,0,0,0,0.801891
53252,The Ugly Swans,2006-10-19,2006,0,0,0,0.641755
53256,Three,2010-12-23,2010,0,2611555,2611555,4.898882
53263,Price of Glory,2000-05-31,2000,10000000,0,-10000000,0.52082
53267,On the Occasion of Remembering the Turning Gate,2002-03-22,2002,0,0,0,1.935173
53268,World Builder,2007-01-01,2007,0,0,0,0.373912
53283,Khichdi: The Movie,2010-10-01,2010,0,0,0,0.129796
53284,Do Dooni Chaar,2010-10-08,2010,0,0,0,0.151141
53287,The Super,1991-10-04,1991,22000000,11000863,-10999137,4.196125
53290,Plastic Planet,2009-09-15,2009,0,0,0,0.51045
53296,Beauty and the Bastard,2005-10-21,2005,0,0,0,0.814929
53301,Toss-Up,2004-09-24,2004,0,0,0,0.328221
53310,Sci-fighters,1996-12-30,1996,0,0,0,0.401204
53315,The Kreutzer Sonata,2008-06-20,2008,0,0,0,0.086266
53318,The Fairy King Of Ar,1998-01-01,1998,0,0,0,1.054717
53319,What a Beautiful Day,2011-01-05,2011,6000000,0,-6000000,3.793012
53328,The Last Mountain,2011-06-03,2011,0,90425,90425,0.07821
53335,Candy Stripers,2006-06-27,2006,0,0,0,0.91894
53336,Soldier In The Rain,1963-11-27,1963,0,0,0,0.46871
53342,Delitto al Blue Gay,1984-11-11,1984,0,0,0,0.111062
53344,Lemmy,2010-03-15,2010,0,0,0,2.561829
53354,In Their Sleep,2010-03-21,2010,0,0,0,1.461445
53355,Nightmare at Noon,1988-09-28,1988,0,0,0,0.000844
53358,Fubar II,2010-10-01,2010,0,0,0,0.405272
53364,Der letzte sch√∂ne Herbsttag,2010-11-11,2010,0,0,0,0.121914
53367,Charlie: The Life and Art of Charles Chaplin,2003-05-01,2003,0,0,0,10.351391
53368,Making a Living,1914-02-02,1914,0,0,0,0.502653
53374,Mabel at the Wheel,1914-04-18,1914,0,0,0,0.483293
53380,Divine Trash,1998-01-18,1998,0,39842,39842,1.143004
53385,The Knockout,1914-06-11,1914,0,0,0,0.287549
53387,Mabel's Married Life,1914-06-20,1914,0,0,0,0.217682
53389,Trader Games,2010-09-01,2010,0,0,0,1.122716
53392,His New Profession,1914-08-31,1914,0,0,0,0.339995
53397,His Musical Career,1914-11-07,1914,0,0,0,0.784595
53399,The Solitude of Prime Numbers,2010-09-10,2010,0,0,0,3.497322
53403,A Night Out,1915-02-15,1915,0,0,0,0.403987
53404,Love Crime,2010-08-09,2010,0,0,0,2.440568
53405,In the Park,1915-03-18,1915,0,0,0,0.857619
53406,By the Sea,1915-04-29,1915,0,0,0,0.577051
53407,His Regeneration,1915-05-07,1915,0,0,0,0.077873
53410,The Bank,1915-08-09,1915,0,0,0,0.955414
53411,Shanghaied,1915-10-04,1915,0,0,0,0.396449
53412,A Night in the Show,1915-11-20,1915,0,0,0,2.718023
53413,The Strange Case of Angelica,2010-12-29,2010,2000000,0,-2000000,0.70052
53414,Police,1916-05-27,1916,0,0,0,1.657657
53416,The Floorwalker,1916-05-15,1916,0,0,0,1.558567
53417,The Fireman,1916-06-12,1916,0,0,0,1.250114
53418,One A.M.,1916-08-07,1916,0,0,0,1.472505
53419,Behind the Screen,1916-11-13,1916,0,0,0,1.097877
53420,The Cure,1917-04-16,1917,0,0,0,1.472339
53421,Triple Trouble,1918-08-11,1918,0,0,0,0.456385
53423,Shoulder Arms,1918-08-20,1918,0,0,0,1.448145
53424,Sunnyside,1919-06-15,1919,0,0,0,1.105613
53425,A Day's Pleasure,1919-12-15,1919,0,0,0,0.331941
53426,The Evil That Men Do,1984-03-14,1984,0,0,0,1.488663
53430,The Pilgrim,1923-02-26,1923,0,0,0,1.34682
53435,"A Man, a Woman and a Bank",1979-09-28,1979,0,0,0,0.616693
53437,Strongman,2011-01-25,2011,0,0,0,0.083285
53441,You're Never Too Young,1955-08-25,1955,0,0,0,0.844448
53445,The Unloved,2009-05-17,2009,0,0,0,1.812246
53446,Blue Skies,1946-10-15,1946,0,0,0,0.207643
53456,What War May Bring,2010-09-15,2010,0,0,0,0.313699
53457,Sarah's Key,2010-09-16,2010,10000000,17511906,7511906,6.091224
53459,F,2010-09-07,2010,1300000,0,-1300000,2.299942
53463,Dreamland,2007-02-27,2007,0,0,0,0.635456
53472,De Flat,1994-04-21,1994,0,0,0,0.367507
53482,One Man Up,2001-08-31,2001,0,0,0,1.270431
53486,The Family Friend,2006-10-01,2006,0,0,0,1.648111
53487,This Must Be the Place,2011-10-01,2011,25000000,11790979,-13209021,10.710831
53500,Lomalla,2000-12-01,2000,0,0,0,0.177569
53503,Me and Morrison,2001-12-28,2001,0,0,0,1.291258
53505,The Last Lions,2011-02-11,2011,0,0,0,5.37272
53514,Cyrano Agency,2010-09-16,2010,0,0,0,1.240166
53516,"Billy Blazes, Esq.",1919-07-06,1919,0,0,0,0.173856
53518,Now or Never,1921-03-27,1921,0,0,0,0.147469
53519,High and Dizzy,1920-07-11,1920,0,0,0,0.217148
53520,Face,2009-10-02,2009,0,0,0,0.73406
53522,Movie Crazy,1932-09-23,1932,0,0,0,0.150713
53524,"Danny, The Champion of the World",1989-04-29,1989,0,0,0,0.583021
53527,Professor Beware,1938-07-29,1938,0,0,0,0.097874
53543,Claymation Comedy of Horrors,1991-05-29,1991,0,0,0,0.007319
53544,Unborn in the USA: Inside the War on Abortion,2007-06-15,2007,0,0,0,0.041153
53554,Hundhotellet,2000-10-03,2000,0,0,0,0.378644
53565,Steamboat Willie,1928-11-18,1928,4986,0,-4986,3.394625
53567,Thale,2012-02-16,2012,0,0,0,2.775518
53569,No One Killed Jessica,2011-01-07,2011,0,0,0,0.785505
53571,"Parlor, Bedroom and Bath",1931-02-28,1931,0,0,0,0.122557
53573,Sidewalks of New York,1931-09-26,1931,0,0,0,0.001859
53574,Born to the West,1937-12-10,1937,0,0,0,0.251068
53575,The Passionate Plumber,1932-02-06,1932,0,0,0,0.038698
53576,What! No Beer?,1933-02-10,1933,0,0,0,0.001753
53596,Even the Rain,2010-09-16,2010,10600000,0,-10600000,3.917709
53598,The Villain Still Pursued Her,1940-10-11,1940,0,0,0,0.001799
53617,Pajama Party,1964-11-11,1964,0,0,0,0.297137
53619,Sergeant Dead Head,1965-08-18,1965,0,0,0,0.005905
53622,The Man From Utah,1934-05-15,1934,0,0,0,2.098026
53623,Two Marines and a General,1966-04-20,1966,0,0,0,0.418877
53624,The Desert Trail,1935-04-21,1935,0,0,0,0.784048
53648,Seeking Asylum,1979-10-24,1979,0,0,0,0.439138
53650,The Ugly American,1963-04-02,1963,0,0,0,0.875873
53651,Hangman's Knot,1952-11-15,1952,0,0,0,2.893266
53654,The Brotherhood,1968-12-01,1968,0,0,0,0.751144
53655,The Box,2007-01-01,2007,0,0,0,0.450207
53657,Raid on Rommel,1971-02-12,1971,0,0,0,2.002281
53670,Say Nothing,2001-08-01,2001,0,0,0,0.229743
53685,Telling You,1998-08-07,1998,0,0,0,0.376634
53688,Stinsen brinner... filmen allts√•,1991-03-03,1991,0,0,0,0.074832
53689,Monopol,1996-11-29,1996,0,0,0,0.143323
53693,Krummerne,1991-10-04,1991,0,0,0,0.791976
53701,Who's Camus Anyway?,2005-10-03,2005,0,0,0,0.180219
53712,A Kiss Before Dying,1956-06-12,1956,0,0,0,2.711073
53714,Another Man's Poison,1951-11-20,1951,0,0,0,2.021032
53729,Wild Cherry,2009-02-07,2009,3500000,0,-3500000,5.689825
53734,A Foreign Affair,2003-01-21,2003,0,0,0,0.85986
53739,For the Good of Others,2010-06-03,2010,0,0,0,0.714674
53741,Crazy Love,1987-10-01,1987,0,119919,119919,0.288203
53743,Wild Combination: A Portrait of Arthur Russell,2008-09-26,2008,0,0,0,0.118612
53759,The Wonderful Wizard of Oz,1910-03-24,1910,0,0,0,0.759167
53761,Male and Female,1919-11-23,1919,0,0,0,1.175646
53765,Mr. Jealousy,1997-09-11,1997,0,0,0,0.728872
53766,Why Change Your Wife?,1920-05-21,1920,0,0,0,0.193764
53767,Kaagaz Ke Phool,1959-02-01,1959,0,0,0,0.177365
53769,Singapore,1947-08-13,1947,0,0,0,0.272778
53772,The Affairs of Anatol,1921-09-25,1921,0,0,0,0.083294
53774,The Sinking of the Laconia,2011-01-06,2011,18550417,0,-18550417,1.573298
53776,Nobody Else But You,2011-01-12,2011,0,0,0,3.352027
53778,DMT: The Spirit Molecule,2010-10-15,2010,0,0,0,1.641261
53779,Kings Row,1942-04-18,1942,0,0,0,0.877933
53780,The Amazing Mr Blunden,1972-12-07,1972,0,0,0,0.268079
53781,Rainbow Valley,1935-03-15,1935,0,0,0,0.394636
53792,Counsellor at Law,1933-12-25,1933,0,0,0,0.499504
53796,The Trespasser,1929-11-11,1929,0,0,0,0.145548
53798,Father Takes a Wife,1941-10-03,1941,0,0,0,0.053283
53800,Sherlock Holmes,1922-03-07,1922,0,0,0,1.206513
53804,No Problem,2010-12-10,2010,0,0,0,0.77532
53805,Cemento Armato,2007-10-05,2007,0,0,0,1.392158
53807,"Bruce Lee, My Brother",2010-11-25,2010,0,0,0,2.712488
53827,The Dawn Rider,1935-06-20,1935,0,0,0,1.228535
53828,Blue Steel,1934-05-10,1934,0,0,0,0.94151
53830,'Neath the Arizona Skies,1934-12-05,1934,0,0,0,0.343641
53834,Mr. Peabody and the Mermaid,1948-08-11,1948,0,0,0,0.80741
53850,Basilisk: The Serpent King,2006-11-25,2006,0,0,0,0.83825
53851,The Baroness and the Butler,1938-02-18,1938,0,0,0,0.039214
53853,The Emperor's Candlesticks,1937-07-02,1937,0,0,0,0.113817
53857,The Last of Mrs. Cheyney,1937-02-19,1937,0,0,0,1.72531
53860,Rendezvous,1935-10-25,1935,0,0,0,0.147055
53861,Die,2010-01-06,2010,0,0,0,1.898197
53862,Trippin',1999-05-12,1999,0,9016377,9016377,0.218263
53863,Star of Midnight,1935-04-19,1935,280,831,551,0.110801
53864,Evelyn Prentice,1934-11-09,1934,0,0,0,0.715067
53865,The Key,1934-06-09,1934,0,0,0,0.184905
53868,The Vault of Horror,1973-03-16,1973,0,0,0,2.278268
53870,10.5,2004-05-02,2004,20000000,0,-20000000,5.536166
53871,Glastonbury,2006-04-13,2006,0,0,0,0.328167
53875,Journey to the Center of the Earth,1999-07-07,1999,0,0,0,1.529991
53879,Love Is a Many-Splendored Thing,1955-08-18,1955,0,0,0,1.553697
53882,Absence of the Good,1999-10-15,1999,17,0,-17,0.737285
53883,Anjathe,2008-02-14,2008,0,0,0,0.158599
53896,Close My Eyes,1991-11-22,1991,0,135893,135893,1.404434
53898,A Safe Place,1971-10-01,1971,0,0,0,0.707226
53905,Marilyn Hotchkiss' Ballroom Dancing & Charm School,2006-01-24,2006,2500000,0,-2500000,7.113961
53906,Jet Pilot,1957-10-11,1957,9000000,0,-9000000,0.836961
53909,The Perfect Murder,1988-08-03,1988,0,0,0,0.690045
53914,The Story of Piera,1983-02-02,1983,0,0,0,1.44879
53915,But Forever in My Mind,1999-10-01,1999,0,0,0,1.130083
53922,Carbon Copy,1981-09-25,1981,0,9566593,9566593,3.858572
53928,Adam and Eve,2005-11-05,2005,0,0,0,1.621741
53931,Seven Alone,1974-12-20,1974,0,0,0,0.201163
53935,Living 'til the End,2005-10-21,2005,0,0,0,0.221851
53939,Sons and Lovers,1960-08-29,1960,0,0,0,2.575294
53945,Pirates: Blood Brothers,1999-01-03,1999,0,0,0,1.114882
53947,The Murder of Fred Hampton,1971-01-01,1971,0,0,0,0.000578
53949,The Monster that Challenged the World,1957-06-01,1957,0,0,0,1.721675
53950,The Hearse,1980-06-01,1980,0,0,0,1.362088
53953,The Tooth Fairy,2006-08-08,2006,0,0,0,0.740517
53957,La matassa,2009-03-13,2009,0,0,0,4.314133
53961,Brainstorm,2001-06-22,2001,0,0,0,1.071448
53962,The Mediator,1990-01-01,1990,0,0,0,1e-06
53975,New Wave,2008-09-19,2008,0,0,0,0.15538
53985,Mutant Pumpkins from Outer Space,2009-10-28,2009,0,0,0,4.579609
53999,My Super Psycho Sweet 16: Part 2,2010-10-22,2010,0,0,0,0.694531
54000,Fedora,1978-05-30,1978,6727000,0,-6727000,1.935843
54001,The Traveler,1974-01-01,1974,0,0,0,0.036044
54002,Listening to You: The Who Live at the Isle of Wight,1998-11-03,1998,0,0,0,0.272714
54003,Pups,1999-04-18,1999,0,0,0,0.798845
54007,Star Kid,1997-01-16,1997,0,7,7,1.079117
54008,Sugar Hill,1974-02-01,1974,0,0,0,0.937372
54013,The Visitor,1979-03-22,1979,800000,0,-800000,3.035226
54022,Search and Destroy,1995-01-01,1995,4000000,389503,-3610497,0.737602
54028,The Clock,1945-04-25,1945,0,0,0,0.549031
54040,Wanderlust,2006-07-12,2006,0,0,0,0.195999
54045,The Code,2002-10-22,2002,0,0,0,0.903935
54050,The Over-the-Hill Gang,1969-10-07,1969,0,0,0,0.422313
54051,The Song of Ceylon,1934-11-30,1934,0,0,0,0.037259
54052,Who Do I Gotta Kill?,1994-07-07,1994,0,0,0,0.444714
54054,One for the Money,2012-01-26,2012,40000000,36893721,-3106279,6.322435
54064,Call Me Elisabeth,2006-11-15,2006,0,0,0,0.157796
54075,Choose,2011-01-17,2011,0,0,0,1.754538
54081,Aakrosh,2010-10-01,2010,0,0,0,0.405492
54083,Film Socialisme,2010-05-17,2010,0,0,0,1.992959
54087,Mr. Saturday Night,1992-09-23,1992,43000000,13300000,-29700000,0.987196
54093,Killing Bono,2011-04-01,2011,0,0,0,2.271809
54099,Hyenas,2010-05-12,2010,0,0,0,1.731322
54102,Generation Kill,2008-07-13,2008,0,0,0,4.213894
54105,Immigration Tango,2010-04-17,2010,0,0,0,0.118978
54107,"Splash, Too",1988-05-01,1988,0,0,0,0.138058
54109,The Witch Who Came from the Sea,1976-02-06,1976,0,0,0,1.057618
54111,Whispering Corridors 2: Memento Mori,1999-12-24,1999,0,0,0,1.822103
54113,The Swan Princess: Escape from Castle Mountain,1997-01-01,1997,0,273644,273644,5.121309
54117,Three,2002-07-09,2002,0,2425000,2425000,0.938167
54118,Night School,1981-01-07,1981,0,0,0,0.262326
54120,Bastards of the Party,2005-01-01,2005,0,0,0,0.117955
54133,Madhouse,1981-01-01,1981,0,0,0,1.289193
54138,Star Trek Into Darkness,2013-05-05,2013,190000000,467365246,277365246,15.78129
54139,Fourteen Hours,1951-04-01,1951,0,0,0,0.849681
54140,Providence,1977-01-25,1977,0,0,0,1.281044
54142,Mirch,2010-09-26,2010,0,0,0,0.370744
54144,Abel,2010-05-28,2010,1000000,0,-1000000,0.829065
54146,Pitfall,1962-07-01,1962,0,0,0,1.209985
54148,Soccer Days,2003-09-19,2003,0,12212123,12212123,1.211616
54154,5th Day of Peace,1970-09-09,1970,0,0,0,0.284301
54155,Hands in the Air,2010-07-06,2010,0,0,0,0.5223
54156,First Desires,1983-12-11,1983,0,0,0,1.647619
54157,The Cost of Living,2003-07-30,2003,0,0,0,0.604093
54160,Message from Space,1978-04-29,1978,0,0,0,0.753465
54162,Hotel California,2008-07-25,2008,0,0,0,0.043353
54164,Man of the East,1972-09-28,1972,0,0,0,2.124813
54165,A Summer in St. Tropez,1983-06-06,1983,0,0,0,1.353097
54166,La feldmarescialla,1967-12-21,1967,0,0,0,0.003422
54178,The One-Armed Swordsman,1967-07-26,1967,0,0,0,2.814809
54182,Dirty Ho,1979-04-07,1979,0,0,0,0.616564
54186,Confessions,2010-06-04,2010,0,0,0,5.882762
54191,Paris Trout,1991-04-21,1991,0,0,0,0.521478
54194,Koko: A Talking Gorilla,1978-10-01,1978,0,0,0,0.435271
54195,It Happened Here,1966-05-01,1966,0,0,0,0.352743
54198,My Boy,1921-12-01,1921,0,0,0,0.090443
54220,Anima Mundi,1992-01-01,1992,0,0,0,0.552794
54225,Five Senses of Eros,2009-07-09,2009,0,2484095,2484095,0.867872
54227,Lt. Robin Crusoe U.S.N.,1966-07-29,1966,0,0,0,0.356129
54229,Cold Trail,2006-12-29,2006,0,0,0,0.64384
54233,A Confucian Confusion,1994-01-01,1994,0,0,0,0.085966
54236,Cousin Angelica,1974-04-28,1974,0,0,0,0.772852
54241,The Extra Girl,1923-10-28,1923,0,0,0,0.142776
54242,Mickey,1918-08-01,1918,250000,8000000,7750000,0.211008
54243,Kart Racer,2003-05-16,2003,0,0,0,0.700658
54254,The Song of Sparrows,2008-10-01,2008,0,115605,115605,1.165679
54256,Rang Birangi,1983-04-23,1983,0,0,0,0.046196
54257,Lilla J√∂nssonligan och Cornflakeskuppen,1996-11-29,1996,0,0,0,0.824952
54265,Zat√¥ichi's Flashing Sword,1964-07-11,1964,0,0,0,1.024061
54266,"Fight, Zat√¥ichi, Fight",1964-10-17,1964,0,0,0,1.758765
54271,The Big Bang,2011-01-17,2011,17000000,0,-17000000,2.608546
54272,Adventures of Zat√¥ichi,1964-12-30,1964,0,0,0,1.112057
54273,Zat√¥ichi's Revenge,1965-04-03,1965,0,0,0,0.916076
54274,Zat√¥ichi and the Doomed Man,1965-09-18,1965,0,0,0,0.373428
54275,Zat√¥ichi and the Chess Expert,1965-12-24,1965,0,0,0,0.548119
54276,Zat√¥ichi's Pilgrimage,1966-08-13,1966,0,0,0,1.291947
54277,Zat√¥ichi's Cane Sword,1967-01-03,1967,0,0,0,0.838838
54278,Zat√¥ichi the Outlaw,1967-08-12,1967,0,0,0,0.950665
54279,Zat√¥ichi Challenged,1967-12-30,1967,0,0,0,0.991587
54280,Zat√¥ichi and the Fugitives,1968-08-10,1968,0,0,0,0.440479
54281,Samaritan Zat√¥ichi,1968-12-28,1968,0,0,0,0.351251
54283,Zat√¥ichi Goes to the Fire Festival,1970-08-12,1970,0,0,0,0.65914
54284,Zat√¥ichi at Large,1972-01-15,1972,0,0,0,0.145289
54285,"301, 302",1995-04-22,1995,0,0,0,0.396626
54287,Hangar 18,1980-07-01,1980,0,6000000,6000000,0.657274
54288,Carnival of Sinners,1943-03-21,1943,0,0,0,0.399185
54291,The River,1997-08-27,1997,0,0,0,0.839024
54293,Zeitgeist: Moving Forward,2011-01-15,2011,0,0,0,2.68829
54297,McHale's Navy Joins the Air Force,1965-07-09,1965,0,0,0,0.137939
54300,Live Forever,2003-03-07,2003,0,0,0,0.151995
54302,Royal Flash,1975-10-10,1975,0,0,0,1.988779
54306,Zat√¥ichi in Desperation,1972-09-02,1972,0,0,0,1.059291
54307,Zat√¥ichi's Conspiracy,1973-04-21,1973,0,0,0,0.899505
54309,Notte prima degli esami - Oggi,2007-02-14,2007,0,0,0,4.34552
54312,Kawasaki's Rose,2009-12-21,2009,0,0,0,0.690246
54313,I Am Self-Sufficient,1976-12-14,1976,1000,0,-1000,0.007223
54315,The Stranger in Me,2008-10-16,2008,500000,0,-500000,0.235217
54316,Tonite Let's All Make Love in London,1967-09-26,1967,0,0,0,0.382074
54318,The Water Horse,2007-12-25,2007,40000000,103071443,63071443,5.083211
54320,Love,2011-02-02,2011,500000,0,-500000,3.760776
54325,Back Soon,2007-06-03,2007,0,0,0,0.341711
54326,"Help Me, Eros",2007-09-04,2007,0,0,0,0.525347
54328,Ocean Heaven,2010-08-05,2010,1000000,0,-1000000,1.758492
54330,Baby and Me,2008-08-13,2008,0,0,0,1.410154
54336,Hori Smoku Sailor Jerry,2008-03-03,2008,0,0,0,0.039175
54354,Eila,2003-03-14,2003,0,0,0,0.077438
54356,Emmauksen tiell√§,2001-09-26,2001,0,0,0,0.07607
54358,Resurrect Dead: The Mystery of the Toynbee Tiles,2011-08-01,2011,0,0,0,1.538625
54380,Captains of April,2000-04-21,2000,6105121,0,-6105121,0.929182
54384,Our Beloved Month of August,2008-08-21,2008,0,0,0,0.866608
54388,The Daring Dobermans,1973-07-01,1973,0,0,0,0.000578
54390,Passionada,2003-08-17,2003,0,0,0,0.475951
54391,Millions Like Us,1943-06-01,1943,0,0,0,0.174896
54392,The Blue Lamp,1950-01-19,1950,0,0,0,2.094507
54396,The Cheerleaders,1973-03-01,1973,0,0,0,0.457852
54398,Strigoi,2009-11-01,2009,0,0,0,0.914338
54400,"Wax, or the Discovery of Television Among the Bees",1991-10-21,1991,0,0,0,0.106002
54405,Hear My Song,1991-12-27,1991,0,0,0,0.003977
54406,The Young Visiters,2003-12-26,2003,0,0,0,0.637468
54407,Bliss,1985-10-04,1985,3400000,660537,-2739463,0.40319
54415,Sinbad: The Fifth Voyage,2014-02-07,2014,0,0,0,1.262737
54418,Primitive London,1965-01-01,1965,0,0,0,0.114485
54419,Under the Roofs of Paris,1930-01-02,1930,0,0,0,0.918802
54421,Mahjong,1996-12-07,1996,0,0,0,0.973084
54424,Majority,2010-01-10,2010,0,0,0,0.399254
54430,Topper Takes a Trip,1938-12-29,1938,0,0,0,0.947509
54436,La Pointe-Courte,1955-05-13,1955,0,0,0,0.478364
54440,The Education of Sonny Carson,1974-07-17,1974,0,0,0,0.000308
54445,S.W.A.T.: Firefight,2011-03-01,2011,8000000,0,-8000000,5.024828
54466,Dirty Business,2009-10-06,2009,0,0,0,0.005043
54469,Main Street,2010-10-21,2010,10000000,0,-10000000,6.713351
54471,Le Jaguar,1996-10-09,1996,0,0,0,2.62384
54474,The Star,2002-05-06,2002,1300000,809000,-491000,0.321524
54484,Tracy Morgan: Black & Blue,2010-11-13,2010,0,0,0,0.36028
54487,Cane Toads: The Conquest,2010-01-26,2010,0,0,0,0.295907
54491,The Trumpet Of The Swan,2001-05-11,2001,0,100202,100202,0.851599
54494,The Sterile Cuckoo,1969-10-22,1969,0,0,0,0.454271
54503,The Mystery of Chess Boxing,1979-01-01,1979,0,0,0,0.342469
54505,Manson,1973-01-01,1973,0,0,0,0.150003
54506,What Is It?,2005-01-27,2005,0,0,0,1.016382
54507,A Very Potter Musical,2009-04-09,2009,0,0,0,1.054258
54509,The Flying Mouse,1934-07-14,1934,31386,0,-31386,1.423911
54514,Country of the Deaf,1998-04-06,1998,0,0,0,1.210728
54518,Justin Bieber: Never Say Never,2011-02-11,2011,13000000,98441954,85441954,5.892524
54523,Hitch Hike,1977-04-30,1977,0,0,0,4.253225
54524,The Robber,2010-02-14,2010,3900000,208475,-3691525,1.824255
54525,Secrets in the Walls,2010-11-24,2010,0,0,0,1.356312
54527,Into Eternity,2010-11-12,2010,900000,0,-900000,1.227597
54539,L'Inhumaine,1924-12-12,1924,0,0,0,0.756384
54540,Beverly Hills Chihuahua 2,2011-02-01,2011,0,12000000,12000000,3.58087
54541,Zero Hour!,1957-11-13,1957,0,0,0,2.647351
54544,A Crime in Paradise,2001-02-28,2001,0,0,0,3.305413
54546,China Blue,2005-01-01,2005,0,0,0,0.517793
54548,All You Need is Love,2009-11-03,2009,0,0,0,0.567095
54551,Banana,2010-12-13,2010,0,0,0,5.958505
54555,She's on Duty,2005-03-17,2005,0,0,0,0.662966
54557,The Chaperone,2011-02-11,2011,0,0,0,1.80095
54558,The Legend of Seven Cutter,2006-03-30,2006,1700000,0,-1700000,0.90546
54559,Minions: Orientation Day,2010-12-13,2010,0,0,0,4.662093
54560,Directed by Andrei Tarkovsky,1988-09-23,1988,0,0,0,0.017296
54561,An Average Little Man,1977-03-17,1977,0,0,0,0.497718
54563,"Muriel, or the Time of Return",1963-10-08,1963,0,0,0,1.021998
54566,Millipilleri,1966-08-26,1966,0,0,0,0.001189
54568,To Each His Own,1946-03-12,1946,0,0,0,0.956142
54569,These Three,1936-03-18,1936,0,0,0,1.513527
54570,The Gay Deception,1935-09-13,1935,0,0,0,0.005244
54575,The Killing of Sister George,1968-09-01,1968,0,0,0,0.487602
54580,Mondays in the Sun,2002-09-27,2002,4000000,146402,-3853598,2.061389
54583,Hollywood North,2004-01-12,2004,500000,0,-500000,0.023944
54597,Blood Out,2011-04-25,2011,0,0,0,2.493654
54598,Septien,2011-07-06,2011,0,0,0,0.418174
54602,Skateland,2010-01-25,2010,0,14944,14944,2.150786
54613,The Duchess and the Dirtwater Fox,1976-04-01,1976,0,0,0,1.36669
54615,When Willie Comes Marching Home,1950-02-01,1950,0,0,0,0.148705
54625,Checking Out,2006-09-15,2006,500000,0,-500000,0.272407
54627,Azzurro,2000-08-12,2000,3100000,0,-3100000,0.003863
54635,When Ladies Meet,1941-08-29,1941,0,0,0,0.100301
54638,Virtual Nightmare,2000-04-13,2000,0,0,0,0.853328
54642,Heavy Metal Parking Lot,1986-01-01,1986,0,0,0,0.885949
54648,The Pebble and the Penguin,1995-04-11,1995,28000000,3983912,-24016088,2.304986
54653,Last Rites,2006-06-30,2006,0,0,0,0.224612
54655,Jersey Girl,1992-07-31,1992,0,0,0,1.085018
54656,Maalamaal,1988-11-01,1988,0,0,0,0.0
54657,Lava Kusa-The Warrior Twins,2010-10-08,2010,0,0,0,0.041177
54658,Misunderstood,1984-05-31,1984,0,0,0,0.05105
54659,Woman on the Beach,2006-08-31,2006,0,0,0,0.882777
54660,Paternity,1981-10-02,1981,0,0,0,0.000809
54662,The Future,2011-02-15,2011,1000000,0,-1000000,1.61744
54663,Starting Over,1979-10-05,1979,0,0,0,0.597398
54669,Tears of April,2008-08-29,2008,0,0,0,0.14983
54677,Four Days in October,2010-10-05,2010,0,0,0,0.438135
54685,Little Big Men,2010-08-31,2010,0,0,0,0.216996
54690,Virgin Stripped Bare by Her Bachelors,2000-05-27,2000,0,0,0,0.805995
54692,Once Brothers,2010-10-12,2010,0,0,0,0.528624
54694,Pony Excess,2010-12-11,2010,0,0,0,0.217652
54699,Nora Roberts' Blue Smoke,2007-02-12,2007,0,0,0,1.048238
54700,The Presence,2010-08-04,2010,0,0,0,2.086145
54714,The Trials of Henry Kissinger,2002-09-29,2002,0,0,0,0.299669
54715,Leaving Normal,1992-04-29,1992,0,0,0,0.945706
54720,Killing Kasztner,2008-10-01,2008,0,0,0,0.004706
54723,Only Two Can Play,1962-01-19,1962,0,0,0,0.574925
54731,"Run, Ricky Run",2010-04-27,2010,0,0,0,0.29247
54732,Silly Little Game,2010-04-20,2010,0,0,0,0.076471
54734,Small Potatoes: Who Killed the USFL?,2009-10-20,2009,0,0,0,0.54473
54735,Straight Outta LA,2010-05-11,2010,0,0,0,0.668264
54743,The Legend of Jimmy the Greek,2009-11-10,2009,0,0,0,0.589301
54744,The U,2009-12-12,2009,0,0,0,0.550363
54746,Unmatched,2010-09-14,2010,0,0,0,0.076477
54752,Firstborn,1984-10-26,1984,0,0,0,1.90619
54759,Blue Corner,2002-10-11,2002,0,0,0,0.004666
54764,Pearls and Pigs,2003-08-29,2003,0,0,0,0.480027
54768,Zapped Again!,1990-04-14,1990,0,0,0,0.828592
54769,Drei M√§nner im Schnee,1955-07-14,1955,0,0,0,0.215364
54770,Time Traveller: The Girl Who Leapt Through Time,2010-03-13,2010,0,0,0,1.388467
54773,The Gilded Lily,1935-01-25,1935,0,0,0,0.001184
54779,Clonehunter,2009-01-01,2009,0,0,0,0.111587
54782,The Substitute 4: Failure Is Not an Option,2001-04-24,2001,0,0,0,1.514248
54793,Public Speaking,2010-11-22,2010,0,0,0,0.470645
54794,Heartlands,2002-08-20,2002,0,0,0,0.938316
54795,Keep the Aspidistra Flying,1997-11-20,1997,0,0,0,0.691061
54796,Thicker than Water,2005-11-23,2005,0,0,0,0.119372
54797,Ill Met by Moonlight,1957-03-04,1957,0,0,0,0.515906
54800,Urban Ghost Story,1998-07-13,1998,0,0,0,0.085069
54801,Night of the Big Heat,1967-05-01,1967,0,0,0,1.650251
54803,The Beach Girls,1982-03-26,1982,0,0,0,1.726196
54804,Staggered,1994-07-08,1994,0,0,0,0.791416
54807,Mickey,2004-05-02,2004,6000000,293793,-5706207,0.33262
54812,The Lottery,2010-06-11,2010,0,0,0,0.093776
54814,Hum Hain Rahi Pyar Ke,1993-07-05,1993,0,0,0,0.007531
54821,Adam,1992-10-05,1992,500000,0,-500000,0.177464
54825,Creature Comforts,1989-07-15,1989,500000,0,-500000,2.329233
54832,Monsieur Taxi,1952-09-03,1952,0,0,0,0.476965
54837,Highway Patrolman,1991-12-28,1991,500000,0,-500000,0.160818
54838,Robinson in Space,1997-01-10,1997,700000,0,-700000,0.100451
54845,Trouble Bound,1993-01-09,1993,0,0,0,0.366457
54850,Loaded,1996-04-12,1996,500000,0,-500000,0.618066
54857,Snake-Crane Secret,1978-01-01,1978,0,0,0,0.071981
54858,The Crippled Masters,1979-12-31,1979,0,0,0,0.512085
54860,The Bodyguard,1973-06-30,1973,0,0,0,0.116019
54861,Freedom Strikes a Blow,1973-12-31,1973,0,0,0,0.070658
54865,You Will Be Mine,2009-03-11,2009,3000000,0,-3000000,1.007136
54880,The Hunchback of Paris,1959-11-26,1959,0,0,0,2.78801
54890,Dhobi Ghat,2011-01-21,2011,0,0,0,1.017917
54893,One Day Like Rain,2007-06-15,2007,500000,0,-500000,0.152431
54894,Modify,2005-01-01,2005,500000,0,-500000,0.719373
54898,The Green Ray,1986-08-29,1986,0,0,0,2.194581
54900,Gitmek: My Marlon and Brando,2008-04-25,2008,500000,0,-500000,0.00659
54910,Off the Black,2006-12-08,2006,0,0,0,0.708427
54911,The Amazing Truth About Queen Raquela,2008-03-07,2008,400000,5255,-394745,0.038876
54919,The Gladiators,1969-06-25,1969,0,0,0,0.418236
54928,Project Viper,2002-05-15,2002,500000,0,-500000,0.183141
54933,A Map of the World,1999-09-13,1999,0,0,0,1.588189
54934,Swoon,1992-09-11,1992,250000,340147,90147,0.003013
54940,Ground Control,1998-08-26,1998,500000,0,-500000,8.437586
54959,Soldier,1998-12-10,1998,0,0,0,0.17381
54966,Pakeezah,1972-09-10,1972,0,0,0,0.00222
54968,Simon Magus,1999-02-17,1999,0,0,0,0.313628
54969,Daud,1997-08-22,1997,0,0,0,0.221302
54970,Spring on Zarechnaya Street,1956-11-26,1956,0,0,0,0.593318
54971,Dulhe Raja,1998-07-10,1998,0,0,0,0.850284
54973,Dopamine,2003-10-03,2003,0,22278,22278,0.401575
54979,Robinson Crusoe,1954-08-05,1954,350000,0,-350000,1.218976
54982,Introducing Dorothy Dandridge,1999-08-21,1999,0,0,0,6.197144
54986,Chunhyang,2000-01-29,2000,0,0,0,0.644469
54988,Bird on a Wire,1974-07-05,1974,0,0,0,1e-06
54994,Teenage Paparazzo,2010-01-22,2010,0,0,0,0.912766
55008,Be Sure to Share,2009-06-01,2009,0,0,0,0.414789
55011,Morlang,2001-11-22,2001,500000,0,-500000,0.514632
55012,Wolves In The Snow,2002-04-10,2002,500000,0,-500000,0.367052
55015,Home Room,2002-04-12,2002,0,0,0,6.040767
55018,Crazy As Hell,2002-10-23,2002,1800000,0,-1800000,0.405812
55027,Dan Aykroyd - Unplugged On UFO's,2005-07-15,2005,0,0,0,0.110854
55032,Madame Sin,1972-01-15,1972,0,0,0,0.285071
55033,The Buttercream Gang,1992-01-25,1992,0,0,0,0.266798
55035,The Hatter's Ghost,1982-05-26,1982,0,0,0,0.582222
55044,Cisco Pike,1972-01-14,1972,0,0,0,1.880781
55045,Psych:9,2010-05-07,2010,5000000,0,-5000000,1.849045
55047,Born Rich,2003-01-19,2003,0,0,0,0.285404
55049,Three Lives and Only One Death,1996-05-15,1996,500000,0,-500000,1.163947
55058,Love Is All There Is,1996-05-10,1996,0,0,0,0.453988
55059,Happy Together,1989-05-04,1989,0,0,0,5.371907
55061,Frankie & Alice,2010-05-17,2010,0,693181,693181,2.178315
55063,Still Bill,2010-01-27,2010,0,0,0,0.589117
55066,The Eternal,1998-09-18,1998,0,0,0,0.490035
55069,The Delivery,1999-09-16,1999,500000,0,-500000,0.068057
55086,Old Acquaintance,1943-11-28,1943,0,0,0,0.632669
55106,Butterflies Are Free,1972-07-06,1972,0,0,0,2.700782
55107,L'ennui,1998-11-14,1998,0,0,0,1.535323
55123,Tumbleweeds,1999-11-28,1999,312000,1281176,969176,0.88888
55125,Ivko's Feast,2005-11-03,2005,0,0,0,0.551454
55130,The Professional,2003-05-21,2003,0,0,0,0.645741
55134,Mickybo and Me,2005-03-25,2005,0,0,0,0.895613
55135,"When I Grow Up, I'll Be a Kangaroo",2004-03-25,2004,0,0,0,0.508196
55138,Barking at the Stars,1998-06-01,1998,0,0,0,1.00088
55144,Lush Life,1993-10-01,1993,500000,0,-500000,0.952815
55146,Hearts and Minds,1995-08-29,1995,500000,0,-500000,0.001202
55149,84C MoPic,1989-03-22,1989,500000,0,-500000,1.061491
55150,Invitation to a Gunfighter,1964-10-14,1964,0,0,0,1.225546
55151,"Tuesday, After Christmas",2010-05-13,2010,0,20666,20666,1.812899
55152,The Oblong Box,1969-06-11,1969,175000,0,-175000,1.932663
55154,Den siste Fleksnes,1974-11-04,1974,0,0,0,0.373596
55156,Hail the Judge,1994-01-01,1994,0,0,0,1.290828
55157,Eagle Shooting Heroes,1993-02-05,1993,0,0,0,1.944802
55165,Simple Simon,2010-09-03,2010,0,0,0,2.721449
55166,Hurmaava joukkoitsemurha,2000-03-03,2000,0,0,0,0.110304
55167,Sixtynine,1969-10-03,1969,0,0,0,0.108482
55177,Touch of Pink,2004-07-16,2004,0,0,0,1.062502
55180,The Last Big Thing,1998-09-23,1998,0,0,0,0.695095
55184,In the Grip of Passion,1947-03-21,1947,0,0,0,0.001247
55190,Princess and the Pony,2011-01-25,2011,17000,0,-17000,0.522892
55192,Tokyo Twilight,1957-04-30,1957,0,0,0,1.112972
55194,Jedi Junkies,2010-05-25,2010,0,0,0,0.166559
55197,Flavor of Green Tea Over Rice,1952-10-01,1952,0,0,0,0.727895
55198,The Munekata Sisters,1950-08-08,1950,0,0,0,0.106001
55204,Which Way Home,2009-01-31,2009,0,0,0,0.225251
55207,Gaslight,1940-06-25,1940,0,0,0,1.102931
55208,Clash,2009-12-09,2009,0,0,0,0.743727
55215,Dead Space: Aftermath,2010-12-31,2010,2500000,0,-2500000,1.507249
55222,Power and Terror: Noam Chomsky in Our Times,2002-11-22,2002,0,0,0,0.073793
55225,Six Days in June,2007-05-18,2007,0,0,0,0.00876
55229,Impact,2009-06-21,2009,0,0,0,2.989957
55230,Tsunami: Caught on Camera,2009-12-30,2009,0,0,0,0.089775
55236,Desperate Journey,1942-09-25,1942,0,0,0,1.204787
55238,Edge of Darkness,1943-01-01,1943,0,0,0,0.97699
55240,Uncertain Glory,1944-01-01,1944,0,0,0,0.488483
55244,Bill Cunningham New York,2010-03-24,2010,0,1339650,1339650,1.172363
55245,!Women Art Revolution,2010-01-01,2010,0,0,0,0.077485
55246,Ceremony,2010-10-08,2010,0,22270,22270,4.186599
55249,Night At The Golden Eagle,2002-05-17,2002,0,0,0,0.152677
55253,The Machine,2006-04-26,2006,0,0,0,0.239638
55254,Uuno Turhapuro - pisnismies,1998-08-28,1998,0,0,0,0.107109
55256,The River,2001-09-14,2001,1000000,0,-1000000,0.072409
55257,Juha,1999-02-25,1999,1000000,0,-1000000,0.702021
55261,Hidden Assassin,1995-12-15,1995,0,0,0,6.833725
55283,Leader,2010-02-19,2010,0,1458709,1458709,0.380204
55292,Shaolin,2011-01-20,2011,29000000,33662874,4662874,5.311245
55294,Canvas,2006-11-12,2006,1500000,0,-1500000,1.130269
55301,Alvin and the Chipmunks: Chipwrecked,2011-12-14,2011,75000000,342695435,267695435,8.066393
55306,Ulee's Gold,1997-06-13,1997,0,0,0,1.138972
55308,Gunfighters,1947-07-15,1947,0,0,0,0.257029
55309,Vincent & Theo,1990-12-02,1990,0,0,0,0.919064
55316,Pasha,1968-03-14,1968,0,0,0,1.049774
55317,Don't Take God's Children for Wild Geese,1968-09-06,1968,0,0,0,0.587849
55321,The Diary of Anne Frank,1980-11-17,1980,0,0,0,0.038276
55322,Grant Morrison:  Talking with Gods,2010-10-26,2010,0,0,0,0.511896
55325,The Double O Kid,1992-09-07,1992,0,0,0,0.888674
55327,Moebius Redux: A Life in Pictures,2007-01-01,2007,0,0,0,0.431208
55328,When Good Ghouls Go Bad,2001-10-20,2001,0,0,0,0.329979
55335,An Enemy of the People,2005-01-21,2005,0,0,0,0.037867
55343,Overlord,1975-07-01,1975,0,0,0,3.751877
55344,Boys on the Run,2010-01-30,2010,0,0,0,0.329866
55347,Beginners,2010-09-11,2010,3200000,5332926,2132926,6.72639
55368,"Lacombe, Lucien",1974-01-30,1974,0,0,0,2.235918
55370,The Thief of Paris,1967-02-22,1967,0,0,0,1.934197
55372,Va Savoir (Who Knows?),2001-09-28,2001,0,0,0,0.446953
55376,Karzzzz,2008-10-17,2008,0,0,0,0.177779
55396,Koirankynnen leikkaaja,2004-02-12,2004,0,0,0,0.435044
55398,Inspector Palmu's Error,1960-09-09,1960,0,0,0,0.536368
55403,Kulkuri ja joutsen,1999-02-19,1999,0,0,0,0.00125
55408,Kymmenen riivinrautaa,2002-08-30,2002,0,0,0,0.04048
55412,Girl of Finland,1967-12-01,1967,0,0,0,0.041718
55418,The Earth Is a Sinful Song,1973-11-02,1973,0,0,0,0.768542
55420,Another Earth,2011-07-22,2011,100000,1776935,1676935,8.957372
55424,Essaye-moi,2006-03-06,2006,0,0,0,1.272188
55426,Broken Blade: Book One - The Time of Awakening,2010-05-29,2010,0,0,0,0.775251
55429,Ko≈Çysanka,2010-02-12,2010,0,0,0,0.311789
55430,Broken Blade: Book Two - The Split Path,2010-06-26,2010,0,0,0,0.508495
55431,Broken Blade: Book Three - The Mark of the Assassin's Dagger,2010-10-28,2010,0,0,0,0.126082
55433,Bomber,2009-03-14,2009,0,0,0,0.594317
55435,Broken Blade: Book Four - The Earth of Calamity,2010-10-29,2010,0,0,0,0.490792
55437,Broken Blade: Book Five - The Horizon Between Life and Death,2011-01-21,2011,0,0,0,0.115414
55438,Broken Blade: Book Six - Enclave of Lamentations,2011-03-25,2011,0,0,0,0.429279
55441,Fancy Pants,1950-07-19,1950,0,0,0,0.480292
55448,Money for Nothing,1993-09-10,1993,11000000,1044824,-9955176,4.08938
55457,I Wanna Hold Your Hand,1978-04-20,1978,2700000,0,-2700000,2.186882
55465,A Very Harold & Kumar Christmas,2011-11-04,2011,19000000,35387212,16387212,10.724679
55470,One Missed Call 3: Final,2006-06-24,2006,0,0,0,2.513257
55472,Colt .45,1950-07-20,1950,0,0,0,0.098794
55475,Nueba Yol,1995-08-16,1995,0,0,0,0.291021
55479,Pi√±ero,2001-01-01,2001,0,0,0,0.362429
55495,Noin 7 veljest√§,1968-08-22,1968,0,0,0,0.013735
55496,Upswing,2003-02-28,2003,0,0,0,1.410221
55500,The Land of Happiness,1993-04-30,1993,400000,0,-400000,0.000127
55502,The Pelican Man,2004-12-16,2004,0,0,0,0.120108
55504,Go Figure,2005-06-10,2005,0,0,0,2.163422
55505,To Be the Best,1993-08-03,1993,0,0,0,0.00195
55520,Plainlands,1988-02-26,1988,0,0,0,0.000431
55522,Letters to Father Jacob,2009-04-03,2009,0,0,0,0.570175
55524,Prinsessa Ruusunen,1949-04-08,1949,0,0,0,0.005578
55529,The Thirst,2007-05-15,2007,0,0,0,0.250956
55531,The Radio Burglary,1951-04-06,1951,0,0,0,0.054709
55534,Dreamkeeper,2003-12-28,2003,0,0,0,3.599103
55536,The Finances of the Grand Duke,1924-01-07,1924,0,0,0,0.262052
55538,Bloody Birthday,1981-04-28,1981,0,0,0,2.68115
55539,Zombie High,1987-10-02,1987,0,0,0,1.329736
55544,Tartuffe,1925-11-20,1925,0,0,0,0.921315
55547,Route 666,2001-10-30,2001,2300000,0,-2300000,1.141172
55551,Lumumba,2000-05-13,2000,0,0,0,0.2994
55553,"Rakkaudella, Maire",1999-09-17,1999,0,0,0,0.001177
55558,"Rautakauppias Uuno Turhapuro, presidentin v√§vy",1978-08-25,1978,0,0,0,0.006091
55561,Clockwatchers,1997-01-01,1997,0,0,0,1.885671
55562,Rosa Luxemburg,1986-04-10,1986,0,0,0,0.332373
55563,Tammy and the T-Rex,1994-12-28,1994,0,0,0,0.619015
55567,Standing Ovation,2010-07-16,2010,0,531826,531826,0.221837
55576,Last Stand at Saber River,1997-01-19,1997,0,0,0,1.087671
55580,P.O. Box Tinto Brass,1995-08-30,1995,0,0,0,7.02299
55584,Asphalt,1929-03-12,1929,0,0,0,1.652859
55587,Michael,1924-01-01,1924,0,0,0,0.615521
55589,Master of the House,1925-10-05,1925,0,0,0,0.693611
55596,Christmas in Connecticut,1992-04-13,1992,0,0,0,0.914122
55602,Buried Alive,1939-11-06,1939,0,0,0,0.167618
55603,The Golden Eye,1948-08-29,1948,0,0,0,0.255532
55604,Boom Town,1940-08-30,1940,2000000,9172000,7172000,1.52854
55608,Captive,2008-09-11,2008,0,0,0,0.199632
55612,Varg Veum - Black Sheep,2011-01-21,2011,0,0,0,2.111151
55613,Careful,1992-09-30,1992,0,0,0,0.160571
55615,Burn Up!,1991-03-21,1991,0,0,0,0.067036
55616,Dracula: Pages from a Virgin's Diary,2002-02-28,2002,1596010,0,-1596010,0.810769
55624,Fata Morgana,1971-06-04,1971,0,0,0,1.08524
55627,100 Days,1991-01-01,1991,0,0,0,0.030124
55628,The Last Remake of Beau Geste,1977-06-15,1977,0,0,0,0.956692
55632,Peep World,2010-09-15,2010,0,10967,10967,1.185288
55638,Opposite Day,2009-11-07,2009,0,0,0,1.389182
55648,The Wildcat,1921-04-14,1921,0,0,0,0.732999
55650,Saraband,2003-12-01,2003,0,0,0,3.464937
55651,Kimjongilia,2009-01-01,2009,0,0,0,0.400267
55655,The Sound of Insects: Record of a Mummy,2009-05-01,2009,0,0,0,0.155071
55657,"Surrender, Dorothy",2006-01-01,2006,0,0,0,0.877446
55662,Virus X,2010-10-01,2010,3500000,0,-3500000,0.535661
55663,Dinosaurus!,1960-08-10,1960,0,0,0,0.512911
55667,Carnosaur 3: Primal Species,1996-11-21,1996,0,0,0,0.833274
55676,A Personal Journey with Martin Scorsese Through American Movies,1995-05-21,1995,0,0,0,8.890621
55680,The Craigslist Killer,2011-01-03,2011,0,0,0,2.389617
55681,The Halfway House,2004-02-14,2004,0,0,0,0.510135
55685,To Be Twenty,1978-07-14,1978,0,0,0,1.737503
55687,Adrenalin: Fear the Rush,1996-11-29,1996,0,0,0,0.782292
55689,Baba Yaga,1973-09-20,1973,0,0,0,1.67161
55694,Miracle Beach,1992-09-15,1992,0,0,0,1.783703
55699,The Experts,1989-01-13,1989,0,0,0,1.025298
55700,Ossos,1997-01-01,1997,0,0,0,0.639743
55710,Deal of a Lifetime,1999-01-01,1999,0,0,0,0.113878
55712,Demolition University,1997-10-27,1997,0,0,0,0.08955
55715,Fast Girl,2008-01-24,2008,0,0,0,0.510484
55717,The Wind Blows Round,2006-09-30,2006,0,0,0,0.517199
55720,A Better Life,2011-06-24,2011,10000000,1759252,-8240748,3.033797
55721,Bridesmaids,2011-04-28,2011,32500000,288383523,255883523,6.810991
55723,ChromeSkull: Laid to Rest 2,2011-09-20,2011,0,0,0,2.651419
55725,Win Win,2011-03-18,2011,10831173,10654385,-176788,4.480723
55727,Making the Grade,1984-05-18,1984,0,0,0,0.411365
55728,Plain Clothes,1988-01-01,1988,0,0,0,0.872768
55730,My New Gun,1992-10-26,1992,0,0,0,0.178585
55731,Race the Sun,1996-03-22,1996,0,0,0,1.317878
55733,The Princess & the Marine,2001-02-18,2001,0,0,0,1.193211
55734,Second String,2002-12-18,2002,0,0,0,0.119456
55735,Loco Love,2003-03-16,2003,0,0,0,0.404979
55738,Shut Up and Kiss Me!,2004-03-05,2004,0,0,0,0.398379
55739,Single Santa Seeks Mrs. Claus,2004-01-01,2004,0,0,0,0.336266
55740,Waltzing Anna,2006-08-11,2006,1000000,11455,-988545,0.333017
55741,Sacrifice,2010-12-17,2010,10000000,0,-10000000,0.992235
55748,Yst√§v√§ni Henry,2004-08-20,2004,0,0,0,0.002524
55754,V√§√§peli K√∂rmy ja vetenalaiset vehkeet,1991-10-18,1991,0,0,0,0.107327
55756,Sergeant K√∂rmy and the Marshall's Stick,1990-11-02,1990,0,0,0,0.001021
55758,Midnight FM,2010-10-14,2010,0,0,0,1.924528
55759,V√§√§peli K√∂rmy ja kahtesti laukeava,1997-08-15,1997,0,0,0,0.072329
55761,V√§√§peli K√∂rmy ja etel√§n hetelm√§t,1992-10-09,1992,0,0,0,1e-06
55762,Sweeney!,1977-01-14,1977,209595,0,-209595,0.529845
55763,V√§√§peli K√∂rmy - Taisteluni,1994-09-16,1994,0,0,0,0.072357
55765,Righteous Ties,2006-10-19,2006,4500000,0,-4500000,1.602638
55767,Our Town,2007-11-29,2007,0,0,0,0.603371
55769,Man Maid,2009-10-28,2009,0,0,0,0.351056
55773,Man on the Flying Trapeze,1935-08-03,1935,0,0,0,0.162378
55774,The Band,2009-11-17,2009,0,0,0,0.417214
55776,Uuno Turhapuro ‚Äì kaksoisagentti,1987-08-28,1987,0,0,0,0.085015
55779,Final Destination 5,2011-08-12,2011,47000000,157887643,110887643,12.912491
55784,Grizzly,1976-05-21,1976,750000,0,-750000,5.424121
55785,Neds,2010-10-08,2010,0,0,0,3.668167
55787,Water for Elephants,2011-03-15,2011,38000000,114156230,76156230,7.649466
55792,Simon,1980-02-01,1980,0,0,0,6.295611
55802,The World According to Ion B.,2009-12-17,2009,0,0,0,0.081059
55804,Mike Birbiglia: What I Should Have Said Was Nothing,2008-02-09,2008,0,0,0,0.402883
55819,Daniel,1983-08-26,1983,0,0,0,2.388788
55823,The Great War,1959-10-28,1959,0,0,0,2.763792
55825,Spider,2007-06-17,2007,0,0,0,1.132774
55831,Boynton Beach Club,2005-08-05,2005,0,0,0,0.708481
55836,A Gentle Woman,1969-08-27,1969,0,0,0,0.602797
55845,Phil Ochs: There But for Fortune,2011-01-05,2011,0,0,0,0.014692
55846,Blitz,2011-05-20,2011,15774948,741875,-15033073,9.491865
55847,Four Nights of a Dreamer,1971-01-01,1971,0,0,0,0.119379
55848,Lancelot of the Lake,1974-09-26,1974,0,0,0,0.362866
55852,Southern Comfort,2001-01-25,2001,0,0,0,0.313267
55853,Gang of Four,1989-02-08,1989,0,0,0,0.098918
55859,Knock On Wood,1954-04-06,1954,0,0,0,0.872895
55861,The Task,2011-01-28,2011,0,0,0,2.427323
55863,On the Double,1961-05-19,1961,0,0,0,1.35869
55872,Tarzan and the Amazons,1945-04-29,1945,0,0,0,2.164087
55873,Tarzan and the Leopard Woman,1946-01-01,1946,0,0,0,2.360545
55884,Sword of Desperation,2010-07-10,2010,0,0,0,0.956893
55888,Ed Gein,2000-11-17,2000,0,5708,5708,2.475288
55890,Bereavement,2010-07-16,2010,2000000,0,-2000000,5.319254
55892,Mezzo Forte,2000-05-25,2000,0,0,0,1.637685
55893,Putty Hill,2010-02-18,2010,0,48132,48132,0.514257
55895,Monogamy,2010-04-24,2010,1000000,0,-1000000,0.375211
55902,American Perfekt,1997-03-01,1997,0,0,0,0.039858
55903,Betty Fisher and Other Stories,2001-09-01,2001,0,0,0,0.159662
55909,Claudine,1974-04-22,1974,0,0,0,1.421475
55912,Twice Upon a Yesterday,1998-11-27,1998,0,258464,258464,1.217192
55916,One Way Out,2002-02-01,2002,0,0,0,1.322408
55922,Intern Academy,2004-05-16,2004,0,0,0,2.088552
55931,The Animatrix,2003-05-09,2003,5000000,0,-5000000,10.934268
55934,Cold Weather,2010-03-13,2010,0,0,0,1.636778
55936,Prisoner of the Mountains,1996-03-15,1996,0,0,0,1.015881
55949,Vampirella,1996-09-28,1996,0,0,0,1.807486
55950,Wilder Napalm,1993-08-20,1993,0,0,0,1.765977
55951,Aadhavan,2009-10-17,2009,0,0,0,0.954289
55952,Xtro 2: The Second Encounter,1990-05-04,1990,0,0,0,1.24306
55955,My Son the Fanatic,1997-10-21,1997,0,408339,408339,0.147516
55956,God's Puzzle,2008-06-07,2008,0,0,0,0.974418
55960,"Toto, Peppino, and the Hussy",1956-08-14,1956,0,0,0,2.032722
55971,Moloch,1999-05-14,1999,0,0,0,0.992149
55989,Southie,1998-06-10,1998,0,0,0,0.280893
55996,Pacific Banana,1981-02-04,1981,0,0,0,0.013577
55998,A Quiet Outpost,2011-01-20,2011,0,0,0,0.753449
56002,Ang√®le and Tony,2011-01-26,2011,0,0,0,0.73656
56007,Looking For Lola,1997-12-31,1997,0,0,0,0.108347
56014,Men Vs Women,2010-10-27,2010,0,0,0,5.146043
56036,Nothing's All Bad,2010-09-23,2010,0,0,0,0.316017
56041,Unlikely Revolutionaries,2010-10-22,2010,0,0,0,0.694441
56049,A Grande Fam√≠lia: O Filme,2007-01-26,2007,0,0,0,0.536814
56067,The Biscuit Eater,1972-03-22,1972,0,0,0,0.001393
56068,The Band of Honest Men,1956-04-12,1956,0,0,0,1.916468
56077,Talk of Angels,1998-10-30,1998,0,0,0,0.978989
56078,Vabank II,1984-05-06,1984,0,0,0,0.840863
56083,Hermanoteu In the Land of Godah,2009-11-26,2009,0,0,0,0.394099
56085,Camouflage,2001-01-09,2001,0,0,0,0.976349
56088,The Show,1995-08-25,1995,0,0,0,0.159596
56092,Twisted Nerve,1968-10-15,1968,0,0,0,2.061215
56095,The Invincible Armour,1977-06-29,1977,0,0,0,1.423036
56100,Lisa Lampanelli: Take It Like a Man,2005-08-30,2005,0,0,0,0.426417
56109,Swamp Devil,2008-07-04,2008,2000000,0,-2000000,0.612139
56113,The Parking Lot Movie,2010-08-06,2010,0,0,0,0.402405
56115,The Bikini Carwash Company,1992-01-01,1992,0,0,0,0.408778
56122,The Gold of Naples,1954-12-03,1954,0,0,0,0.916447
56126,Batch '81,1982-11-18,1982,0,0,0,0.409704
56132,The Mafu Cage,1978-01-01,1978,0,0,0,1.239583
56133,Black Like Me,1964-01-01,1964,0,0,0,0.006154
56134,Summer Night,1986-01-01,1986,0,0,0,0.11492
56135,The Razor's Edge,1946-11-19,1946,0,0,0,4.420637
56137,I Know Where I'm Going!,1945-11-16,1945,0,0,0,1.50485
56142,Conversation Piece,1974-12-10,1974,0,0,0,8.58169
56143,The Battle of Midway,1942-09-14,1942,0,0,0,0.531296
56146,The Moon and Sixpence,1942-10-27,1942,401000,0,-401000,0.428483
56147,The Loves of Hercules,1960-08-19,1960,0,0,0,1.49308
56150,Jonathan Livingston Seagull,1973-10-23,1973,0,0,0,1.321845
56151,Lydia,1941-01-01,1941,0,0,0,0.021041
56152,Brigham Young,1940-09-27,1940,0,0,0,1.08263
56153,The Seduction of Mimi,1972-01-01,1972,0,0,0,1.554499
56154,Young Tom Edison,1940-03-15,1940,0,0,0,0.698176
56156,The Last Hurrah,1958-10-24,1958,0,0,0,0.660349
56157,The Violent Years,1956-01-01,1956,0,0,0,0.129098
56162,Rosalie Goes Shopping,1989-01-01,1989,0,0,0,0.435777
56164,Cavalcade,1933-02-08,1933,1180280,7630000,6449720,1.196324
56165,Billy the Kid vs. Dracula,1966-01-01,1966,0,0,0,0.53403
56167,The Golden Coach,1952-12-05,1952,0,0,0,0.687293
56168,The Oscar,1966-03-04,1966,0,0,0,0.602006
56171,Mega Python vs. Gatoroid,2011-01-29,2011,0,0,0,1.529379
56177,Blood Feud,1978-12-21,1978,0,0,0,0.402564
56178,Beauty Prize,1930-01-01,1930,0,0,0,0.444066
56179,Triumph of the Spirit,1989-01-01,1989,0,0,0,1.986116
56180,The Silent House,2010-08-25,2010,6000,0,-6000,2.266539
56188,Fire Down Below,1957-05-30,1957,0,0,0,1.021429
56190,Green Legend Ran,1992-01-01,1992,0,0,0,0.2875
56191,Iria: Zeiram the Animation,1994-06-23,1994,0,0,0,0.134957
56192,Trail of the Screaming Forehead,2008-06-08,2008,0,0,0,0.451906
56195,Billboard Dad,1998-02-06,1998,0,0,0,1.800704
56212,The Stoker,2010-10-13,2010,0,183640,183640,1.444925
56214,Margaret Cho: Assassin,2005-10-23,2005,0,0,0,0.074589
56224,Z Channel: A Magnificent Obsession,2004-05-16,2004,0,0,0,1.422413
56231,The Working Class Goes to Paradise,1971-09-17,1971,0,0,0,2.397549
56232,The Seaside Motel,2010-06-05,2010,0,0,0,0.219986
56233,The Girl with a Pistol,1968-08-22,1968,0,0,0,1.740951
56235,Return with Honor,1999-06-11,1999,1000000,0,-1000000,0.15025
56245,MollyCam,2008-07-18,2008,0,0,0,0.013492
56255,Executive Koala,2005-10-28,2005,0,0,0,0.220642
56256,Stuff and Dough,2001-06-01,2001,0,0,0,0.313928
56259,Werewolves on Wheels,1971-11-19,1971,0,0,0,0.090689
56263,Going South,2009-12-30,2009,0,0,0,0.854655
56264,Dillinger and Capone,1995-01-01,1995,0,0,0,1.017269
56268,Captain Blood,1960-10-05,1960,0,0,0,1.280777
56271,Double Take,2009-02-10,2009,0,0,0,0.194308
56272,Elektra Luxx,2010-03-14,2010,0,10,10,4.118699
56275,Reggie Watts: Why Shit So Crazy?,2010-07-01,2010,0,0,0,0.242956
56287,Scandal in Sorrento,1955-12-22,1955,0,0,0,1.301228
56288,Spy Kids: All the Time in the World,2011-08-18,2011,27000000,85564310,58564310,9.580214
56290,Attila,1954-05-18,1954,0,0,0,1.018412
56292,Mission: Impossible - Ghost Protocol,2011-12-07,2011,145000000,694713380,549713380,14.25843
56294,The Oil Factor: Behind the War on Terror,2005-07-15,2005,0,0,0,0.16323
56295,The Love of Siam,2007-11-22,2007,0,0,0,1.843725
56296,Deuce of Spades,2010-06-01,2010,25000,0,-25000,0.455584
56304,Satisfaktsiya,2011-01-20,2011,0,0,0,0.468259
56309,Carry on Admiral,1957-05-14,1957,0,0,0,0.107064
56314,Truly Human,2001-04-27,2001,0,0,0,0.837297
56320,The Scientist,2010-04-16,2010,0,0,0,0.159456
56321,Toto the Hero,1991-05-15,1991,0,0,0,2.582899
56325,Naked Ambition: An R Rated Look at an X Rated Industry,2009-04-30,2009,230,0,-230,1.369933
56329,The Detective,2007-09-25,2007,0,0,0,0.809306
56332,Jack Frusciante √® uscito dal gruppo,1996-01-01,1996,0,0,0,1.956065
56338,7 Khoon Maaf,2011-02-18,2011,0,0,0,1.367451
56339,Qualunquemente,2011-01-21,2011,0,0,0,4.388407
56340,The Widower,1959-01-01,1959,0,0,0,1.223918
56341,The Scopone Game,1972-10-08,1972,0,0,0,0.864819
56343,A Difficult Life,1961-12-19,1961,0,0,0,1.071131
56344,The Dark Diamond,2004-02-14,2004,0,0,0,0.045085
56345,Animal Love,1996-08-29,1996,0,0,0,0.44885
56350,"Jesus, You Know",2003-07-05,2003,0,0,0,0.109188
56354,Captain Nemo and the Underwater City,1969-12-19,1969,0,0,0,1.167913
56364,The Pyx,1973-09-08,1973,0,0,0,0.034545
56366,Drama of Jealousy,1970-04-30,1970,0,0,0,0.566868
56369,"Straziami, ma di baci saziami",1968-10-04,1968,0,0,0,0.520489
56372,Shadowboxing,2005-03-05,2005,3500000,8262833,4762833,0.768181
56373,Day of Anger,1967-12-19,1967,0,0,0,2.897529
56379,Beach House,1977-10-27,1977,0,0,0,1.355624
56383,"Lisa, Lisa",1974-07-23,1974,0,0,0,0.00022
56385,True Identity,1991-07-23,1991,0,0,0,0.815294
56386,SS Experiment Love Camp,1976-11-16,1976,0,0,0,1.486119
56391,The Adventures of Scamper the Penguin,1987-06-26,1987,0,0,0,1.165088
56400,A Matter of Heart,2009-04-17,2009,0,0,0,1.062729
56401,The Music Never Stopped,2011-03-18,2011,4000000,253899,-3746101,13.504065
56402,"Bread, Love and Dreams",1953-12-22,1953,0,0,0,0.91826
56405,Black Venus,2010-10-27,2010,0,0,0,7.145871
56412,Skinwalkers,2002-11-02,2002,0,0,0,0.428065
56413,Coyote Waits,2003-11-16,2003,0,0,0,0.123726
56415,A Gang Story,2011-11-10,2011,0,0,0,6.597927
56418,The Source,2011-11-02,2011,0,0,0,5.171689
56419,Tesla: Master of Lightning,2000-01-01,2000,0,0,0,0.401288
56424,Les Invit√©s de mon p√®re,2010-03-31,2010,0,0,0,1.377949
56428,Beyond Bedlam,1994-04-22,1994,4800000,0,-4800000,0.426952
56429,Up from the Depths,1979-06-01,1979,0,0,0,0.003921
56431,A Pistol for Ringo,1965-05-12,1965,0,0,0,1.492526
56435,The Sign of Venus,1955-03-12,1955,0,0,0,0.312283
56440,Amador,2010-10-08,2010,0,0,0,3.119413
56441,The Elephant in the Living Room,2011-04-08,2011,0,0,0,0.243856
56448,Stalin,1992-11-21,1992,0,0,0,1.057204
56474,Philanthropy,2002-03-15,2002,0,0,0,1.67028
56475,Touch the Sound,2004-09-10,2004,0,0,0,0.347049
56481,Beyond the Border,2011-01-28,2011,0,0,0,0.380827
56482,Paz!,2002-02-22,2002,0,0,0,1.175193
56486,Loss Is to Be Expected,1992-01-01,1992,0,0,0,0.085797
56487,The Bosom Friend,1997-01-01,1997,0,0,0,0.051062
56489,The Last Real Men,1995-10-03,1995,0,0,0,0.28084
56491,In Her Line of Fire,2006-04-21,2006,1000000,0,-1000000,0.632334
56499,Babette Goes to War,1959-09-18,1959,0,0,0,0.339142
56500,They Call Us Misfits,1968-03-25,1968,12000,0,-12000,1.289488
56508,Fant√¥mas: In the Shadow of the Guillotine,1913-05-09,1913,0,0,0,0.791727
56511,Fant√¥mas: Juve Against Fant√¥mas,1913-09-12,1913,0,0,0,0.787866
56512,Fant√¥mas: Fant√¥mas Against Fant√¥mas,1914-03-13,1914,0,0,0,0.322249
56515,Fant√¥mas: The False Magistrate,1914-05-08,1914,0,0,0,0.237483
56516,Fant√¥mas: The Dead Man Who Killed,1913-11-28,1913,0,0,0,0.414734
56518,The Flowers of St. Francis,1950-12-14,1950,0,0,0,1.088237
56525,Boj S Tenyu 2: Revansh,2007-10-18,2007,6000000,11171900,5171900,0.471086
56527,Skeleton Man,2004-03-01,2004,0,0,0,1.179182
56529,The Violent Kind,2010-01-25,2010,0,0,0,1.45965
56531,The Life and Death of a Porno Gang,2009-09-16,2009,0,0,0,1.990855
56533,Viva Knievel!,1977-06-10,1977,0,0,0,0.004425
56539,Friday Foster,1975-12-25,1975,0,0,0,1.05356
56544,The Law Is the Law,1958-09-17,1958,0,0,0,0.591066
56547,The Garage,1979-06-06,1979,0,0,0,1.093057
56549,Operation 'Happy New Year'!,1996-01-01,1996,0,0,0,0.629096
56551,Maledetto il giorno che t'ho incontrato,1992-01-31,1992,0,0,0,1.100118
56552,The Valley of Light,2007-01-28,2007,0,0,0,0.491809
56554,Stag Night of the Dead,2010-10-31,2010,0,0,0,0.650044
56555,Life Support,2007-03-10,2007,0,0,0,0.997996
56557,Maid of Salem,1937-02-12,1937,0,0,0,0.287532
56558,Remember the Day,1941-12-25,1941,0,0,0,0.049783
56578,Troubleshooter,2010-09-12,2010,0,0,0,0.77737
56579,24 Hours On Craigslist,2006-01-19,2006,0,0,0,0.007335
56583,The Saint of Fort Washington,1993-11-03,1993,0,0,0,1.065843
56584,"The Late, Great Planet Earth",1979-01-01,1979,0,0,0,0.006091
56589,The Seventh Company Outdoors,1977-12-07,1977,0,0,0,2.920281
56590,All Star Superman,2011-02-22,2011,3500000,0,-3500000,7.786765
56591,Corman's World: Exploits of a Hollywood Rebel,2011-01-21,2011,0,0,0,3.784339
56596,Trust Me,2010-08-20,2010,0,0,0,1.342536
56598,The Lady in Question,1940-08-07,1940,0,0,0,1.105324
56599,The Man Without a Map,1968-06-01,1968,0,0,0,0.425726
56601,The Perfect Game,2010-04-01,2010,12500000,3878993,-8621007,1.830829
56608,Darkness Falls,1999-08-27,1999,0,0,0,0.039134
56616,"Goodbye, Dragon Inn",2003-08-29,2003,0,0,0,0.929244
56619,Darkness/Light/Darkness,1989-01-01,1989,0,0,0,1.04531
56623,Ao: The Last Hunter,2010-01-29,2010,0,0,0,1.955611
56624,Run If You Can,2010-07-28,2010,0,0,0,0.165787
56647,Cousinhood,2011-02-04,2011,0,0,0,3.528977
56648,The Toy,1976-12-08,1976,0,0,0,1.968883
56651,Kicked in the Head,1997-09-26,1997,0,0,0,0.07992
56653,Sombre,1998-08-06,1998,0,0,0,0.865784
56655,Everything about Mustafa,2004-03-19,2004,0,0,0,1.014129
56663,Paul McCartney Really Is Dead: The Last Testament of George Harrison,2010-09-01,2010,0,0,0,0.27381
56666,Fiza,2000-09-08,2000,1000000,623791,-376209,0.254553
56669,Hider in the House,1989-05-13,1989,0,0,0,0.845246
56672,The Legend of Secret Pass,2010-12-05,2010,0,0,0,0.334532
56685,Psalm 21,2009-01-01,2009,0,0,0,0.578867
56691,The Wayward Girl,1959-10-08,1959,0,0,0,0.003421
56693,Dillinger Is Dead,1969-02-25,1969,0,0,0,1.059382
56697,Fools in the Mountains,1957-08-19,1957,0,0,0,0.3528
56702,The Undertaker and His Pals,1966-07-01,1966,0,0,0,0.312707
56705,Crawlspace,1986-05-21,1986,0,0,0,2.230313
56709,Legacy,1998-10-09,1998,0,0,0,0.391822
56715,Just Visiting,2001-04-06,2001,0,0,0,6.198238
56718,The Mind Snatchers,1972-06-28,1972,0,0,0,0.170247
56724,What Price Hollywood?,1932-06-24,1932,0,0,0,0.694158
56725,One Man Force,1989-09-21,1989,0,0,0,0.005568
56743,Elena Undone,2010-06-25,2010,0,0,0,1.715955
56744,Murder in Greenwich,2002-11-15,2002,0,0,0,0.509197
56745,Speed & Angels,2008-02-01,2008,1,0,-1,0.749686
56746,Carol's Journey,2002-09-06,2002,0,0,0,0.795422
56759,Notre Dame de Paris,1998-09-18,1998,0,0,0,1.925849
56761,Reagan,2011-02-07,2011,0,0,0,0.190137
56763,The South Shaolin Master,1984-04-14,1984,0,0,0,0.669701
56764,The Glass Menagerie,1973-12-16,1973,0,0,0,0.033575
56766,The Riverman,2004-09-06,2004,0,0,0,1.107156
56771,WWII IN HD,2009-11-15,2009,0,0,0,0.157804
56778,Blue Vinyl,2002-01-01,2002,0,0,0,0.152845
56780,Atlas Shrugged Part I,2011-04-14,2011,15000000,4627375,-10372625,3.4949
56784,Scusate il ritardo,1983-03-10,1983,0,0,0,0.812045
56787,Bad Ronald,1974-10-23,1974,0,0,0,0.955192
56790,The Doll Master,2004-08-06,2004,0,0,0,2.284982
56798,The Profession of Arms,2001-05-11,2001,0,0,0,0.915968
56800,Judex,1963-12-04,1963,0,0,0,0.630414
56801,Judex,1916-12-16,1916,0,0,0,0.457288
56804,Viaggi di nozze,1995-12-15,1995,0,0,0,4.32364
56807,Son of Babylon,2009-05-01,2009,0,0,0,0.308648
56809,Coming Down The Mountain,2007-08-16,2007,0,0,0,0.475101
56810,The Blind Sunflowers,2008-01-01,2008,0,0,0,0.967416
56811,Cropsey,2010-04-29,2010,0,35456,35456,2.065029
56812,The Last Circus,2010-12-17,2010,7000000,3218666,-3781334,4.896196
56815,Post Mortem,2010-07-02,2010,0,0,0,0.762202
56816,The Visitor,2008-12-08,2008,0,0,0,0.389459
56820,Live and Remember,2008-06-26,2008,0,0,0,0.113431
56821,Lassiter,1984-02-17,1984,0,17500000,17500000,3.962864
56822,PoliWood,2009-07-03,2009,0,0,0,0.176668
56825,Compagni di scuola,1988-12-12,1988,0,0,0,1.914778
56828,Dexter's Laboratory: Ego Trip,1999-12-31,1999,0,0,0,0.616473
56830,Johns,1996-12-10,1996,0,0,0,0.271674
56831,The Sunset Limited,2011-02-12,2011,0,0,0,4.470133
56832,Gantz,2011-01-26,2011,0,0,0,3.533091
56841,A Thousand Times Stronger,2010-09-24,2010,0,0,0,1.072412
56844,The White Space,2009-09-08,2009,0,0,0,0.776056
56853,We Believed,2010-11-12,2010,0,0,0,0.796792
56858,The Key to Paradise,1970-08-24,1970,0,0,0,0.329484
56860,Lost Signal,2007-11-02,2007,2000000,0,-2000000,0.617863
56897,Phas Gaye Re Obama,2010-11-01,2010,0,0,0,1.047111
56901,Yeh Saali Zindagi,2011-02-04,2011,0,0,0,0.516803
56906,Husk,2011-01-28,2011,0,0,0,10.816473
56909,The Immature,2011-01-21,2011,0,0,0,4.00779
56913,Sacrifice,2011-04-26,2011,6800000,0,-6800000,6.738661
56919,Love Likes Coincidences,2011-01-01,2011,0,0,0,1.093847
56920,Tot√≤ Diabolicus,1963-01-01,1963,0,0,0,0.221073
56922,A Second Childhood,2010-10-08,2010,0,0,0,0.367016
56927,The Annunciation,1984-07-13,1984,0,0,0,1.640446
56928,Meet Monica Velour,2010-06-04,2010,5000000,31649,-4968351,1.608163
56929,Elle: A Modern Cinderella Tale,2011-04-26,2011,250000,0,-250000,2.095084
56930,Tycoon,1947-12-27,1947,0,0,0,0.478243
56931,Tom Thumb,1958-12-24,1958,0,0,0,1.045618
56934,Bride of the Wind,2001-06-08,2001,0,0,0,0.016404
56935,The Lacemaker,1977-05-25,1977,0,0,0,2.468159
56937,Cold Prey III,2010-10-15,2010,0,0,0,1.817929
56942,Family Life,1971-12-01,1971,0,0,0,2.034236
56943,The Remains of Nothing,2004-09-11,2004,0,0,0,0.102116
56946,Vodka Lemon,2003-11-21,2003,0,0,0,0.977228
56947,La crise,1992-12-02,1992,0,0,0,0.794746
56948,M√°ncora,2008-09-02,2008,1800000,0,-1800000,0.25362
56949,Wind with the Gone,1998-11-12,1998,0,0,0,0.379683
56950,Frits and Freddy,2010-12-08,2010,0,0,0,0.45292
56952,Scream of the Ants,2007-09-14,2007,0,0,0,0.083216
56959,The Salt of Life,2011-02-11,2011,0,0,0,2.298897
56965,Dirty Movie,2011-02-15,2011,1150000,0,-1150000,1.600411
56967,I Think We're Alone Now,2008-01-01,2008,0,0,0,0.287635
56968,Pregnancy Pact,2010-01-23,2010,0,0,0,4.010044
56969,Tere Naam,2003-08-15,2003,1,2,1,1.280455
56971,The New Monsters Today,2009-03-27,2009,0,0,0,0.32023
56974,Black and White,2008-01-11,2008,0,0,0,0.943728
56975,Pensavo fosse amore invece era un calesse,1991-12-20,1991,0,0,0,0.000308
56978,Misunderstood,1966-01-01,1966,0,0,0,0.243093
56986,Khaleja,2010-10-07,2010,0,0,0,0.368497
56991,√Ösa-Nisse - Welcome to Knohult,2011-02-11,2011,0,0,0,0.726197
56992,Black Sea,2009-01-30,2009,0,0,0,0.050802
56994,The Second Wedding Night,2005-11-11,2005,0,0,0,0.578479
56997,Are You Scared 2,2009-02-10,2009,0,0,0,0.865505
57000,Breaking the Maya Code,2008-05-05,2008,1000000,0,-1000000,0.154635
57005,Eternal Summer,2006-10-13,2006,0,254000,254000,0.690159
57008,Alice in Murderland,2010-02-05,2010,0,0,0,0.678476
57011,Alien vs. Ninja,2010-07-03,2010,0,0,0,2.764059
57012,Talking to Heaven,2002-04-28,2002,0,0,0,1.697106
57016,Mandela,1996-10-11,1996,0,0,0,1.183739
57019,No Return,2010-09-29,2010,0,0,0,0.634539
57022,Sunshine State,2002-06-21,2002,0,0,0,4.016473
57035,The House of Rothschild,1934-04-07,1934,0,0,0,0.844427
57046,"What's Up, Scarlet?",2005-05-18,2005,0,0,0,0.91194
57047,The Fourth Angel,2001-08-15,2001,0,0,0,1.100517
57052,The Right Distance,2007-10-19,2007,0,0,0,0.375661
57059,Loft,2010-12-16,2010,0,0,0,2.224816
57082,Babylon,1980-11-07,1980,0,0,0,0.168154
57088,Confessions of an Eco-Terrorist,2011-01-01,2011,0,0,0,0.207871
57089,Hoodwinked Too! Hood VS. Evil,2011-04-29,2011,30000000,13521829,-16478171,9.382577
57091,Granny O'Grimm's Sleeping Beauty,2008-01-01,2008,0,0,0,0.865532
57100,Double Vision,2002-10-17,2002,0,0,0,1.462804
57103,The Best of Everything,1959-10-09,1959,0,0,0,1.022321
57106,Freedom,2009-08-01,2009,0,0,0,0.666161
57110,The Yes Man,1991-04-05,1991,0,0,0,0.248596
57112,Tu la conosci Claudia?,2004-12-15,2004,0,0,0,5.038131
57118,That's What I Am,2011-04-01,2011,0,0,0,7.839933
57119,Jumping the Broom,2011-05-06,2011,6600000,37710610,31110610,2.664211
57120,Meek's Cutoff,2010-09-05,2010,0,876302,876302,4.725763
57124,Swastika,1974-09-01,1974,0,0,0,0.288698
57130,One Survivor Remembers,1996-06-19,1996,0,0,0,0.516589
57144,Rob the Bank,1964-02-25,1964,0,0,0,2.323818
57157,Young Adult,2011-12-16,2011,12000000,22939027,10939027,6.142913
57158,The Hobbit: The Desolation of Smaug,2013-12-11,2013,250000000,958400000,708400000,20.644776
57165,Wrath of the Titans,2012-03-27,2012,150000000,301000000,151000000,7.739904
57173,Monsterwolf,2010-10-09,2010,0,0,0,2.05618
57186,Skinning,2010-10-06,2010,500000,198,-499802,1.018477
57190,Vlad,2003-05-16,2003,0,0,0,0.849703
57201,The Lone Ranger,2013-07-03,2013,255000000,89289910,-165710090,12.729104
57203,Mega Snake,2007-07-28,2007,0,0,0,0.802397
57204,Touch and Go,1986-08-22,1986,0,1300000,1300000,1.491589
57207,Kiss through the Wall,2011-01-25,2011,0,0,0,0.318805
57209,Inadequate People,2010-12-12,2010,100000,0,-100000,1.50953
57210,Angels Sing,2013-10-19,2013,0,0,0,7.073059
57211,Magic Trip,2011-08-05,2011,0,0,0,0.689448
57212,War Horse,2011-12-25,2011,66000000,177584879,111584879,8.166363
57214,Project X,2012-03-01,2012,12000000,100000000,88000000,9.803023
57215,"Drive, He Said",1971-06-13,1971,0,0,0,0.383116
57218,Bal-Can-Can,2005-10-11,2005,0,0,0,0.678618
57219,Chain of Command,2000-07-22,2000,0,0,0,0.542097
57221,Blood & Donuts,1995-09-09,1995,0,0,0,0.748734
57230,Viy,1967-11-27,1967,0,0,0,1.536545
57240,Big Shots,1987-10-02,1987,0,0,0,0.306709
57241,Kissed by Winter,2005-11-10,2005,0,0,0,0.264445
57243,The Women on the 6th Floor,2010-12-20,2010,0,0,0,3.653474
57248,The Movie Hero,2003-03-08,2003,475000,0,-475000,0.225311
57251,Tickets,2005-03-25,2005,0,0,0,0.663224
57256,Facing the Truth,2002-10-24,2002,0,0,0,1.179277
57258,The Indian Fighter,1955-12-21,1955,0,0,0,3.022988
57269,Sidekick,2005-10-01,2005,0,0,0,0.039907
57276,Pina,2011-02-24,2011,4317946,14624826,10306880,12.452985
57277,Care Bears To the Rescue,2010-04-03,2010,0,0,0,0.044307
57278,The Hexer,2001-11-09,2001,4600000,0,-4600000,1.372661
57283,H√§xan,1922-09-18,1922,0,0,0,2.914798
57296,Oil City Confidential,2009-10-20,2009,0,0,0,0.408882
57305,Miss Director,1964-01-01,1964,0,0,0,0.179745
57307,L'incruste,2004-03-01,2004,0,0,0,0.111031
57308,P.R.O.F.S,1985-09-18,1985,0,0,0,0.020262
57309,Slice,2009-10-22,2009,0,0,0,2.269273
57310,The Sunday Woman,1975-12-23,1975,0,0,0,0.91631
57311,"Thelma, Louise et Chantal",2010-03-03,2010,0,0,0,0.270254
57313,8213: Gacy House,2010-09-28,2010,500,0,-500,1.184452
57326,Sabretooth,2002-11-26,2002,0,0,0,0.711905
57327,Post Coitum,1997-08-29,1997,0,0,0,0.410894
57330,Chameleon,2008-12-03,2008,1800000,0,-1800000,0.678594
57331,Largo Winch II,2011-02-16,2011,21169000,0,-21169000,6.643015
57337,Game Over: Kasparov and the Machine,2003-09-05,2003,0,0,0,0.366087
57342,Amn√®sia,2002-03-15,2002,0,0,0,0.674261
57343,This Time Around,2003-06-22,2003,0,0,0,0.941683
57346,Thomas Jefferson,1997-02-18,1997,0,0,0,0.001921
57351,Love and a Bullet,2002-08-30,2002,0,0,0,0.210241
57353,Cat Run,2011-04-01,2011,25000000,0,-25000000,7.695889
57361,The Yellow Sea,2010-12-22,2010,0,0,0,4.573242
57382,Halal Police d'Etat,2011-02-16,2011,0,0,0,1.558942
57387,In Your Hands,2010-11-04,2010,0,0,0,0.460063
57389,Four Times,2010-05-16,2010,0,0,0,1.82925
57393,Africa United,2010-10-22,2010,0,0,0,1.216629
57394,Champion,2002-06-28,2002,0,0,0,0.469409
57395,I Wish I Knew,2010-09-24,2010,0,0,0,0.205067
57400,The Human Resources Manager,2011-03-04,2011,0,0,0,0.631271
57403,Mysteries of Lisbon,2010-10-20,2010,2500000,0,-2500000,3.115988
57406,Leonard Cohen: I'm Your Man,2006-09-11,2006,0,0,0,0.322965
57409,"Hugh Hefner: Playboy, Activist and Rebel",2009-01-01,2009,0,21878,21878,0.167833
57412,Peter Ibbetson,1935-11-07,1935,0,0,0,0.484253
57413,The Great Vazquez,2010-09-24,2010,0,0,0,0.438456
57419,"Montevideo, God Bless You!",2010-12-19,2010,0,0,0,1.774187
57424,The Heart Elsewhere,2003-01-24,2003,0,0,0,0.417815
57425,Once You're Born You Can No Longer Hide,2005-05-13,2005,0,0,0,1.359507
57431,The Sitter,2011-12-09,2011,25000000,34942188,9942188,13.105682
57436,The Erotic Man,2010-09-26,2010,1400000,0,-1400000,1.038676
57438,Kristin Lavransdatter,1995-08-25,1995,0,0,0,0.089995
57440,After School,2008-05-24,2008,0,0,0,0.142451
57447,The House with Laughing Windows,1976-08-16,1976,0,0,0,2.089199
57448,L'amour fou,2010-09-22,2010,0,0,0,1.426909
57458,A Letter to Uncle Boonmee,2009-05-05,2009,0,0,0,0.254099
57476,The Spirit of '76,1990-01-01,1990,0,0,0,0.549549
57479,What the Deaf Man Heard,1997-11-23,1997,0,0,0,0.246795
57483,Special Forces,2003-06-06,2003,0,0,0,0.45367
57489,The Last Summer of La Boyita,2009-11-05,2009,0,0,0,0.922653
57500,Moomins and the Comet Chase,2010-08-06,2010,0,0,0,0.212277
57510,Ethos,2011-01-01,2011,500000,0,-500000,0.524436
57518,Eddie Griffin: You Can Tell 'Em I Said It,2011-02-19,2011,0,0,0,0.211287
57521,Black Bread,2010-10-10,2010,6000000,3770657,-2229343,3.546146
57529,Ghost Voyage,2008-01-26,2008,0,0,0,0.900107
57536,"Bicicleta, Cullera, Poma",2010-10-01,2010,0,0,0,0.087917
57537,The Jericho Mile,1979-03-01,1979,0,0,0,0.552565
57544,Dying of Laughter,1999-03-12,1999,3000000,0,-3000000,0.396431
57548,Lilla J√∂nssonligan p√• styva linan,1997-01-01,1997,0,0,0,1.231656
57558,Vacuuming Completely Nude in Paradise,2001-08-23,2001,0,0,0,0.804705
57563,Level Five,1997-02-19,1997,0,0,0,0.323039
57564,Rebels of the Neon God,1993-02-01,1993,0,0,0,0.64432
57565,A Private Function,1984-11-09,1984,0,0,0,0.734578
57568,The Intruder,2010-10-19,2010,0,0,0,0.457989
57573,Craig Ferguson: Does This Need to Be Said?,2011-02-19,2011,0,0,0,0.252693
57575,The Last Time I Saw Paris,1954-01-01,1954,0,105,105,0.912955
57578,The Greek Tycoon,1978-05-12,1978,0,0,0,1.526592
57585,Elephant White,2011-05-17,2011,10000000,0,-10000000,6.459079
57586,African Cats,2011-04-22,2011,0,15240456,15240456,3.267026
57597,Xtro 3: Watch the Skies,1995-11-14,1995,0,0,0,0.409937
57602,A Screaming Man,2010-09-28,2010,0,0,0,0.62543
57622,Act da Fool,2010-09-02,2010,0,0,0,0.306907
57627,A Little Thing Called Love,2010-08-12,2010,0,0,0,1.910328
57644,The Smashing Pumpkins: Vieuphoria,1994-10-04,1994,0,0,0,0.002987
57654,Munyurangabo,2007-01-01,2007,0,0,0,0.205707
57655,Spin,2007-01-26,2007,5000000,0,-5000000,1.210178
57656,Dangerous Days: Making Blade Runner,2007-12-18,2007,0,0,0,3.26206
57662,Storm in a Teacup,1937-02-25,1937,0,0,0,0.211715
57664,From Hell to Texas,1958-06-01,1958,0,0,0,0.711775
57665,The Mask,1961-10-27,1961,0,0,0,0.935695
57666,The Appointment,1969-05-22,1969,0,0,0,0.161141
57680,The Simple Life Of Noah Dearborn,1999-05-09,1999,0,0,0,0.502176
57681,Legalese,1998-10-04,1998,0,0,0,0.103131
57683,The Maker,1997-10-17,1997,0,0,0,0.849209
57684,Roxie Hart,1942-02-20,1942,0,0,0,1.090093
57695,The Princess of Montpensier,2010-11-03,2010,14734000,6775121,-7958879,2.156145
57698,Gold Diggers of 1937,1936-12-28,1936,0,0,0,0.393288
57701,On the Hook!,2011-02-03,2011,3000000,1957000,-1043000,0.445269
57703,Norwegian Wood,2010-12-11,2010,0,17636261,17636261,6.972723
57706,Samurai Wolf,1966-11-19,1966,0,0,0,0.547061
57709,Battle of the Brave,2004-11-19,2004,0,0,0,0.747541
57713,La scuola √® finita,2010-11-12,2010,0,0,0,0.111765
57714,Housewarming,2005-06-01,2005,0,0,0,0.599841
57718,Megamind: The Button Of Doom,2011-02-25,2011,0,0,0,4.061347
57722,Kings of Pastry,2009-11-06,2009,0,0,0,1.482868
57725,The Escape Artist,1982-05-04,1982,0,0,0,1.291504
57726,La Maladie de Sachs,1999-09-22,1999,0,0,0,0.226127
57733,Respire,2011-01-01,2011,0,0,0,0.837392
57737,Barbie: A Fairy Secret,2011-03-01,2011,0,0,0,5.08917
57738,Cross My Heart,1987-12-13,1987,0,0,0,0.469374
57739,Ya Sonra?,2011-02-24,2011,0,0,0,0.297242
57743,The Learning Curve,2001-10-05,2001,1000000,0,-1000000,0.225537
57744,The Kiss,1988-10-14,1988,6000000,0,-6000000,0.646642
57745,Orphans,1998-09-03,1998,0,49501,49501,2.805298
57749,The Clinic,2010-10-10,2010,0,0,0,4.927278
57757,The Sannikov Land,1973-10-01,1973,0,0,0,1.735003
57768,I Embrace You With 1000 Arms,2006-03-09,2006,0,0,0,0.382448
57770,Poor Sasha,1997-12-26,1997,0,0,0,0.260901
57771,Score: A Hockey Musical,2010-10-22,2010,0,0,0,0.507532
57775,Khottabych,2006-08-10,2006,0,0,0,1.22474
57776,"There's Good Weather in Deribasovskaya, Or It's Raining Again in Brighton Beach",1993-04-01,1993,0,0,0,0.286533
57778,Unbelievable Adventures of Italians in Russia,1974-01-01,1974,0,0,0,2.101817
57779,Peculiarities of the National Ice Fishing,2007-01-01,2007,0,0,0,0.204356
57781,Old Hags,2000-03-03,2000,0,0,0,0.38494
57784,Glass House: The Good Mother,2006-10-03,2006,0,0,0,1.481012
57789,"Double, Double, Toil and Trouble",1993-10-30,1993,0,0,0,1.602717
57800,Ice Age: Continental Drift,2012-06-26,2012,95000000,877244782,782244782,13.26958
57809,Six Degrees of Celebration,2010-12-12,2010,5000000,22772019,17772019,2.025505
57811,Foreign Land,1996-09-04,1996,0,0,0,1.567614
57812,51,2011-02-26,2011,1000000,0,-1000000,2.160202
57813,Perth: The Geylang Massacre,2004-04-28,2004,0,0,0,0.113128
57816,8th Wonderland,2008-05-15,2008,0,0,0,0.944554
57825,Bride & Prejudice,2004-02-11,2004,7000000,0,-7000000,9.55791
57829,The Mill and the Cross,2011-03-18,2011,0,342519,342519,3.768353
57830,Outbound,2010-08-14,2010,0,0,0,0.548007
57834,Blue Sky,1994-09-16,1994,0,0,0,4.993829
57837,George Carlin: On Location at Phoenix,1978-07-23,1978,0,0,0,0.040509
57840,Captain January,1936-04-24,1936,0,0,0,2.033395
57843,Mars,1998-03-12,1998,4500000,0,-4500000,0.226335
57845,Mandroid,1993-08-18,1993,0,0,0,0.484612
57849,Casanova's Big Night,1954-04-07,1954,0,0,0,0.210882
57855,"Charlie, the Lonesome Cougar",1967-10-18,1967,0,0,0,0.439681
57857,The Christmas Box,1995-12-17,1995,0,0,0,0.784015
57859,Night and Day,2008-02-28,2008,0,0,0,0.897443
57866,Kiss and Make-Up,1934-07-13,1934,0,0,0,0.632989
57868,The Autobiography of Miss Jane Pittman,1974-01-01,1974,0,0,0,0.617547
57875,The Snow Woman,1968-04-20,1968,0,0,0,0.299327
57876,Area 51,2015-05-15,2015,5000000,0,-5000000,6.055594
57880,I Love Hong Kong,2011-02-03,2011,0,0,0,0.726513
57889,The Best Movie 3-DE,2011-01-19,2011,6500000,9816332,3316332,0.877477
57892,Vizontele,2001-02-02,2001,0,0,0,1.807017
57911,Harry and the Butler,1961-09-07,1961,0,0,0,0.263102
57914,A Boy from Calabria,1987-09-11,1987,0,0,0,0.001021
57918,Da grande,1987-12-23,1987,0,0,0,0.003977
57924,Auschwitz,2011-02-11,2011,0,0,0,0.827141
57943,The Love Letter,1998-02-01,1998,0,0,0,0.861656
57946,Margaret Cho: Notorious C.H.O.,2002-06-29,2002,0,0,0,0.104037
57953,Project Grizzly,1997-10-03,1997,0,0,0,0.318296
57954,Gizmo!,1977-09-16,1977,0,0,0,0.227416
57965,Red Like the Sky,2006-10-17,2006,0,0,0,0.941648
57967,Sweet Dreams,1981-09-10,1981,0,0,0,0.653364
57976,Little Dieter Needs to Fly,1997-12-01,1997,0,0,0,1.014863
57977,Luna de Avellaneda,2004-01-01,2004,0,0,0,0.827289
57978,Meantime,1984-03-14,1984,0,0,0,1.509256
57979,Pro Dia Nascer Feliz,2006-03-23,2006,0,0,0,0.155787
57981,Rapado,1992-08-01,1992,0,0,0,0.011353
57983,The Jester's Tale,1964-05-05,1964,0,0,0,0.077088
57991,Frisky,1954-01-01,1954,0,0,0,0.571273
57992,The Red Siren,2002-01-01,2002,0,0,0,1.024265
57993,The Mountain,1956-11-14,1956,0,0,0,0.591862
57996,Neapolitan Turk,1953-09-16,1953,0,0,0,0.787063
57999,Io so che tu sai che io so,1982-01-01,1982,0,0,0,0.000578
58007,Poverty and Nobility,1954-01-01,1954,0,0,0,1.573912
58011,Let's Hope It's a Girl,1986-01-01,1986,0,0,0,0.516496
58012,The Devil's Brother,1933-01-01,1933,0,0,0,0.589807
58013,The Santa Claus Gang,2010-12-17,2010,0,0,0,3.670624
58018,U Pana Boga za piecem,1998-10-06,1998,0,0,0,0.19559
58028,Hollow Point,1996-10-21,1996,0,0,0,1.098837
58032,Dial H-I-S-T-O-R-Y,1997-01-01,1997,0,0,0,0.001192
58035,To the Shores of Tripoli,1942-11-09,1942,0,0,0,0.060829
58043,My Piece of the Pie,2011-03-16,2011,0,0,0,2.740962
58048,Shanghai Surprise,1986-08-29,1986,17000000,0,-17000000,1.408849
58051,Housefull,2010-04-30,2010,0,0,0,1.974336
58058,Elisa,1995-02-01,1995,0,0,0,1.375176
58060,The Jewel,2011-03-04,2011,0,0,0,0.465041
58061,White Fang,1973-12-21,1973,0,0,0,0.879724
58062,Into the Arms of Strangers: Stories of the Kindertransport,2000-09-06,2000,0,0,0,0.838983
58069,May 18,2007-07-25,2007,0,0,0,0.613963
58070,Mi manda Picone,1984-01-12,1984,0,0,0,0.00195
58074,"Tot√≤, Peppino e i fuorilegge",1956-12-21,1956,0,0,0,0.986756
58075,My Zinc Bed,2008-08-27,2008,0,0,0,0.411501
58076,Immortal Sergeant,1943-04-29,1943,0,0,0,0.438115
58080,The Violent Professionals,1973-08-22,1973,0,0,0,0.542048
58081,Iris Blond,1996-01-01,1996,0,0,0,1.066085
58083,The Haunted House,1982-01-01,1982,0,0,0,1.060676
58084,Julia and Julia,1987-01-01,1987,0,0,0,0.756115
58086,The Past Is a Foreign Land,2008-01-01,2008,0,0,0,0.32147
58089,People of Rome,2003-10-31,2003,0,0,0,0.13098
58096,Killer Pad,2008-02-05,2008,0,0,0,4.372474
58097,Freedomfighters,1996-04-19,1996,0,0,0,0.668261
58098,The Way We Laughed,1998-01-01,1998,0,0,0,0.630045
58102,Some Mother's Son,1996-12-25,1996,0,0,0,0.332582
58106,The Boy Next Door,2008-06-01,2008,0,0,0,0.675401
58128,Andaz Apna Apna,1994-04-11,1994,0,0,0,2.058966
58129,The Phantom Carriage,1921-01-01,1921,0,0,0,3.830428
58133,Possibility of an Island,2008-10-09,2008,0,0,0,0.402427
58151,Fright Night,2011-08-18,2011,17000000,24922237,7922237,9.665251
58156,Pure,2009-10-22,2009,0,0,0,2.667022
58159,The Tortoise and the Hare,1935-01-05,1935,32671,0,-32671,2.463865
58160,Little Hiawatha,1937-05-15,1937,33500,0,-33500,0.52336
58166,Lessons of a Dream,2011-02-24,2011,0,0,0,1.726298
58182,The Stooge,1952-12-31,1952,0,0,0,4.78654
58188,Il medico della mutua,1968-10-23,1968,0,0,0,0.840422
58189,Perdiamoci di vista!,1994-01-01,1994,0,0,0,0.414483
58191,He's Worse than Me,1985-02-21,1985,0,0,0,1.561117
58192,Broken Lullaby,1932-01-24,1932,0,0,0,0.504959
58194,White Irish Drinkers,2011-03-25,2011,600000,0,-600000,0.660746
58195,Almost Blue,2000-01-01,2000,0,0,0,0.588541
58197,A Beautiful Life,2008-08-14,2008,0,0,0,0.031905
58200,Shadowzone,1990-02-22,1990,0,0,0,1.179286
58204,Love & Slaps,2010-12-17,2010,0,0,0,1.464137
58207,If Tomorrow Comes,1986-03-16,1986,0,0,0,1.445004
58218,The Devil's Nightmare,1971-06-06,1971,0,0,0,1.57184
58219,The Ages of Love,2011-02-25,2011,0,0,0,4.168043
58224,Mr. Popper's Penguins,2011-06-17,2011,55000000,187361754,132361754,15.214342
58227,The Connection,1962-10-03,1962,167,0,-167,0.196275
58231,Mardi Gras: Spring Break,2011-09-23,2011,0,0,0,5.886775
58232,Chalet Girl,2011-02-02,2011,8000000,1749457,-6250543,6.496259
58233,Johnny English Reborn,2011-09-15,2011,45000000,160078586,115078586,10.668658
58235,Confessions of a Brazilian Call Girl,2011-02-25,2011,200,0,-200,3.648268
58242,"Sarah, Plain and Tall - Winter's End",1999-11-20,1999,0,0,0,0.197754
58244,Upside Down,2012-09-27,2012,60000000,8106475,-51893525,7.37535
58250,The Bucks County Massacre,2010-12-01,2010,0,0,0,0.077303
58251,Daddy Longlegs,2009-05-16,2009,0,20728,20728,0.89682
58255,Kung Phooey,2003-03-11,2003,0,0,0,0.405229
58257,Savage Messiah,1972-06-27,1972,0,0,0,1.276455
58258,The Chameleon,2010-08-23,2010,0,0,0,4.582976
58261,Transcendent Man,2009-04-25,2009,0,0,0,0.760211
58287,Position Among the Stars,2011-03-03,2011,0,0,0,0.49163
58291,The Battle for Marjah,2010-01-01,2010,0,0,0,0.076597
58293,The Anniversary,1968-02-07,1968,0,0,0,1.087084
58296,977,2006-10-26,2006,0,0,0,0.117195
58301,Betty Blowtorch: And Her Amazing True Life Adventures,2003-06-11,2003,0,0,0,0.00425
58302,Dus,2005-07-08,2005,0,0,0,1.798957
58306,Devo: The Complete Truth About De-Evolution,1993-11-19,1993,0,0,0,4e-06
58309,School For All,2006-10-18,2006,0,0,0,0.281173
58311,Executioners,1993-09-30,1993,0,0,0,0.832443
58333,Tanu Weds Manu,2011-03-25,2011,400000,252000,-148000,1.252133
58365,Just Call Me Nobody,2010-12-03,2010,10000000,0,-10000000,0.702693
58368,Kung Fu Wing Chun,2010-10-12,2010,0,0,0,0.954363
58372,Reckless,1995-11-17,1995,0,0,0,0.119713
58376,Presumed Guilty,2008-11-21,2008,0,0,0,0.151281
58383,Hands Over the City,1963-10-09,1963,0,0,0,1.00931
58384,Drowning Ghost,2004-10-14,2004,0,0,0,0.766605
58390,Ciao Bella,2007-08-03,2007,0,0,0,0.483302
58391,Three Wise Men,2008-11-14,2008,0,0,0,0.239772
58396,Joy,2010-04-08,2010,0,0,0,0.37015
58400,Just a Father,2008-01-01,2008,0,0,0,1.597821
58402,The Boss,1973-02-01,1973,0,0,0,0.34866
58404,The Treasure of San Gennaro,1966-01-01,1966,0,0,0,1.655515
58405,Don't Look Up,1996-01-01,1996,0,0,0,0.617637
58411,Cannibal Girls,1973-04-01,1973,0,0,0,1.998366
58414,A True Mob Story,1998-07-01,1998,0,0,0,0.522017
58416,"Take Care of Your Scarf, Tatiana",1994-01-01,1994,0,0,0,0.471183
58419,2020 Texas Gladiators,1983-01-01,1983,0,0,0,0.201384
58421,Ignition,2002-01-17,2002,0,0,0,0.333701
58427,Samson and Delilah,1996-12-08,1996,0,0,0,0.518177
58428,The Innkeepers,2011-12-01,2011,750000,78396,-671604,8.560726
58429,La Cienaga,2001-04-12,2001,0,0,0,1.628692
58430,Solomon,1997-12-15,1997,0,0,0,1.631905
58431,Pride and Prejudice and Zombies,2016-02-04,2016,28000000,16374328,-11625672,7.954623
58432,The Dark Hour,2006-10-06,2006,0,0,0,1.936301
58433,The Apocalypse,2002-12-10,2002,0,0,0,1.02832
58434,Rocket Gibraltar,1988-09-02,1988,0,187349,187349,0.871303
58435,Hitler: A Film from Germany,1977-07-07,1977,0,0,0,0.24812
58443,Blue Crush 2,2011-06-07,2011,7000000,0,-7000000,2.689455
58444,Women Vs Men,2011-02-04,2011,0,0,0,4.812756
58446,Daydream Nation,2010-09-10,2010,0,0,0,5.116632
58447,Three Giant Men,1973-01-01,1973,0,0,0,0.605245
58448,Knockout,2011-03-05,2011,9000000,0,-9000000,1.654237
58450,Cosmonaut,2009-09-11,2009,0,0,0,1.407524
58453,Niente paura,2010-01-01,2010,0,0,0,0.335542
58455,Dakota,1945-12-25,1945,0,0,0,5.428329
58462,Loverboy,2005-01-24,2005,0,0,0,2.45181
58467,Girl,1998-11-05,1998,0,0,0,8.532861
58470,The Green Man,1956-12-21,1956,0,0,0,0.308907
58473,After the Promise,1987-10-11,1987,0,0,0,0.1377
58483,A Family,2011-02-24,2011,0,0,0,0.575124
58487,La strat√©gie de l'√©chec,2000-01-28,2000,0,0,0,0.334757
58492,The Greatest Movie Ever Sold,2011-04-22,2011,0,621951,621951,4.39817
58493,A Small Act,2010-01-01,2010,0,0,0,0.00594
58494,Daniel Tosh: Happy Thoughts,2011-03-08,2011,0,0,0,0.762356
58496,Senna,2010-10-07,2010,0,8212430,8212430,11.331859
58500,The Butterfly Circus,2009-01-01,2009,0,0,0,0.999437
58507,The Check Is in the Mail...,1986-01-01,1986,0,0,0,0.041717
58509,Unfair Competition,2001-01-01,2001,0,0,0,1.480577
58511,"Suddenly, Last Winter",2008-02-12,2008,0,0,0,0.00541
58515,The Lost Thing,2010-01-01,2010,0,0,0,2.113402
58517,Life Even Looks Like a Party,2009-01-16,2009,0,0,0,0.086215
58518,La vita facile,2011-03-04,2011,0,0,0,1.117175
58522,Boris - Il film,2011-04-01,2011,3347850,1248748,-2099102,2.906503
58525,Parole sante,2007-01-01,2007,0,0,0,0.003848
58526,Splendor,1989-01-01,1989,0,0,0,0.307184
58529,Dealer,2004-02-11,2004,0,0,0,0.457814
58531,Saimir's decision,2004-01-01,2004,0,0,0,0.389291
58545,The Most Wonderful Evening of My Life,1972-12-22,1972,0,0,0,0.588623
58547,10 Years,2011-09-12,2011,0,201146,201146,8.881954
58550,Memoirs of a Teenage Amnesiac,2010-03-27,2010,0,0,0,0.212271
58551,Tokyo Girl,2008-02-23,2008,0,0,0,0.074182
58553,Porno,1990-01-26,1990,0,0,0,1.226896
58559,Confession of a Child of the Century,2012-08-29,2012,0,0,0,0.77848
58570,Where a Good Man Goes,1999-05-06,1999,0,0,0,0.050215
58574,Sherlock Holmes: A Game of Shadows,2011-11-22,2011,125000000,334615000,209615000,18.695329
58587,Diario de un skin,2005-06-13,2005,0,0,0,0.369894
58589,Metal Gear Solid: Philanthropy,2009-09-27,2009,15000,0,-15000,0.254232
58591,Miracle Run,2003-10-06,2003,0,0,0,0.911542
58595,Snow White and the Huntsman,2012-05-30,2012,170000000,396600000,226600000,18.751554
58607,High on Crack Street: Lost Lives in Lowell,1995-08-08,1995,0,0,0,0.150412
58611,√à arrivato mio fratello,1985-03-19,1985,0,0,0,0.960562
58613,Stuff for the Rich,1987-11-13,1987,0,0,0,0.725035
58615,Noi uomini duri,1987-01-01,1987,0,0,0,0.020262
58625,Street Kings 2: Motor City,2011-07-15,2011,0,0,0,1.718239
58626,The Hit List,2011-04-02,2011,6000000,0,-6000000,5.658506
58631,29 Palms,2002-07-29,2002,5000000,0,-5000000,1.657116
58646,OPA!,2005-11-13,2005,0,6000000,6000000,1.218763
58648,Closet Land,1991-03-06,1991,4000000,259012,-3740988,1.456755
58655,Parade,1974-12-18,1974,0,0,0,0.07996
58658,The Day of the Owl,1968-02-17,1968,0,0,0,0.564494
58664,Mostly Ghostly,2008-09-30,2008,3600000,0,-3600000,2.064163
58669,The Secret Life of Girls,1999-05-29,1999,0,0,0,0.607193
58679,"The Butcher, the Chef, and the Swordsman",2011-03-17,2011,0,0,0,0.968275
58680,Woo,1998-05-08,1998,13000000,8026971,-4973029,2.326115
58692,Slove,2011-02-21,2011,7000000,0,-7000000,0.796489
58699,Bellflower,2011-04-16,2011,17000,101236,84236,7.759376
58700,"Yobi, The Five-Tailed Fox",2007-01-25,2007,0,0,0,1.616062
58701,Two Colonels,1962-08-31,1962,0,0,0,0.315895
58702,Between Miracles,1971-05-24,1971,0,0,0,0.708466
58703,La scuola,1995-04-06,1995,0,0,0,0.237707
58704,The Wonderful World of Puss 'n Boots,1969-03-18,1969,0,0,0,0.961031
58714,Due partite,2009-01-01,2009,0,0,0,0.964569
58718,Siren,2010-11-11,2010,0,0,0,1.227119
58720,True Confessions of a Go-Go Girl,2008-01-01,2008,0,0,0,0.66693
58725,Netaji Subhas Chandra Bose: The Forgotten Hero,2005-05-13,2005,0,0,0,0.388216
58732,The Bullfighters,1945-05-01,1945,0,0,0,0.389227
58733,The Pirates of Blood River,1962-07-31,1962,0,0,0,0.436141
58757,Heidi,1952-11-13,1952,0,0,0,0.73248
58760,Jackboots on Whitehall,2010-10-08,2010,6000000,0,-6000000,6.356866
58763,God of Love,2010-06-12,2010,0,0,0,0.940317
58764,Lapland Odyssey,2010-10-15,2010,0,0,0,1.885261
58767,Sniper: Reloaded,2011-04-26,2011,0,0,0,5.249191
58769,Die Konferenz der Tiere,1969-12-13,1969,0,0,0,0.112502
58770,The Trigger Effect,1996-08-30,1996,8000000,0,-8000000,9.028947
58772,A Film Unfinished,2010-08-18,2010,0,0,0,0.488031
58773,On tour,1990-04-06,1990,0,0,0,0.177013
58777,Will It Snow for Christmas?,1996-12-25,1996,0,0,0,0.286321
58781,31 North 62 East,2009-09-18,2009,3100000,0,-3100000,0.442155
58782,A Dead Calling,2006-12-12,2006,0,0,0,0.335112
58788,Attack of the Sabretooth,2005-07-14,2005,2,0,-2,0.840179
58790,Blood Tide,1982-09-01,1982,0,0,0,0.863501
58792,BreadCrumbs,2011-01-25,2011,0,0,0,0.850359
58799,Christmas Eve,1947-10-31,1947,0,0,0,0.275289
58813,Deathlands,2003-05-17,2003,0,0,0,0.139254
58820,The Beckoning Silence,2007-10-22,2007,0,0,0,0.439807
58828,The Story of Menstruation,1946-10-18,1946,0,0,0,0.275712
58832,Babysitters Beware,2009-12-03,2009,1500000,0,-1500000,0.458808
58833,"So Long, Stooge",1983-12-20,1983,0,0,0,1.223298
58857,13 Assassins,2010-09-09,2010,6000000,17555141,11555141,9.534232
58858,The Marquis,2011-03-09,2011,0,0,0,6.213759
58859,The Light Thief,2011-03-02,2011,0,0,0,1.311524
58865,Loaf and Camouflage,1984-10-01,1984,0,0,0,0.65694
58877,Episode 3: Enjoy Poverty,2009-06-04,2009,0,0,0,0.452745
58878,Three Outlaw Samurai,1964-05-13,1964,0,0,0,1.133661
58882,Snow Flower and the Secret Fan,2011-07-15,2011,134005,1332231,1198226,2.003832
58884,Sympathy for Delicious,2011-04-29,2011,0,0,0,7.058832
58886,Everybody's Famous!,2000-04-12,2000,0,0,0,0.917373
58887,When Harry Tries to Marry,2011-04-22,2011,0,38261,38261,0.698153
58891,PressPausePlay,2011-03-01,2011,0,0,0,0.584342
58895,Hush Little Baby,2007-10-27,2007,0,0,0,0.337246
58897,Dry Summer,1963-12-16,1963,0,0,0,0.708582
58899,Demon Wind,1990-07-05,1990,500000,0,-500000,0.178519
58902,North West Frontier,1959-10-13,1959,0,0,0,7.902787
58903,Creature,1985-05-08,1985,750000,0,-750000,5.475876
58904,Haunted Castle,2001-02-23,2001,0,13651656,13651656,0.695382
58905,The Crusades,1935-08-21,1935,0,0,0,0.456739
58911,Hotel de Love,1996-12-19,1996,0,0,0,0.228157
58918,Backflash,2002-01-22,2002,0,0,0,0.359651
58920,Lost in a Harem,1944-12-01,1944,0,0,0,0.34846
58923,When the Levees Broke: A Requiem in Four Acts,2006-08-16,2006,2000000,0,-2000000,0.525385
58925,Mr. Klein,1976-05-08,1976,0,0,0,6.298305
58928,Fragments of Antonin,2006-11-08,2006,0,0,0,0.189496
58936,Pure Country 2: The Gift,2010-10-15,2010,0,133771,133771,0.684516
58937,Wittgenstein,1993-03-26,1993,0,0,0,0.801156
58954,The Web of Death,1976-10-28,1976,0,0,0,0.018297
58959,A Better Tomorrow,2010-09-16,2010,8700000,0,-8700000,3.253841
58985,Grace of My Heart,1996-09-13,1996,0,0,0,9.364418
58995,Night Crossing,1982-02-05,1982,0,0,0,1.132689
58997,Invisible Invaders,1959-05-15,1959,0,0,0,1.060773
59005,Quackser Fortune Has a Cousin in the Bronx,1970-06-13,1970,0,0,0,2e-06
59006,Girl Walks Into a Bar,2011-03-07,2011,1000000,0,-1000000,9.586854
59013,The Royal Scandal,2001-10-19,2001,0,0,0,0.193886
59015,Lights Out,2010-10-22,2010,0,0,0,1.187577
59017,A Very Potter Sequel,2010-07-22,2010,0,0,0,0.471348
59040,I due carabinieri,1984-01-01,1984,0,0,0,0.169231
59045,Ro.Go.Pa.G.,1963-02-19,1963,0,0,0,0.382572
59046,Mio cognato,2003-01-01,2003,0,0,0,0.110602
59050,The Voice of the Moon,1990-01-01,1990,0,0,0,1.193661
59051,Dark Angel: The Ascent,1994-08-31,1994,0,0,0,0.312543
59053,The Raffle,1991-11-15,1991,0,0,0,1.263203
59058,Riff-Raff,1991-06-21,1991,0,295444,295444,1.501241
59060,Alan Davies: Live at the Lyric,1994-11-06,1994,0,0,0,0.051624
59065,Route Irish,2011-03-16,2011,0,0,0,2.005383
59066,The Umbrella Woman,1987-05-14,1987,0,1155000,1155000,0.139463
59075,Snow White,1987-05-14,1987,0,0,0,0.60522
59087,5 Fingers,1952-02-22,1952,0,0,0,8.253802
59088,I Even Met Happy Gypsies,1967-03-26,1967,0,0,0,0.28146
59095,Revelation,2001-04-12,2001,0,10000000,10000000,0.625099
59098,Au Pair Girls,1972-07-01,1972,0,0,0,0.877947
59100,Beautiful Dreamer: Brian Wilson and the Story of Smile,2004-10-05,2004,0,0,0,0.563247
59101,Confessions of an Opium Eater,1962-06-20,1962,0,0,0,0.301024
59108,Tower Heist,2011-11-02,2011,75000000,152930623,77930623,7.762917
59110,Parked,2010-09-01,2010,0,0,0,1.248383
59111,Kalamity,2010-10-22,2010,2000000,0,-2000000,0.812938
59115,Quarantine 2: Terminal,2011-06-16,2011,4000000,0,-4000000,4.520607
59117,Torrente 4: Lethal crisis,2011-03-11,2011,0,0,0,2.260114
59118,The Prey,2011-04-12,2011,0,0,0,8.908143
59120,The Lost Tribe,2009-11-07,2009,1000000,0,-1000000,1.391639
59122,Peluca,2003-01-20,2003,0,0,0,0.239901
59126,The Holy Modal Rounders: Bound to Lose,2007-12-07,2007,0,0,0,0.007914
59138,Modulations,1998-09-18,1998,0,0,0,0.100482
59139,Il commissario Lo Gatto,1987-01-01,1987,0,0,0,0.347202
59142,You Can't Run Away from It,1956-10-30,1956,0,0,0,0.060995
59143,Mikey and Nicky,1976-12-21,1976,0,0,0,0.415597
59145,The Assault,2010-11-12,2010,0,0,0,3.141456
59146,The Wooden Man's Bride,1994-02-05,1994,0,0,0,0.088451
59147,Bits & Pieces,1996-02-01,1996,0,0,0,0.710598
59156,Il giocattolo,1979-02-21,1979,0,0,0,0.050841
59158,The Death Kiss,1932-12-05,1932,0,0,0,0.670124
59159,Callan,1974-01-01,1974,0,0,0,0.000308
59163,Papa,2005-06-01,2005,0,0,0,0.4792
59169,Beyond The Mind's Eye,1992-10-09,1992,0,0,0,0.016204
59171,The Lady and the Highwayman,1989-01-22,1989,0,0,0,0.336878
59173,Sam Kinison: Why Did We Laugh?,1998-01-01,1998,0,0,0,0.00277
59178,The Wind in the Willows,1995-12-24,1995,0,0,0,1.338982
59181,H.O.T.S.,1979-05-01,1979,0,0,0,0.585177
59189,Phase IV,1974-09-01,1974,0,0,0,3.194233
59191,Eloise at Christmastime,2003-11-23,2003,0,0,0,1.151862
59196,Lost Boys of Sudan,2003-04-24,2003,0,0,0,0.160637
59197,Battle of Los Angeles,2011-03-10,2011,0,0,0,7.987112
59199,World Traveler,2002-01-17,2002,0,0,0,1.251219
59201,Kinjite: Forbidden Subjects,1989-02-03,1989,0,0,0,0.635271
59206,LennoNYC,2010-09-25,2010,0,0,0,1.012072
59210,The Mother,2003-01-01,2003,2500000,1062253,-1437747,3.551063
59219,Quo Vadis,2001-08-30,2001,18000000,0,-18000000,1.212036
59230,Lucky Luciano,1973-10-10,1973,0,0,0,0.178017
59231,The Rain People,1969-08-27,1969,0,0,0,0.785882
59232,The War at Home,1996-11-20,1996,0,0,0,0.893464
59238,Jesse Stone: Innocents Lost,2011-05-21,2011,0,0,0,2.623682
59239,The Cloud-Capped Star,1960-12-31,1960,0,0,0,0.505948
59241,Ultr√†,1991-03-01,1991,0,0,0,0.266692
59248,The Wildest Dream,2010-08-06,2010,0,0,0,1.064957
59249,Vacations in Majorca,1960-03-25,1960,0,0,0,0.196462
59255,The Unintentional Kidnapping of Mrs. Elfriede Ott,2010-10-01,2010,0,0,0,0.382647
59264,Silvio Forever,2011-03-25,2011,0,0,0,0.157131
59266,The Arbor,2010-10-22,2010,0,21268,21268,0.707297
59290,Polar Opposites,2008-01-01,2008,0,0,0,0.115732
59296,"Love, Wedding, Marriage",2011-06-03,2011,1,1378,1377,4.060122
59297,Princess Arete,2001-08-01,2001,0,0,0,0.417516
59298,The Perfect World of Kai,2007-07-21,2007,0,0,0,2.880395
59314,The Day After Trinity,1981-01-20,1981,0,0,0,0.336354
59317,Scrapbook,2000-01-01,2000,0,0,0,0.875813
59333,Official Rejection,2009-04-04,2009,0,0,0,0.497752
59336,I Knew Her Well,1965-12-01,1965,0,0,0,1.073023
59346,Darling,2007-11-07,2007,0,0,0,0.48251
59349,Apr√®s la guerre,1989-04-26,1989,0,0,0,0.000844
59354,Nocturna Artificialia,1979-01-01,1979,0,0,0,0.211414
59356,This Unnameable Little Broom,1985-01-01,1985,0,0,0,0.572949
59357,Street of Crocodiles,1986-01-01,1986,0,0,0,0.040509
59358,Rehearsals for Extinct Anatomies,1987-01-01,1987,0,0,0,0.952685
59362,Pyaar Ke Side Effects,2006-09-15,2006,0,0,0,0.160698
59372,Sur,2002-09-13,2002,0,0,0,0.04845
59387,The Powerpuff Girls Movie,2002-07-03,2002,10000000,11411644,1411644,5.024459
59388,Calamari Union,1985-02-08,1985,0,0,0,1.01438
59390,Running Mates,1992-10-04,1992,0,0,0,0.746921
59392,Backlight,2010-07-10,2010,0,0,0,1.072862
59401,The Red Badge of Courage,1951-03-16,1951,1640000,0,-1640000,1.340142
59402,Shaolin Mantis,1978-06-28,1978,0,0,0,0.521963
59403,The Adventures of Huckleberry Finn,1939-02-10,1939,0,0,0,0.23574
59404,Shaolin vs. Lama,1983-01-01,1983,0,0,0,0.768148
59405,Ten Tigers of Kwangtung,1979-12-25,1979,0,0,0,0.435576
59406,PsyWar: The real battlefield is your mind,2010-10-08,2010,0,0,0,0.147094
59408,Deep End,1970-09-01,1970,0,0,0,3.043987
59414,The Concert for Bangladesh,1972-03-23,1972,0,0,0,0.73888
59419,The Best and the Brightest,2010-01-01,2010,0,0,0,0.663723
59421,Bedevilled,2010-08-19,2010,700000,0,-700000,6.375628
59423,Marathon,2005-01-27,2005,0,0,0,0.464192
59424,Sonny Boy,2011-01-27,2011,0,0,0,0.985211
59426,Zhit,2010-11-03,2010,0,0,0,0.553507
59427,Ring of Bright Water,1969-06-18,1969,0,0,0,0.508126
59429,Paranormal Activity: Tokyo Night,2010-11-20,2010,0,0,0,4.677365
59434,The Counterfeiters of Paris,1961-02-27,1961,0,0,0,1.249245
59435,An Invisible Sign,2010-10-06,2010,0,1279,1279,2.23481
59436,Midnight in Paris,2011-05-11,2011,30000000,151119219,121119219,11.43256
59437,Beautiful Boy,2010-09-12,2010,0,63931,63931,2.114833
59439,Natural Selection,2011-03-13,2011,0,55282,55282,0.416296
59440,Warrior,2011-09-09,2011,25000000,23057115,-1942885,13.121626
59441,A Bag of Hammers,2011-03-12,2011,2000000,0,-2000000,0.967134
59444,2 Young,2005-04-28,2005,0,0,0,0.677252
59455,Pour 100 briques t'as plus rien !,1982-05-12,1982,0,0,0,1.023183
59457,Womb,2010-07-15,2010,3100000,0,-3100000,7.279917
59468,The Way,2010-09-10,2010,0,4430765,4430765,7.131032
59474,Cazuza: Time Doesn't Stop,2004-06-11,2004,0,0,0,1.519792
59475,Look for a Woman,1982-06-09,1982,0,0,0,0.876368
59481,A House In The Hills,1993-01-20,1993,0,0,0,0.601325
59482,August 32nd on Earth,1998-11-18,1998,0,0,0,0.711932
59484,Le Pont du Nord,1982-03-24,1982,0,0,0,0.019669
59490,Cave of Forgotten Dreams,2010-09-10,2010,0,6467348,6467348,4.508588
59499,Mr. & Mrs. Incredible,2011-02-03,2011,0,0,0,0.473097
59500,Jade Warrior,2006-09-08,2006,0,0,0,0.939785
59507,Four Lovers,2010-09-15,2010,0,0,0,1.919481
59517,Walter,1982-11-02,1982,0,0,0,0.95088
59527,Pleasure at Her Majesty's,1976-12-29,1976,0,0,0,0.000758
59529,The State Counsellor,2005-01-01,2005,0,0,0,0.521143
59533,The Secret Policeman's Other Ball,1982-09-23,1982,0,0,0,0.588173
59557,Marco Polo,2007-04-06,2007,0,0,0,0.968789
59558,Miami Connection,1987-08-18,1987,0,0,0,1.972494
59566,"Think Fast, Mr. Moto",1937-07-27,1937,0,0,0,3.997872
59569,Killer: A Journal of Murder,1996-09-06,1996,0,0,0,0.705136
59570,Escort in love,2011-03-18,2011,0,0,0,4.832601
59572,Buster Keaton: A Hard Act to Follow,1987-09-30,1987,0,0,0,0.674009
59581,"Thank You, Mr. Moto",1937-12-24,1937,0,0,0,0.733865
59582,It Begins with the End,2010-05-26,2010,0,0,0,0.226351
59584,Mr. Moto's Gamble,1938-04-07,1938,0,0,0,1.060894
59585,Immediate Family,1989-10-27,1989,0,0,0,0.60641
59589,Mr. Moto in Danger Island,1939-04-07,1939,0,0,0,0.224115
59596,La Domination Masculine,2009-11-25,2009,0,0,0,0.460364
59678,Attack the Block,2011-05-12,2011,14350531,3964682,-10385849,9.93263
59700,12 Days of Christmas Eve,2004-12-07,2004,0,0,0,0.438806
59701,Mr. Wong in Chinatown,1939-08-01,1939,0,0,0,0.165704
59704,Where Angels Fear to Tread,1991-06-21,1991,0,0,0,0.852183
59706,The Fatal Hour,1940-01-15,1940,0,0,0,0.614139
59719,Lupin the Third: Sweet Lost Night,2008-07-25,2008,0,0,0,0.513825
59722,2012: Ice Age,2011-06-27,2011,0,0,0,7.504259
59726,Wake Wood,2011-03-25,2011,0,0,0,3.092998
59733,Down from the Mountain,2001-06-05,2001,0,0,0,0.051216
59735,Cameron's Closet,1988-12-02,1988,7000000,136203,-6863797,0.861473
59738,Girls Nite Out,1982-06-20,1982,0,0,0,0.959481
59744,Grotesque,1988-09-09,1988,0,0,0,0.497236
59762,"Initiation: Silent Night, Deadly Night 4",1990-11-21,1990,0,0,0,0.6167
59797,Bad Dreams,1988-04-08,1988,4000000,9797098,5797098,5.296777
59802,Incubus,1966-10-26,1966,0,0,0,0.535626
59803,Adventures of Mowgli,1973-01-01,1973,0,0,0,1.349284
59807,Love and Mary,2007-01-01,2007,500000,0,-500000,0.497321
59809,Lipstick,1976-04-02,1976,0,0,0,0.522987
59810,The Least of These,2011-08-02,2011,0,0,0,0.042356
59820,Come See the Paradise,1990-08-17,1990,0,0,0,6.408322
59828,Killer McCoy,1947-12-01,1947,0,0,0,0.001336
59833,Stakeout on Dope Street,1958-05-03,1958,0,0,0,0.047829
59835,Among Wolves,2010-11-26,2010,8000000,0,-8000000,1.291609
59838,Critic's Choice,1963-04-13,1963,0,0,0,0.149068
59839,The Gospel According to Philip K. Dick,2001-01-01,2001,0,0,0,0.127593
59843,Millionaires Express,1986-01-30,1986,0,0,0,1.761699
59847,M√©lo,1986-09-03,1986,0,0,0,0.767496
59852,Blinky‚Ñ¢,2011-03-21,2011,61733,0,-61733,1.750012
59853,The Bull,1994-01-01,1994,0,0,0,0.289507
59857,Arcane Sorcerer,1996-01-01,1996,0,0,0,0.219228
59858,Figli ‚Äì Hijos,2001-01-01,2001,0,0,0,0.263589
59859,Kick-Ass 2,2013-07-17,2013,28000000,60700000,32700000,13.570264
59860,Monte Carlo,2011-07-01,2011,20000000,17425000,-2575000,8.34835
59861,Larry Crowne,2011-06-30,2011,30000000,36160375,6160375,10.778028
59871,Emmanuelle in the Country,1982-01-01,1982,0,0,0,1.020488
59873,Amore libero - Free Love,1974-08-13,1974,0,0,0,0.298042
59881,Taking Off,1971-05-17,1971,0,0,0,1.65322
59882,The Desperadoes,1943-05-25,1943,0,0,0,0.513797
59883,Age of the Dragons,2011-03-21,2011,5000000,0,-5000000,3.042738
59892,Conspirators of Pleasure,1996-10-17,1996,0,0,0,1.274652
59895,Sudden Danger,1955-12-14,1955,0,0,0,0.072413
59897,Where the Boys Are '84,1984-04-06,1984,0,10530000,10530000,0.168904
59904,The Train: Some Lines Shoulder Never Be Crossed...,2007-06-07,2007,0,0,0,0.087513
59908,Daddy and the Muscle Academy,1991-10-17,1991,0,0,0,0.240738
59912,The Reincarnation of Isabel,1973-01-17,1973,0,0,0,0.199618
59914,The Blonde with Bare Breasts,2010-07-21,2010,7500000,0,-7500000,0.882188
59917,Cotton Comes to Harlem,1970-05-27,1970,1200000,0,-1200000,2.162236
59928,Spooner,2009-01-18,2009,0,0,0,1.118926
59930,The Inkwell,1994-04-22,1994,0,8880705,8880705,0.613335
59935,"For a Moment, Freedom",2008-08-29,2008,0,0,0,1.758122
59939,Slaves to the Underground,1997-11-14,1997,0,0,0,0.425474
59940,Zebra Lounge,2001-10-04,2001,0,0,0,1.745899
59944,From Me To You,2010-09-25,2010,0,0,0,1.42545
59950,Drole de Drame,1937-10-20,1937,0,0,0,1.135768
59958,Gideon's Daughter,2005-10-21,2005,0,0,0,1.170696
59959,You Won't Have Alsace-Lorraine,1977-10-19,1977,0,0,0,0.698575
59961,Safe House,2012-02-09,2012,85000000,208076205,123076205,8.338675
59962,This Means War,2012-02-14,2012,65000000,156974557,91974557,12.366641
59963,Dark Tide,2012-03-28,2012,25000000,432274,-24567726,5.405958
59964,Cabin in the Sky,1943-04-09,1943,662141,1606624,944483,1.233446
59965,Abduction,2011-09-22,2011,35000000,82087155,47087155,10.512109
59967,Looper,2012-09-26,2012,30000000,47042000,17042000,12.727269
59968,Our Idiot Brother,2011-08-26,2011,10000000,17273593,7273593,5.918193
59974,Genius Within: The Inner Life of Glenn Gould,2009-09-13,2009,0,166770,166770,0.146422
59981,Legends of Oz: Dorothy's Return,2013-06-13,2013,70000000,18662027,-51337973,6.660309
59990,The Given Word,1962-04-17,1962,0,0,0,0.904016
59993,World War Three,1998-12-01,1998,0,0,0,0.200477
59995,Wild Tigers I Have Known,2006-07-12,2006,0,0,0,0.854778
59996,Cold Heart,2001-02-10,2001,0,0,0,0.719804
60002,Room 314,2006-01-01,2006,0,0,0,0.172008
60003,Red Rover,2006-10-08,2006,0,0,0,0.407508
60005,American Virgin,2000-06-02,2000,0,0,0,0.109065
60008,Rosso,1985-08-26,1985,0,0,0,0.006617
60009,The Shadow Men,1997-09-24,1997,2000000,0,-2000000,0.480637
60011,The Bang Bang Club,2010-09-15,2010,0,0,0,3.468202
60014,The Child and the Policeman,1989-01-01,1989,0,0,0,0.568246
60015,Novo,2002-08-03,2002,0,0,0,1.955932
60018,The Last Minute,1988-01-01,1988,0,0,0,0.035412
60025,"I, Cesar",2003-04-09,2003,6844180,0,-6844180,2.292595
60029,Malibu Beach,1978-05-01,1978,0,0,0,0.084335
60033,"This World, Then the Fireworks",1997-07-11,1997,0,0,0,0.02329
60035,Dreams on Spec,2007-01-01,2007,0,0,0,0.077386
60038,Il tassinaro,1983-01-01,1983,0,0,0,0.28369
60041,White Mischief,1987-11-30,1987,5300000,0,-5300000,7.312595
60046,Il vigile,1960-01-01,1960,0,0,0,0.312507
60061,Side Street Story,1951-04-17,1951,0,0,0,0.493066
60062,Judy Moody and the Not Bummer Summer,2011-06-10,2011,20000000,14166853,-5833147,2.321394
60063,The Topp Twins: Untouchable Girls,2009-09-13,2009,0,0,0,0.12663
60067,Open Doors,1990-01-01,1990,0,0,0,0.000578
60068,S.S.D.,2008-09-04,2008,0,0,0,0.619569
60071,Missing Pieces,2000-02-06,2000,0,0,0,0.472738
60076,Girl 27,2007-07-27,2007,0,0,0,0.116449
60079,Lunar Cop,1995-12-19,1995,0,0,0,0.448982
60080,They Killed Sister Dorothy,2008-01-01,2008,0,0,0,0.003799
60082,Sprung,1997-05-14,1997,0,7553105,7553105,1.511388
60083,Salut cousin !,1996-11-20,1996,0,0,0,0.15935
60085,Final Flesh,2009-11-17,2009,0,0,0,0.208257
60086,Babysitter Wanted,2009-02-06,2009,0,0,0,8.262337
60087,Black Heat,1976-06-01,1976,0,0,0,0.170712
60106,Loser Takes All!,2004-06-23,2004,0,0,0,0.865623
60116,Teresa Venerd√¨,1941-01-01,1941,0,0,0,0.834656
60119,Second Skin,2000-12-22,2000,3,0,-3,0.605088
60120,Finisterrae,2010-06-11,2010,0,0,0,0.224193
60125,Men Seeking Women,1997-03-08,1997,0,0,0,0.473282
60139,Lethal Ninja,1993-04-19,1993,0,0,0,0.334247
60140,Allotment Wives,1945-11-08,1945,0,0,0,0.284479
60141,Lavoura Arcaica,2001-10-29,2001,0,0,0,0.652255
60142,"Master, a Building in Copacabana",2002-11-22,2002,0,0,0,0.639752
60152,L.A. Zombie,2010-10-07,2010,0,0,0,1.349654
60153,Hi Way,2006-05-02,2006,0,0,0,0.08482
60160,Gamera the Brave,2006-11-11,2006,0,0,0,0.448223
60163,Beck,2010-09-04,2010,0,0,0,1.098231
60164,The Speed of Thought,2011-04-29,2011,2000000,0,-2000000,2.031708
60170,Christopher and His Kind,2011-03-19,2011,0,0,0,9.933547
60173,Nemesis 4: Death Angel,1996-12-23,1996,0,0,0,1.004636
60175,The Under-Gifted,1980-04-30,1980,0,0,0,3.736959
60181,Blood on the Streets,1974-10-23,1974,0,0,0,1.664664
60189,Lovey-Dovey 3,2011-03-03,2011,4000000,0,-4000000,1.174113
60190,Beyond Darkness,1990-01-01,1990,0,0,0,0.198093
60191,Magnificat,1993-04-09,1993,0,0,0,1e-06
60193,Arrangiatevi!,1959-01-01,1959,0,0,0,0.142545
60194,Umbrella Coup,1980-10-08,1980,0,0,0,1.491333
60195,Il conte Max,1957-01-01,1957,0,0,0,1.397323
60199,Hotel Room,1993-04-01,1993,0,0,0,0.357286
60202,Macaroni,1985-10-24,1985,0,0,0,0.61828
60213,Corto Maltese: The Ballad of the Salt Sea,2003-01-01,2003,0,0,0,0.614148
60216,Five Graves to Cairo,1943-05-03,1943,855000,1200000,345000,1.121417
60221,Corto Maltese: La maison dor√©e de Samarkand,2004-01-01,2004,0,0,0,0.430711
60225,Mar√≠a Candelaria,1944-01-21,1944,0,0,0,0.451149
60228,Losers' Club,2011-03-23,2011,0,0,0,1.054826
60230,Trumbo,2007-09-10,2007,0,0,0,1.666664
60233,Norm MacDonald: Me Doing Standup,2011-03-01,2011,0,0,0,0.298558
60234,The Silent World,1956-08-15,1956,0,0,0,1.027804
60236,Countdown,2004-12-09,2004,0,0,0,0.458782
60238,Hidden Secrets,2006-10-06,2006,0,0,0,0.011778
60243,A Separation,2011-03-15,2011,800000,0,-800000,7.939625
60254,The Other Dumas,2010-02-10,2010,0,0,0,1.30528
60261,The Prefab People,1982-12-09,1982,0,0,0,0.049377
60269,Mad Dog Morgan,1976-07-09,1976,0,0,0,2.212707
60270,Wish You Were Here,2012-04-26,2012,0,0,0,1.302359
60276,Scenes from the Class Struggle in Beverly Hills,1989-06-03,1989,0,0,0,0.283289
60278,Hollywood Hong Kong,2001-09-02,2001,0,0,0,0.259577
60279,Made in Hungaria,2009-02-05,2009,0,0,0,0.126889
60281,To the Wonder,2013-02-22,2013,0,587615,587615,8.452485
60285,Alvarez Kelly,1966-10-01,1966,0,0,0,1.49303
60287,The Thirty Nine Steps,1978-11-04,1978,0,0,0,6.622148
60290,Corto Maltese: Under the Sign of Capricorn,2002-01-01,2002,0,0,0,0.253285
60293,Tom and Jerry: Shiver Me Whiskers,2006-08-21,2006,0,0,0,2.933224
60302,"Cougars, Inc.",2011-05-10,2011,1000000,0,-1000000,1.614276
60304,Hansel & Gretel: Witch Hunters,2013-01-17,2013,50000000,224803475,174803475,10.337211
60306,Victim,2010-11-17,2010,0,0,0,0.840678
60307,Diary of a Wimpy Kid: Rodrick Rules,2011-03-25,2011,21000000,72417394,51417394,8.425361
60308,Moneyball,2011-09-22,2011,50000000,110206216,60206216,15.785663
60309,The Conspirator,2010-09-10,2010,25000000,15478800,-9521200,5.481452
60315,High School,1968-05-01,1968,0,0,0,0.312707
60316,Food,1993-01-01,1993,0,0,0,0.936181
60363,Letter to Brezhnev,1985-12-26,1985,0,0,0,3.521953
60364,The Nazis - A Warning From History,1997-09-10,1997,0,0,0,0.179601
60366,ThanksKilling,2009-11-17,2009,3500,0,-3500,1.212005
60375,Rocky VI,1986-01-01,1986,0,0,0,1.139611
60378,Hitler: A Career,1977-07-08,1977,0,0,0,0.361641
60387,Operation Mad Ball,1957-01-01,1957,0,0,0,0.962968
60389,The Cook,1972-04-07,1972,0,0,0,0.125203
60392,Chashme Buddoor,1981-04-30,1981,0,0,0,1e-06
60400,The Blue Bird,1940-01-19,1940,0,0,0,0.73103
60405,Sharpay's Fabulous Adventure,2011-04-19,2011,0,0,0,14.129281
60409,Zombie and the Ghost Train,1991-07-26,1991,0,0,0,0.231318
60410,Remote Control,1988-04-07,1988,0,0,0,0.336057
60415,The Flag of Iron,1980-02-01,1980,0,0,0,0.596252
60420,Like Crazy,2011-10-28,2011,250000,3542353,3292353,8.002786
60421,Circumstance,2011-08-26,2011,0,0,0,1.349971
60422,Another Happy Day,2011-11-18,2011,4000000,355688,-3644312,3.496577
60430,Love at the Top,1974-03-13,1974,0,0,0,1.115666
60434,Kapitalism: Our Improved Formula,2010-04-23,2010,0,0,0,0.090802
60437,Lilith,1964-09-27,1964,0,0,0,1.452711
60438,Boots and Saddles,1937-10-04,1937,0,0,0,0.008309
60440,The Human Experience,2008-06-12,2008,0,0,0,0.145912
60447,Devolved,2010-03-22,2010,0,0,0,0.374136
60457,Michael Jordan: An American Hero,1999-04-18,1999,0,0,0,0.402164
60479,Max Schmeling,2010-10-07,2010,0,0,0,0.878435
60481,Ask a Policeman,1939-04-29,1939,0,0,0,0.245237
60488,Arabian Nights,1942-12-25,1942,0,0,0,3.252473
60489,The Last Patrol,2001-08-21,2001,3000000,0,-3000000,3.095364
60495,Guardian,2001-06-12,2001,0,0,0,0.21049
60498,The Legend of the Candy Cane,2001-06-01,2001,0,0,0,0.001295
60504,Bone Daddy,1998-07-19,1998,0,0,0,0.110404
60505,Blind Side,1993-01-30,1993,0,0,0,0.42608
60531,Heartbeat Detector,2007-09-12,2007,0,0,0,0.087977
60534,The Silence,2010-08-13,2010,0,0,0,2.698707
60539,The Cimarron Kid,1952-01-13,1952,0,0,0,1.015736
60540,Sushi Girl,2012-12-07,2012,2000000,0,-2000000,5.538648
60541,Ramrod,1947-05-02,1947,0,0,0,0.854433
60542,Albuquerque,1948-02-20,1948,0,0,0,0.554577
60543,More Than a Miracle,1967-10-19,1967,0,0,0,0.378546
60547,The Duel at Silver Creek,1952-08-01,1952,0,0,0,0.89585
60551,War Arrow,1954-01-01,1954,0,0,0,1.092612
60555,Ride in the Whirlwind,1966-10-23,1966,0,0,0,2.352893
60562,The Big Broadcast of 1938,1938-02-11,1938,0,0,0,0.09058
60566,She,1935-06-12,1935,0,0,0,0.845834
60567,The Big City,1963-09-27,1963,0,0,0,0.865544
60568,Shaolin Intruders,1983-10-06,1983,0,0,0,0.306312
60573,The Burning Bed,1984-10-08,1984,0,0,0,0.568187
60575,Prowl,2010-09-04,2010,0,0,0,1.573101
60579,Hey Ram,2000-02-18,2000,3900000,4900000,1000000,0.562097
60587,The Audrey Hepburn Story,2000-03-27,2000,0,0,0,1.156667
60591,The Chain Reaction,1980-09-25,1980,0,0,0,1.578196
60592,The Importance of Tying Your Own Shoes,2011-03-18,2011,950000,0,-950000,0.510589
60595,Siddhartha,1972-08-01,1972,0,0,0,0.366362
60599,Arbitrage,2012-09-14,2012,12000000,35485056,23485056,5.808496
60604,Hanamizuki,2010-06-21,2010,0,0,0,0.651043
60608,How I Killed My Father,2001-09-19,2001,0,0,0,1.811615
60612,Le Bal,1983-12-21,1983,0,0,0,0.674605
60616,The Rashevski Tango,2003-09-03,2003,0,0,0,0.041791
60623,Love Unto Death,1984-09-05,1984,0,0,0,0.009961
60629,A Smoky Mountain Christmas,1986-12-14,1986,0,0,0,0.630396
60631,Street Smart,1987-03-20,1987,0,0,0,7.721588
60639,Shaolin Kung-Fu Mystagogue,1977-10-13,1977,0,0,0,0.722427
60643,The Violent Men,1955-01-26,1955,0,0,0,2.647017
60645,MC5: A True Testimonial,2002-02-02,2002,0,0,0,0.009044
60650,Tous les soleils,2011-03-23,2011,0,0,0,0.808765
60662,Fifteen and Pregnant,1998-01-19,1998,0,0,0,0.617702
60664,The Perfect Assistant,2008-01-02,2008,0,0,0,1.420558
60665,Drum,2004-10-30,2004,0,0,0,0.119573
60670,The Crimson Rivers,2000-09-26,2000,2365000,0,-2365000,6.649222
60672,Crimson Rivers II: Angels of the Apocalypse,2004-02-18,2004,0,0,0,9.261826
60676,Wesley Willis: The Daddy of Rock 'n' Roll,2003-04-22,2003,0,0,0,0.002361
60677,Kohtaamisia,2010-03-05,2010,0,0,0,0.127308
60678,Prinsessa,2010-09-09,2010,0,0,0,0.864227
60695,Sundays at Tiffany's,2010-12-06,2010,0,0,0,2.823378
60700,Sorry for the Disturbance,2008-09-01,2008,0,0,0,0.326323
60703,Slow Burn,2000-11-01,2000,0,0,0,0.386383
60708,Southern District,2009-08-20,2009,0,0,0,0.22964
60730,Khubsoorat,1980-02-26,1980,0,0,0,0.114394
60747,Red Dawn,2012-11-21,2012,65000000,44806783,-20193217,5.627787
60759,Payroll,1961-01-01,1961,0,0,0,0.759767
60760,Masques,1987-02-11,1987,0,0,0,0.807687
60769,Radiopiratene,2007-09-14,2007,0,0,0,0.009726
60773,Bay of Angels,1963-03-01,1963,0,0,0,0.555174
60775,Oxygen,2010-09-08,2010,0,0,0,0.940431
60778,Downtown,1990-01-12,1990,0,2346150,2346150,1.026053
60784,Win/Win,2010-05-20,2010,0,0,0,0.352373
60785,Exodus,2007-09-13,2007,0,0,0,0.977704
60792,Walk on the Wild Side,1962-03-20,1962,0,0,0,1.123864
60794,El Crack,1981-01-01,1981,0,0,0,0.4351
60800,Cat City,1986-10-02,1986,0,0,0,1.83837
60807,Kick,2009-05-08,2009,0,0,0,0.827978
60809,Single By Contract,2010-09-15,2010,0,0,0,4.366954
60810,Yuppi Du,1975-01-08,1975,0,0,0,0.268594
60813,The Bunker of the Last Gunshots,1981-01-01,1981,0,0,0,0.13139
60821,The Good Witch's Garden,2009-02-07,2009,0,0,0,3.387914
60824,Lune Froide,1991-05-22,1991,0,0,0,0.380269
60825,Mr. St. Nick,2002-10-17,2002,0,0,0,0.197333
60828,Gang Tapes,2001-01-01,2001,0,0,0,0.73065
60836,Wild Times,1980-01-24,1980,0,0,0,0.074392
60843,Nasu: Summer in Andalusia,2003-06-26,2003,0,0,0,0.191879
60850,Fashion Victims,2007-08-08,2007,0,1101480,1101480,1.160355
60853,Jim Thorpe ‚Äì All-American,1951-08-24,1951,0,0,0,0.76582
60855,Double Happiness,1994-09-07,1994,0,759393,759393,0.372239
60859,The Confession,1970-04-29,1970,0,0,0,2.436542
60867,Zero. Lilac Lithuania,2006-09-08,2006,0,0,0,1.230765
60895,Beyond the Blackboard,2011-04-24,2011,0,0,0,2.984173
60897,"Happiness Is a Warm Blanket, Charlie Brown",2011-03-29,2011,0,0,0,1.785932
60898,Erotic Ghost Story,1987-10-01,1987,0,0,0,0.434823
60899,Brink of Life,1958-03-31,1958,0,0,0,1.16503
60908,Breakthrough,1950-11-17,1950,0,0,0,0.17582
60917,Painted Lady,1998-04-26,1998,0,0,0,0.173855
60932,The Last Keepers,2013-01-04,2013,0,0,0,4.270228
60935,The Thing,2011-10-12,2011,35000000,28128670,-6871330,10.169411
60938,Time Without Pity,1957-03-01,1957,0,0,0,0.588952
60948,On the Comet,1970-10-09,1970,0,0,0,0.937762
60949,Toys in the Attic,2009-04-04,2009,0,0,0,4.052588
60951,Passion in the Desert,1997-08-31,1997,0,0,0,0.396851
60961,Held Up,2010-01-01,2010,0,0,0,0.777895
60964,Macross Frontier: The Wings of Goodbye,2011-02-26,2011,0,0,0,1.032299
60965,The Legend of Bloody Mary,2008-12-09,2008,1000000,0,-1000000,1.076888
60966,My Sister Eileen,1955-09-22,1955,0,0,0,0.417876
60971,Underworld Beauty,1958-03-25,1958,0,0,0,0.683192
60976,The Fourth World War,2003-04-27,2003,0,0,0,0.043897
60977,The Pee-Wee Herman Show on Broadway,2011-03-19,2011,0,0,0,0.287956
60981,My Joy,2010-09-30,2010,0,0,0,1.380163
60985,Turkish Passion,1994-11-18,1994,0,3777141,3777141,1.112376
60993,Salla - Selling the Silence,2011-03-11,2011,0,0,0,0.045428
60994,Guinevere,1999-09-04,1999,2600000,614202,-1985798,4.004968
61002,"For Better, for Worse",1954-06-20,1954,0,0,0,0.407544
61005,The Good Witch's Gift,2010-10-24,2010,0,0,0,2.472998
61008,You and Your Stupid Mate,2005-05-24,2005,0,0,0,0.221519
61012,Silent Hill: Revelation 3D,2012-10-10,2012,20000000,52302796,32302796,5.745206
61015,"UltraMarathon Man: 50 Marathons, 50 States, 50 Days",2008-07-31,2008,0,0,0,0.114274
61016,Perfume,2001-04-08,2001,0,0,0,1.023572
61020,Adventures of Captain Marvel,1941-03-28,1941,0,0,0,0.164738
61025,The Dark Side Of Chocolate,2010-03-16,2010,0,0,0,0.076436
61033,Armless,2010-01-22,2010,0,0,0,0.137612
61035,Hier kommt Lola,2010-03-04,2010,0,0,0,1.020805
61038,Go for It!,2011-05-13,2011,2450000,0,-2450000,1.029916
61041,Woman Times Seven,1967-06-26,1967,0,0,0,1.694798
61044,Companeros,1970-12-18,1970,0,0,0,2.446983
61046,Tovarich,1937-12-25,1937,0,0,0,0.053798
61048,The Swan,1956-04-26,1956,0,0,0,0.36218
61049,Arrowhead,1953-08-03,1953,0,0,0,0.740172
61050,Our Fathers,2005-05-11,2005,0,0,0,0.736094
61052,The Night We Called It a Day,2003-08-14,2003,0,0,0,1.027134
61054,Children Of The Night,1991-09-06,1991,0,0,0,0.312221
61062,The Unjust,2010-10-28,2010,0,0,0,3.171362
61070,Pekka ja P√§tk√§ lumimiehen j√§ljill√§,1954-07-30,1954,0,0,0,0.107042
61080,Pluto's Christmas Tree,1952-11-21,1952,0,0,0,1.163695
61086,The Wild Bunch: An Album in Montage,1996-11-01,1996,0,0,0,0.001651
61095,The Turning Point,1952-11-15,1952,0,0,0,0.662567
61104,Mount St. Elias,2009-11-28,2009,0,0,0,0.159445
61105,The Honey Pot,1967-05-21,1967,0,0,0,1.721778
61108,Emmanuelle 6,1988-07-06,1988,0,0,0,2.834832
61109,The Flame of New Orleans,1941-07-07,1941,0,0,0,1.034282
61111,The Day the Fish Came Out,1967-09-27,1967,0,0,0,0.116528
61112,The Ch√¢teau,2001-01-16,2001,0,0,0,0.671441
61113,The 4th Tenor,2002-12-03,2002,0,0,0,0.388866
61117,Hardbodies 2,1986-09-12,1986,0,0,0,0.608661
61120,A Sense of History,1992-01-01,1992,0,0,0,0.177453
61121,Colorado Avenue,2007-09-07,2007,0,0,0,0.040347
61123,Vares - The Girls of April,2011-04-20,2011,0,0,0,0.676424
61125,Vares - The Kiss of Evil,2011-01-06,2011,1400000,0,-1400000,1.27935
61138,The Whip Hand,1951-10-01,1951,0,0,0,0.48243
61139,Bummer 2,2006-12-12,2006,0,0,0,1.914548
61144,Scorchers,1991-07-07,1991,0,0,0,0.187811
61151,Never Say Goodbye,1946-11-09,1946,0,0,0,0.188417
61168,Since You've Been Gone,1998-06-06,1998,0,0,0,0.75038
61178,Nadine,1987-08-07,1987,12000000,5669831,-6330169,7.569698
61187,Star Runner,2003-01-01,2003,0,0,0,0.076517
61194,Beyond the Time Barrier,1960-09-08,1960,125000,0,-125000,0.518062
61198,How to Live Forever,2011-05-13,2011,0,40836,40836,0.517199
61202,Zindagi Na Milegi Dobara,2011-07-15,2011,0,0,0,8.475505
61203,Shor in the City,2011-04-28,2011,0,0,0,0.661642
61208,Ferdinando and Carolina,1999-01-01,1999,0,0,0,0.010305
61212,The Last Four Days,1974-03-27,1974,0,0,0,0.361443
61217,I cavalieri che fecero l'impresa,2001-01-01,2001,0,0,0,0.403825
61221,13 Frightened Girls,1963-09-11,1963,0,0,0,0.539332
61222,Home,2008-10-29,2008,0,0,0,1.605963
61225,The Babe,1992-04-17,1992,0,17530973,17530973,4.337214
61233,Dark Fields,2009-10-25,2009,0,0,0,0.584606
61237,"A Reason to Live, a Reason to Die",1972-12-27,1972,0,0,0,2.422204
61263,Illegal,2010-10-06,2010,0,404,404,1.764981
61265,Where Sleeping Dogs Lie,1991-11-13,1991,0,0,0,0.520664
61266,A Hunting Accident,1978-07-31,1978,0,0,0,0.65511
61267,Clara and Me,2004-06-30,2004,0,0,0,0.294255
61271,Tezaab,1988-11-11,1988,0,0,0,0.565544
61280,The Turning Point,1977-11-14,1977,0,0,0,1.118538
61293,Office Romance. Our time,2011-03-17,2011,5000000,0,-5000000,1.35828
61294,You and I,2011-01-31,2011,20000000,0,-20000000,1.393826
61296,Stavisky,1974-05-15,1974,0,0,0,0.398914
61302,Culloden,1964-05-24,1964,0,0,0,0.727385
61303,Infelici e contenti,1992-12-18,1992,0,0,0,0.1719
61312,"Video Nasties: Moral Panic, Censorship & Videotape",2010-08-30,2010,0,0,0,0.376182
61313,Fimfarum 2,2006-02-23,2006,0,0,0,0.074607
61314,Ho visto le stelle,2003-12-19,2003,0,0,0,0.403386
61320,Fimf√°rum Jana Wericha,2002-11-28,2002,0,0,0,0.297479
61330,Please Remove Your Shoes,2010-07-01,2010,0,0,0,0.165904
61337,Critical Care,1997-10-31,1997,0,0,0,2.287762
61340,Beyond the Gates of Splendor,2002-01-01,2002,0,38,38,0.002354
61341,Ferocious Planet,2011-04-09,2011,0,0,0,7.746663
61348,The Lost Valentine,2011-01-30,2011,0,0,0,3.672708
61361,L'outremangeur,2002-09-10,2002,0,0,0,0.550466
61369,Rain,1932-10-12,1932,0,0,0,0.577818
61370,Men in War,1957-03-19,1957,0,0,0,1.807804
61372,Colin Quinn: Long Story Short,2011-04-09,2011,0,0,0,0.111362
61382,Breaking The Surface: The Greg Louganis Story,1997-03-19,1997,0,0,0,0.541054
61385,The Tuner,2004-09-06,2004,0,0,0,0.969783
61391,Distant Drums,1951-12-25,1951,0,0,0,6.578688
61400,Thank You,2011-04-08,2011,13100000,4100000,-9000000,1.417392
61401,Tibet: Cry of the Snow Lion,2002-09-13,2002,0,0,0,0.152361
61404,Point Blank,2010-12-01,2010,16000000,0,-16000000,5.578585
61410,Spud,2010-12-03,2010,5000000,0,-5000000,1.539813
61411,Che!,1969-06-27,1969,0,0,0,0.364037
61415,Meetin' WA,1986-04-23,1986,0,0,0,0.006359
61416,Beautiful People,1999-09-16,1999,0,0,0,0.978894
61418,The Waterdance,1992-05-13,1992,0,0,0,4.358659
61420,The 19th Wife,2010-09-13,2010,0,0,0,0.814923
61430,Affair in Trinidad,1952-07-29,1952,0,0,0,0.197406
61431,Assigned to Danger,1948-05-19,1948,0,0,0,0.054691
61434,They All Kissed the Bride,1942-06-11,1942,0,0,0,0.206772
61436,Behind Green Lights,1946-02-15,1946,0,0,0,0.149562
61461,The Children Are Watching Us,1944-10-27,1944,0,0,0,0.412633
61462,The Italian Connection,1972-09-02,1972,0,0,0,1.935637
61464,Maddalena... zero in condotta,1940-12-18,1940,0,0,0,0.131368
61473,Race to Space,2001-10-31,2001,0,0,0,0.796926
61475,Pale Flower,1964-03-01,1964,0,0,0,11.77327
61477,Zhou Yu's Train,2002-08-01,2002,0,0,0,0.885053
61485,Springtime in a Small Town,2002-09-04,2002,0,0,0,0.802407
61487,Mayor of the Sunset Strip,2003-06-17,2003,0,0,0,0.572591
61488,Foo Fighters: Back and Forth,2011-04-05,2011,0,0,0,0.991492
61492,g@me.,2003-11-08,2003,0,0,0,0.324654
61495,Santa Claus and the Magic Drum,1996-12-24,1996,0,0,0,0.331975
61501,Between Midnight and Dawn,1950-10-01,1950,0,0,0,0.228318
61502,Stolen Identity,1953-01-01,1953,0,0,0,0.199557
61523,Idiot's Delight,1939-01-27,1939,0,0,0,0.155988
61524,A-Haunting We Will Go,1942-08-07,1942,0,0,0,0.738739
61525,Air Raid Wardens,1943-04-04,1943,0,0,0,0.415583
61527,Helena from the Wedding,2010-11-12,2010,0,0,0,0.671563
61528,Born Equal,2006-12-04,2006,0,0,0,0.513746
61532,Dustbin Baby,2008-12-21,2008,0,0,0,1.253951
61533,Final Sale,2011-01-24,2011,0,0,0,0.425814
61535,If the Shoe Fits,1990-12-12,1990,0,0,0,0.263049
61536,I'm Not Rappaport,1996-12-24,1996,0,0,0,0.659056
61537,Burn Notice: The Fall of Sam Axe,2011-04-17,2011,0,0,0,14.649159
61539,Rage,2009-08-12,2009,0,0,0,0.986182
61540,The Girl in the Yellow Pajamas,1977-12-31,1977,0,0,0,0.271397
61541,Love on the Run,1936-11-20,1936,0,0,0,0.05764
61542,Funkytown,2011-03-04,2011,0,0,0,0.830483
61545,The Holy Land,2001-04-04,2001,0,0,0,0.001714
61546,The Bishop Murder Case,1930-01-03,1930,0,0,0,0.743953
61548,The Journey of August King,1995-09-14,1995,0,0,0,0.411424
61550,Christmas Every Day,1996-11-30,1996,0,0,0,1.548156
61552,Julietta,2001-09-06,2001,0,0,0,0.041677
61559,Sabah,2005-06-04,2005,0,0,0,0.539326
61560,Smoking / No Smoking,1993-12-15,1993,0,0,0,0.501632
61563,Touch,1997-02-14,1997,0,0,0,0.455272
61564,The Bravados,1958-06-25,1958,0,0,0,2.759182
61574,Jeremy,1973-01-01,1973,0,0,0,0.492897
61578,Esther Kahn,2000-10-04,2000,0,0,0,0.10648
61580,Baby Blues,2012-09-10,2012,1635794,0,-1635794,0.127616
61581,California,1977-09-16,1977,0,0,0,0.035314
61591,Welcome to the Space Show,2010-02-18,2010,0,0,0,1.653651
61594,The Grand Duel,1972-12-29,1972,0,0,0,1.942407
61613,The Inheritance,2011-04-11,2011,500000,0,-500000,0.737628
61629,"Lebanon, Pa.",2011-04-29,2011,0,0,0,0.833131
61638,Don Giovanni,1979-11-06,1979,7000000,0,-7000000,0.470574
61642,Silver Bears,1978-07-21,1978,0,0,0,0.442866
61644,Squeeze Play,1979-09-24,1979,150000,0,-150000,0.101352
61645,First Love,1939-11-10,1939,0,0,0,0.427819
61647,One Hundred Men and a Girl,1937-09-05,1937,762,0,-762,0.561477
61648,Something in the Wind,1947-07-21,1947,0,0,0,0.222832
61650,A Foreign Affair,1948-08-20,1948,1500000,0,-1500000,1.061486
61651,And God Created Woman,1988-03-04,1988,0,0,0,2.572665
61656,Meet Prince Charming,2002-01-01,2002,0,0,0,0.406123
61658,In Your Dreams,2005-04-13,2005,0,0,0,0.590099
61662,In girum imus nocte et consumimur igni,1978-03-12,1978,0,0,0,0.043028
61663,Why Not Me?,1999-01-06,1999,0,0,0,0.283486
61667,We Have a Pope,2011-04-15,2011,11000000,0,-11000000,7.235656
61669,The Bonnie Parker Story,1958-05-28,1958,0,0,0,0.36391
61672,Titeuf,2011-04-06,2011,0,0,0,2.598588
61675,L.A. Without a Map,1998-09-11,1998,0,0,0,2.280865
61682,A Boy and His Samurai,2010-07-31,2010,0,0,0,1.315194
61683,Don't Deliver Us from Evil,1971-04-05,1971,0,0,0,2.935694
61686,Marock,2005-05-20,2005,0,0,0,0.347623
61689,Thirst,1979-09-28,1979,0,0,0,4.510859
61699,Flipping Out - Israel's Drug Generation,2008-01-01,2008,0,0,0,0.03883
61702,12 to the Moon,1960-06-10,1960,0,0,0,0.419484
61708,Shake! Otis at Monterey,1987-10-16,1987,0,0,0,0.052331
61711,The Truth,1960-11-02,1960,0,0,0,1.179709
61716,Killjoy 3,2010-09-14,2010,0,0,0,1.108782
61717,Wendy Wu: Homecoming Warrior,2006-06-16,2006,6000000,0,-6000000,4.784181
61718,Bad Day to Go Fishing,2009-07-31,2009,0,0,0,0.633795
61719,Midway to Heaven,2011-02-04,2011,0,0,0,0.319514
61722,Sennentuntschi,2010-09-23,2010,0,0,0,2.136975
61724,Reparando,2010-01-01,2010,0,0,0,0.076471
61730,Year of the Carnivore,2009-05-01,2009,0,0,0,0.452088
61736,The Ice Princess,1996-12-12,1996,0,0,0,0.001448
61738,Forgotten Pistolero,1969-10-17,1969,0,0,0,0.332087
61751,Jesus is a Palestinian,1999-04-17,1999,0,0,0,0.670067
61752,Girl 6,1996-03-22,1996,12000000,4939939,-7060061,4.405169
61755,1990: The Bronx Warriors,1982-08-22,1982,0,0,0,8.273556
61765,Up to His Ears,1965-12-04,1965,0,0,0,1.647437
61777,Dear America: Letters Home from Vietnam,1987-10-01,1987,0,0,0,0.733091
61783,Congorama,2006-05-25,2006,5000000,0,-5000000,0.221544
61791,Rise of the Planet of the Apes,2011-08-03,2011,93000000,482860185,389860185,41.613762
61799,A Girl in Australia,1971-01-01,1971,0,0,0,0.875069
61803,Shakedown,2002-12-24,2002,0,0,0,0.119012
61807,Ethan Frome,1993-03-12,1993,0,0,0,1.571857
61813,Dream Man,1995-01-01,1995,0,0,0,0.155859
61814,Gilles' Wife,2004-09-15,2004,0,0,0,0.20225
61820,Buddha Collapsed Out of Shame,2007-09-09,2007,0,0,0,0.801167
61823,The Ape Woman,1964-01-31,1964,0,0,0,1.172612
61828,The Story of Seabiscuit,1949-11-12,1949,700000,0,-700000,0.694835
61829,Poor But Beautiful,1957-12-30,1957,0,0,0,0.717089
61852,The Big Store,1973-09-06,1973,0,0,0,2.793815
61854,Something Ventured,2011-04-01,2011,0,0,0,0.911482
61855,The Painted Hills,1951-05-04,1951,0,0,0,0.113627
61856,Courage of Lassie,1946-11-08,1946,0,0,0,0.703422
61863,Invisible Mom,1997-05-20,1997,0,0,0,0.080736
61864,Out of It,1978-10-10,1978,0,0,0,1.352869
61865,Born in Absurdistan,1999-11-01,1999,0,0,0,0.306183
61872,Alice,2009-12-06,2009,0,0,0,2.076139
61880,Strategic Air Command,1955-07-12,1955,0,0,0,0.332145
61888,Villain,2010-09-11,2010,0,0,0,0.325326
61891,Anonymous,2011-10-21,2011,30000000,15395087,-14604913,13.413895
61892,Sunday in New York,1963-11-13,1963,0,0,0,1.183226
61895,Pageant,2008-12-26,2008,0,0,0,0.404649
61896,Prom Night in Mississippi,2009-01-15,2009,0,0,0,0.737666
61901,The Prodigies,2011-06-07,2011,0,0,0,2.549224
61903,The Boss,1956-10-01,1956,0,0,0,0.409502
61904,Lady Terminator,1989-06-10,1989,0,0,0,0.19886
61908,Canon City,1948-06-30,1948,0,0,0,1.108281
61911,High Infidelity,1964-01-22,1964,0,0,0,0.001662
61925,The Cop in Blue Jeans,1976-03-11,1976,0,0,0,0.665794
61933,The Light Bulb Conspiracy,2010-11-30,2010,0,0,0,1.362069
61934,The Long Gray Line,1955-02-09,1955,0,0,0,0.936527
61935,Crazy About Ya,2010-10-20,2010,0,3082901,3082901,0.190879
61936,The Reformer and the Redhead,1950-05-05,1950,0,0,0,0.002407
61939,The Three Marias,2002-01-01,2002,0,0,0,0.153388
61940,Some Say No,2011-01-01,2011,8100000,0,-8100000,1.330845
61943,"Django, Kill! (If You Live Shoot!)",1967-05-03,1967,0,0,0,1.012359
61950,The Fine Art of Love: Mine Ha-Ha,2005-11-25,2005,0,0,0,0.894956
61952,A Good Lawyer's Wife,2003-08-15,2003,0,0,0,1.076806
61954,Class of 1999 II - The Substitute,1994-03-29,1994,0,0,0,4.140523
61966,Swing,2008-02-14,2008,0,0,0,0.516834
61979,Three Steps Above Heaven,2010-12-03,2010,0,0,0,6.28597
61984,Space Battleship Yamato,2010-12-01,2010,12000000,11212294,-787706,5.23198
61985,Westward Ho,1935-08-19,1935,0,0,0,0.246978
61988,The Naked Jungle,1954-03-03,1954,0,0,0,1.914277
61991,Impudent Girl,1985-12-11,1985,0,0,0,1.586668
61997,Beware the Moon: Remembering 'An American Werewolf in London',2009-09-14,2009,0,0,0,0.14892
61998,The PyraMMMid,2011-04-07,2011,2200000,0,-2200000,0.6028
61999,Sara,1997-05-23,1997,835000,0,-835000,1.648043
62000,Johnny Belinda,1948-09-14,1948,0,0,0,5.361702
62001,Cuba,1979-12-21,1979,0,0,0,1.846984
62006,The Captive City,1952-03-26,1952,0,0,0,0.091194
62008,Good Deeds,2012-02-23,2012,0,0,0,3.129928
62009,Bimboland,1998-12-23,1998,0,0,0,1.870599
62012,Le Poulpe,1998-10-07,1998,0,0,0,0.37066
62029,Bingo Bongo,1982-12-23,1982,0,0,0,2.353858
62033,The Girl in Black Stockings,1957-09-24,1957,0,0,0,0.222323
62034,Toto and Carolina,1955-03-03,1955,0,0,0,0.149058
62036,Fiasco in Milan,1959-12-19,1959,0,0,0,0.920408
62037,High School Hellcats,1958-06-01,1958,0,0,0,0.318612
62039,Breaking Point,1994-01-01,1994,0,0,0,0.232658
62040,CounterForce,1998-12-14,1998,7000000,0,-7000000,1.092346
62045,Only God Knows,2006-01-20,2006,0,0,0,0.684859
62046,Flypaper,2011-08-19,2011,5000000,3142154,-1857846,8.132748
62069,Four More Years,2010-11-25,2010,0,0,0,0.874978
62071,The Flying Guillotine,1975-02-18,1975,0,0,0,1.135839
62077,Neon Flesh,2010-10-09,2010,0,0,0,1.06874
62091,City Across the River,1949-04-07,1949,0,0,0,0.042484
62103,Agnosia,2010-09-26,2010,0,0,0,1.233579
62106,Earth Days,2009-08-14,2009,1200000,0,-1200000,0.005577
62108,"Mumsy, Nanny, Sonny & Girly",1970-02-12,1970,0,0,0,0.90314
62116,Mozart's Sister,2010-06-09,2010,0,0,0,1.122997
62124,Murderous Maids,2000-11-22,2000,0,0,0,0.607812
62127,The Fantasticks,1995-12-27,1995,10000000,0,-10000000,0.995584
62128,Raiders of the Lost Ark - The Adaptation,1989-01-01,1989,5000,0,-5000,0.001586
62130,El Big Bang de Tunguska,2008-06-01,2008,0,0,0,0.043159
62131,Link,1986-03-05,1986,0,0,0,3.72826
62132,Blood Diner,1987-07-24,1987,0,0,0,2.056523
62134,Paparazzi,1998-04-29,1998,0,0,0,0.717324
62143,The Wrong Box,1966-06-19,1966,0,0,0,1.632505
62156,Head Over Heels,2010-12-31,2010,0,0,0,1.639481
62177,Brave,2012-06-21,2012,185000000,538983207,353983207,15.876341
62184,Eye of God,1997-10-17,1997,0,0,0,0.119266
62185,Death Before Dishonor,1987-02-20,1987,0,0,0,0.000603
62186,Pittsburgh,1942-12-11,1942,0,0,0,1.09199
62188,The Next Voice You Hear....,1950-06-29,1950,0,0,0,0.331677
62190,American Gun,2002-06-13,2002,0,0,0,0.246518
62196,Somebody's Hero,2011-05-01,2011,0,0,0,0.311896
62204,Quest for Fire,1981-12-15,1981,12000000,55260558,43260558,8.341166
62206,30 Minutes or Less,2011-08-11,2011,28000000,40547440,12547440,9.763493
62211,Monsters University,2013-06-20,2013,200000000,743559607,543559607,16.267502
62213,Dark Shadows,2012-05-08,2012,150000000,245527149,95527149,10.665859
62214,Frankenweenie,2012-10-04,2012,39000000,35287788,-3712212,10.296047
62215,Melancholia,2011-05-26,2011,7400000,21817298,14417298,8.124767
62241,Long Way Down,2010-11-30,2010,0,0,0,1.097027
62243,I giorni contati,1963-01-01,1963,0,0,0,0.07607
62255,Tracker,2010-05-20,2010,6500000,0,-6500000,7.12869
62276,Bummer,2003-08-02,2003,700000,1600000,900000,1.400186
62289,A Good Night to Die,2003-01-01,2003,0,0,0,0.153852
62297,Guernsey,2005-08-25,2005,0,0,0,0.793096
62301,Stray Dog: Kerberos Panzer Cops,1991-12-31,1991,0,0,0,0.008673
62320,Home,2009-06-03,2009,0,0,0,6.05028
62321,Attenberg,2010-09-14,2010,0,0,0,2.7151
62323,Vanishing of the Bees,2009-10-09,2009,0,0,0,0.792574
62325,Bhutto,2010-11-05,2010,0,0,0,0.473057
62327,Promised Land,1987-09-01,1987,0,316000,316000,0.809129
62330,The Spook Who Sat by the Door,1973-09-21,1973,0,0,0,0.005351
62337,Hotte in Paradise,2003-01-25,2003,0,0,0,0.217325
62342,La suerte est√° echada,2005-08-11,2005,0,0,0,0.152178
62347,Precious Find,1996-01-01,1996,0,0,0,0.469421
62349,Alza la testa,2009-11-06,2009,0,0,0,0.351224
62352,Private Confessions,1996-12-25,1996,0,0,0,0.768534
62363,Le viager,1972-09-05,1972,0,0,0,0.000809
62364,Mouth to Mouth,1995-11-10,1995,0,0,0,1.133409
62368,Cat Shit One,2010-10-17,2010,0,0,0,2.633938
62382,The Mattei Affair,1972-01-26,1972,0,0,0,0.049776
62383,Passed Away,1992-04-24,1992,0,0,0,0.232637
62385,The Little Girl Who Conquered Time,1983-07-16,1983,0,0,0,0.011064
62392,Tammy Tell Me True,1961-07-26,1961,0,0,0,0.791764
62394,The Education of Little Tree,1997-12-25,1997,0,0,0,0.007123
62395,The Miracle of Marcelino,1954-02-24,1954,0,0,0,1.406589
62396,3 Ring Circus,1954-12-22,1954,0,0,0,0.477674
62397,The Teacher from Vigevano,1963-12-24,1963,0,0,0,0.201846
62399,Under New Management,2009-01-01,2009,0,0,0,0.218021
62403,Madagascar,2011-02-16,2011,0,0,0,0.15962
62409,2033,2010-02-05,2010,5000000,0,-5000000,0.472025
62410,P.U.N.K.S,1999-01-05,1999,0,0,0,1.143115
62414,A Hot Dog Program,1999-08-31,1999,0,0,0,0.071756
62422,Year of the Horse,1997-10-08,1997,0,0,0,0.405805
62425,Talking Funny,2011-04-22,2011,0,0,0,1.102216
62429,Peter-No-Tail in Americat,1985-12-14,1985,0,0,0,0.446533
62432,The Questor Tapes,1974-01-23,1974,0,0,0,0.47035
62437,Land of Silence and Darkness,1971-10-08,1971,0,0,0,0.00022
62439,Hello Ghost,2010-12-23,2010,0,0,0,1.326652
62441,United,2011-01-02,2011,0,0,0,3.412706
62447,Aquatic Language,2002-10-26,2002,0,0,0,0.283602
62463,Raining Stones,1993-09-09,1993,0,0,0,1.592047
62472,Battle in Outer Space,1959-12-26,1959,0,0,0,1.181169
62488,Destiny Turns on the Radio,1995-04-28,1995,0,0,0,0.710671
62491,My Sister and I,1987-12-19,1987,0,0,0,0.130579
62492,The Wedding Weekend,2006-12-12,2006,0,0,0,1.250767
62495,First Love,2004-01-01,2004,0,9392,9392,0.38744
62503,Almost Kings,2010-11-11,2010,0,0,0,0.167343
62522,35 and Ticking,2011-05-20,2011,0,0,0,1.658429
62527,Johnny Kapahala - Back on Board,2007-06-08,2007,0,0,0,3.898595
62529,Sound and Fury,2000-10-29,2000,0,0,0,0.245355
62545,Casomai,2002-01-01,2002,0,0,0,0.877983
62547,Fan-Fan the Tulip,1952-03-21,1952,0,0,0,0.591899
62557,Fetish,2008-05-01,2008,0,0,0,0.050625
62558,Nothing Underneath,1985-01-01,1985,0,0,0,0.521388
62564,"Turn Me On, Dammit!",2011-08-19,2011,3100000,0,-3100000,11.937301
62567,The Great Waltz,1938-11-04,1938,0,0,0,0.506852
62570,The Two of Us,1967-03-08,1967,0,0,0,0.262582
62580,The Well Digger's Daughter,2011-04-19,2011,0,0,0,11.968475
62592,Revenge of the Bridesmaids,2010-07-18,2010,0,0,0,4.105867
62614,Hella W,2011-01-01,2011,2500000,0,-2500000,0.447029
62616,Alive,2006-09-21,2006,0,3214998,3214998,0.741482
62630,The Devil's Double,2011-02-11,2011,19100000,5728213,-13371787,6.681211
62635,Unmistaken Child,2009-06-07,2009,0,302000,302000,0.110592
62637,Why Has Bodhi-Dharma Left for the East?,1989-09-23,1989,0,0,0,0.212889
62643,The Charge,2003-02-20,2003,0,0,0,0.735658
62648,Backlash,1956-04-11,1956,0,0,0,0.794079
62652,Bamako,2006-06-21,2006,2000000,111000,-1889000,0.367324
62655,Two Weeks in Another Town,1962-08-17,1962,0,0,0,0.951403
62661,The Second Woman,1950-07-07,1950,0,0,0,0.470505
62664,Indigo,2008-03-20,2008,2500000,0,-2500000,0.461312
62670,The Adventures of Tom Thumb & Thumbelina,2002-08-06,2002,0,0,0,0.895267
62675,Distracted,1970-12-09,1970,0,0,0,0.857372
62676,Limbo,1999-06-04,1999,8000000,1997807,-6002193,1.969282
62677,Songcatcher,2001-03-01,2001,0,0,0,6.468495
62678,Bastards,2006-02-02,2006,0,0,0,1.055545
62684,Snowman's Land,2010-09-19,2010,0,0,0,0.354054
62688,Nevalyashka,2007-04-26,2007,0,0,0,0.526709
62691,Midnight Sun,2006-06-17,2006,0,0,0,1.252695
62692,The Donkey's Hide,1982-01-01,1982,0,0,0,0.051501
62694,The Snake Pit,1948-11-04,1948,0,0,0,1.384302
62695,Storefront Hitchcock,1998-03-27,1998,0,0,0,0.036965
62697,Bug,1975-06-06,1975,0,0,0,1.981546
62709,Blood Crime,2002-09-13,2002,0,0,0,0.33195
62713,Madonna che silenzio c'√® stasera,1982-09-01,1982,0,0,0,0.206132
62715,Assassination on the Tiber,1979-10-12,1979,0,0,0,1.022522
62717,Loki - Arnaldo Baptista,2008-10-17,2008,0,0,0,0.410066
62719,Kummeli Stories,1995-10-20,1995,0,0,0,1.011155
62720,Cry Wolf,1947-07-18,1947,0,0,0,0.3627
62721,Countdown,2006-11-02,2006,0,0,0,0.193972
62722,The Green Glove,1952-02-28,1952,0,0,0,0.700504
62725,Delitto a Porta Romana,1980-01-01,1980,0,0,0,0.027777
62726,Aurora,2006-11-30,2006,0,0,0,0.175627
62727,Pinky,1949-09-28,1949,0,0,0,0.905818
62728,Brighton Rock,2010-09-13,2010,0,0,0,2.566211
62729,His Wife's Diary,2000-06-06,2000,0,0,0,0.189647
62730,In Search of Memory,2008-08-20,2008,0,0,0,0.154823
62731,Lovey-Dovey,2007-03-01,2007,0,0,0,0.686991
62732,Lovey-Dovey 2,2008-12-23,2008,3000000,17850711,14850711,1.16103
62737,The Best Movie,2008-01-23,2008,0,0,0,1.272069
62738,The Best Movie 2,2009-01-22,2009,0,0,0,1.159844
62741,Tender Age,2000-06-06,2000,0,0,0,0.201279
62749,Bombardier,1943-05-14,1943,0,0,0,0.574158
62753,Beachhead,1954-02-05,1954,0,0,0,0.15772
62755,Back Door to Hell,1964-12-19,1964,0,0,0,0.252623
62756,Singam,2010-05-28,2010,2200000,9700000,7500000,1.132835
62757,Savages,2006-11-23,2006,800000,1328612,528612,0.903061
62759,Quiet Days in Clichy,1970-06-01,1970,0,0,0,0.405074
62761,The Cars That Ate Paris,1974-10-10,1974,0,0,0,2.030621
62762,The Chinese Boxer,1970-11-26,1970,0,0,0,0.83307
62764,Mirror Mirror,2012-03-15,2012,85000000,183018522,98018522,14.170183
62768,Flying,1986-05-14,1986,0,0,0,1.354417
62775,Havukka-Ahon Ajattelija,2010-01-15,2010,2225000,0,-2225000,0.164919
62783,A Real Dad,2008-04-17,2008,0,0,0,0.09193
62787,Strayed,2009-09-01,2009,0,0,0,0.117539
62789,Illustrious Corpses,1976-02-12,1976,0,0,0,0.647341
62796,William & Kate,2011-04-18,2011,20,15,-5,2.493638
62803,Hero,1983-01-01,1983,0,0,0,0.000431
62804,Death of a Scoundrel,1956-10-31,1956,0,0,0,0.821633
62825,A Long Hot Summer,1999-03-26,1999,0,0,0,0.261709
62835,Colombiana,2011-07-27,2011,40000000,60965854,20965854,8.062578
62836,The Kennedys,2011-04-03,2011,0,0,0,0.789609
62837,Dolphin Tale,2011-09-23,2011,37000000,95404397,58404397,6.695229
62838,New Year's Eve,2011-12-08,2011,56000000,142044638,86044638,6.948818
62842,Innocence Unprotected,1968-11-12,1968,0,0,0,0.322308
62843,Witchhammer,1970-01-23,1970,0,0,0,0.716033
62847,The Hound of the Baskervilles,1978-07-21,1978,0,0,0,0.548818
62851,Under the Flag of the Rising Sun,1972-03-12,1972,0,0,0,0.069476
62852,Zero Woman: Red Handcuffs,1974-05-21,1974,0,0,0,1.910093
62855,Prince of Space,1959-03-19,1959,0,0,0,0.338785
62871,A Distant Neighborhood,2010-05-20,2010,18000000,0,-18000000,1.824977
62876,A Man Named Rocca,1961-11-17,1961,0,0,0,0.409034
62878,Riverworld,2010-04-18,2010,0,0,0,1.650176
62880,Smokey Bites the Dust,1981-10-01,1981,0,0,0,0.053047
62883,Hum Saath Saath Hain,1999-11-05,1999,0,0,0,0.702863
62894,Uuno Turhapuron Aviokriisi,1981-10-16,1981,0,0,0,0.149544
62896,Uuno Turhapuron muisti palailee p√§tkitt√§in,1983-09-30,1983,0,0,0,0.407039
62897,Uuno Turhapuro menett√§√§ muistinsa,1982-09-17,1982,0,0,0,0.009113
62898,Uuno Turhapuro muuttaa maalle,1986-08-29,1986,0,0,0,0.120042
62900,Tupla-Uuno,1988-08-26,1988,0,0,0,0.07077
62904,Mask Maker,2010-01-01,2010,0,0,0,0.729668
62931,Afro Samurai,2007-01-04,2007,0,0,0,3.292097
62934,Fight for Your Right Revisited,2011-04-22,2011,0,0,0,5.184915
62941,The Doors - Live at the Bowl '68,2012-10-22,2012,0,0,0,0.222318
62947,The Witch,1966-09-16,1966,0,0,0,0.223138
62956,Very Annie Mary,2001-05-25,2001,0,46352,46352,0.474556
62967,The Lady and the Reaper,2009-10-01,2009,700000,0,-700000,1.778469
62976,What Women Want,2011-02-03,2011,5000000,0,-5000000,1.532239
62977,The Lost Bladesman,2011-04-28,2011,0,0,0,6.929708
62978,The Salamander,1971-10-27,1971,0,0,0,0.187435
62981,Deadly Circuit,1983-03-09,1983,0,0,0,0.90394
62989,Ice Quake,2010-12-11,2010,0,0,0,2.567848
62994,Dog Park,1998-09-14,1998,0,0,0,0.437857
62996,They Only Kill Their Masters,1972-11-22,1972,0,0,0,0.891776
62997,Kilometer Zero,2007-10-25,2007,0,0,0,0.411851
62999,From 180 & Taller,2005-03-25,2005,0,0,0,0.44836
63004,Don't Die Without Telling Me Where You're Going,1995-05-04,1995,0,0,0,0.075991
63006,Dum Maaro Dum,2011-04-22,2011,0,0,0,0.277393
63011,Assume the Position with Mr. Wuhl,2007-10-09,2007,0,0,0,0.007067
63020,The Perez Family,1995-05-12,1995,11000000,2832826,-8167174,1.433544
63025,A Lizard in a Woman's Skin,1971-02-17,1971,0,0,0,1.045737
63026,The Killer Must Kill Again,1975-03-07,1975,0,0,0,0.947937
63029,Mr. Robinson,1976-12-23,1976,0,0,0,1.129639
63039,Noah's Ark,1999-05-02,1999,0,0,0,5.055015
63044,De Vlaschaard,1983-07-01,1983,900000,0,-900000,0.000102
63045,Textuality,2011-04-22,2011,0,0,0,0.98388
63046,The Battle of Chernobyl,2006-05-05,2006,0,0,0,0.223721
63054,Fetishes,1996-09-12,1996,0,0,0,0.900057
63064,Buddha Mountain,2010-10-24,2010,0,0,0,1.357992
63065,Neue Vahr S√ºd,2010-11-30,2010,0,0,0,0.775613
63066,25 Watts,2001-01-01,2001,0,0,0,0.45289
63067,My Best Friend's Wife,1998-12-16,1998,0,0,0,0.826487
63069,Bank Holiday,1938-01-27,1938,0,0,0,0.787832
63071,The Bishop's Bedroom,1977-01-01,1977,0,0,0,0.246382
63074,Le rose del deserto,2006-01-01,2006,0,0,0,0.639412
63075,Lucky,2010-01-24,2010,0,0,0,0.437868
63076,Heidi Fleiss: Hollywood Madam,1995-12-27,1995,0,0,0,0.638211
63077,The Coming Days,2010-11-04,2010,8900000,0,-8900000,0.726752
63081,The Victim,2006-10-11,2006,0,0,0,1.327942
63083,The Brass Bottle,1964-05-20,1964,0,0,0,0.828822
63087,The Slime People,1963-03-29,1963,0,0,0,0.390902
63088,The Eye Creatures,1965-10-29,1965,0,0,0,0.518025
63096,Tea and Sympathy,1956-06-06,1956,0,0,0,1.069177
63097,Golden Gate,1994-01-28,1994,0,0,0,0.165679
63100,Psych-Out,1968-03-06,1968,0,0,0,1.037835
63105,Nemesis 2 - Nebula,1995-09-26,1995,0,0,0,1.466491
63107,¬°Que Viva M√©xico!,1979-10-01,1979,0,0,0,1.267451
63112,Plot of Fear,1976-01-01,1976,0,0,0,0.524831
63115,Crush,1992-09-15,1992,0,0,0,0.003921
63139,All Things Fall Apart,2011-03-05,2011,0,0,0,1.364335
63140,Breaking and Entering,2011-01-14,2011,0,0,0,0.118658
63142,Silver Tongues,2011-11-18,2011,0,0,0,0.625666
63143,Blank City,2011-04-06,2011,0,99303,99303,0.31754
63144,Page One: Inside the New York Times,2011-04-29,2011,0,429766,429766,1.373641
63146,Cleanflix,2010-02-16,2010,0,0,0,0.589383
63147,Snow on tha Bluff,2011-01-05,2011,0,0,0,0.823384
63154,Zenith,2010-10-01,2010,0,0,0,0.553216
63160,Successful Alcoholics,2010-01-22,2010,0,0,0,0.261062
63163,The Master and Margarita,1994-06-06,1994,0,0,0,0.813845
63171,"Glenn, the Flying Robot",2010-12-31,2010,0,0,0,0.740885
63172,The Year 01,1973-02-22,1973,0,0,0,0.64636
63176,Liza,1972-08-11,1972,0,0,0,0.682909
63178,Toto in Color,1953-05-21,1953,0,0,0,0.315559
63179,Tot√≤ Sceicco,1950-11-30,1950,0,0,0,0.566432
63180,Marihuana,1936-05-08,1936,0,0,0,0.696968
63186,La pelle,1981-08-27,1981,0,0,0,0.679038
63187,The Sinner,1972-01-01,1972,0,0,0,0.898086
63190,The Father and the Foreigner,2010-01-01,2010,0,0,0,0.121946
63193,Front of the Class,2008-01-01,2008,0,0,0,2.480436
63194,The Diary of an Unknown Soldier,1959-01-02,1959,0,0,0,0.124487
63195,"La Commune (Paris, 1871)",2001-09-06,2001,0,0,0,0.286634
63197,Megan is Missing,2011-05-01,2011,0,0,0,2.770306
63206,Starz Inside: Fantastic Flesh,2008-10-07,2008,0,0,0,0.386706
63207,Intruders,2011-09-12,2011,13000000,0,-13000000,9.734012
63212,Le combat dans l'√Æle,1962-08-16,1962,0,0,0,0.347836
63215,Toute une nuit,1982-10-27,1982,0,0,0,0.506871
63217,At Home by Myself... with You,2009-10-06,2009,0,0,0,0.00482
63224,The Truth About Bebe Donge,1952-02-13,1952,0,0,0,0.398774
63229,Good King Dagobert,1984-08-22,1984,0,0,0,1.499058
63230,We Won't Grow Old Together,1972-05-02,1972,0,0,0,0.493914
63244,Classic Albums: Deep Purple - Machine Head,2002-12-02,2002,0,0,0,0.116621
63258,Carnival Night,1956-12-29,1956,0,0,0,0.514901
63260,The Return of Ringo,1965-12-08,1965,0,0,0,0.812402
63266,Phobos. Fear Kills,2010-03-25,2010,0,0,0,0.643625
63269,Il caso Moro,1986-01-01,1986,0,0,0,0.428693
63273,Endure,2010-01-01,2010,0,0,0,1.251192
63274,Velvet Hands,1979-01-01,1979,0,0,0,0.693673
63276,L'odore della notte,1998-01-01,1998,0,0,0,0.326061
63281,Pro Lyuboff,2010-09-30,2010,2000000,1268793,-731207,0.121844
63287,The Poker House,2008-06-20,2008,0,0,0,3.248042
63290,Workingman's Death,2005-11-25,2005,0,0,0,0.3281
63291,Come Tomorrow...,1962-12-03,1962,0,0,0,1.010353
63293,Three Poplars on Plyuschikha Street,1967-06-06,1967,0,0,0,0.795092
63297,200 MPH,2011-04-26,2011,0,0,0,1.023577
63299,The Blonde Around the Corner,1983-06-06,1983,0,0,0,0.053876
63300,Be My Husband,1981-06-06,1981,0,0,0,0.077739
63303,Girl without an Address,1957-01-01,1957,0,0,0,0.202153
63304,Hussar Ballad,1962-09-07,1962,0,0,0,1.568433
63310,Bullhead,2011-02-02,2011,2000000,0,-2000000,4.666232
63311,The Skin I Live In,2011-08-17,2011,13000000,5774854,-7225146,9.782542
63315,The Hottie & The Nottie,2008-02-08,2008,0,0,0,3.402819
63317,Poor Pretty Eddie,1975-06-01,1975,0,0,0,0.188011
63318,"One Sings, the Other Doesn't",1977-03-09,1977,0,0,0,0.008939
63319,Belle √©pine,2010-11-10,2010,0,0,0,0.776292
63320,Lions Love,1969-09-20,1969,0,0,0,0.112507
63326,The Perfect Student,2011-03-01,2011,0,0,0,1.17723
63327,The Valley,1972-07-06,1972,0,0,0,1.012805
63333,Gog,1954-06-04,1954,250000,0,-250000,1.106166
63334,Sexual Life,2005-01-05,2005,0,0,0,0.116586
63339,The Suspicions of Mr. Whicher: The Murder at Road Hill House,2011-04-25,2011,0,0,0,1.095164
63340,Three the Hard Way,1974-06-26,1974,0,0,0,0.468913
63348,The Encounter,2010-05-03,2010,0,0,0,0.812442
63350,Father's Day,2011-06-19,2011,10,0,-10,2.199072
63358,The Nazi Officer's Wife,2003-03-30,2003,0,0,0,0.16285
63360,The Initiation,1984-12-07,1984,0,0,0,3.123043
63365,The First Assignment,2011-05-06,2011,0,0,0,0.153944
63375,Generation P,2011-04-14,2011,7000000,0,-7000000,1.537982
63376,Mr Perfect,2011-04-21,2011,0,0,0,0.231904
63378,100% Love,2011-05-06,2011,1500000,0,-1500000,0.758785
63383,The Story of Maths,2008-10-06,2008,0,0,0,0.005036
63395,A Run for Your Money,1949-11-23,1949,0,0,0,0.306905
63398,Conseil de famille,1986-03-19,1986,0,0,0,0.007319
63401,L'Amour Fou,1969-01-15,1969,0,0,0,0.460171
63414,Darling,2010-04-23,2010,0,0,0,2.023483
63418,Boy Meets Girl,1984-05-01,1984,0,0,0,1.156252
63423,Protagonist,2007-12-02,2007,0,0,0,0.080801
63427,Tracking Down Maggie,1994-01-01,1994,0,0,0,0.001656
63432,The Three Fantastic Supermen,1967-02-04,1967,0,0,0,0.294994
63435,Fingers,1978-03-02,1978,0,0,0,1.01416
63437,Telling Lies In America,1997-08-02,1997,0,0,0,1.886677
63438,Treasure of Matecumbe,1976-07-01,1976,0,0,0,0.011656
63441,Masked Avengers,1981-05-15,1981,0,0,0,1.394126
63443,Modern Romance,1981-03-13,1981,0,0,0,2.258556
63447,Cupid's Balls,2011-01-01,2011,2800000,0,-2800000,0.938866
63449,Ordinary Wonder,1964-12-01,1964,0,0,0,0.406559
63452,The Straw Hat,1974-06-06,1974,0,0,0,0.02696
63460,Vice Squad,1982-01-22,1982,0,0,0,0.870174
63465,Petty Romance,2010-08-10,2010,0,0,0,0.889214
63472,His Way,2011-03-04,2011,0,0,0,0.662728
63474,The Good Humor Man,2008-02-19,2008,1000000,0,-1000000,0.336161
63481,Calmos,1976-02-11,1976,0,0,0,0.976726
63483,Cyber Seduction: His Secret Life,2005-06-20,2005,0,0,0,0.818094
63484,The Incite Mill,2010-10-16,2010,0,0,0,1.277397
63486,Magic Boy,1959-12-25,1959,0,0,0,0.162513
63492,What's Your Number?,2011-09-30,2011,20000000,30426096,10426096,6.958086
63493,The Ledge,2011-05-06,2011,10000000,610986,-9389014,4.883085
63498,Chico & Rita,2010-11-19,2010,0,0,0,2.099105
63505,Gideon's Trumpet,1980-04-30,1980,0,0,0,0.455142
63510,"Jo Jo Dancer, Your Life Is Calling",1986-05-02,1986,0,0,0,0.109362
63512,Murders in the Rue Morgue,1971-10-06,1971,0,0,0,0.719385
63517,The Turn of the Screw,2009-12-30,2009,0,0,0,0.946251
63536,"Naval Cadets, Charge!",1987-06-06,1987,0,0,0,1.313907
63537,"Vivat, Naval Cadets!",1991-06-06,1991,0,0,0,0.156648
63538,Naval Cadets III,1992-06-06,1992,0,0,0,0.035138
63540,To the Sea!,2009-01-08,2009,0,0,0,0.23968
63555,Leap Year,2010-05-17,2010,0,0,0,2.118561
63564,The Last of the High Kings,1996-12-06,1996,0,0,0,1.427756
63568,But What If This Is Love?,1961-06-06,1961,0,0,0,0.104567
63569,Oh How It Hurts 66,1966-06-06,1966,0,0,0,0.794776
63572,Without Family,1984-06-06,1984,0,0,0,6e-06
63573,Scarecrow,1984-09-14,1984,0,0,0,1.485344
63574,Joyful Noise,2012-01-13,2012,0,0,0,3.448826
63578,The Trip,2010-09-01,2010,0,951179,951179,8.832903
63579,Project Nim,2011-07-08,2011,0,0,0,9.765195
63581,Louis Theroux: The Most Hated Family in America,2007-04-01,2007,0,0,0,0.92226
63584,The Whiskered Nanny,1977-06-06,1977,0,0,0,0.056979
63585,Island,2011-04-22,2011,0,0,0,1.202119
63590,Hospital Massacre,1981-10-16,1981,0,0,0,0.971343
63591,Honolulu,1939-02-03,1939,0,0,0,0.304476
63607,27 Missing Kisses,2000-10-26,2000,0,0,0,0.82155
63611,Under the Stars,2007-03-15,2007,0,0,0,0.313065
63612,Bienvenido a casa,2006-04-07,2006,0,0,0,0.085908
63615,Un buen hombre,2009-04-30,2009,0,0,0,0.004763
63616,Camar√≥n: When Flamenco Became Legend,2005-11-04,2005,0,0,0,0.713381
63617,Reap the Wild Wind,1942-03-18,1942,0,0,0,1.076119
63618,The Left Hand of God,1955-09-02,1955,0,0,0,1.347798
63624,My Breakfast with Blassie,1983-11-01,1983,0,0,0,0.002538
63625,The Stationmaster Meets His Match,1980-11-12,1980,0,0,0,0.114527
63639,A Month in the Country,1987-01-01,1987,0,0,0,4.366662
63654,Ko,2011-04-22,2011,0,0,0,0.827742
63665,Hanna K.,1983-09-07,1983,0,114247,114247,0.71649
63670,Vettaiyaadu Vilaiyaadu,2006-08-25,2006,0,0,0,0.728629
63681,The Cheaters,1958-10-10,1958,0,0,0,0.354972
63686,Thor: Tales of Asgard,2011-05-16,2011,0,3100000,3100000,1.697118
63687,Circo,2011-04-01,2011,0,67821,67821,0.077653
63691,Scene of the Crime,1986-05-16,1986,0,0,0,0.073413
63700,My Babysitter's a Vampire,2010-10-08,2010,0,0,0,7.671413
63702,Liliom,1934-05-15,1934,0,0,0,0.157182
63706,Mandrake,2010-09-11,2010,0,0,0,2.390484
63709,Reach The Rock,1998-10-16,1998,0,0,0,0.158503
63710,Honey 2,2011-06-23,2011,0,0,0,5.768543
63717,Gardens in Autumn,2006-09-06,2006,0,0,0,0.229323
63721,Future Cops,1993-07-15,1993,0,0,0,1.16345
63727,Exorcismus,2010-12-29,2010,0,0,0,4.535245
63736,Almighty Thor,2011-05-07,2011,0,0,0,1.255939
63749,Swamp Shark,2011-06-25,2011,0,0,0,6.218698
63762,Broken Hill,2009-09-11,2009,0,54058,54058,0.743271
63764,Devil in the Flesh,1947-09-22,1947,0,0,0,0.352696
63766,There's No Tomorrow,1940-03-22,1940,0,0,0,0.546732
63771,Douce,1943-11-09,1943,0,0,0,0.095589
63773,Leadbelly,1976-05-28,1976,0,0,0,0.057789
63774,Chicks,2010-10-13,2010,200000,0,-200000,0.205985
63775,Burn Paris Burn,2008-11-12,2008,0,0,0,0.148411
63787,Convicted,1931-11-01,1931,0,0,0,0.044505
63795,Abbott and Costello Meet Captain Kidd,1952-12-27,1952,450,0,-450,4.063707
63809,Three Days,2001-12-09,2001,0,0,0,0.429065
63825,Aayitha Ezhuthu,2004-05-21,2004,0,0,0,0.665428
63831,The Kid with a Bike,2011-05-18,2011,0,0,0,7.95457
63838,Mechenosets,2006-10-12,2006,5000000,3919731,-1080269,0.414793
63840,Huddersfield,2007-05-07,2007,0,0,0,0.459026
63848,The Ritz,1976-08-12,1976,0,0,0,0.473585
63849,Almanya: Welcome to Germany,2011-05-13,2011,0,0,0,4.965281
63858,All I Desire,1953-06-25,1953,0,0,0,1.338054
63859,Pufnstuf,1970-05-03,1970,0,0,0,0.007223
63876,Circle of Love,1964-10-16,1964,0,0,0,0.378413
63877,The Ranch,2004-07-05,2004,0,0,0,0.268363
63880,Adieu Philippine,1962-09-25,1962,0,0,0,0.464764
63883,Drama/Mex,2006-05-23,2006,0,0,0,0.125223
63887,The Great Impostor,1961-03-01,1961,0,0,0,0.407738
63888,Mayerling,1968-01-01,1968,0,0,0,0.783968
63892,"L√©on Morin, Priest",1961-09-22,1961,0,0,0,1.015323
63898,Antidur,2007-09-06,2007,5000000,1413000,-3587000,0.039793
63899,White Bim Black Ear,1977-09-15,1977,0,0,0,1.185288
63907,Reykjavik-Rotterdam,2008-09-30,2008,0,0,0,1.14599
63923,Opera Jawa,2006-08-07,2006,0,0,0,0.076219
63924,Jungleground,1995-01-01,1995,0,0,0,0.535497
63930,Law of Corruption,2005-09-15,2005,0,0,0,0.808483
63938,Bad Luck Love,2000-05-26,2000,0,0,0,0.713033
63943,West Is West,2010-10-19,2010,3837625,3867000,29375,0.749665
63945,Bliss,1997-04-14,1997,0,294064,294064,1.262649
63946,Viva Riva!,2010-09-10,2010,0,43880,43880,0.214552
63951,In the Year of the Pig,1969-02-26,1969,0,0,0,0.485044
63954,Honest Man: The Life of R. Budd Dwyer,2010-10-09,2010,0,0,0,0.041326
63956,Two Family House,2000-01-21,2000,0,0,0,0.265689
63957,Bear with Me,2000-01-01,2000,0,0,0,0.340505
63958,Down House,2001-06-06,2001,0,0,0,0.985597
63959,The Zodiac Killer,1971-04-07,1971,0,0,0,0.072873
63963,Maundy Thursday,2006-09-14,2006,4,0,-4,0.921739
63964,Deiva Thirumagal,2011-06-03,2011,0,0,0,0.477893
63971,Deserter,2002-04-30,2002,3500000,0,-3500000,1.347715
63978,Life Is a Bed of Roses,1983-04-20,1983,0,0,0,0.006566
63988,Forest Warrior,1996-11-05,1996,0,0,0,1.228287
63989,Ir√®ne,2002-06-26,2002,0,0,0,0.459399
63990,Joanna,2010-11-26,2010,0,0,0,0.37667
63996,Vipers Nest,2011-03-10,2011,3500000,18000000,14500000,1.426776
64015,An Autumn's Tale,1987-07-16,1987,0,0,0,0.396948
64022,Lumikuningatar,1986-11-19,1986,0,0,0,0.000578
64029,Rollo and the Spirit of the Woods,2001-12-21,2001,2200000,0,-2200000,0.540947
64032,The White Ship,1941-10-31,1941,0,0,0,0.146451
64042,D'Artagnan and Three Musketeers,1979-12-25,1979,0,0,0,0.801275
64043,I due orfanelli,1947-01-01,1947,0,0,0,0.199214
64044,Musketeers 20 Years Later,1992-06-06,1992,0,0,0,0.716771
64046,The Secret of Queen Anna or Musketeers 30 Years Later,1993-06-06,1993,0,0,0,0.036093
64047,Cranford,2007-11-18,2007,0,0,0,1.42123
64051,Jimi Plays Berkeley,2012-07-10,2012,0,0,0,0.190578
64071,Tobor the Great,1954-09-01,1954,0,0,0,1.100509
64074,Two in the Wave,2010-05-19,2010,0,0,0,0.232855
64075,Dead Man's Eyes,1944-11-10,1944,0,0,0,0.206768
64076,Weird Woman,1944-03-02,1944,0,0,0,0.505014
64077,Pillow of Death,1945-12-14,1945,0,0,0,0.213339
64078,The Frozen Ghost,1945-06-01,1945,0,0,0,0.583353
64079,The Gypsy Moths,1969-08-29,1969,0,0,0,1.456925
64084,Scorned,1994-07-13,1994,0,0,0,3.821994
64091,Flesh Wounds,2011-06-09,2011,0,0,0,0.748749
64100,Hecate,1982-11-21,1982,0,0,0,0.335052
64104,After Last Season,2009-06-05,2009,0,0,0,0.156478
64108,The Frankenstein Syndrome,2010-10-01,2010,0,0,0,2.219179
64109,Paanch,2003-01-01,2003,0,0,0,0.189724
64115,I Hate Mondays,1971-08-27,1971,0,0,0,0.286199
64116,Falling Sky,2002-10-18,2002,0,0,0,0.225225
64123,Neverwhere,1996-09-12,1996,0,0,0,0.577181
64124,√Ä l'aventure,2008-08-29,2008,0,0,0,3.282339
64129,D-Day The Sixth of June,1956-05-29,1956,0,0,0,1.015895
64130,The Rainbow Tribe,2011-02-01,2011,0,0,0,1.108375
64131,Mauvais Sang,1986-11-26,1986,0,0,0,4.355678
64133,The Lorry,1977-05-27,1977,0,0,0,0.103929
64142,Three Smart Girls,1936-12-20,1936,0,0,0,0.360971
64143,Three Smart Girls Grow Up,1939-03-24,1939,0,0,0,0.380349
64155,La Notte del mio primo amore,2006-08-11,2006,0,0,0,0.038824
64156,Spring Subway,2002-05-28,2002,0,0,0,0.068382
64158,Guns at Batasi,1964-10-30,1964,0,0,0,7.938968
64160,Cyborg Cop II,1994-09-01,1994,0,0,0,0.874752
64161,Cyborg Cop III,1995-05-01,1995,0,0,0,0.201284
64166,Brown's Requiem,1998-11-01,1998,0,0,0,0.283548
64167,Let Him Have It,1991-10-04,1991,0,0,0,1.609107
64183,Parent Trap III,1989-04-09,1989,0,0,0,0.161979
64190,The Wooden Camera,2004-07-28,2004,0,0,0,0.10836
64191,Mom at Sixteen,2005-03-01,2005,0,0,0,6.555387
64197,Travelling with Pets,2007-06-25,2007,0,0,0,0.528657
64199,The Nude,2001-02-14,2001,0,0,0,0.638939
64202,Batman Beyond: The Movie,1999-01-10,1999,0,0,0,2.363167
64204,Pull My Daisy,1959-11-11,1959,0,0,0,0.161218
64212,Crown witness,2007-02-02,2007,0,0,0,0.441046
64215,Laddaland,2011-04-28,2011,0,0,0,0.936761
64218,Deathline,1997-12-22,1997,0,0,0,0.325371
64225,Love on the Ground,1984-10-17,1984,0,0,0,0.003013
64228,"Love, Pain and Vice Versa",2008-02-10,2008,2556455,0,-2556455,1.126962
64239,Kamikaze,1986-12-10,1986,0,0,0,0.941056
64246,Colorful,2010-08-21,2010,0,0,0,8.732753
64257,Born Invincible,1978-01-01,1978,0,0,0,0.584322
64264,Gloss,2007-08-23,2007,2500000,4684165,2184165,0.880482
64265,The Paper Brigade,1997-02-25,1997,0,0,0,0.408254
64266,Demobbed,2000-03-31,2000,0,0,0,1.601712
64268,Dura,2005-07-21,2005,0,0,0,0.803834
64272,War of the Shaolin Temple,1980-09-14,1980,0,0,0,0.003013
64278,Interceptor Force 2,2002-11-30,2002,0,0,0,0.384546
64288,Forks Over Knives,2011-05-06,2011,0,664747,664747,3.089226
64291,Sapphire,1959-11-02,1959,0,0,0,1.756658
64304,Clan of Amazons,1978-02-19,1978,0,0,0,0.151359
64305,Dreadnaught,1981-03-26,1981,0,0,0,0.412425
64307,Heroes of Sung,1973-12-01,1973,0,0,0,0.083321
64310,Les Destin√©es sentimentales,2000-07-12,2000,0,0,0,0.117912
64316,Warriors Two,1978-12-28,1978,0,0,0,0.635436
64318,Hide-Out,1934-08-24,1934,0,0,0,0.365873
64320,Good Neighbours,2011-06-03,2011,0,0,0,8.90645
64325,Cross,2011-07-12,2011,2000000,0,-2000000,4.171114
64328,The Muppets,2011-11-22,2011,45000000,165184237,120184237,10.214369
64334,Ghost River,2002-09-04,2002,0,0,0,0.156694
64335,Fig Jam,2011-02-11,2011,0,0,0,1.736752
64340,Witch Way Love,1997-03-19,1997,0,0,0,1.177375
64347,See How They Fall,1994-08-31,1994,0,0,0,0.721287
64348,Robotrix,1991-05-31,1991,0,0,0,0.667275
64349,S√©rie noire,1979-04-25,1979,0,0,0,0.976968
64350,Living with Wolves,2005-05-08,2005,0,0,0,0.520346
64353,The Hitch Hikers Guide to the Galaxy,1981-02-09,1981,0,0,0,2.442825
64357,Meilleur espoir f√©minin,2000-05-31,2000,0,0,0,0.64678
64362,"Oui, mais...",2001-04-18,2001,0,0,0,0.747546
64372,Dana Carvey: Squatting Monkeys Tell No Lies,2008-06-14,2008,0,0,0,0.359009
64382,The Reluctant Debutante,1958-01-01,1958,0,0,0,1.954175
64383,Bad Faith,2006-12-06,2006,0,0,0,0.974722
64386,L'oeuvre au noir,1988-05-13,1988,0,0,0,0.53219
64393,Hard-Hearted,2007-06-19,2007,0,0,0,0.299356
64397,"Basic Sanitation, the Movie",2007-07-20,2007,0,0,0,1.268534
64398,The Pleasure Garden,1925-11-03,1925,0,0,0,0.753073
64403,Princesa,2001-06-01,2001,0,0,0,0.001188
64404,Le r√©v√©lateur,1968-01-01,1968,0,0,0,0.206755
64407,Between Eleven and Midnight,1949-03-23,1949,0,0,0,0.001443
64414,Sign of the Lion,1962-05-03,1962,0,0,0,0.831463
64418,The Phantom Carriage,1939-09-07,1939,0,0,0,0.016394
64423,Fric-Frac,1939-06-15,1939,0,0,0,0.548551
64428,The Vengeance of She,1968-04-14,1968,0,0,0,0.804678
64433,Pardon,2005-03-04,2005,0,0,0,0.608454
64437,L'√ât√© en pente douce,1987-04-29,1987,0,0,0,0.217835
64441,Three Crowns of the Sailor,1983-10-05,1983,0,0,0,0.00022
64442,Boys' School,1938-04-05,1938,0,0,0,0.844862
64450,Kinatay,2009-09-23,2009,0,0,0,1.696516
64454,The Hamburg Syndrome,1979-11-22,1979,0,0,0,0.814198
64456,The Lawless,1950-06-01,1950,0,0,0,0.979775
64458,Bed & Breakfast,2010-12-10,2010,0,0,0,0.388392
64462,Sammy and Me,2002-07-11,2002,0,0,0,0.524159
64465,"The Case Is Closed, Forget It",1971-10-27,1971,0,0,0,0.014966
64468,√áalgƒ± √áengi,2011-02-18,2011,0,0,0,0.886442
64481,The Officers' Ward,2001-09-26,2001,0,0,0,2.187121
64483,A Driver for Vera,2004-07-27,2004,3300000,2011837,-1288163,0.975857
64484,Playing the Victim,2006-06-08,2006,0,0,0,1.217921
64494,Malibu Express,1985-03-01,1985,500000,0,-500000,0.558542
64499,Quincea√±era,2006-06-05,2006,0,0,0,0.584072
64501,Naughty @ 40,2011-04-14,2011,0,0,0,0.009359
64502,The Day of the Triffids,2009-12-28,2009,15000000,0,-15000000,2.751991
64504,My Best Friend's Girl,1983-08-31,1983,0,0,0,1.060343
64508,Hard to Be a God,1989-09-09,1989,0,0,0,0.705069
64519,Making a Killing: The Untold Story of Psychotropic Drugging,2008-10-24,2008,0,0,0,0.228266
64522,Reel Bad Arabs: How Hollywood Vilifies a People,2006-01-01,2006,0,0,0,0.263374
64524,Nightmare,1964-04-19,1964,0,0,0,1.957153
64525,Paranoia,1969-02-07,1969,0,0,0,2.262992
64526,Alex L'ariete,2000-07-21,2000,0,0,0,0.506796
64527,A Pool Without Water,1982-01-23,1982,0,0,0,0.119379
64528,Amuck!,1972-03-21,1972,0,0,0,1.157955
64534,The Strange Case of Dr. Jekyll and Miss Osbourne,1981-06-17,1981,0,0,0,0.765706
64544,Boyfriends and Girlfriends,1987-08-26,1987,0,0,0,0.788394
64551,The Soldier and the Lady,1937-04-09,1937,0,0,0,0.038377
64559,The Swindle,1997-10-15,1997,0,0,0,0.760098
64562,Other Voices Other Rooms,1995-09-15,1995,0,0,0,0.03668
64566,Cinema Verite,2011-04-23,2011,0,0,0,1.131682
64567,Dead Tired,1994-05-18,1994,0,0,0,0.665616
64568,Taste of Fear,1961-06-05,1961,0,0,0,0.989954
64572,La nuit la plus longue,1965-07-28,1965,0,0,0,0.001177
64576,Stray Cat Rock: Delinquent Girl Boss,1970-05-02,1970,0,0,0,0.430769
64577,Summer Affair,1971-04-09,1971,0,0,0,0.300227
64584,Perfect Love,1996-10-23,1996,0,0,0,1.224596
64586,Sleeping Beauty,2011-06-10,2011,10000000,0,-10000000,5.356167
64605,Seven Thieves,1960-03-12,1960,0,0,0,4.518656
64624,The House That Screamed,1969-01-01,1969,0,0,0,1.125099
64627,Operation Ganymed,1977-11-05,1977,0,0,0,0.68213
64628,The Sweet Body of Deborah,1968-03-20,1968,0,0,0,0.320186
64630,Oasis of Fear,1971-08-18,1971,0,0,0,0.320724
64632,Pianomania,2009-01-28,2009,0,0,0,0.115685
64635,Total Recall,2012-08-02,2012,125000000,198802074,73802074,16.42635
64639,Straw Dogs,2011-09-16,2011,25000000,10324441,-14675559,8.048422
64649,The Watcher in the Attic,1976-06-12,1976,0,0,0,0.745193
64650,Sartana the Gravedigger,1969-11-20,1969,0,0,0,0.79626
64651,Stray Cat Rock: Sex Hunter,1970-09-01,1970,0,0,0,0.60719
64655,Archipelago,2010-10-22,2010,0,0,0,1.644963
64666,The Scorpion with Two Tails,1982-09-17,1982,0,0,0,0.470938
64674,Alice in the Navy,1961-02-20,1961,0,0,0,0.389976
64678,The Art of Getting By,2011-06-17,2011,0,1406224,1406224,5.24456
64679,Cleopatra,1999-05-23,1999,0,0,0,1.37675
64682,The Great Gatsby,2013-05-10,2013,105000000,351040419,246040419,17.598936
64683,Killing Us Softly 3: Advertising's Image of Women,1999-01-01,1999,0,0,0,0.001684
64685,Extremely Loud & Incredibly Close,2011-12-24,2011,40000000,55247881,15247881,7.82605
64686,47 Ronin,2013-12-06,2013,175000000,150962475,-24037525,14.88937
64688,21 Jump Street,2012-03-12,2012,42000000,201585328,159585328,11.250764
64689,Killing Them Softly,2012-09-20,2012,15000000,37930465,22930465,6.777326
64690,Drive,2011-08-06,2011,15000000,78054825,63054825,15.388875
64694,"No eres t√∫, soy yo",2010-08-27,2010,0,0,0,0.55308
64714,The Golden Calf,1968-12-08,1968,0,0,0,1.728708
64720,Take Shelter,2011-11-25,2011,5000000,3099314,-1900686,5.59686
64725,The Dead Are Alive,1972-05-25,1972,0,0,0,0.027777
64728,Japanese Girls at the Harbor,1933-06-01,1933,0,0,0,0.391217
64735,The One That Got Away,1957-11-22,1957,0,0,0,0.874367
64736,Piter FM,2006-04-20,2006,0,0,0,1.047412
64739,Day of the Cobra,1980-08-12,1980,0,0,0,0.069176
64765,Love and Lies,1980-06-06,1980,0,0,0,0.521762
64780,Upside Down: The Creation Records Story,2010-10-19,2010,0,0,0,0.111765
64782,A Lesson in Love,1954-10-04,1954,0,0,0,1.076791
64784,Gestalt,1997-01-22,1997,0,0,0,0.104754
64786,Yes or No,2010-12-16,2010,0,0,0,1.316925
64792,The Red Shoes,2006-01-20,2006,0,0,0,1.589082
64802,Love! Valour! Compassion!,1997-05-16,1997,2000000,2900000,900000,1.7442
64805,Body to Body,2003-04-22,2003,0,0,0,0.598955
64807,Grudge Match,2013-12-25,2013,40000000,44907260,4907260,11.655588
64811,Girl with Green Eyes,1964-05-01,1964,0,0,0,0.286364
64820,The Crimson Petal and the White,2011-01-01,2011,0,0,0,0.732176
64822,Dear Goddamned Friends,1994-01-01,1994,0,0,0,0.972392
64827,L'educazione sentimentale di Eugenie,2005-01-01,2005,0,0,0,0.46583
64828,The Landlord,1970-05-20,1970,0,0,0,1.514513
64831,The Boys: The Sherman Brothers' Story,2009-01-01,2009,0,0,0,0.254965
64832,Shadows & Lies,2010-04-25,2010,0,0,0,1.408602
64834,Operaci√≥n Ogro,1979-09-27,1979,0,0,0,1.071094
64835,Corpo celeste,2011-05-20,2011,0,0,0,0.292426
64836,Exporting Raymond,2011-04-29,2011,0,0,0,0.28542
64847,Belladonna of Sadness,1973-01-01,1973,0,0,0,1.797756
64850,Mr. Average,2006-06-21,2006,0,0,0,0.415034
64851,The Sword and the Rose,1953-07-23,1953,0,0,0,0.444989
64852,London After Midnight,1927-12-17,1927,152000,0,-152000,0.377017
64854,Seconds Apart,2011-01-28,2011,0,0,0,3.27105
64861,Thirst,2010-06-22,2010,0,0,0,0.476642
64868,Greyfriars Bobby: The True Story of a Dog,1961-07-17,1961,0,0,0,0.881457
64869,"Nikki, Wild Dog of the North",1961-07-12,1961,0,0,0,0.037374
64871,The Legend of Lobo,1962-11-07,1962,0,0,0,0.017999
64872,A Tiger Walks,1964-04-12,1964,0,0,0,0.806964
64875,The Fighting Prince of Donegal,1966-10-01,1966,0,0,0,0.099109
64876,Ohyaku: The Female Demon,1968-05-25,1968,0,0,0,0.142424
64877,"The One and Only, Genuine, Original Family Band",1968-04-19,1968,0,0,0,0.755717
64880,Tum Bin,2001-07-13,2001,0,1486992,1486992,0.371679
64882,Finding Mr. Destiny,2010-12-08,2010,0,0,0,0.54874
64897,Stormy Waters,1941-11-27,1941,0,0,0,0.584374
64900,I Can't Sleep,1994-05-18,1994,0,0,0,0.318366
64901,Cold Water,1994-07-06,1994,0,0,0,0.207079
64912,"The Yakuza Papers, Vol. 5: Final Episode",1974-06-29,1974,0,0,0,0.978531
64923,Gulliver's Travels,1977-01-01,1977,0,0,0,0.441911
64924,The Weight of Chains,2010-12-17,2010,0,0,0,0.464437
64926,June Night,1940-04-03,1940,0,0,0,0.384436
64928,It All Came True,1940-04-06,1940,0,0,0,0.274233
64931,Detective K: Secret of the Virtuous Widow,2011-01-27,2011,0,0,0,1.105025
64934,Le Nouveau Jean-Claude,2002-06-26,2002,0,0,0,0.265559
64935,A Private Affair,2002-04-30,2002,0,0,0,0.718978
64936,Murder √† la Mod,1968-05-01,1968,0,0,0,0.533862
64942,Mary,2005-11-18,2005,0,0,0,0.953421
64943,Giordano Bruno,1973-11-29,1973,0,0,0,0.738416
64944,A Parting Shot,2007-05-30,2007,2700000,0,-2700000,0.00376
64945,That was Then... This is Now,1985-11-08,1985,0,0,0,0.619283
64948,Bix,1991-01-01,1991,0,0,0,0.00222
64961,When Women Had Tails,1970-12-16,1970,0,0,0,1.179922
64963,Rough Night in Jericho,1967-01-01,1967,0,0,0,1.078688
64964,Forest,2003-02-13,2003,0,0,0,0.169052
64965,"Per amore, solo per amore",1993-01-01,1993,0,0,0,0.015894
64968,Marius and Jeannette,1997-01-01,1997,0,0,0,0.454392
64972,The Kid & I,2005-12-02,2005,5,0,-5,1.078538
64973,"Peace, Propaganda & the Promised Land",2005-01-28,2005,0,0,0,0.166667
64976,Day of the Animals,1977-05-13,1977,1200000,0,-1200000,4.34926
64983,Barocco,1976-12-08,1976,0,0,0,0.573299
64984,The Admirable Crichton,1957-12-16,1957,0,0,0,0.733941
64988,Descendant of the Sun,1983-12-16,1983,0,0,0,0.276669
64992,Human Lanterns,1982-07-14,1982,0,0,0,0.844967
64994,Martial Club,1981-08-19,1981,0,0,0,1.611307
64998,The Magnificent Trio,1966-11-08,1966,0,0,0,0.341629
65002,The Circle of Deceit,1981-10-15,1981,0,0,0,0.978886
65010,Smiling Eyes,1977-03-01,1977,0,0,0,0.452158
65012,This Property Is Condemned,1966-08-03,1966,0,0,0,3.732049
65014,Female on the Beach,1955-08-19,1955,0,0,0,0.627368
65015,Sweetie,1989-09-28,1989,0,0,0,0.880755
65016,The Sleeping Beauty,2010-09-03,2010,0,0,0,0.666491
65020,The Taint,2010-01-01,2010,0,0,0,0.752246
65034,Too Big to Fail,2011-05-22,2011,0,0,0,3.363008
65035,Bertie and Elizabeth,2002-07-07,2002,0,0,0,1.056596
65040,"Up, Down, Fragile",1995-03-12,1995,0,0,0,0.25447
65041,Triple Agent,2004-03-17,2004,0,0,0,1.464714
65044,The Heirloom,2005-09-15,2005,0,0,0,0.214527
65045,My Mother's Smile,2002-01-01,2002,0,0,0,0.647701
65046,Love Serenade,1996-10-10,1996,0,0,0,0.881482
65048,The Four Days of Naples,1962-01-01,1962,800000,0,-800000,0.829464
65049,Submarine X-1,1969-06-23,1969,0,0,0,0.565796
65055,Shark Night,2011-09-02,2011,28000000,10126458,-17873542,6.062425
65056,A Little Help,2010-07-22,2010,0,0,0,2.518077
65057,The Descendants,2011-09-09,2011,20000000,177243185,157243185,11.794753
65058,Conan O'Brien Can't Stop,2011-06-24,2011,0,223959,223959,1.686871
65066,Going in Style,1979-12-07,1979,0,0,0,1.32675
65075,Keep the River on Your Right: A Modern Cannibal Tale,2000-04-15,2000,0,0,0,0.122334
65081,My Little Business,1999-09-01,1999,0,0,0,0.264677
65086,The Woman in Black,2012-02-01,2012,17000000,127730736,110730736,8.896679
65089,31st of June,1978-11-11,1978,0,0,0,0.000844
65092,The Rite,1969-03-25,1969,0,0,0,0.539979
65096,EMR,2004-01-01,2004,150000,0,-150000,0.882615
65099,Marta the Pious Woman,1980-06-06,1980,0,0,0,0.00195
65102,The Bat,1979-03-04,1979,0,0,0,0.000578
65103,Race to Nowhere,2009-12-31,2009,0,0,0,0.246243
65104,Dust,2005-06-17,2005,0,0,0,0.901892
65107,The Elder Son,1975-06-06,1975,0,0,0,0.563797
65110,Winter Evening in Gagry,1985-06-06,1985,0,0,0,0.004425
65114,The Cockleshell Heroes,1955-11-16,1955,0,0,0,0.931527
65118,Interceptors,1999-09-11,1999,0,0,0,0.435022
65120,Days of Santiago,2004-01-29,2004,0,0,0,0.279829
65123,Three Men in a Boat,1979-06-06,1979,0,0,0,0.153597
65131,Shadow,1971-09-18,1971,0,0,0,0.241974
65134,Zachariah,1971-01-12,1971,0,0,0,0.071054
65137,Father Hood,1993-08-27,1993,0,3418141,3418141,2.011108
65142,The Most Charming and Attractive,1985-06-06,1985,0,0,0,0.671173
65156,The North Avenue Irregulars,1979-02-09,1979,0,0,0,0.437256
65157,Cheetah,1989-08-18,1989,5000000,8153677,3153677,0.011574
65158,Squanto: A Warrior's Tale,1994-10-28,1994,0,3337685,3337685,1.935006
65170,Breaking the Silence: Truth and Lies in the War on Terror,2003-09-21,2003,0,0,0,0.102147
65186,Forget Me Not,2011-05-06,2011,0,0,0,1.733993
65188,Leben nach Microsoft,2001-11-06,2001,0,0,0,0.107603
65192,The Savage Five,1974-02-15,1974,0,0,0,0.802808
65203,The Broadway Melody,1929-02-08,1929,379000,4358000,3979000,0.758012
65207,The Twelve Gold Medallions,1970-01-07,1970,0,0,0,0.725473
65210,Fingers at the Window,1942-04-22,1942,0,0,0,0.260309
65211,Flaxy Martin,1949-02-15,1949,0,0,0,0.32808
65212,The Silver Chalice,1954-12-20,1954,4500000,3200000,-1300000,0.313032
65213,Smart Girls Don't Talk,1948-10-09,1948,0,0,0,0.142624
65214,Dead Hooker in a Trunk,2009-04-20,2009,0,0,0,0.336357
65215,Family Guy Presents Stewie Griffin: The Untold Story,2005-07-23,2005,0,0,0,6.365552
65216,Bloody Cartoons,2007-10-16,2007,0,0,0,0.039187
65218,Lemonade Mouth,2011-04-15,2011,0,0,0,5.196496
65229,Tomboy,2011-04-20,2011,1000000,0,-1000000,12.892982
65233,The Conquest,2011-05-18,2011,0,0,0,2.07181
65252,Breeders,1997-08-09,1997,0,0,0,0.296848
65256,H2O Just Add Water - The Movie,2011-10-10,2011,0,0,0,1.902088
65257,Longshot,2001-10-25,2001,0,0,0,1.187862
65262,He Knows You're Alone,1980-09-12,1980,0,0,0,2.502341
65264,Once Upon a Time Twenty Years Later,1981-01-05,1981,0,0,0,0.107001
65270,Kenny Chesney: Summer In 3D,2010-08-21,2010,0,0,0,0.071225
65275,The Universe of Keith Haring,2009-02-28,2009,0,0,0,0.147195
65280,Body Language,1995-07-22,1995,0,0,0,0.005517
65282,Gambling House,1950-12-27,1950,0,0,0,0.694338
65283,The Proud and the Beautiful,1953-11-25,1953,0,0,0,0.143037
65289,A Nightmare in Las Cruces,2011-05-05,2011,0,0,0,0.059294
65291,Green Lantern: Emerald Knights,2011-04-09,2011,3500000,0,-3500000,7.226834
65296,Humanit√©,1999-05-17,1999,0,0,0,1.087756
65300,Endangered Species,1982-09-10,1982,0,0,0,0.842237
65310,Hornblower: Loyalty,2003-01-05,2003,0,0,0,1.094773
65317,The Perfume of the Lady in Black,1974-03-29,1974,0,0,0,0.163995
65320,Rulers of the City,1976-12-03,1976,0,0,0,0.254612
65326,Nobody's Fool,1986-11-07,1986,0,0,0,0.088621
65332,Love and Anarchy,1973-02-23,1973,0,0,0,0.614959
65345,Longhorns,2011-06-25,2011,0,0,0,0.815856
65364,Sexual Predator,2001-12-04,2001,1000000,0,-1000000,4.775734
65367,Trigger Man,2007-10-19,2007,10000,0,-10000,0.694785
65374,Samurai Cop,1991-11-30,1991,0,0,0,2.909637
65386,Officers,1971-07-26,1971,0,0,0,2.002326
65403,Vital Signs,1990-04-13,1990,0,0,0,0.462832
65416,An American Vampire Story,1997-01-24,1997,0,0,0,0.297741
65421,Eaux d'artifice,1953-01-01,1953,0,0,0,0.373656
65431,The Hunley,1999-07-11,1999,0,0,0,0.702798
65435,Consuming Kids: The Commercialization of Childhood,2007-12-31,2007,0,0,0,0.180931
65442,Breaking the Surface,2006-10-25,2006,0,0,0,2.190206
65448,Penitentiary,1979-12-01,1979,0,0,0,0.232477
65452,Penitentiary II,1982-04-02,1982,0,0,0,0.004425
65456,The Atrocity Exhibition,2000-06-05,2000,0,0,0,0.140566
65460,Carnosaur 2,1995-02-23,1995,0,0,0,0.552444
65480,Caro pap√†,1979-01-01,1979,0,0,0,0.007319
65481,Germany Pale Mother,1980-09-26,1980,0,0,0,0.002001
65482,The Law,1990-09-24,1990,0,0,0,0.363502
65485,The Dinner,1998-09-03,1998,0,0,0,1.821941
65488,Raintree County,1957-12-20,1957,5000000,0,-5000000,2.607994
65489,Malta Story,1953-06-01,1953,0,0,0,0.635763
65496,Student Services,2010-01-18,2010,0,0,0,3.732023
65497,Martial Law,1991-05-16,1991,0,0,0,0.627188
65501,Housekeeping,1987-11-25,1987,0,1083282,1083282,0.773954
65502,Fools' Parade,1971-08-18,1971,0,0,0,0.772388
65503,A Lady Takes a Chance,1943-08-19,1943,0,0,0,0.569912
65504,Chronopolis,1982-01-01,1982,0,0,0,0.873757
65506,Lady from Louisiana,1941-04-22,1941,0,0,0,0.261899
65507,Purgatory House,2003-09-20,2003,0,0,0,0.056262
65509,See This Movie,2004-03-03,2004,0,0,0,0.006019
65513,They Came Back,2004-10-27,2004,0,0,0,1.182462
65515,The Eleventh Hour,2008-01-01,2008,0,0,0,0.733475
65521,Pyaar Ka Punchnama,2011-05-20,2011,0,0,0,1.294741
65534,Poison,1951-11-30,1951,0,0,0,0.957004
65545,Vanished Empire,2008-02-14,2008,0,0,0,0.402849
65546,Grand Central Murder,1942-05-01,1942,0,0,0,0.221792
65550,The Rose Tattoo,1955-12-12,1955,0,0,0,0.982464
65572,Heart of Midnight,1988-11-10,1988,0,0,0,0.920379
65573,In the Name of the Italian People,1971-12-15,1971,0,0,0,0.669622
65576,Bicycle Dreams,2009-04-01,2009,300000,0,-300000,0.596722
65579,Dirty Filthy Love,2005-05-24,2005,0,0,0,0.402405
65586,"Davy Crockett, Indian Scout",1950-01-06,1950,0,0,0,0.601034
65591,The New Adventures of the Elusive Avengers,1968-06-06,1968,0,0,0,0.590717
65592,Princes and Princesses,2000-01-26,2000,0,0,0,1.141182
65594,"Crown of Russian Empire, or the Elusives Again",1971-06-06,1971,0,0,0,0.352603
65595,T2 3-D: Battle Across Time,1996-01-01,1996,0,0,0,1.674317
65596,The Spaceman and King Arthur,1979-07-10,1979,0,0,0,0.867064
65599,The Woman,2011-10-14,2011,0,0,0,5.895968
65603,Nightwing,1979-06-22,1979,0,0,0,0.000844
65611,Such a Pretty Little Beach,1949-01-19,1949,0,0,0,0.632151
65612,Keep Your Right Up,1987-09-19,1987,0,0,0,0.416594
65614,Dreaming of Space,2005-06-23,2005,2000000,696681,-1303319,0.570293
65615,The Innocents,1987-12-23,1987,0,0,0,0.034341
65626,Lift,2006-07-01,2006,0,123182,123182,0.158207
65628,The Fascist,1961-08-05,1961,0,0,0,0.575828
65632,The 10th Victim,1965-12-01,1965,0,0,0,1.188717
65642,The Story of a Cheat,1936-10-02,1936,0,0,0,0.646416
65646,The Eternal Return,1943-12-13,1943,0,0,0,0.211747
65650,The Good Doctor,2011-01-01,2011,6000000,5206,-5994794,8.278079
65651,The Man in the Sky,1957-01-24,1957,0,0,0,0.154078
65656,Beauties of the Night,1952-11-14,1952,0,0,0,0.363916
65662,Hit Me,1996-09-09,1996,0,0,0,0.086692
65673,A Letter to Elia,2010-09-04,2010,0,0,0,0.49715
65674,A Town Called Hell,1971-10-27,1971,0,0,0,0.391461
65679,Butterfly Kiss,2006-06-06,2006,0,0,0,0.601258
65683,Dil,1990-06-22,1990,0,0,0,0.835895
65684,The Guys,2002-09-11,2002,0,0,0,0.780534
65696,"Och, Karol 2",2011-01-21,2011,0,0,0,0.325635
65703,Manon of the Spring,1952-12-16,1952,0,0,0,0.499113
65707,Duelle,1976-09-15,1976,0,0,0,0.102022
65713,Seven Old Men and One Girl,1968-06-06,1968,0,0,0,0.038695
65718,The Walls of Malapaga,1949-11-16,1949,0,0,0,0.439894
65719,"Baxter, Vera Baxter",1977-06-08,1977,0,0,0,0.07725
65726,Lake Tahoe,2008-02-09,2008,0,0,0,0.437806
65749,Tango,1998-02-12,1998,0,0,0,0.596717
65754,The Girl with the Dragon Tattoo,2011-12-14,2011,90000000,232617430,142617430,8.907829
65755,Uncle P,2007-06-26,2007,0,0,0,0.109432
65759,Happy Feet Two,2011-11-17,2011,130000000,150406466,20406466,9.141045
65760,The Whistleblower,2010-09-13,2010,0,0,0,12.510849
65762,Swinging with the Finkels,2011-06-01,2011,0,0,0,1.747904
65766,Bon app√©tit,2010-11-12,2010,0,0,0,0.965179
65771,Boy,2011-01-27,2011,0,0,0,0.487798
65777,The October Man,1947-08-28,1947,0,0,0,1.165061
65787,With a Song in My Heart,1952-04-03,1952,0,0,0,0.399419
65793,The Feast of the Goat,2006-02-11,2006,0,0,0,0.192335
65795,The Education of Fairies,2006-06-23,2006,0,0,0,0.245427
65796,Wild Bill,1995-12-01,1995,30000000,0,-30000000,8.922139
65799,The Sea Shall Not Have Them,1954-06-01,1954,0,0,0,0.811448
65821,The Lost Prince,2005-12-18,2005,0,0,0,1.072258
65830,No Night Is Too Long,2002-12-27,2002,0,0,0,0.346531
65831,Sasha,2011-03-24,2011,0,0,0,0.91351
65839,It Doesn't Hurt Me,2006-06-08,2006,0,1110566,1110566,1.238971
65851,Jackass 3.5,2011-08-03,2011,0,0,0,10.485937
65869,Attraction,2001-04-22,2001,0,0,0,0.532948
65871,Zombie Undead,2010-01-15,2010,0,0,0,0.406797
65873,The N Word,2006-01-16,2006,0,0,0,0.054365
65874,Borderline,1930-10-13,1930,0,0,0,0.286199
65881,Battlefield Heroes,2011-01-27,2011,0,0,0,0.952669
65885,Emergency Kisses,1989-05-31,1989,0,0,0,0.003553
65887,The horse,1970-02-22,1970,0,0,0,0.697114
65889,Roseanna's Grave,1997-03-06,1997,0,0,0,1.081043
65891,The Dunwich Horror,1970-01-14,1970,0,0,0,2.150841
65892,My Future Boyfriend,2011-04-10,2011,0,0,0,1.357201
65896,Buttoners,1997-10-05,1997,0,0,0,0.086451
65898,The Suspended Vocation,1978-07-27,1978,0,0,0,0.06
65900,Of Parents and Children,2008-03-06,2008,0,0,0,0.003744
65904,Who Wants To Kill Jessie?,1966-08-26,1966,0,0,0,1.274399
65953,Gun Hill Road,2011-08-05,2011,119567,0,-119567,0.379004
65958,The Supper,1992-12-23,1992,0,0,0,0.524492
65967,Up and Down,2004-09-16,2004,2000000,0,-2000000,0.880914
65973,Dragon Ball Z Gaiden: The Plot to Destroy the Saiyans,1993-08-06,1993,0,0,0,1.579885
65990,Meteor,2009-10-09,2009,0,0,0,1.078008
65992,How to Die in Oregon,2011-01-01,2011,0,0,0,0.973323
65994,Prince Valiant,1954-04-05,1954,2970000,0,-2970000,1.503184
65997,Vampires,2010-04-17,2010,0,0,0,0.398848
66013,Death Duel,1977-07-06,1977,0,0,0,0.723632
66018,Drunken Master III,1994-07-02,1994,0,0,0,0.450367
66022,The Chalk Garden,1964-04-02,1964,0,0,0,0.813061
66025,Mooz-lum,2011-02-11,2011,0,330048,330048,0.816803
66027,Women in Love,1969-09-01,1969,1250000,0,-1250000,2.345912
66034,Mad Dog Time,1996-11-08,1996,0,0,0,0.768894
66035,The Kentuckian,1955-08-01,1955,0,0,0,0.786025
66043,The Incident,1967-11-05,1967,0,0,0,1.166142
66045,Black Magic M-66,1987-06-28,1987,0,0,0,1.448415
66055,Shoot the Living and Pray for the Dead,1971-08-13,1971,0,0,0,0.013577
66060,Vacation,2008-06-07,2008,0,0,0,0.039983
66062,Into a Dream,2005-06-11,2005,0,0,0,0.117204
66066,Verlengd Weekend,2005-10-12,2005,0,0,0,0.08521
66068,Girl,2002-09-01,2002,0,0,0,0.01711
66082,Rembrandt,1999-08-09,1999,0,0,0,0.561564
66084,No Need to Grieve,2010-03-16,2010,0,0,0,0.170717
66085,Sky. Plane. Girl.,2002-09-02,2002,0,314195,314195,0.518078
66087,Knives of the Avenger,1966-05-30,1966,0,0,0,0.213154
66091,A Cruel Romance,1984-06-06,1984,0,0,0,0.687325
66092,I Never Promised You a Rose Garden,1977-07-14,1977,3000000,0,-3000000,0.796358
66105,Saint Seiya: Legend of Crimson Youth,1988-07-23,1988,0,0,0,2.566613
66109,Wyatt Cenac: Comedy Person,2011-05-14,2011,0,0,0,0.304543
66110,Fall from Grace,2007-03-12,2007,7000,0,-7000,0.411575
66111,Luster,2010-12-12,2010,0,0,0,1.641912
66113,In Her Skin,2009-03-13,2009,7000000,0,-7000000,3.660025
66115,Nice Guys Sleep Alone,1999-10-14,1999,0,0,0,0.214291
66118,Case d√©part,2011-07-05,2011,0,0,0,4.075222
66120,The Monk,2011-07-12,2011,11000000,807535,-10192465,8.888718
66125,Red Dog,2011-08-04,2011,0,0,0,4.881643
66127,Ferat Vampire,1982-05-01,1982,0,0,0,0.105577
66129,Les Tuche,2011-06-30,2011,0,0,0,4.454853
66135,The Cry of the Owl,1987-10-28,1987,0,0,0,0.857733
66144,Sepultura: Under Siege (Live in Barcelona),1991-05-12,1991,0,0,0,0.067518
66148,The Late Mathias Pascal,1926-02-12,1926,0,0,0,0.161462
66150,Life in a Day,2011-01-27,2011,45202,225861,180659,4.955542
66159,The Most Fertile Man in Ireland,2000-06-08,2000,0,0,0,0.108591
66160,Flying Guillotine II,1978-01-19,1978,0,0,0,0.182952
66164,Little Deaths,2011-02-25,2011,0,0,0,2.022045
66175,I Was a Shoplifter,1950-05-13,1950,0,0,0,0.110471
66177,"Tot√≤, lascia o raddoppia?",1956-01-01,1956,0,0,0,0.399389
66178,Plastic Bag,2009-09-07,2009,0,0,0,0.693564
66180,The Fiances,1963-05-16,1963,0,0,0,0.320648
66187,Elite Group,1974-04-10,1974,0,0,0,0.191804
66192,After Midnight,1989-11-03,1989,0,0,0,1.290763
66193,Sinners and Saints,2010-06-30,2010,0,0,0,7.951137
66194,Deadtime Stories,1986-04-13,1986,0,2750741,2750741,1.712138
66195,The Perfect Host,2010-07-01,2010,0,14870,14870,5.935839
66209,Perils of the Sentimental Swordsman,1982-05-13,1982,0,0,0,0.000308
66211,Fire in Babylon,2011-07-22,2011,0,0,0,0.560459
66212,Righting Wrongs,1986-11-27,1986,0,0,0,0.785103
66224,Veyyil,2006-12-09,2006,0,0,0,0.081031
66247,Muthu,1995-05-05,1995,0,0,0,0.252468
66292,Agni Sakshi,1996-03-14,1996,0,0,0,0.320909
66340,Virumandi,2004-02-26,2004,0,0,0,0.117257
66344,Pammal K. Sambandam,2002-01-15,2002,0,0,0,0.475954
66346,Aalavandhan,2001-11-16,2001,300000,0,-300000,0.208012
66436,The Grand Maneuver,1955-10-25,1955,0,0,0,0.2095
66447,Tango,1993-02-03,1993,0,0,0,0.445571
66469,Dream Machine,1991-11-13,1991,0,0,0,0.504655
66473,A Damsel in Distress,1937-11-19,1937,0,0,0,1.685981
66485,Viva Max!,1969-12-01,1969,0,0,0,0.006763
66487,Streamers,1983-01-01,1983,0,0,0,0.225313
66488,That Cold Day in the Park,1969-06-08,1969,500000,0,-500000,0.562587
66526,Mudhalvan,1999-11-07,1999,7400000,22000000,14600000,0.236466
66536,Eeram,2009-09-11,2009,0,0,0,0.36954
66537,The Disenchanted,1990-10-31,1990,0,0,0,3.723832
66538,The Discreet,1990-11-21,1990,0,0,0,0.784395
66540,Ali Baba and the Forty Thieves,1954-12-24,1954,0,0,0,1.272557
66541,I Sent a Letter to My Love,1980-04-09,1980,0,0,0,0.000344
66566,Past Midnight,1991-01-01,1991,0,0,0,0.479052
66568,The 25th Hour,1967-04-26,1967,0,0,0,1.310994
66584,Le party,1990-02-02,1990,0,0,0,0.08533
66588,A Thousand Acres,1997-09-17,1997,0,0,0,0.82942
66590,Callie & Son,1981-10-13,1981,0,0,0,0.033422
66592,Charlie Chan and the Curse of the Dragon Queen,1981-02-01,1981,0,0,0,1.128953
66597,Falling in Love Again,1980-11-21,1980,0,0,0,0.462729
66599,Love Field,1992-12-11,1992,0,0,0,8.107503
66600,Sweet Liberty,1986-05-14,1986,0,0,0,1.028354
66605,Russell Peters: The Green Card Tour,2011-03-23,2011,0,0,0,0.626616
66608,Blubberella,2011-07-29,2011,0,0,0,0.859908
66623,"Tattoo, a Love Story",2002-04-11,2002,0,0,0,0.07304
66628,Toward the Terra,1980-04-25,1980,0,0,0,0.144113
66634,Dingo,1991-06-02,1991,200000,300000,100000,0.124273
66638,Soldier Girls,1981-09-15,1981,0,0,0,0.075
66641,Voices of Iraq,2004-01-01,2004,0,0,0,0.037698
66659,Equalizer 2000,1987-01-01,1987,0,0,0,0.764715
66660,How to Draw a Bunny,2002-01-01,2002,0,0,0,0.002692
66664,Shocking Dark,1990-08-22,1990,0,0,0,0.864606
66668,The Shrink Is In,2001-08-01,2001,6000000,0,-6000000,0.802417
66700,Cose da pazzi,2005-03-25,2005,0,0,0,1.456116
66701,Heroes for Sale,1933-06-17,1933,290,0,-290,1.094643
66702,Dil Ne Jise Apna Kahaa,2004-09-10,2004,0,0,0,0.281065
66706,Grim Prairie Tales,1990-09-14,1990,0,0,0,0.001586
66707,Johnny Apollo,1940-04-19,1940,0,0,0,0.913351
66720,Special When Lit,2009-10-01,2009,0,0,0,0.727515
66722,The Goodbye Girl,2004-01-16,2004,0,0,0,0.792355
66730,The Rescue,1971-09-24,1971,0,0,0,0.125147
66733,Finding Rin Tin Tin,2007-08-15,2007,0,0,0,0.06756
66741,Total Reality,1997-04-03,1997,0,0,0,0.816326
66745,Malibu High,1979-05-01,1979,56000,0,-56000,0.969741
66753,Out of Life,1991-05-15,1991,0,0,0,0.365192
66756,Shaolin Prince,1982-01-01,1982,0,0,0,0.482788
66759,The Battle Wizard,1977-09-09,1977,0,0,0,0.580472
66762,Jennifer,1978-05-13,1978,0,0,0,0.468194
66770,Dutchman,1967-02-27,1967,0,0,0,0.275086
66772,Cold Blood,1975-07-18,1975,0,0,0,0.233153
66775,Young Winston,1972-07-20,1972,0,0,0,1.288199
66780,The Journey,2001-06-13,2001,500000,0,-500000,0.142783
66787,Mentor,2006-04-28,2006,0,0,0,0.527645
66799,Assault at West Point: The Court-Martial of Johnson Whittaker,1994-02-26,1994,0,0,0,1.015929
66812,Nana,1926-06-25,1926,0,0,0,0.410031
66819,Alpine Climbers,1936-07-25,1936,0,0,0,0.497393
66824,Boat Builders,1938-02-25,1938,0,0,0,0.37722
66834,Clock Cleaners,1937-10-15,1937,0,0,0,0.649579
66878,Home Made Home,1951-03-23,1951,0,0,0,0.289609
66881,Nightbeast,1982-11-01,1982,14000,0,-14000,1.201388
66892,Tale of the Mummy,1998-03-19,1998,0,0,0,0.883828
66893,The White Angel,1955-04-06,1955,0,0,0,0.571449
66894,Ride,1998-03-27,1998,0,0,0,0.987366
66895,Ticked-Off Trannies with Knives,2010-10-15,2010,0,0,0,0.295864
66897,Les deux timides,1928-12-04,1928,0,0,0,0.267114
66918,Beginning of the End,1957-06-28,1957,0,0,0,0.448948
66925,Stripperland,2011-02-22,2011,0,0,0,1.260298
66926,Magyar v√°ndor,2004-02-05,2004,0,0,0,0.353403
66942,Griff the Invisible,2011-08-19,2011,2902660,0,-2902660,2.930897
66944,Seventy-Two Days,2010-07-20,2010,0,0,0,0.94711
66945,Love's Kitchen,2011-06-07,2011,0,0,0,2.397077
66946,The Bad News Bears Go to Japan,1978-06-30,1978,0,0,0,1.047396
66949,Moli√®re,1978-08-30,1978,0,0,0,0.62798
66953,"Who Are You, Polly Maggoo?",1966-10-21,1966,0,0,0,0.16663
66956,This Special Friendship,1964-09-04,1964,0,0,0,0.341223
66963,Lucrezia Borgia,1935-12-20,1935,0,0,0,0.142167
66965,Come Dance with Me!,1959-12-28,1959,0,0,0,0.693065
66966,Love Is My Profession,1958-09-17,1958,750000,0,-750000,1.325876
66967,The Night Heaven Fell,1958-04-05,1958,0,0,0,0.761508
66968,Plucking the Daisy,1956-07-25,1956,0,0,0,0.100586
66969,That Naughty Girl,1956-04-10,1956,0,0,0,0.331038
66984,How to Play Football,1944-09-15,1944,0,0,0,0.282634
66997,Magician Mickey,1937-02-06,1937,0,0,0,0.579559
67018,The Image,1975-09-10,1975,0,0,0,3.078861
67021,The Young Vagabond,1985-01-01,1985,0,0,0,0.47608
67022,Quartet,1981-05-20,1981,0,0,0,0.248291
67025,Addicted,2002-10-18,2002,0,0,0,0.256316
67062,Entranced Earth,1967-05-08,1967,0,0,0,1.518475
67067,Zone 39,1996-05-04,1996,0,0,0,0.087065
67079,Brooklyn Bridge,1982-05-24,1982,0,0,0,0.3509
67083,BaadAsssss Cinema,2002-01-01,2002,0,0,0,4.108869
67087,Curtains,1983-03-04,1983,0,0,0,1.436731
67089,Beat,1997-05-10,1997,0,0,0,0.159576
67102,Pilot Pirx's Inquest,1979-05-27,1979,0,0,0,0.894956
67109,Delhi Belly,2011-07-01,2011,4090000,18035000,13945000,1.932489
67113,Mickey's Polo Team,1936-01-04,1936,0,0,0,0.55117
67130,Moving Day,1936-06-20,1936,0,0,0,4.938759
67145,No Smoking,1951-11-23,1951,0,0,0,0.226643
67162,Pluto's Judgement Day,1935-08-31,1935,0,0,0,0.907356
67166,Runaway Brain,1995-08-11,1995,0,0,0,1.022445
67174,Exodus: Tales from the Enchanted Kingdom,2005-12-25,2005,0,0,0,0.236331
67177,Dear Michele,1976-01-01,1976,0,0,0,0.003794
67179,St. Michael Had a Rooster,1972-01-01,1972,0,0,0,0.225051
67180,"Saturday, Sunday and Friday",1979-06-06,1979,0,0,0,0.113966
67183,Paganini Horror,1989-06-06,1989,0,0,0,0.974416
67198,Bloodworth,2010-02-06,2010,0,0,0,1.834093
67216,The Dead Will Tell,2004-10-24,2004,0,0,0,1.091954
67217,Signs of Life,1968-07-05,1968,0,0,0,1.245559
67219,The Great Alligator,1979-11-03,1979,0,0,0,0.481113
67220,Hard Contract,1969-04-30,1969,4000000,1750000,-2250000,0.491227
67221,Hands of Steel,1986-03-26,1986,0,0,0,1.030584
67232,Daughter from Danang,2002-01-11,2002,0,0,0,0.073748
67236,Tiresia,2003-05-20,2003,0,0,0,0.611037
67255,The Crazy Family,1984-06-24,1984,0,0,0,0.002001
67263,Alpine Fire,1985-09-02,1985,0,0,0,0.880194
67272,K√§nd fr√•n TV,2001-09-21,2001,0,0,0,0.567912
67273,Buck,2011-06-17,2011,0,386749,386749,2.564695
67276,Absurda,2007-05-16,2007,0,0,0,0.581896
67280,Billy Wilder Speaks,2006-06-22,2006,0,0,0,0.183492
67297,The Girl of Your Dreams,1998-11-13,1998,0,0,0,2.289624
67298,Lisztomania,1975-10-10,1975,0,0,0,1.144401
67303,Tale About the Cat and the Moon,1997-01-01,1997,0,0,0,0.158473
67307,The Big Town,1987-09-25,1987,0,1700000,1700000,4.23544
67308,3-D Sex and Zen: Extreme Ecstasy,2011-04-14,2011,0,0,0,6.030363
67313,One Wild Oat,1951-05-16,1951,0,0,0,0.20538
67314,Prey,2011-07-13,2011,0,0,0,0.714459
67317,Dr. Alien,1989-10-12,1989,0,0,0,0.426789
67320,Stanley,1972-05-23,1972,0,0,0,0.040509
67323,The Adventures of Sebastian Cole,1998-09-11,1998,0,0,0,0.371975
67327,The Samurai of Ayothaya,2010-12-02,2010,0,0,0,1.348011
67328,The Gundown,2011-09-12,2011,0,0,0,0.793642
67337,Killer Darts,1968-05-09,1968,0,0,0,1.05294
67339,Kung Fu Zombie,1981-10-01,1981,0,0,0,0.124009
67342,Mr. Vampire,1985-11-07,1985,0,0,0,4.191925
67343,Mr. Vampire 2,1986-08-15,1986,0,0,0,0.692027
67355,No Child of Mine,1997-02-25,1997,0,0,0,0.001408
67362,The Last Lullaby,2008-03-28,2008,0,0,0,0.011759
67365,The Search for One-eye Jimmy,1994-11-14,1994,0,0,0,0.617014
67367,The Thorn in the Heart,2009-10-10,2009,0,0,0,0.408405
67375,The Story of Alexander Graham Bell,1939-04-04,1939,0,0,0,0.702342
67377,The Best of Enemies,1961-10-26,1961,0,0,0,0.55901
67378,The Conjugal Bed,1963-01-01,1963,0,0,0,0.190725
67381,La Danse: The Paris Opera Ballet,2009-10-07,2009,0,0,0,1.655702
67384,A Hell of a Day,2001-10-24,2001,0,0,0,0.544788
67385,The Town Is Quiet,2000-08-30,2000,0,0,0,0.143611
67387,Assault of the Killer Bimbos,1988-05-06,1988,0,0,0,0.014895
67390,Avenging Angel,1985-01-11,1985,0,0,0,1.490898
67394,Savage Beach,1989-10-01,1989,0,0,0,0.76945
67404,The Autobiography of Nicolae Ceausescu,2010-10-29,2010,0,0,0,0.375066
67409,Duck Dodgers in the 24¬Ωth Century,1953-07-25,1953,0,0,0,1.859834
67429,The Model Couple,1977-03-30,1977,0,0,0,0.222456
67431,Hi-Jack Highway,1955-10-18,1955,0,0,0,0.383766
67441,Rain over Santiago,1975-12-10,1975,0,0,0,0.442612
67443,They Were Five,1936-09-01,1936,0,0,0,0.34768
67445,Jiminy Glick in Lalawood,2004-09-18,2004,0,0,0,0.152631
67451,The Imaginary Voyage,1926-04-30,1926,0,0,0,0.158356
67455,The Fantastic Night,1942-07-10,1942,0,0,0,0.543794
67460,We Can Be Heroes,2005-07-27,2005,0,0,0,0.14353
67463,Heimat: A Chronicle of Germany,1984-09-16,1984,0,0,0,0.016204
67467,Can't Change the Meeting Place,1979-11-11,1979,0,0,0,0.994758
67488,A Little Princess,1986-01-01,1986,0,0,0,0.001021
67493,Centennial,1978-10-01,1978,0,0,0,0.664727
67499,My Grandpa the Bankrobber,2011-02-10,2011,0,0,0,0.377286
67509,Lily Sometimes,2010-12-01,2010,2300000,0,-2300000,0.726152
67515,Luther the Geek,1990-01-01,1990,0,0,0,0.256753
67521,Something of Value,1957-05-10,1957,0,0,0,0.681134
67530,The Lords of Discipline,1983-02-18,1983,0,11787127,11787127,0.945726
67531,West Point,1928-01-07,1928,0,0,0,0.226302
67532,Les Mis√©rables,1934-02-03,1934,0,0,0,1.523165
67545,Patrioticheskaya Komediya,1992-01-01,1992,0,0,0,0.082394
67556,The Suitor,1962-11-12,1962,0,0,0,0.265256
67560,Yuriko's Aroma,2010-05-08,2010,0,0,0,0.693071
67572,The Band Concert,1935-02-23,1935,0,0,0,1.108439
67592,The Little Whirlwind,1941-02-14,1941,0,0,0,0.667704
67595,The Positively True Adventures of the Alleged Texas Cheerleader Murdering Mom,1993-04-10,1993,0,0,0,0.783454
67612,"Black God, White Devil",1964-03-13,1964,0,0,0,1.732727
67617,O Quatrilho,1995-10-20,1995,0,0,0,0.329549
67619,Revenge of the Electric Car,2011-10-21,2011,0,0,0,0.618371
67626,Three Orphan Kittens,1935-10-26,1935,25771,0,-25771,0.749343
67633,Maternal Half-Brothers,1988-09-10,1988,0,0,0,6.9e-05
67636,Comanche Moon,2008-01-13,2008,0,0,0,0.51968
67654,The Mascot,1933-01-01,1933,0,0,0,0.518636
67657,Armageddon,1977-03-16,1977,0,0,0,0.157014
67659,Guns for San Sebastian,1968-03-20,1968,0,0,0,1.576396
67660,Think Like a Man,2012-04-16,2012,12000000,96070507,84070507,5.264551
67661,Thru the Mirror,1936-05-30,1936,0,0,0,0.930058
67669,Going Back,2001-01-01,2001,0,0,0,0.398455
67675,Glee: The Concert Movie,2011-08-11,2011,9000000,18663238,9663238,9.202416
67687,The Stepmother,1973-06-06,1973,0,0,0,0.000308
67693,Jocks,1986-11-14,1986,0,0,0,0.521713
67696,A Warm December,1973-05-23,1973,0,0,0,0.076367
67699,Trick or Treat,1952-10-10,1952,0,0,0,0.76974
67701,Right America:  Feeling Wronged,2009-02-15,2009,0,0,0,0.006847
67713,Popeye the Sailor Meets Sindbad the Sailor,1936-11-27,1936,0,0,0,0.978521
67736,Th√©r√®se Raquin,1953-11-06,1953,0,0,0,1.726864
67737,Macabre,1980-04-17,1980,0,0,0,0.30828
67740,"Butcher, Baker, Nightmare Maker",1982-02-24,1982,0,0,0,2.332268
67742,S&Man,2006-03-10,2006,0,0,0,0.637189
67748,Snowtown,2011-05-16,2011,0,8452,8452,5.322953
67750,The Grotesque,1995-09-09,1995,0,0,0,0.699768
67753,Heartbeat,1938-04-15,1938,0,0,0,0.139009
67756,Topaze,1951-01-25,1951,0,0,0,0.6505
67758,Betrayal,2003-08-01,2003,0,0,0,0.903007
67772,"Come Back to the 5 & Dime, Jimmy Dean, Jimmy Dean",1982-11-12,1982,850000,840000,-10000,1.094395
67790,Ye Olden Days,1933-04-08,1933,0,0,0,0.857073
67793,Don't Go Breaking My Heart,2011-03-31,2011,0,0,0,1.424099
67794,Heat and Dust,1983-01-01,1983,0,0,0,0.090019
67809,Normal,2003-01-21,2003,0,0,0,4.898537
67810,Hard,1998-06-22,1998,0,264,264,0.082495
67822,Rituals,1977-07-21,1977,0,0,0,0.912787
67840,Classic Albums: The Who - Who's Next,1999-10-21,1999,0,0,0,0.073418
67844,The 2000 Year Old Man,1975-01-11,1975,0,0,0,0.06664
67846,Richard Jeni: A Big Steaming Pile of Me,2005-06-14,2005,0,0,0,0.002353
67849,Break Up,1998-08-20,1998,0,0,0,1.76
67852,Space Tourists,2010-06-01,2010,0,0,0,0.208747
67857,The Mindscape of Alan Moore,2003-08-24,2003,0,0,0,0.544176
67866,Guyana Tragedy: The Story of Jim Jones,1980-04-15,1980,0,0,0,0.206933
67869,"Sport, Sport, Sport",1970-06-06,1970,0,0,0,0.706966
67880,Four Daughters,1938-08-09,1938,0,0,0,0.724273
67883,Street People,1976-03-30,1976,0,0,0,1.43964
67884,Chinese Take-Out,2011-03-24,2011,5000000,0,-5000000,3.843784
67885,Bobby Fischer Against the World,2011-06-06,2011,0,0,0,2.234857
67899,Thick as Thieves,1999-04-09,1999,0,0,0,1.245812
67900,Scooby-Doo! Legend of the Phantosaur,2011-09-06,2011,0,0,0,3.606081
67908,Programming The Nation?,2011-08-19,2011,0,0,0,0.117849
67911,Bucky Larson: Born to Be a Star,2011-09-09,2011,10000000,0,-10000000,3.640776
67913,The Guard,2011-07-07,2011,6000000,19560274,13560274,11.256636
67927,Sunshine Follows Rain,1946-12-26,1946,0,0,0,0.100481
67941,Max & Co,2007-09-08,2007,0,0,0,0.42801
67952,Kathleen Madigan: Gone Madigan,2010-12-17,2010,0,0,0,0.246567
67958,"SuperManager, or Hack of the Fate",2011-05-19,2011,0,400134,400134,0.864913
67962,A Slipping Down Life,1999-01-22,1999,0,0,0,0.407378
67967,The Gang's All Here,1943-12-24,1943,0,0,0,0.241028
67977,I Just Want to Kiss You,1998-01-01,1998,0,0,0,0.102491
67988,Curse of the Wolf,2006-01-01,2006,0,0,0,0.119542
68004,Center Stage,1991-11-29,1991,0,0,0,1.463427
68013,Week-End in Havana,1941-10-17,1941,0,0,0,0.282366
68016,Aadukalam,2011-01-14,2011,4000000,6000000,2000000,0.372987
68023,Beaumarchais the Scoundrel,1996-03-20,1996,0,0,0,0.398703
68029,Double Dhamaal,2011-06-24,2011,0,0,0,1.387143
68044,Paperback Hero,1999-03-25,1999,0,1369280,1369280,0.759048
68047,Los Marziano,2011-04-10,2011,0,0,0,0.092413
68048,FLicKeR,2009-07-14,2009,0,0,0,0.01239
68050,Copkiller,1983-03-15,1983,0,0,0,0.416434
68053,Slap the Monster on Page One,1972-10-19,1972,0,0,0,0.035742
68063,Questa notte √® ancora nostra,2008-03-19,2008,0,0,0,1.084856
68064,Flash Gordon Conquers the Universe,1940-04-09,1940,0,0,0,1.062163
68078,Broadway to Cheyenne,1932-09-10,1932,0,0,0,0.001402
68097,Mohawk,1956-04-01,1956,0,0,0,1.817021
68098,Menolippu Mombasaan,2002-09-06,2002,1800000,0,-1800000,0.361054
68115,Terminal Justice,1996-04-01,1996,0,0,0,0.436341
68116,Incubus,2006-06-06,2006,0,0,0,1.194126
68123,Boarding School,1978-04-14,1978,0,0,0,0.97855
68139,Endgame,2000-09-10,2000,0,0,0,0.011746
68143,Dick Tracy vs. Cueball,1946-12-18,1946,0,0,0,0.477524
68146,Man from Deep River,1972-08-07,1972,0,0,0,4.578016
68163,The Hidden II,1993-09-06,1993,0,0,0,0.068859
68170,The Last September,2000-04-28,2000,0,0,0,0.041845
68173,Jungle Freaks,1969-09-03,1969,0,0,0,0.377849
68174,Waking Madison,2011-05-02,2011,0,0,0,0.900425
68178,Omar Killed Me,2011-06-21,2011,0,0,0,1.509963
68179,Escape from Planet Earth,2013-02-14,2013,40000000,74597643,34597643,11.617481
68180,"I, Zombie: The Chronicles of Pain",1998-01-01,1998,0,0,0,0.428261
68184,Cougar Hunting,2011-04-22,2011,5500000,0,-5500000,1.486976
68189,Man Exposed,2006-02-15,2006,0,0,0,0.221628
68190,Ralliraita,2009-06-16,2009,0,0,0,0.188832
68191,The Student Prince,1954-06-15,1954,0,0,0,0.545476
68192,Cabbages and Kings,1978-06-06,1978,0,0,0,0.035723
68193,The Perfect Teacher,2010-09-12,2010,0,0,0,5.959698
68197,Chasing Madoff,2010-11-19,2010,0,0,0,0.351217
68198,The Long and the Short and the Tall,1961-02-28,1961,0,0,0,0.583961
68200,Hot Coffee,2011-06-27,2011,0,0,0,0.718842
68202,Without Men,2011-06-29,2011,4,0,-4,0.915353
68208,Louis Theroux: A Place for Paedophiles,2009-07-07,2009,0,0,0,0.767274
68213,Louis Theroux: America's Medicated Kids,2010-04-18,2010,0,0,0,1.014495
68242,Doctor in the House,1954-03-23,1954,0,0,0,0.685924
68247,The Wrath of God,1972-07-14,1972,0,0,0,0.837091
68252,Haunters,2010-11-10,2010,0,0,0,2.77211
68256,Stanley Ka Dabba,2011-05-13,2011,0,0,0,0.31392
68259,The Violin,2005-03-11,2005,0,0,0,1.589875
68271,Dream,1941-11-11,1941,0,0,0,0.348717
68274,Moonlight and Valentino,1995-09-29,1995,0,0,0,1.01115
68275,Special Features: Handsome,1983-12-22,1983,0,0,0,1.581873
68280,Requiem for a Killer,2011-06-01,2011,0,0,0,5.479873
68297,Hiroshima,2005-08-05,2005,0,0,0,1.127808
68309,The Wooden Horse,1950-10-16,1950,0,0,0,0.561225
68335,Now & Later,2009-02-18,2009,0,0,0,3.522927
68337,Doctor in Distress,1963-07-30,1963,0,0,0,1.381238
68339,Doctor at Sea,1955-01-01,1955,0,0,0,0.515608
68340,Doctor at Large,1957-03-26,1957,0,0,0,0.515824
68341,Cold Fish,2010-06-04,2010,0,0,0,3.764296
68347,Food of the Gods II,1989-05-18,1989,0,0,0,1.159883
68348,The Architecture of Doom,1989-10-13,1989,0,0,0,0.022252
68351,Sankofa,1993-05-28,1993,1000000,2691899,1691899,0.04586
68352,Sherlock Holmes: The Hound of the Baskervilles,1988-08-31,1988,0,0,0,1.831212
68360,Unspoken,2008-10-08,2008,0,0,0,0.225249
68365,The Life Of Buddha,2007-12-05,2007,4000000,0,-4000000,0.146255
68370,Doug Stanhope: Oslo - Burning the Bridge to Nowhere,2011-05-03,2011,10000,0,-10000,0.560842
68387,Bringing Ashley Home,2011-03-20,2011,0,0,0,0.538859
68412,3 Backyards,2010-01-01,2010,0,0,0,0.481907
68419,Anuvahood,2011-03-18,2011,1000000,0,-1000000,6.231965
68426,Get Bruce!,1999-01-01,1999,0,0,0,0.489067
68427,Daughters of the Dust,1991-09-10,1991,800000,0,-800000,1.09058
68429,"Go, Go Second Time Virgin",1969-01-01,1969,0,0,0,1.348411
68430,Paradise,1991-09-18,1991,34000000,18634643,-15365357,7.176726
68437,Svart Lucia,1992-12-11,1992,0,0,0,0.002841
68440,Watch on the Rhine,1943-08-27,1943,0,0,0,0.958211
68443,The Glass Menagerie,1950-09-28,1950,0,0,0,0.408682
68444,Blind,2007-02-08,2007,0,0,0,0.452244
68445,Cold Fever,1995-02-10,1995,0,0,0,0.494977
68450,The Art of Flight,2011-09-08,2011,0,0,0,3.128824
68472,House of the Rising Sun,2011-07-19,2011,1500000,0,-1500000,2.726267
68482,Tanya's Island,1980-12-05,1980,0,0,0,0.689222
68503,Paris by Night of the Living Dead,2009-01-20,2009,0,0,0,0.499516
68507,Jan Dara,2001-09-28,2001,0,0,0,1.776516
68528,Dr. Akagi,1998-05-17,1998,0,0,0,1.132806
68529,Kick the Moon,2001-06-23,2001,0,0,0,0.262952
68545,Intimate Relations,1996-01-01,1996,0,0,0,1.372838
68546,Cotton Mary,1999-01-01,1999,0,0,0,0.30869
68551,Shades,1999-10-19,1999,0,0,0,0.350875
68553,Siberiade,1979-06-06,1979,0,0,0,1.998944
68555,Death Note Relight 2: L's Successors,2009-10-07,2009,0,0,0,0.635941
68556,Days of Grace,2011-05-17,2011,0,0,0,1.350744
68569,Invincible,2001-01-01,2001,0,0,0,0.685649
68572,Possessed,2000-10-22,2000,0,0,0,0.289559
68590,Legacy of Rage,1986-12-20,1986,0,0,0,0.723855
68591,Snowglobe,2007-12-15,2007,0,0,0,0.755834
68623,Bullets Over Summer,1999-08-05,1999,0,0,0,0.16453
68629,Happy Here and Now,2002-06-08,2002,0,0,0,0.091066
68634,My Flesh My Blood,2009-06-19,2009,0,0,0,0.303624
68635,Women in Cellblock 9,1978-03-17,1978,0,0,0,1.055272
68636,Blacker than the Night,1975-12-25,1975,0,0,0,0.97968
68637,Ducoboo,2011-06-22,2011,0,0,0,3.582418
68646,Superprodukcja,2002-02-28,2002,0,0,0,0.053215
68649,Karate Girl,2011-02-05,2011,0,0,0,0.716156
68659,The Horsemen,1971-08-16,1971,0,0,0,0.000844
68663,Guilty Hearts,2006-01-01,2006,0,0,0,0.887398
68684,Detention,2011-03-16,2011,10000000,0,-10000000,7.74967
68692,7 Women,1966-01-05,1966,0,0,0,0.999041
68701,Beetle Queen Conquers Tokyo,2009-03-01,2009,0,10068,10068,0.075409
68712,The Lazarus Papers,2009-12-31,2009,0,0,0,1.446887
68713,You Will Be My Son,2011-08-23,2011,0,0,0,1.958051
68715,Illusion of Blood,1965-07-25,1965,0,0,0,0.39949
68716,Venus & Vegas,2010-11-01,2010,0,0,0,0.859083
68718,Django Unchained,2012-12-25,2012,100000000,425368238,325368238,19.785025
68720,Tammy and the Doctor,1963-05-29,1963,0,0,0,0.241608
68721,Iron Man 3,2013-04-18,2013,200000000,1215439994,1015439994,23.721243
68722,The Master,2012-09-07,2012,32000000,28258060,-3741940,8.074218
68724,Elysium,2013-08-07,2013,115000000,286140700,171140700,15.232738
68726,Pacific Rim,2013-07-11,2013,180000000,407602906,227602906,33.949359
68727,Trance,2013-03-27,2013,20000000,24261569,4261569,7.876299
68728,Oz: The Great and Powerful,2013-03-07,2013,200000000,491868548,291868548,11.137329
68730,Silence,2016-12-22,2016,46000000,23737523,-22262477,14.16938
68732,White Wolves - A Cry in the Wild II,1993-12-31,1993,0,0,0,0.102036
68734,Argo,2012-10-11,2012,44500000,232324128,187824128,14.238234
68735,Warcraft,2016-05-25,2016,160000000,433677183,273677183,12.572718
68736,Joe Cocker - Mad Dogs & Englishmen,1971-08-27,1971,0,0,0,0.035284
68737,Seventh Son,2014-12-12,2014,95000000,114178613,19178613,15.297821
68744,Johnny Skidmarks,1998-01-18,1998,0,0,0,0.441113
68745,Dollar for the Dead,1998-01-01,1998,0,0,0,0.327614
68750,Rapid Fire,2006-01-01,2006,0,0,0,0.995223
68752,Judgment in Berlin,1988-01-01,1988,0,0,0,0.542289
68754,Under the Paris Sky,1951-03-28,1951,0,0,0,0.001177
68756,Comrades,1970-11-05,1970,0,0,0,0.002615
68757,City of Pirates,1984-02-22,1984,0,0,0,0.003013
68761,A Brooklyn State of Mind,1998-01-01,1998,0,0,0,0.322091
68773,Dollman,1991-11-27,1991,0,0,0,1.82974
68774,Eastern Drift,2010-12-01,2010,0,0,0,0.279821
68780,Lincz,2010-09-17,2010,0,0,0,0.26527
68797,The Quack,1982-04-12,1982,0,0,0,2.056565
68802,Friend of the Jolly Devil,1987-02-06,1987,0,0,0,0.000151
68806,The Escort,1993-01-01,1993,0,0,0,0.046196
68812,The Iceman,2012-09-01,2012,20000000,1969193,-18030807,13.132127
68816,Will Our Heroes Be Able to Find Their Friend Who Has Mysteriously Disappeared in Africa?,1968-12-19,1968,0,0,0,0.235106
68817,Footloose,2011-10-06,2011,24000000,63543328,39543328,6.162257
68818,Blackthorn,2011-08-31,2011,0,623528,623528,4.191928
68821,La notte brava,1959-11-12,1959,0,0,0,0.059818
68822,Casque d'Or,1952-04-16,1952,0,0,0,4.715268
68823,Come Play with Me,1968-01-01,1968,0,0,0,0.657498
68827,She Does Not Drink Smoke or Flirts but She Talks,1970-04-17,1970,0,0,0,0.000844
68828,Outlanders,1986-12-16,1986,0,0,0,0.136933
68849,The Man Who Could Work Miracles,1936-02-19,1936,0,0,0,0.513083
68850,Bitter Victory,1957-08-28,1957,0,0,0,4.126816
68861,Veijarit,2010-12-25,2010,0,0,0,0.239316
68863,The Heroin Busters,1977-08-13,1977,0,0,0,0.042847
68864,L'agression,1975-04-16,1975,0,0,0,0.885415
68865,The Amazons,1973-12-15,1973,0,0,0,1.498463
68876,32A,2007-07-13,2007,0,0,0,0.567032
68882,Quelle strane occasioni,1976-12-23,1976,0,0,0,0.155267
68883,Rouge,1987-01-07,1987,0,0,0,1.871935
68894,Shadow Magic,2000-09-08,2000,0,0,0,0.101444
68895,The King of the Kickboxers,1990-11-01,1990,0,0,0,1.107843
68922,Sword for Truth,1990-12-28,1990,0,0,0,0.103139
68924,The Ice Storm,1997-09-27,1997,18000000,8038061,-9961939,7.146352
68927,Born to Be Wild,1995-03-31,1995,0,0,0,1.315948
68954,Longitude,2000-01-13,2000,0,0,0,6.051227
68972,Claude Chabrol's High Heels,1972-09-29,1972,0,0,0,0.947798
68976,The Unknown Man,1951-11-16,1951,0,0,0,0.333586
68977,So Big,1953-10-21,1953,0,0,0,0.071544
68979,Dead Heat on a Merry-Go-Round,1966-10-12,1966,2000000,0,-2000000,1.300278
68981,Temptation of a Monk,1993-09-15,1993,0,0,0,0.103153
68982,Psychic Killer,1975-12-01,1975,0,0,0,0.009183
68987,Cooking With Stella,2010-03-19,2010,0,0,0,0.466178
69014,Tales of Ordinary Madness,1981-09-11,1981,0,0,0,1.244269
69016,Eve's Christmas,2004-12-06,2004,0,0,0,0.191866
69017,The Dancing Masters,1943-11-19,1943,0,0,0,0.438511
69019,The Amazing Mr. Bickford,1987-01-01,1987,0,0,0,0.174562
69022,Bipedalism,2005-05-02,2005,0,2800,2800,0.252171
69035,Ruby Cairo,1992-10-29,1992,0,0,0,1.238051
69040,Shy People,1987-05-01,1987,0,0,0,0.630259
69054,Slavoj ≈Ωi≈æek: The Reality of the Virtual,2004-03-23,2004,11,0,-11,0.037647
69056,Breathing Fire,1991-09-25,1991,0,0,0,0.109362
69058,Crescendo,1970-06-07,1970,0,0,0,0.008527
69059,Shark Zone,2003-10-14,2003,0,0,0,0.372454
69060,Ah√≠ est√° el detalle,1940-09-11,1940,0,0,0,1.707174
69061,Dr. Otto and the Riddle of the Gloom Beam,1986-04-09,1986,0,0,0,0.111171
69065,Deadfall,1968-09-11,1968,0,0,0,1.696445
69069,The Chant of Jimmie Blacksmith,1978-06-21,1978,1380000,0,-1380000,0.65296
69072,Sam Kinison: Family Entertainment Hour,1991-01-01,1991,0,0,0,1e-06
69075,Snakeman,2005-04-09,2005,1000000,0,-1000000,0.579663
69097,All Inclusive ili Vsyo Vklyucheno,2011-06-09,2011,0,0,0,0.523244
69103,Donald's Nephews,1938-04-15,1938,0,0,0,0.664346
69119,Larceny Inc.,1942-04-24,1942,0,0,0,0.322872
69120,Flower in the Pocket,2007-10-05,2007,0,0,0,0.054363
69129,Anonymous Rex,2004-11-19,2004,0,0,0,0.787374
69150,Chrome and Hot Leather,1971-09-29,1971,0,0,0,0.209517
69152,Escape from the Bronx,1983-09-02,1983,0,0,0,0.732103
69160,Hells Angels Forever,1983-10-09,1983,0,0,0,0.004974
69161,Heroes Shed No Tears,1986-09-05,1986,0,0,0,0.196391
69162,I Know What I Saw,2009-11-01,2009,0,0,0,0.080713
69165,New Year's Evil,1980-12-26,1980,0,0,0,0.518379
69166,A Perfect Fake,2005-04-15,2005,0,0,0,0.002494
69168,Stella: Live in Boston,2009-08-13,2009,0,0,0,0.050486
69169,Tattoo,1981-10-09,1981,0,0,0,0.803521
69204,Coney Island,1943-06-18,1943,0,0,0,0.003053
69214,Tricks,2007-10-26,2007,0,0,0,0.268886
69217,Black Cadillac,2003-01-01,2003,0,0,0,0.687207
69225,Switch,2011-06-04,2011,0,0,0,9.509765
69234,The Phantom of the Opera,1990-03-18,1990,10000000,0,-10000000,0.43849
69234,The Phantom of the Opera,1990-03-18,1990,10000000,0,-10000000,0.441872
69266,Special Bulletin,1983-03-20,1983,0,0,0,0.143994
69278,Phase 7,2011-07-13,2011,600000,0,-600000,1.985124
69292,The Creation of the Humanoids,1962-07-03,1962,0,0,0,0.3624
69299,Resistance,2003-07-16,2003,0,0,0,0.010317
69310,Beginning of the Great Revival,2011-01-01,2011,0,0,0,1.413762
69313,The Guitar Mongoloid,2004-10-01,2004,0,0,0,0.488422
69315,Battlestar Galactica: Razor,2007-12-18,2007,0,0,0,4.944294
69319,Mavi Boncuk,1974-01-01,1974,0,0,0,0.141288
69321,Pretty Maids All in a Row,1971-04-28,1971,0,0,0,4.216414
69324,Rain,2001-05-14,2001,0,0,0,0.18238
69325,Around June,2011-09-30,2011,0,0,0,0.06636
69326,Gothic & Lolita Psycho,2010-09-04,2010,0,0,0,0.644851
69328,How Wang-Fo Was Saved,1987-01-01,1987,0,0,0,0.004425
69335,Est√¥mago: A Gastronomic Story,2007-09-26,2007,0,0,0,1.756998
69342,The Dark Backward,1991-07-26,1991,0,0,0,0.669473
69346,Zeher,2005-03-25,2005,0,0,0,0.318265
69352,Our Grand Despair,2011-01-01,2011,0,0,0,0.573122
69353,Apnea,2010-11-06,2010,0,0,0,0.077316
69393,"Augusta, Gone",2006-03-01,2006,0,0,0,0.982213
69399,Citizen,2001-06-08,2001,500000,500000,0,0.233572
69401,Dheena,2001-01-14,2001,500000,500000,0,0.349478
69404,Mugavari,2000-02-02,2000,500000,500000,0,0.284847
69406,Rio Sex Comedy,2010-09-16,2010,0,0,0,0.851056
69407,Varalaru,2006-10-20,2006,500000,500000,0,0.482527
69417,Villan,2002-12-05,2002,500000,500000,0,0.45621
69422,Aasai,1995-09-25,1995,500000,500000,0,0.370114
69423,Kadhal Kottai,1996-07-12,1996,500000,500000,0,0.071908
69426,Kandukondain Kandukondain,2000-05-05,2000,500000,500000,0,0.660663
69427,Amarkalam,1999-08-25,1999,500000,500000,0,0.493342
69428,Vaali,1999-05-01,1999,500000,500000,0,0.509127
69471,Lecture 21,2008-01-01,2008,0,0,0,0.750919
69480,Tabloid,2010-10-01,2010,0,0,0,1.640733
69483,Julia Misbehaves,1948-08-08,1948,0,0,0,0.419679
69484,Winter Days,2003-11-21,2003,0,0,0,0.353259
69492,Borderline,2002-11-15,2002,3700000,0,-3700000,2.117171
69495,Lone Rider,2008-04-08,2008,0,0,0,0.932205
69499,Naan Kadavul,2009-02-06,2009,0,7500000,7500000,0.476025
69517,Death of a Corrupt Man,1977-12-07,1977,0,0,0,1.778116
69520,Pudhupettai,2006-05-26,2006,4000000,0,-4000000,0.056489
69526,The Assassination Bureau,1969-03-09,1969,0,0,0,6.833346
69535,Race to Mars,2007-09-23,2007,0,0,0,0.591676
69544,Secrets of Women,1952-11-03,1952,0,0,0,0.751652
69550,Kattradhu Thamizh,2007-10-06,2007,0,0,0,0.252479
69557,The Pumpkin Eater,1964-06-01,1964,0,0,0,0.442331
69559,Dead Times,1964-12-01,1964,0,0,0,0.474695
69560,Dying to Belong,1997-02-24,1997,0,0,0,0.226036
69569,Mark Strikes Again,1976-10-20,1976,0,0,0,8.2e-05
69576,Who Saw Her Die?,1972-05-12,1972,1000000,0,-1000000,0.132899
69578,What Have They Done to Your Daughters?,1974-08-10,1974,0,0,0,1.090186
69579,My Dear Killer,1972-02-03,1972,0,0,0,0.774628
69592,Iron Man,1951-08-18,1951,0,0,0,0.092891
69598,Paruthiveeran,2007-02-23,2007,0,0,0,0.309296
69599,Long Arm of the Law,1984-07-11,1984,0,0,0,0.979872
69605,Written on the Wind,1956-12-01,1956,0,0,0,1.949246
69610,Kapƒ±cƒ±lar Kralƒ±,1976-01-01,1976,0,0,0,0.584912
69619,The Detective 2,2011-05-12,2011,0,0,0,0.74913
69621,Counterstrike,2002-07-02,2002,0,0,0,0.894639
69635,Sillunu Oru Kaadhal,2006-09-08,2006,0,0,0,0.906853
69636,Ghajini,2005-10-14,2005,3200000,0,-3200000,0.802284
69638,Pithamagan,2003-10-24,2003,0,0,0,0.520341
69668,Dream House,2011-09-30,2011,50000000,38502340,-11497660,9.995617
69696,What Remains,2005-01-01,2005,1000000,0,-1000000,0.043363
69716,The Earthling,1980-07-24,1980,0,0,0,0.006964
69717,Ways to Live Forever,2010-10-29,2010,0,0,0,2.287183
69722,Songwriter,1984-10-14,1984,0,0,0,0.038639
69727,Final Justice,1988-06-23,1988,0,0,0,0.350875
69735,Batman: Year One,2011-09-27,2011,0,0,0,5.031094
69740,Smoorverliefd,2010-12-08,2010,0,0,0,0.148966
69746,The String,2009-05-12,2009,0,0,0,1.394477
69765,Orders,1974-09-27,1974,0,0,0,0.002001
69775,Murder 2,2011-07-08,2011,0,0,0,1.488908
69778,A Good Old Fashioned Orgy,2011-09-02,2011,0,0,0,5.059544
69780,The Beach Girls and the Monster,1965-01-01,1965,0,0,0,0.358309
69784,Anne of the Indies,1951-10-18,1951,0,0,0,0.589217
69785,Shaitan,2011-06-01,2011,0,0,0,0.645457
69787,Sharpe's Eagle,1993-05-12,1993,0,0,0,1.683858
69792,Love Birds,2011-02-24,2011,0,0,0,1.386526
69794,Small Town Murder Songs,2010-09-14,2010,0,0,0,1.226856
69798,The Inbetweeners Movie,2011-08-19,2011,0,88025781,88025781,5.747681
69803,Mayor Cupcake,2011-07-19,2011,0,0,0,1.268691
69828,Breaking In,1989-10-13,1989,0,0,0,0.418753
69841,Swineherd and Shepherd,1941-06-06,1941,0,0,0,0.036592
69846,Manhunt,1976-02-11,1976,0,0,0,0.191082
69847,Wing and a Prayer,1944-01-01,1944,0,0,0,0.125698
69848,One Man's Hero,1999-08-02,1999,0,0,0,0.996778
69850,The Mystic Masseur,2001-01-01,2001,0,0,0,0.123276
69851,The Grandfather,1998-10-16,1998,0,0,0,0.81126
69870,The Sender,1982-10-22,1982,0,0,0,0.000578
69872,Your Vice is a Locked Room and Only I Have the Key,1972-08-04,1972,0,0,0,2.095122
69878,Harvest,2011-03-11,2011,0,0,0,0.966593
69895,Stefano Quantestorie,1993-05-26,1993,0,0,0,0.036699
69898,The Karen Carpenter Story,1989-01-01,1989,0,0,0,0.713962
69899,The Mitten,1967-06-06,1967,0,0,0,0.835344
69903,The Greatest,1977-05-17,1977,0,0,0,0.422303
69912,The Taking of Power by Louis XIV,1966-10-08,1966,0,0,0,0.598802
69915,Sikumi (On The Ice),2008-01-01,2008,0,0,0,0.130241
69917,Room,2005-04-01,2005,0,0,0,0.117059
69921,Dazzle,1999-10-10,1999,0,0,0,0.650763
69928,The Man Who Loved Women,1983-12-18,1983,19000000,11000000,-8000000,5.214505
69974,The Sea That Thinks,2000-12-20,2000,0,0,0,0.188306
69976,Glukhar v kino,2010-05-06,2010,2500000,1477030,-1022970,0.209434
69977,Torpedo Run,1958-10-24,1958,0,0,0,0.698957
69985,The Cat Vanishes,2011-04-21,2011,0,0,0,0.207875
69990,Bejewelled,1991-01-20,1991,0,0,0,0.000739
69999,Absolute Aggression,2004-02-17,2004,0,0,0,0.037647
70005,Cafe,2011-10-11,2011,0,0,0,2.427612
70006,Never Back Down 2: The Beatdown,2011-09-13,2011,3000000,0,-3000000,7.964291
70008,Tactical Force,2011-08-09,2011,8400000,0,-8400000,3.015625
70009,The River Murders,2011-06-30,2011,0,0,0,9.097032
70011,Human Highway,1982-09-10,1982,0,0,0,0.478192
70026,Falling From Grace,1992-02-21,1992,3,232,229,1e-06
70027,The Wrecking Crew,2008-03-11,2008,0,0,0,4.34739
70042,Theremin: An Electronic Odyssey,1994-01-29,1994,0,0,0,0.113788
70044,The Scouting Book for Boys,2009-01-01,2009,0,0,0,0.674886
70046,Grave Secrets: The Legacy of Hilltop Drive,1992-03-02,1992,0,0,0,0.572073
70051,U.S. Seals,2000-01-18,2000,0,0,0,0.149997
70054,Girls Can't Swim,2000-10-18,2000,0,0,0,1.557804
70057,Dragon,2011-07-04,2011,0,0,0,3.688285
70061,On the Trail of the Bremen Town Musicians,1973-02-02,1973,0,0,0,0.425523
70069,Doomed,2007-01-06,2007,0,0,0,0.074804
70074,Bullet to the Head,2013-01-31,2013,55000000,9489829,-45510171,8.26008
70086,George Carlin - On Location at USC,1977-01-01,1977,0,0,0,0.855637
70089,Comet in Moominland,1992-08-08,1992,0,0,0,2.164527
70090,The Pearls of the Crown,1937-05-12,1937,0,0,0,0.416902
70104,A Killer Among Friends,1992-12-08,1992,0,0,0,0.050606
70113,Tokyo Joe,1949-10-26,1949,0,0,0,0.799256
70115,Machete Maidens Unleashed!,2010-10-15,2010,0,0,0,0.943453
70119,Le roman de Georgette,2003-01-01,2003,0,0,0,0.037648
70121,First Target,2000-01-01,2000,0,0,0,0.734755
70122,"Arabella, the Pirate's Daughter",1983-08-22,1983,0,0,0,0.136951
70131,Cruel Winter Blues,2006-11-19,2006,0,0,0,1.143786
70133,Sharpe's Rifles,1993-05-05,1993,0,0,0,1.591882
70149,Morgen,2010-10-01,2010,0,0,0,0.141908
70151,Johnny Stool Pigeon,1949-09-22,1949,0,0,0,0.344184
70160,The Hunger Games,2012-03-12,2012,75000000,691210692,616210692,20.031667
70172,Still Not Quite Human,1992-01-01,1992,0,0,0,0.175059
70177,Secrets of the Summer House,2008-01-01,2008,0,0,0,0.121553
70190,Scarred City,1999-07-23,1999,0,0,0,0.385951
70191,The Good Guys and the Bad Guys,1969-11-19,1969,0,0,0,0.882141
70192,Count Three and Pray,1955-10-01,1955,0,0,0,0.179491
70193,Hazard,2005-11-05,2005,0,0,0,0.455885
70196,The Veteran,2011-04-29,2011,0,0,0,2.482198
70199,Dead of Winter,1987-02-06,1987,0,2413427,2413427,0.096403
70202,Patty Hearst,1988-09-23,1988,0,0,0,0.646504
70207,The Crooked E: The Unshredded Truth About Enron,2003-01-05,2003,0,0,0,0.085047
70224,The Curse of the Oily Maniac,1956-01-01,1956,0,0,0,0.002449
70247,Watchers II,1990-08-16,1990,0,0,0,0.487334
70259,The Fortune,1975-05-20,1975,0,0,0,1.349807
70264,Fly Away,2011-07-17,2011,0,0,0,0.151612
70278,Where Souls Go,2007-01-01,2007,0,0,0,0.038832
70282,The Visit,2000-01-01,2000,0,0,0,0.001712
70313,Bowery to Bagdad,1955-01-07,1955,0,0,0,0.409838
70322,Gamera vs. Zigra,1971-07-17,1971,0,0,0,0.598895
70324,The Trap,1959-01-28,1959,0,0,0,0.142274
70327,Gamera vs. Jiger,1970-03-21,1970,0,0,0,0.006668
70338,"A Fairly Odd Movie: Grow Up, Timmy Turner!",2011-07-09,2011,0,0,0,3.694115
70342,Beats Rhymes & Life: The Travels of A Tribe Called Quest,2011-07-08,2011,0,0,0,0.838919
70345,Sssssss,1973-07-06,1973,0,0,0,2.283113
70349,Beauty and the Beast,1978-03-01,1978,0,0,0,2.936378
70351,Mirror Mirror,1990-10-19,1990,0,0,0,1.267372
70366,"Master, Mistress, Servant",1962-01-01,1962,0,0,0,0.101058
70368,The Cheat,1915-12-13,1915,17311,137365,120054,0.680407
70374,Little Criminals,1995-01-01,1995,0,0,0,0.577649
70386,The Devil's Rock,2011-07-08,2011,0,0,0,4.422049
70387,A Man Called Sledge,1970-11-14,1970,0,0,0,1.360791
70404,First Shot,2002-08-11,2002,0,0,0,0.478751
70410,The Public Woman,1984-06-16,1984,0,0,0,3.449936
70412,Blind Woman's Curse,1970-06-20,1970,0,0,0,0.903342
70417,Borrowed Hearts,1997-11-30,1997,0,0,0,1.307312
70418,Wasted on the Young,2010-06-13,2010,0,0,0,1.948284
70422,The Lickerish Quartet,1970-10-13,1970,0,0,0,0.704667
70423,CrissCross,1992-05-08,1992,0,0,0,0.015894
70435,Haywire,2011-11-06,2011,23000000,33372606,10372606,9.574817
70436,The Raven,2012-03-09,2012,26000000,29657751,3657751,7.254242
70443,Safe Conduct,2002-01-09,2002,0,0,0,0.47396
70447,Louisiana Story,1948-09-28,1948,258,0,-258,0.901723
70448,All About Evil,2010-05-01,2010,0,0,0,1.112225
70449,My Wife's Husband,1963-09-01,1963,0,0,0,0.534559
70457,Small Gods,2007-09-01,2007,0,0,0,0.003861
70461,IP5: The Island of Pachyderms,1992-06-12,1992,0,0,0,0.000578
70476,Gracie's Choice,2004-01-12,2004,0,0,0,1.049284
70489,Zebrahead,1992-10-23,1992,0,0,0,0.506589
70490,Massacre Mafia Style,1974-12-19,1974,0,0,0,1.008279
70498,A Fine Madness,1966-06-29,1966,0,0,0,0.25025
70500,Prisoners of the Lost Universe,1983-08-15,1983,0,0,0,0.839441
70503,Crepuscule,2009-04-02,2009,0,0,0,0.017926
70512,L'inferno,1911-07-01,1911,0,0,0,0.801412
70527,A Little Night Music,2002-01-01,2002,200000,286000,86000,0.164585
70530,A Chinese Ghost Story,2011-04-21,2011,0,0,0,0.820611
70546,Living in Emergency: Stories of Doctors Without Borders,2008-08-29,2008,2,0,-2,0.051896
70553,Sleepaway Camp IV: The Survivor,1992-03-22,1992,0,0,0,0.157014
70554,Adopt a Sailor,2008-10-24,2008,300000,0,-300000,0.508823
70555,The Indian Tomb,1959-01-22,1959,0,0,0,1.277919
70569,The Windmill Movie,2008-10-05,2008,0,0,0,0.045825
70570,Neshoba,2010-08-15,2010,0,0,0,0.005892
70573,Faithfully Yours,1988-12-17,1988,0,0,0,0.177579
70575,Children of the Corn: Genesis,2011-08-30,2011,0,0,0,2.112394
70577,Faces in the Crowd,2011-10-25,2011,15000000,0,-15000000,12.463435
70578,Trespass,2011-10-13,2011,36000000,9612469,-26387531,9.540381
70581,Heaven's Burning,1997-09-04,1997,0,0,0,0.467352
70583,Empty,2011-01-25,2011,0,0,0,0.30596
70584,Hellraiser: Revelations,2011-10-18,2011,350000,0,-350000,8.548411
70585,Lucky,2011-07-15,2011,0,0,0,8.954166
70586,Setup,2011-11-04,2011,20000000,2128186,-17871814,4.850968
70587,Spooky Buddies,2011-09-20,2011,0,0,0,7.335001
70588,The Myth of the American Sleepover,2010-05-17,2010,0,0,0,9.256321
70590,Singham,2011-07-22,2011,3062000,25034000,21972000,2.07741
70591,For Love of Ivy,1968-07-17,1968,0,0,0,0.037519
70609,Schoolgirl Report Part 5: What All Parents Should Know,1973-04-13,1973,0,0,0,3.484932
70627,Ransom,1975-03-13,1975,0,0,0,2.168976
70635,The Whisperers,1967-07-31,1967,0,0,0,0.470596
70636,Ghost from the Machine,2010-01-01,2010,0,0,0,0.512435
70648,Gravehopping,2005-06-06,2005,0,0,0,0.16687
70656,Imagination,2008-02-26,2008,110000,0,-110000,0.006919
70665,Flatland: The Film,2007-01-14,2007,0,0,0,0.454686
70666,VIPs,2011-03-25,2011,0,0,0,3.734767
70667,Kon-Tiki,2012-08-24,2012,16600000,0,-16600000,7.83072
70668,An Ox's Tale: The John Entwistle Story,2006-08-22,2006,0,0,0,0.003545
70669,Dark Souls,2011-01-14,2011,0,0,0,0.679519
70670,Headhunters,2011-08-04,2011,0,15699707,15699707,9.070215
70687,The Sticky Fingers of Time,1997-06-06,1997,250000,0,-250000,0.623073
70690,Cinderella '80,1984-02-16,1984,0,0,0,1.682096
70695,Dirty Girl,2010-09-12,2010,4000000,55125,-3944875,10.964499
70702,Dick Tracy Meets Gruesome,1947-09-26,1947,0,0,0,0.317036
70703,The Captains,2011-07-22,2011,0,0,0,9.58239
70706,Very Good Girls,2013-01-22,2013,0,0,0,12.32849
70709,Ruby,1992-03-27,1992,0,0,0,0.289508
70712,Te presento a Laura,2010-10-29,2010,0,0,0,1.586898
70734,The White Sister,1923-09-05,1923,0,0,0,0.158491
70736,A Bird of the Air,2011-09-23,2011,0,0,0,2.018721
70738,Midnight Mary,1933-06-30,1933,0,0,0,0.228547
70740,Goblin,2010-07-13,2010,0,0,0,2.541932
70747,Huacho,2009-05-14,2009,0,0,0,0.145888
70748,Uma Onda no Ar,2002-09-06,2002,0,0,0,0.003374
70752,The Sandman,2011-01-18,2011,0,0,0,0.624494
70753,Stella Maris,1918-01-21,1918,0,0,0,0.310636
70757,Alive and Ticking,2011-07-07,2011,0,0,0,0.993068
70758,"Hey, Boo: Harper Lee & To Kill a Mockingbird",2011-05-13,2011,0,26488,26488,0.007294
70772,Don't Look Under the Bed,1999-10-09,1999,0,0,0,2.323756
70779,The American Nightmare,2000-09-11,2000,0,0,0,0.309421
70793,Le grand soir,2012-06-06,2012,0,0,0,2.847953
70794,Empty Days,2000-02-21,2000,0,0,0,0.054167
70798,The Monster X Strikes Back: Attack the G8 Summit,2008-10-26,2008,0,0,0,0.202285
70800,The Outlaw and His Wife,1918-01-01,1918,0,0,0,0.343201
70801,Daddy-Long-Legs,1919-05-11,1919,0,0,0,0.346438
70803,Don't Change Your Husband,1919-01-26,1919,0,0,0,0.125202
70804,J'accuse!,1919-04-25,1919,0,0,0,0.834679
70805,Sunday,1997-08-27,1997,450,288,-162,0.29962
70806,Blind Husbands,1919-10-21,1919,42,0,-42,0.110308
70807,Eine Insel namens Udo,2011-06-16,2011,0,0,0,0.439169
70808,Klitschko,2011-06-15,2011,0,0,0,1.390327
70810,The Ghoul,1975-07-11,1975,0,0,0,1.148474
70811,Hercules in the Maze of the Minotaur,1994-11-19,1994,0,0,0,2.869197
70815,Caramuru: The Invention of Brazil,2001-11-09,2001,0,0,0,1.44664
70816,Posthumous Memories,2001-08-17,2001,0,0,0,0.270305
70821,Cyberbully,2011-07-16,2011,0,0,0,5.044201
70829,The Last Godfather,2010-12-29,2010,13400000,16700000,3300000,1.223071
70842,Salome's Last Dance,1988-05-06,1988,0,331000,331000,0.654549
70845,There's Something Wrong with Aunt Diane,2011-07-25,2011,0,0,0,1.03959
70846,Love & Pop,1998-09-01,1998,0,0,0,1.561896
70859,Wild Palms,1993-05-16,1993,0,0,0,0.8721
70862,American Grindhouse,2010-03-13,2010,0,0,0,9.201047
70863,Poolboy - Drowning Out the Fury,2011-07-22,2011,0,0,0,0.865039
70864,The Day the Sky Exploded,1958-09-04,1958,0,0,0,0.247647
70868,I Don't Know How She Does It,2011-09-16,2011,24000000,30551495,6551495,6.562982
70872,Warning from Space,1956-01-29,1956,0,0,0,0.280851
70874,Do Not Leave...,1989-12-06,1989,0,0,0,0.423116
70875,The Harvest (La Cosecha),2011-07-29,2011,56000,0,-56000,0.040737
70876,Seven Days in Utopia,2011-09-02,2011,0,0,0,1.175587
70877,Inside Out,2011-09-27,2011,0,0,0,2.257677
70878,Mimesis,2011-10-07,2011,0,0,0,1.216599
70881,Anna Karenina,1935-08-30,1935,1152000,1439000,287000,1.810574
70903,Mata Hari,1985-09-05,1985,0,0,0,0.84617
70912,The Advocate,1993-09-25,1993,0,667,667,0.477374
70916,The Lovers,1994-08-13,1994,0,0,0,1.575491
70917,The Scenesters,2009-08-31,2009,0,0,0,0.075993
70925,Oranges and Sunshine,2010-10-08,2010,0,0,0,5.829953
70926,Islands in the Stream,1977-03-09,1977,0,0,0,0.362604
70934,Billy's Holiday,1995-07-26,1995,0,0,0,0.002444
70939,Allyson Is Watching,1999-08-31,1999,0,0,0,0.038659
70954,The Hunter,2011-10-06,2011,0,176669,176669,10.265386
70955,Backstage,2005-11-16,2005,0,0,0,0.198165
70965,Kuka,2007-11-29,2007,0,0,0,0.655728
70966,Courier,1986-06-06,1986,0,0,0,0.10673
70967,Last Known Address,1970-07-25,1970,0,0,0,0.057547
70971,Four Friends,1981-12-11,1981,0,0,0,0.337021
70981,Prometheus,2012-05-30,2012,130000000,403170142,273170142,16.624854
70984,"Silent Night, Deadly Night 5: The Toy Maker",1991-11-06,1991,0,0,0,1.240357
70988,Yuddham Sei,2011-02-04,2011,0,0,0,0.986974
70989,Forgive Me,2006-11-22,2006,0,0,0,0.524187
70993,Man at Bath,2010-09-21,2010,0,0,0,0.956317
71002,Slogan,1969-07-27,1969,0,0,0,2.07075
71010,Purpose,2002-02-21,2002,0,0,0,0.557885
71016,The Return of Captain Invincible,1983-01-01,1983,5,0,-5,0.836124
71031,Wound,2010-07-26,2010,0,0,0,0.239349
71034,Convicts,1991-01-01,1991,0,0,0,0.456911
71041,The Tiger of Eschnapur,1959-01-22,1959,0,0,0,1.455458
71051,Sportloto-82,1982-06-06,1982,0,0,0,0.649651
71055,The African,1983-10-22,1983,0,0,0,0.500009
71063,The Flying Dutchman,1995-05-11,1995,0,0,0,0.07594
71064,Dhund: The Fog,2003-02-21,2003,0,0,0,0.003396
71065,The Last of the Mohicans,1920-11-21,1920,0,0,0,0.264565
71066,Robin Hood,1922-08-18,1922,0,0,0,0.611926
71067,Tess of the Storm Country,1922-11-12,1922,0,0,0,0.126258
71068,The Iron Horse,1924-08-24,1924,0,0,0,0.990037
71072,Crime Zone,1989-03-31,1989,0,0,0,0.015817
71097,Bibi,1974-05-10,1974,0,0,0,1.01888
71098,Jitterbugs,1943-06-05,1943,0,0,0,0.903358
71099,Charms For the Easy Life,2002-08-18,2002,0,0,0,0.014062
71103,Old Man Khottabych,1956-06-06,1956,0,0,0,0.805339
71110,In The City,2003-11-07,2003,0,0,0,0.22271
71114,Cleopatra,2003-08-14,2003,0,0,0,0.691817
71117,Woman of Water,2002-09-12,2002,0,0,0,0.151743
71118,Felicidades,2000-09-07,2000,0,0,0,0.053278
71120,Final Impact,1992-02-07,1992,0,0,0,1e-06
71125,Fool for Love,1985-12-06,1985,0,0,0,0.830943
71133,"Tot√≤, Peppino and... the Sweet Life",1961-03-23,1961,0,0,0,0.55459
71134,Innocent Lies,1995-06-30,1995,0,0,0,0.402104
71138,Female Prisoner #701: Scorpion,1972-08-01,1972,0,0,0,2.660108
71139,Jam,2007-07-03,2007,0,0,0,0.055485
71140,Hear No Evil,1993-03-26,1993,0,0,0,0.095663
71142,One Good Cop,1991-05-03,1991,0,0,0,3.167139
71145,Boo to You Too! Winnie the Pooh,1996-01-01,1996,0,0,0,0.121415
71147,The Triangle,2001-08-13,2001,0,0,0,0.370855
71157,Polisse,2011-10-06,2011,0,20374201,20374201,8.98296
71171,23 Paces to Baker Street,1956-05-18,1956,0,0,0,1.963778
71181,Bullies,1986-08-29,1986,0,0,0,0.984959
71184,When Love Is Not Enough: The Lois Wilson Story,2010-04-25,2010,0,0,0,1.25742
71186,The Rifleman of the Voroshilov Regiment,1999-04-19,1999,0,0,0,2.104629
71189,"Where Angels Go, Trouble Follows",1968-04-10,1968,0,0,0,1.088001
71191,La Planque,2011-09-06,2011,0,0,0,2.391658
71200,Snake Eater,1989-02-22,1989,0,0,0,0.481576
71203,Agenda Grinding America Down,2010-09-03,2010,0,0,0,0.499054
71204,Tempted,2001-01-01,2001,0,0,0,1.004122
71206,Adios Sabata,1970-09-30,1970,0,0,0,1.239092
71208,Judas Kiss,2011-04-01,2011,500000,0,-500000,1.169235
71209,Warm Summer Rain,1989-04-24,1989,0,0,0,0.004425
71243,Flat Top,1952-10-26,1952,0,0,0,0.575229
71254,Arena,2011-10-11,2011,10000000,0,-10000000,9.965719
71261,The Glamorous Life of Sachiko Hanai,2003-10-14,2003,0,0,0,0.798831
71266,Cleopatra,1912-11-13,1912,0,0,0,0.142542
71271,The Blue Bird,1918-03-31,1918,0,0,0,0.113705
71282,China Seas,1935-08-16,1935,0,0,0,5.272138
71288,Meant To Be,2010-04-24,2010,0,0,0,0.69168
71308,Ghayal,1990-06-08,1990,0,0,0,0.05556
71316,Nutcracker: The Motion Picture,1986-11-26,1986,0,0,0,0.330319
71317,Hamlet,1964-06-24,1964,0,0,0,1.383531
71320,Breaking Point,1976-06-02,1976,0,0,0,0.047467
71322,Platon,2008-11-28,2008,2500000,0,-2500000,0.371882
71325,With Every Heartbeat,2011-07-29,2011,0,0,0,5.96317
71326,Bunnyman,2011-06-20,2011,0,0,0,0.594855
71329,Yeelen,1987-01-01,1987,0,0,0,1.322729
71336,The Commissar,1967-06-06,1967,0,0,0,0.304732
71357,Lovesick,1983-02-18,1983,0,0,0,0.013577
71370,Trap,2007-10-27,2007,200000,0,-200000,0.038825
71373,Black Rainbow,1989-12-05,1989,7000000,0,-7000000,0.621116
71374,If I Die Before I Wake,2001-04-24,2001,0,0,0,0.115589
71376,Malicious,1995-11-06,1995,0,0,0,0.608031
71378,Stevie Nicks: Live at Red Rocks,1987-05-05,1987,0,0,0,0.341085
71381,The Heat,2006-12-28,2006,0,0,0,0.653279
71382,"Hello, We Are Your Cover!",2005-06-06,2005,0,0,0,0.405327
71392,Vampire Boys,2011-01-01,2011,0,0,0,0.220052
71393,Cold Summer of 1953,1988-12-03,1988,0,0,0,0.721771
71394,Dear Lemon Lima,2009-10-23,2009,0,0,0,0.619795
71395,Secret Ceremony,1968-10-23,1968,0,0,0,1.139297
71402,Coming Apart,1969-10-26,1969,0,0,0,0.186614
71436,Tol'able David,1921-12-31,1921,0,0,0,0.308298
71444,M.D. Geist,1986-08-13,1986,0,0,0,1.031808
71445,The Bay Boy,1984-09-06,1984,0,0,0,0.044383
71449,M.D. Geist II: Death Force,1996-03-12,1996,0,0,0,0.436949
71456,Bad Day on the Block,1997-08-22,1997,0,0,0,1.122814
71461,Thorne: Sleepyhead,2010-10-01,2010,0,0,0,1.609321
71469,The Darkest Hour,2011-12-22,2011,30000000,64626786,34626786,8.127392
71481,404: Error Not Found,2011-05-20,2011,0,0,0,0.113958
71482,Totally True Love,2011-02-25,2011,0,0,0,1.644328
71496,Le festin de la mante,2004-03-10,2004,0,0,0,0.128281
71503,Cries in the Night,1980-10-03,1980,0,0,0,1.143779
71506,Ringers - Lord of the Fans,2005-01-21,2005,0,0,0,0.361798
71507,Jailbait,2004-05-03,2004,0,0,0,0.640452
71508,The Taming of the Shrew,1980-10-23,1980,0,0,0,0.329193
71511,Medium Raw,2010-08-06,2010,1000000,0,-1000000,0.81999
71520,Last Woman on Earth,1960-08-05,1960,0,0,0,1.543461
71524,Ace of Aces,1982-10-27,1982,0,0,0,2.014981
71539,Ramones: Raw,2004-09-28,2004,0,0,0,0.041363
71543,Intimate Grammar,2010-09-23,2010,0,0,0,0.703027
71548,The Dead and the Damned,2011-07-26,2011,30000,0,-30000,0.248256
71552,American Reunion,2012-04-04,2012,50000000,234989584,184989584,8.10609
71559,Love Like Poison,2010-04-08,2010,2000000,0,-2000000,0.23091
71575,Entre Nos,2009-04-25,2009,0,0,0,0.392813
71576,Buenos Aires 100 KM,2005-02-10,2005,0,0,0,0.145419
71587,The Snowman,2009-11-19,2009,0,0,0,0.007473
71591,The Linguists,2008-01-17,2008,0,0,0,0.074112
71617,The Living and the Dead,2007-01-02,2007,0,0,0,1.421035
71620,Officer of the Year,2011-05-04,2011,0,0,0,0.815157
71622,Atrocious,2010-10-15,2010,0,0,0,4.194524
71623,The King's Whore,1990-11-14,1990,0,0,0,0.551122
71626,Don't Let Him In,2011-06-12,2011,1150000,0,-1150000,2.375399
71630,Le Ruffian,1983-01-12,1983,0,0,0,0.242037
71642,Time to Kill,1989-09-10,1989,0,0,0,0.188826
71662,Come Look at Me,2000-06-06,2000,0,0,0,0.546136
71665,Divina Confusi√≥n,2008-09-26,2008,0,0,0,0.106802
71668,Piranha 3DD,2012-05-11,2012,5000000,8493728,3493728,5.615205
71670,Hostel: Part III,2011-12-27,2011,6000000,0,-6000000,7.130411
71672,Wrong Turn 4: Bloody Beginnings,2011-10-17,2011,0,0,0,10.039999
71676,Ghost Rider: Spirit of Vengeance,2011-12-10,2011,57000000,149217355,92217355,9.421301
71677,Assassination Games,2011-07-28,2011,8000000,0,-8000000,11.050266
71679,Resident Evil: Retribution,2012-09-12,2012,65000000,240159255,175159255,0.948759
71687,My Life's in Turnaround,1994-06-17,1994,0,0,0,0.085025
71688,The Iron Lady,2011-12-30,2011,13000000,114956699,101956699,7.421245
71689,Phineas and Ferb the Movie: Across the 2nd Dimension,2011-08-05,2011,0,0,0,5.506221
71697,Ghost Chase,1987-06-25,1987,0,0,0,0.00222
71700,Repeaters,2010-01-01,2010,0,0,0,2.668794
71701,The Damned,1963-05-19,1963,0,0,0,3.153147
71704,Air Panic,2002-01-22,2002,0,0,0,0.809425
71714,"Luc√≠a, Luc√≠a",2003-01-17,2003,2750000,0,-2750000,0.831106
71719,I Am Waiting,1957-10-22,1957,0,0,0,0.367793
71720,The Rusty Knife,1958-01-01,1958,0,0,0,0.210451
71721,Il Capitano: A Swedish Requiem,1991-11-15,1991,0,0,0,0.000578
71722,Cruel Gun Story,1964-02-01,1964,0,0,0,0.082102
71723,Take Aim at the Police Van,1960-01-27,1960,0,0,0,0.707129
71725,Man Is Not a Bird,1965-03-06,1965,0,0,0,0.552623
71730,Watch the Shadows Dance,1987-01-01,1987,0,0,0,0.266017
71732,The Right of the Weakest,2006-07-19,2006,0,0,0,0.110417
71744,Eating Out: Drama Camp,2011-07-01,2011,0,0,0,1.198567
71750,Sleeping Beauty,1987-06-12,1987,0,0,0,0.842996
71754,Margaret's Museum,1995-09-13,1995,0,0,0,0.372697
71756,Chhoti Si Baat,1975-02-14,1975,0,0,0,0.694499
71762,Trial on the Road,1971-11-06,1971,0,0,0,1.522605
71763,Stealing Candy,2003-05-14,2003,0,0,0,2.753526
71767,Robbery at 3 O'clock,1962-12-10,1962,0,0,0,0.36273
71768,The Guns Of Fort Petticoat,1957-04-01,1957,0,0,0,1.248369
71769,Ice Bound - A Woman's Survival at the South Pole,2003-05-20,2003,0,0,0,0.345127
71771,Knuckle,2011-12-09,2011,0,0,0,1.213981
71772,Go West Young Man,1936-11-18,1936,0,0,0,0.476393
71776,Hospitals:The White Mafia,1973-08-25,1973,0,0,0,0.085964
71786,Fausto 5.0,2001-01-01,2001,0,0,0,0.397162
71805,Shipwrecked,1990-10-03,1990,0,0,0,0.792706
71809,Central Park,1990-04-01,1990,0,0,0,0.00022
71821,Mystics in Bali,1981-01-01,1981,0,0,0,0.560003
71822,The Mystery of Picasso,1956-05-18,1956,0,0,0,0.432432
71825,Mistress,1992-07-24,1992,0,1102469,1102469,1.60034
71827,Patriotism,1966-04-12,1966,0,0,0,1.027005
71839,The Moon Is Blue,1953-07-08,1953,0,0,0,0.691373
71841,Dangerously Close,1986-05-09,1986,0,2390525,2390525,0.004425
71847,Fast Food,1989-04-28,1989,0,0,0,0.002001
71848,Noise,2004-01-31,2004,0,0,0,0.039073
71859,We Need to Talk About Kevin,2011-09-28,2011,7000000,6038942,-961058,5.325574
71864,The Odd Life of Timothy Green,2012-08-15,2012,0,51854875,51854875,5.426921
71866,Tanner Hall,2009-09-14,2009,0,0,0,1.426803
71880,Jack and Jill,2011-11-11,2011,79000000,149673788,70673788,6.620033
71881,Five Corners,1987-09-11,1987,0,0,0,5.939428
71883,Redline,2009-08-14,2009,0,0,0,4.189873
71884,Model Behavior,2000-03-12,2000,0,0,0,1.058851
71885,Motocrossed,2001-02-16,2001,0,0,0,1.082428
71886,Tru Confessions,2002-04-05,2002,0,0,0,0.573647
71887,The Ultimate Christmas Present,2000-12-01,2000,0,0,0,2.563627
71905,Superheroes,2011-08-08,2011,0,0,0,1.516749
71910,Sitting Target,1972-06-19,1972,0,0,0,0.235578
71918,King,2008-12-25,2008,0,0,0,0.710538
71920,LOC: Kargil,2003-12-12,2003,0,0,0,0.108233
71921,Here We Go Round the Mulberry Bush,1968-01-22,1968,0,0,0,0.375375
71924,Henry VIII and His Six Wives,1972-07-13,1972,0,0,0,1.025219
71933,"O-Bi, O-Ba: The End of Civilization",1985-06-28,1985,0,0,0,0.010331
71940,The Ballad of Little Jo,1993-08-20,1993,0,0,0,1.049852
71943,House of Dark Shadows,1970-09-09,1970,750000,0,-750000,2.067663
71945,Night of Dark Shadows,1971-08-04,1971,900000,0,-900000,0.393231
71982,Streets of Laredo,1995-11-12,1995,0,0,0,0.780833
71984,Cottage to Let,1941-09-06,1941,0,0,0,0.160379
71990,The Strange World of Planet X,1958-03-04,1958,0,0,0,0.248199
71995,The Passionate Thief,1960-10-21,1960,0,0,0,0.15675
71996,Stunts,1977-06-01,1977,0,0,0,0.922906
72002,The Last Mile,1959-02-18,1959,0,0,0,0.522024
72003,The Dark Knight,2011-07-11,2011,0,0,0,0.077992
72013,Yu-Gi-Oh! 3D: Bonds Beyond Time,2010-01-23,2010,2017928,0,-2017928,0.933026
72024,Boobs: An American Obsession,2010-02-09,2010,0,0,0,0.425503
72026,Pleasures of the Flesh,1965-08-29,1965,0,0,0,1.029596
72031,The Glass Shield,1994-09-16,1994,0,0,0,1.012197
72032,Return of Sabata,1971-09-03,1971,245000,0,-245000,1.332751
72049,Black Butterflies,2011-02-06,2011,0,0,0,0.721192
72051,Garv: Pride and Honour,2004-07-09,2004,1300000,11000000,9700000,0.386315
72054,All for One,2011-02-10,2011,0,0,0,4.010861
72057,Sorelle Mai,2011-03-16,2011,0,0,0,0.360795
72066,Children...,2011-02-17,2011,0,0,0,1.23969
72074,Murderer,2009-07-09,2009,0,0,0,1.2061
72083,Death of a Cyclist,1955-05-08,1955,0,0,0,1.072649
72086,The Night Visitor,1971-01-01,1971,0,0,0,1.529024
72087,A Shot at Glory,2000-05-03,2000,0,0,0,2.104859
72091,Voyage to the Prehistoric Planet,1965-08-01,1965,0,0,0,0.561712
72093,The Adventures of Sherlock Holmes and Dr. Watson: Bloody Signature,1979-02-01,1979,0,0,0,0.711782
72094,Thorne: Scaredycat,2010-10-01,2010,0,0,0,2.385758
72095,Sherlock Holmes and Dr. Watson: Acquaintance,1979-01-01,1979,0,0,0,0.953298
72096,Bloodhounds of Broadway,1989-11-03,1989,4000000,0,-4000000,0.641979
72100,The Big Cube,1969-04-30,1969,0,0,0,0.157284
72103,Cry 'Havoc',1943-11-23,1943,0,0,0,0.338248
72105,Ted,2012-06-29,2012,50000000,549368315,499368315,19.638605
72111,The Ghost of Flight 401,1978-02-18,1978,0,0,0,0.398015
72113,Carnage,2011-09-16,2011,25000000,27603069,2603069,8.844835
72114,The Groundstar Conspiracy,1972-06-12,1972,0,0,0,0.607572
72123,Meat the Truth,2008-10-03,2008,0,0,0,0.09108
72140,A Grandpa for Christmas,2007-11-24,2007,0,0,0,0.328617
72152,Aarakshan,2011-08-12,2011,0,0,0,0.402087
72153,Virgin Witch,1972-06-08,1972,0,0,0,0.91024
72160,Yellowstone Kelly,1959-11-11,1959,0,0,0,0.39874
72163,Along Came Jones,1945-07-19,1945,0,0,0,0.906365
72172,Nora's Will,2008-10-06,2008,0,0,0,0.403236
72174,Doomsday Prophecy,2011-08-13,2011,0,0,0,2.436725
72178,One Night Only,1986-01-06,1986,0,0,0,0.004425
72183,The Keeper,1995-09-15,1995,0,0,0,0.199284
72185,Winnie the Pooh and Tigger Too,1974-09-20,1974,0,0,0,1.192837
72186,Thunder Soul,2010-03-13,2010,0,0,0,0.779376
72188,Noiseman Sound Insect,1997-01-01,1997,0,0,0,0.144065
72190,World War Z,2013-06-20,2013,200000000,531865000,331865000,26.114917
72197,The Pirates! In an Adventure with Scientists!,2012-03-12,2012,60000000,118338361,58338361,10.271517
72199,Bobik Visiting Barbos,1977-01-01,1977,0,0,0,0.050841
72203,Karlson Returns,1970-01-01,1970,0,0,0,0.804307
72204,A Flying Ship,1979-01-01,1979,0,0,0,0.099939
72205,The Fox and the Hare,1973-01-01,1973,0,0,0,1.353566
72207,The Five-Year Engagement,2012-04-27,2012,30000000,53909751,23909751,12.84554
72210,The Night Before Christmas,1951-01-01,1951,0,0,0,0.090544
72211,The Adventures of Buratino,1959-12-31,1959,0,0,0,0.667698
72213,Courageous,2011-09-30,2011,1000000,34522221,33522221,7.666558
72214,The Snow Queen,1957-10-22,1957,0,0,0,1.814736
72215,There Once Was a Dog,1982-01-01,1982,0,0,0,1.981912
72232,The King and Queen of Moonlight Bay,2003-06-15,2003,0,0,0,0.190112
72240,Odd Girl Out,2005-04-04,2005,0,0,0,1.400182
72241,Unconquered,1947-09-24,1947,0,0,0,1.637557
72245,The Piano in a Factory,2011-07-15,2011,0,0,0,0.5387
72246,"Sex, Lies and Death",2011-01-01,2011,0,0,0,0.110439
72251,Safe Harbor,2009-05-30,2009,0,0,0,0.668199
72268,We Can Be Heroes!,2002-03-26,2002,0,0,0,0.695844
72270,Cry Baby Lane,2000-10-28,2000,0,0,0,0.457114
72272,The Bridesmaid,2004-11-17,2004,0,0,0,0.656954
72277,The Last Wave,1977-01-01,1977,810000,1258000,448000,3.099222
72278,Bad Spelling,2004-11-03,2004,0,0,0,0.158954
72279,Madman at War,1985-08-14,1985,0,0,0,0.003553
72308,Shanghai Ghetto,2002-02-28,2002,0,0,0,0.009083
72309,Marquis de Sade: Justine,1969-04-03,1969,0,0,0,4.475666
72313,Gorilla at Large,1954-05-01,1954,0,0,0,0.680359
72317,True Blue,2001-11-29,2001,0,0,0,0.370335
72331,Abraham Lincoln: Vampire Hunter,2012-06-20,2012,69000000,112265139,43265139,7.922636
72334,Chimpanzee,2012-04-20,2012,0,0,0,5.583996
72338,Frisco Jenny,1932-12-30,1932,0,0,0,0.411674
72340,Partners,1982-04-30,1982,0,0,0,0.408723
72354,Sunrise at Campobello,1960-09-28,1960,0,0,0,0.142145
72356,Sade,2000-08-23,2000,0,0,0,1.254068
72358,A Thousand Words,2012-03-07,2012,40000000,22044277,-17955723,5.446745
72359,Peeples,2013-05-09,2013,15,0,-15,8.043632
72363,I'm Staying,2003-10-01,2003,0,0,0,1.18741
72375,Rien sur Robert,1999-02-24,1999,0,0,0,0.277333
72386,Lenny Bruce in 'Lenny Bruce',1967-03-19,1967,0,0,0,0.036519
72387,Safe,2012-04-16,2012,30000000,40346186,10346186,8.234382
72391,Marley & Me: The Puppy Years,2011-06-01,2011,0,0,0,9.495992
72394,The Ring,1996-10-20,1996,0,0,0,0.366982
72400,La Bandera,1935-09-25,1935,0,0,0,0.175334
72412,Brass Target,1978-12-22,1978,0,0,0,0.91779
72413,The Family Jewels,2004-01-22,2004,0,0,0,0.806664
72419,In jeder Sekunde,2008-12-11,2008,0,0,0,0.218835
72421,Marcel Reich-Ranicki - Mein Leben,2009-04-10,2009,0,0,0,0.291207
72431,Red Tails,2012-01-19,2012,58000000,50365377,-7634623,7.145835
72432,Puncture,2011-09-23,2011,0,68945,68945,4.363087
72440,Once Upon a Warrior,2011-01-14,2011,0,0,0,0.373199
72443,"Josee, the Tiger and the Fish",2003-12-13,2003,0,0,0,0.917899
72445,Boat People,1982-10-13,1982,0,0,0,0.294097
72447,The Last Run,1971-07-07,1971,0,0,0,0.726415
72449,The Carey Treatment,1972-03-29,1972,0,0,0,0.447201
72455,Walking Tall Part II,1975-09-28,1975,0,0,0,1.021878
72460,Harry in Your Pocket,1973-09-23,1973,0,0,0,0.845041
72465,Private Lessons,2008-02-04,2008,0,0,0,1.604897
72471,Thunder Over the Plains,1953-10-27,1953,0,0,0,0.002997
72472,Carson City,1952-06-13,1952,0,0,0,0.71879
72473,Belle Starr,1941-09-12,1941,0,0,0,0.974261
72474,Fort Worth,1951-07-14,1951,0,0,0,0.001489
72477,Texas Killing Fields,2011-10-14,2011,0,957240,957240,6.093938
72478,@Suicide Room,2011-03-04,2011,0,0,0,3.742632
72479,Lightning Strikes Twice,1951-04-12,1951,0,0,0,0.242861
72480,Poetical Refugee,2000-09-04,2000,0,0,0,0.803169
72483,The Twilight of the Golds,1996-03-22,1996,0,0,0,0.099879
72485,The True Meaning of Pictures: Shelby Lee Adams' Appalachia,2002-09-07,2002,0,0,0,0.002354
72490,Charisma,1999-11-10,1999,0,0,0,0.378648
72494,End of the Game,1975-08-31,1975,0,0,0,0.893905
72495,The Blue Light,1932-03-24,1932,0,0,0,0.28348
72505,Tomorrow's Joe,2011-02-11,2011,0,0,0,0.635622
72508,The New Kids,1985-01-18,1985,0,0,0,1.126088
72525,Syrup,2013-06-07,2013,6000000,0,-6000000,5.236985
72544,The Lost Moment,1947-11-21,1947,0,0,0,0.470053
72545,Journey 2: The Mysterious Island,2012-01-19,2012,79000000,355692760,276692760,9.46307
72551,Footnote,2011-05-25,2011,0,0,0,2.737615
72553,Salvador Allende,2004-09-08,2004,0,0,0,0.213073
72558,Children,2006-09-09,2006,0,0,0,0.321128
72559,G.I. Joe: Retaliation,2013-03-26,2013,130000000,371876278,241876278,10.560608
72560,Federal Bank Heist,2011-07-22,2011,0,0,0,1.346629
72570,The Vow,2012-02-05,2012,30000000,196114570,166114570,9.524298
72571,Paranormal Activity 3,2011-10-19,2011,5000000,205703818,200703818,10.996308
72574,Death Valley,1982-05-07,1982,0,0,0,0.740433
72585,Why Man Creates,1968-09-24,1968,0,0,0,0.260901
72589,3nity,2010-10-21,2010,0,0,0,1.079744
72592,Honey and Clover,2006-07-22,2006,0,0,0,0.796677
72596,Movie Days,1994-06-30,1994,0,0,0,0.141973
72602,Up the River,1930-10-12,1930,0,0,0,0.505703
72608,Doctor Bull,1933-09-22,1933,0,0,0,0.418583
72609,Steamboat Round the Bend,1935-09-06,1935,0,0,0,0.385059
72611,"Hello, I'm Your Aunt!",1975-12-26,1975,0,0,0,1.272531
72613,What Price Glory,1952-08-22,1952,0,0,0,0.690709
72614,"One-Two, Soldiers Were Going...",1976-06-06,1976,0,0,0,0.056391
72615,Exposed,1971-08-23,1971,0,0,0,3.449513
72638,The Fighting 69th,1940-01-27,1940,0,0,0,1.128251
72639,The Marseille Contract,1974-09-04,1974,0,0,0,0.786388
72640,The Old Mill,1937-11-05,1937,50663,0,-50663,1.628504
72642,Solitary,2009-03-29,2009,0,0,0,0.713014
72648,Devil Times Five,1974-05-31,1974,0,0,0,0.007963
72650,Punished,2011-05-05,2011,0,0,0,1.773603
72654,Parents,2007-01-19,2007,0,0,0,0.110061
72655,The Loner,1987-03-18,1987,0,0,0,0.965058
72660,I Don't Want to Go Back Alone,2010-07-18,2010,0,0,0,2.533384
72661,Ikingut,2000-01-01,2000,0,0,0,0.001179
72663,Nirvana,2008-07-03,2008,2000000,273137,-1726863,0.679141
72664,The Vultures,1984-03-28,1984,0,0,0,1.29863
72678,Henry,2010-03-31,2010,0,0,0,0.256054
72693,Master of the World,1961-05-01,1961,0,0,0,1.826348
72701,Camila Jam,2008-07-18,2008,0,0,0,0.485616
72710,The Host,2013-03-22,2013,44000000,63327201,19327201,11.342024
72711,The Interrupters,2011-07-29,2011,0,282448,282448,0.904932
72715,Lightning Bolt: The Power Of Salad,2002-06-28,2002,0,0,0,0.060326
72720,Hot Wheels Acceleracers: Ignition,2005-01-08,2005,0,0,0,1.914671
72721,Nostalgia for the Light,2010-10-27,2010,0,0,0,1.529266
72733,Bangkok Traffic Love Story,2009-10-15,2009,0,0,0,1.619762
72744,Pearl Jam: Twenty,2011-09-20,2011,0,0,0,2.649185
72750,Brasilintime: Batucada com Discos,2007-11-13,2007,0,0,0,0.177974
72753,Alley Cats Strike,2000-03-18,2000,0,0,0,0.920318
72754,Decadent Evil,2005-06-25,2005,0,0,0,0.318244
72766,Newlyweds,2011-12-26,2011,9000,0,-9000,1.090484
72767,Battleground,2012-01-01,2012,1000000,0,-1000000,1.648077
72784,The Loft,2014-10-14,2014,14000000,10076790,-3923210,14.443362
72785,The Flight of the Eagle,1982-08-26,1982,0,0,0,0.001393
72790,Ride or Die,2003-11-04,2003,0,0,0,2.29243
72808,The Flesh,1991-08-21,1991,0,0,0,0.21695
72809,Cosmic Journey,1936-01-21,1936,0,0,0,0.199107
72811,Winter Cherries,1985-10-21,1985,0,0,0,0.099798
72821,Mantrap,1926-07-24,1926,0,0,0,0.342271
72822,Ol√© !,2005-12-07,2005,0,0,0,1.12553
72823,The Miami Story,1954-05-03,1954,0,0,0,1.246358
72826,Legend of Dinosaurs and Monster Birds,1977-04-29,1977,0,0,0,0.012869
72834,Sweet Home,1989-01-21,1989,0,0,0,1.027139
72841,Last Call at the Oasis,2011-09-09,2011,0,0,0,0.17424
72842,Albatross,2011-10-14,2011,0,0,0,3.344002
72843,Pete Smalls Is Dead,2010-09-17,2010,6000000,0,-6000000,1.311545
72845,"The Man Nobody Knew: In Search of My Father, CIA Spymaster William Colby",2011-09-23,2011,0,0,0,0.548291
72847,The Unfaithful,1947-06-05,1947,0,0,0,0.98852
72850,Babes in Toyland,1997-01-01,1997,0,0,0,0.197168
72852,Hadewijch,2009-11-25,2009,4600000,0,-4600000,0.985596
72856,Hallelujah,1929-08-20,1929,0,0,0,0.080599
72857,Le Grand Chef 2: Kimchi Battle,2010-01-28,2010,0,0,0,0.156549
72867,Hellboy: The Seeds of Creation,2004-01-01,2004,0,0,0,0.297573
72872,Forever Hardcore: The Documentary,2005-02-15,2005,0,0,0,0.962386
72875,I Want to Be a Soldier,2010-10-14,2010,0,0,0,0.626486
72881,I Walk the Line,1970-11-18,1970,4000000,0,-4000000,0.775854
72882,Operation: Daybreak,1975-11-01,1975,0,0,0,3.273933
72886,Mortal Kombat: The Journey Begins,1995-08-28,1995,0,0,0,0.714715
72888,Truffaldino from Bergamo,1977-08-27,1977,0,0,0,0.22516
72890,Girl Most Likely,2012-09-07,2012,0,0,0,4.80745
72891,Euphoria,2006-02-11,2006,0,2209023,2209023,1.244254
72892,Air Crew,1979-05-19,1979,0,0,0,1.410027
72898,The Seven Deadly Sins,1962-03-07,1962,0,0,0,0.39275
72899,The Music Lovers,1970-12-01,1970,0,0,0,1.049339
72900,Manolito Four Eyes,1999-06-23,1999,0,0,0,0.647123
72901,Johnny Cool,1963-10-01,1963,0,0,0,0.243058
72903,The Midnight Story,1957-08-01,1957,0,0,0,0.410131
72912,Carjacked,2011-11-22,2011,0,0,0,2.418216
72913,Amigo,2010-07-14,2010,1200000,0,-1200000,1.202218
72914,"Fat, Sick & Nearly Dead",2010-04-16,2010,0,0,0,2.255345
72917,La Bande du drugstore,2002-04-17,2002,0,0,0,0.542408
72933,April Story,1998-03-14,1998,0,0,0,0.981129
72946,I Will Follow,2010-09-18,2010,0,0,0,0.482814
72949,September Vacation,1979-01-01,1979,0,0,0,0.747787
72951,Not Another Not Another Movie,2011-10-17,2011,4,0,-4,0.823401
72953,Devil's Bible,2008-12-14,2008,0,0,0,0.11052
72955,D√©j√† vu,1989-04-18,1989,0,0,0,0.231954
72958,The Clay Bird,2002-11-08,2002,0,0,0,0.591562
72962,George & A.J.,2009-11-10,2009,0,0,0,3.720354
72968,Vassilisa the Beautiful,1940-05-13,1940,0,0,0,0.099605
72972,Tom and Jerry & The Wizard of Oz,2011-08-23,2011,0,0,0,6.889644
72976,Lincoln,2012-11-09,2012,65000000,275293450,210293450,10.680331
72977,Soccer Dog 2: European Cup,2004-08-03,2004,0,0,0,0.180215
72984,Hansel and Gretel,1988-12-10,1988,0,0,0,1.15114
72985,Grandmother,2009-09-23,2009,0,0,0,0.723687
72987,A Soldier's Daughter Never Cries,1998-09-18,1998,0,1782005,1782005,0.85691
72993,The Crown Jewels,2011-06-29,2011,0,0,0,2.792745
72996,House of Fools,2002-12-06,2002,2500000,57862,-2442138,0.870645
72997,Skyscraper Souls,1932-07-16,1932,0,0,0,0.349394
73027,Across the Bridge,1957-08-20,1957,0,0,0,0.438243
73043,Kaidan,2007-08-04,2007,5000000,0,-5000000,0.819833
73059,Kozara,1962-05-15,1962,0,0,0,0.526429
73065,The Humanoid,1979-04-11,1979,0,0,0,0.205534
73066,Mad Bastards,2010-01-01,2010,0,0,0,0.13518
73067,Frankie Starlight,1995-11-22,1995,0,0,0,0.637554
73074,Our Tropical Island,2001-10-12,2001,0,0,0,0.729285
73077,Things from Another World,2011-09-03,2011,0,0,0,0.759802
73079,Clara's Heart,1988-10-07,1988,0,0,0,4.922454
73085,Wreckage,2010-01-01,2010,0,0,0,1.223968
73091,The Hanoi Hilton,1987-03-27,1987,0,760000,760000,0.390142
73094,The Fool of the World and the Flying Ship,1990-09-28,1990,0,0,0,0.001393
73098,Los Enchiladas!,1999-01-01,1999,0,0,0,0.191026
73099,August,2011-04-01,2011,1203000,0,-1203000,0.719147
73100,A Slave of Love,1976-09-27,1976,0,0,0,0.660643
73103,Dante's Inferno,2007-01-01,2007,0,0,0,0.587735
73108,Teen Spirit,2011-08-07,2011,0,0,0,5.641483
73116,Brimstone & Treacle,1982-10-01,1982,0,0,0,0.620534
73120,Red Heat,1985-05-28,1985,0,0,0,1.251952
73123,In Orange,2004-04-28,2004,0,0,0,0.485999
73128,"Bruc, the Manhunt",2010-12-22,2010,0,0,0,1.132569
73129,Johanna,2005-05-18,2005,0,0,0,0.152116
73132,"If Not Us, Who?",2011-03-10,2011,0,0,0,1.933294
73134,Tender Cousins,1980-11-19,1980,0,0,0,7.936244
73135,Ratchet,1996-09-12,1996,0,0,0,0.001223
73144,Portal: No Escape,2011-08-23,2011,0,0,0,3.444679
73147,Peeping Toms,1973-06-06,1973,0,0,0,0.040509
73160,Bellini e o Dem√¥nio,2008-09-30,2008,0,0,0,0.116346
73169,Zuzu Angel,2006-08-04,2006,0,0,0,0.444839
73179,Haunted Gold,1932-12-17,1932,0,0,0,0.174538
73183,"The Haunted World of Edward D. Wood, Jr.",1996-05-01,1996,0,0,0,0.037443
73191,The Nutcracker,1993-11-24,1993,19000000,2119994,-16880006,1.418221
73194,Drums Along the Mohawk,1939-11-03,1939,0,0,0,7.179812
73198,Queen Sized,2008-10-06,2008,0,0,0,1.089673
73203,The Sorcerers,1967-06-25,1967,0,0,0,1.342408
73208,Robbery,1967-08-01,1967,0,0,0,0.660248
73211,King of Devil's Island,2010-12-16,2010,10000000,0,-10000000,4.167899
73215,Claustrofobia,2011-05-24,2011,0,0,0,0.890593
73222,Swooni,2011-08-24,2011,0,0,0,0.00967
73241,The Velvet Underground and Nico,1966-02-08,1966,0,0,0,0.24066
73247,Heartbeeps,1981-12-18,1981,10000000,2154696,-7845304,1.08281
73250,Bloodline,2011-12-09,2011,700000,0,-700000,0.061137
73257,My Brother the Pig,1999-09-10,1999,0,0,0,0.873645
73262,Hell,2011-09-20,2011,0,0,0,4.778934
73265,Campus Man,1987-04-10,1987,0,989000,989000,0.000844
73267,Three Plus Two,1963-07-03,1963,0,0,0,0.387842
73281,Dear Yelena Sergeyevna,1988-04-12,1988,0,0,0,0.610155
73283,Transfer,2010-09-23,2010,0,0,0,0.594166
73290,Urban Explorer,2011-09-08,2011,3000000,0,-3000000,1.569303
73293,Empty Nest,2008-04-24,2008,0,0,0,0.704886
73294,Closed Spaces,2008-08-14,2008,0,0,0,0.153447
73306,Karaoke Terror,2003-11-08,2003,0,0,0,0.150139
73307,No Man's Woman,1955-10-27,1955,0,0,0,0.447586
73311,Tender Son: The Frankenstein Project,2010-07-26,2010,0,0,0,0.211103
73313,No Questions Asked,1951-06-15,1951,0,0,0,0.109206
73329,Let the Women Wait!,1998-01-01,1998,0,0,0,0.261612
73335,Marriage Retreat,2011-08-23,2011,0,0,0,0.27922
73336,Buried Alive II,1997-10-01,1997,0,0,0,0.506741
73339,The Boys Club,1997-02-28,1997,0,0,0,0.25047
73340,Heir To An Execution,2004-01-01,2004,0,0,0,0.002353
73348,Where Love Has Gone,1964-11-02,1964,0,0,0,0.102711
73351,Shadrach,1998-09-22,1998,0,0,0,0.532294
73353,Man in the Mirror: The Michael Jackson Story,2004-08-26,2004,0,0,0,0.9835
73358,Page Eight,2011-08-28,2011,0,0,0,5.38902
73369,Shakedown,1950-09-01,1950,0,0,0,0.455328
73376,The Inner Circle,1991-12-25,1991,0,0,0,0.308439
73408,Drive-In Horrorshow,2009-01-01,2009,0,0,0,0.112972
73420,Dishonored,1931-04-04,1931,0,0,0,0.760767
73424,True Adolescents,2009-03-14,2009,0,0,0,0.612806
73430,Government Girl,1943-11-05,1943,0,0,0,0.216485
73448,A Funny Man,2011-08-25,2011,0,0,0,0.564046
73452,Admissions,2004-10-16,2004,0,0,0,0.351194
73454,X,2010-12-31,2010,0,0,0,5.257968
73455,Speaking of Bunuel,2000-06-09,2000,0,0,0,1.042852
73456,Barbie: Princess Charm School,2011-08-11,2011,0,0,0,5.948997
73462,The Aviator,1985-03-01,1985,0,1304192,1304192,0.825362
73473,To The Other Side,2004-03-09,2004,0,0,0,0.215468
73474,The High Cost of Living,2010-09-15,2010,0,0,0,0.324047
73477,For a Few Extra Dollars,1966-10-07,1966,0,0,0,0.51508
73478,The Prince and the Pauper,1962-03-11,1962,0,0,0,0.01573
73482,Siegfried & Roy: The Magic Box,1999-10-01,1999,0,0,0,0.001662
73492,Outrage,1950-09-27,1950,0,0,0,1.057905
73499,The Double,2011-10-27,2011,17000000,3696232,-13303768,5.498819
73500,You May Not Kiss the Bride,2011-04-03,2011,0,0,0,9.664896
73501,A Plumm Summer,2007-01-01,2007,4200000,0,-4200000,0.163851
73503,Last Stop,2002-10-31,2002,0,0,0,0.042157
73515,Mesmerized,1985-11-18,1985,5000000,0,-5000000,1.0085
73517,Boys Love,2006-11-24,2006,0,0,0,1.039086
73526,The Doe Boy,2001-01-25,2001,0,0,0,0.009465
73527,Genius,1999-08-29,1999,0,0,0,0.364562
73529,Mardock Scramble: The First Compression,2010-11-06,2010,0,0,0,2.640175
73530,Mardock Scramble: The Second Combustion,2011-09-03,2011,0,0,0,2.10348
73532,Le Havre,2011-05-17,2011,3850000,0,-3850000,11.395112
73534,Moscow,2000-09-03,2000,0,0,0,0.312742
73541,You Should Meet My Son,2010-10-31,2010,0,0,0,0.573313
73545,–ï—Ö–∞–ª–∏ –≤ —Ç—Ä–∞–º–≤–∞–µ –ò–ª—å—Ñ –∏ –ü–µ—Ç—Ä–æ–≤,1972-08-19,1972,0,0,0,0.066034
73546,The Captivating Star of Happiness,1975-11-11,1975,0,0,0,0.160677
73548,Miracle Dogs Too,2006-04-01,2006,600000,0,-600000,0.209809
73551,Tarzan's Savage Fury,1952-03-14,1952,0,0,0,0.666707
73554,The Raven,2006-11-01,2006,0,0,0,0.68574
73562,Declaration of War,2011-05-10,2011,0,0,0,4.766939
73563,The Greening of Whitney Brown,2011-11-10,2011,0,0,0,0.710603
73565,Burning Man,2011-09-10,2011,0,0,0,7.846028
73567,Killer Joe,2011-09-10,2011,10000000,3665069,-6334931,6.452069
73575,Sparrows,1926-05-14,1926,463455,966878,503423,0.445526
73576,Mermaid,2007-06-05,2007,0,0,0,1.418646
73578,Jalsa,2008-04-02,2008,0,0,0,0.409499
73582,Bodyguard,2011-08-31,2011,130,8,-122,2.402032
73588,The Caller,2011-08-26,2011,0,0,0,5.812898
73590,Synth Britannia,2009-10-16,2009,0,0,0,0.430059
73595,The Threat,1949-12-01,1949,0,0,0,0.180104
73600,Bombay Talkie,1970-11-18,1970,0,0,0,0.000952
73604,Greetings,1968-12-15,1968,0,0,0,1.158633
73612,Sam's Song,1969-01-01,1969,0,0,0,0.233582
73614,House of Usher,2008-05-08,2008,1000000,0,-1000000,0.664555
73621,Night Patrol,1984-11-16,1984,0,0,0,0.231324
73624,The Man from the Future,2011-09-02,2011,0,0,0,3.011822
73628,Turquaze,2010-09-29,2010,0,0,0,1.201392
73642,The Closer You Get,2000-12-27,2000,0,0,0,0.427125
73646,I Accuse,2003-11-30,2003,0,0,0,0.756468
73649,Tutti gli uomini del deficiente,1999-12-17,1999,0,0,0,1.048433
73652,The Victim,1980-02-28,1980,0,0,0,0.007491
73661,Munger Road,2011-09-30,2011,0,0,0,0.993127
73669,Shut Up Little Man! An Audio Misadventure,2011-08-26,2011,0,0,0,0.891691
73680,Just Between Us,2010-03-10,2010,0,0,0,0.959391
73682,The Paper Will Be Blue,2006-08-07,2006,0,0,0,0.429128
73686,In Darkness,2011-09-02,2011,0,5576725,5576725,3.305712
73690,Mouse in Manhattan,1945-07-07,1945,0,0,0,0.284492
73697,Come Have Coffee with Us,1970-09-22,1970,0,0,0,0.190156
73700,Janie Jones,2010-09-17,2010,0,0,0,1.363957
73714,Franz Kafka's a Country Doctor,2007-11-17,2007,0,0,0,1.705657
73723,The Lorax,2012-03-01,2012,70000000,348840316,278840316,7.689395
73740,Johnny Hamlet,1968-03-22,1968,0,0,0,0.274694
73755,Il Ras del quartiere,1983-12-29,1983,0,0,0,0.108207
73770,What a Man,2011-08-25,2011,0,0,0,2.273886
73772,Greyfriars Bobby,2005-10-29,2005,0,0,0,0.164249
73775,The Quiet Love,2005-11-22,2005,0,0,0,0.154847
73791,As the Shadow,2007-06-22,2007,0,0,0,0.038902
73799,Other Worlds,1999-01-02,1999,0,0,0,0.082196
73800,Beach Spike,2011-07-07,2011,1800000,0,-1800000,0.879707
73818,The Entitled,2011-09-06,2011,0,0,0,2.950774
73823,Sidewalk Stories,1989-09-15,1989,0,0,0,0.078252
73827,Why,1971-10-27,1971,0,0,0,0.000308
73832,The Ugly Ones,1966-11-04,1966,0,0,0,0.698609
73835,Il Paramedico,1982-02-07,1982,0,0,0,0.07955
73846,The Family Tree,2011-09-26,2011,0,0,0,6.993769
73856,The Children of Leningradsky,2005-08-05,2005,0,0,0,0.639922
73861,A Serbian Film,2010-06-16,2010,0,0,0,10.431742
73869,The Last Man on Earth,2011-09-09,2011,3000000,0,-3000000,0.478151
73872,Terraferma,2011-09-07,2011,0,0,0,6.771605
73873,Albert Nobbs,2011-12-21,2011,8000000,5634828,-2365172,5.379039
73881,Thawing Out,2009-02-02,2009,0,0,0,4.169996
73884,My Life as McDull,2001-12-15,2001,0,0,0,0.392253
73889,The Day I Was Not Born,2010-09-03,2010,0,0,0,0.365128
73896,Apache Drums,1951-04-01,1951,0,0,0,0.722324
73897,Underdog Knight 2,2011-04-01,2011,0,0,0,0.635838
73901,Wakko's Wish,1999-12-20,1999,0,0,0,1.251338
73907,The Purple Plain,1954-11-25,1954,0,0,0,0.916951
73919,The Famous and the Dead,2009-09-25,2009,0,0,0,0.075403
73920,Dead Man's Letters,1986-12-12,1986,0,0,0,0.887192
73921,Plans for Tomorrow,2010-11-18,2010,0,0,0,0.051972
73922,A Visitor to a Museum,1989-03-14,1989,0,0,0,0.658363
73930,Recollections of the Yellow House,1989-01-01,1989,0,0,0,0.002001
73931,Reunion,1989-05-17,1989,0,0,0,0.006668
73933,Monster Brawl,2011-01-01,2011,0,0,0,7.610012
73935,Vamps,2012-08-25,2012,16000000,0,-16000000,6.290812
73936,Retreat,2011-10-14,2011,0,0,0,4.774096
73937,The Big Year,2011-10-13,2011,41000000,7448385,-33551615,10.267905
73939,Pariah,2011-12-27,2011,0,0,0,2.939603
73941,Limelight,2011-09-23,2011,0,0,0,0.149951
73943,388 Arletta Avenue,2011-09-11,2011,0,0,0,3.86712
73952,When Strangers Appear,2001-02-01,2001,2000000,0,-2000000,1.006285
73953,AmericanEast,2008-11-14,2008,0,0,0,0.783703
73954,The Palermo Connection,1990-02-01,1990,0,0,0,0.743157
73963,Creature,2011-09-09,2011,3000000,0,-3000000,3.619641
73969,My Best Girl,1927-10-31,1927,483103,1027757,544654,0.205671
73976,So Hard to Forget,2010-10-15,2010,0,0,0,1.249126
73981,Ayurveda: Art of Being,2001-09-20,2001,300000,2074000,1774000,0.113042
73983,Race Street,1948-09-11,1948,0,0,0,0.141565
73984,Chino,1973-09-14,1973,0,0,0,1.129177
73997,David Spade: Take the Hit,1998-04-17,1998,0,0,0,0.001684
74008,Undocumented,2010-09-14,2010,0,0,0,0.986401
74012,Crash Dive,1943-04-22,1943,0,0,0,0.553195
74018,A Cinderella Story: Once Upon a Song,2011-09-05,2011,0,0,0,5.899663
74035,Ninjas vs. Zombies,2008-10-31,2008,0,0,0,0.3808
74052,My Name Is Juani,2006-10-20,2006,0,0,0,1.052711
74055,L'iceberg,2005-12-07,2005,0,0,0,0.038843
74057,Steelyard Blues,1973-01-31,1973,0,0,0,0.796176
74071,In the Folds of the Flesh,1970-05-02,1970,0,0,0,0.979763
74074,The Raid,1954-08-04,1954,0,0,0,0.723591
74076,9/11: The Twin Towers,2006-09-03,2006,0,0,0,0.038851
74080,Traffic Jam,1979-01-12,1979,0,0,0,0.417886
74082,"Rome, the other face of violence",1976-07-27,1976,0,0,0,0.0401
74087,Death Carries a Cane,1973-01-05,1973,0,0,0,0.786509
74088,Papa's Delicate Condition,1963-03-06,1963,0,0,0,0.666219
74092,Bleak Night,2010-02-03,2010,0,0,0,0.806425
74097,Bikini Summer III: South Beach Heat,1997-01-01,1997,0,0,0,0.07183
74103,Suicide Club,2010-11-25,2010,0,0,0,0.108027
74113,Taste the Waste,2011-09-08,2011,0,0,0,0.114219
74119,The Day I Saw Your Heart,2011-04-20,2011,0,0,0,1.995494
74121,Gaea Girls,2000-08-16,2000,0,0,0,0.036471
74122,The Bigamist,1953-12-03,1953,0,0,0,0.995928
74124,Shinjuku Boys,1995-07-01,1995,0,0,0,0.100415
74126,Record of a Tenement Gentleman,1947-05-21,1947,0,0,0,0.719233
74128,Three Miles North of Molkom,2008-04-18,2008,0,0,0,0.154914
74130,Waikiki Wedding,1937-03-23,1937,0,0,0,0.245237
74135,Gantz: Perfect Answer,2011-04-23,2011,0,0,0,10.298762
74137,The Wedding Party,1969-04-09,1969,0,43,43,0.349944
74140,Let It Come Down: The Life of Paul Bowles,1999-04-01,1999,0,0,0,0.001824
74154,Nuvvostanante Nenoddantana,2005-01-14,2005,0,0,0,0.286812
74171,Sahte Kabadayƒ±,1976-09-01,1976,0,0,0,0.683873
74183,Vieraalla Maalla,2003-12-19,2003,0,0,0,0.07732
74192,Love Can Seriously Damage Your Health,1997-01-10,1997,0,0,0,0.347937
74197,No Room To Die,1969-01-01,1969,0,0,0,0.620435
74199,Big Beat,1993-09-12,1993,0,0,0,0.07681
74208,Double Or Nothing,1937-09-17,1937,0,0,0,0.06509
74215,The Virgin of Nuremberg,1963-08-15,1963,0,0,0,1.267234
74225,Killer Party,1986-05-09,1986,0,0,0,0.673757
74237,A Skin Too Few: The Days of Nick Drake,2002-04-19,2002,0,0,0,0.766082
74239,Message to Love: The Isle of Wight Festival,1996-02-15,1996,0,0,0,0.330752
74241,Terror Beneath the Sea,1966-07-01,1966,0,0,0,0.246106
74254,The House of Usher,2007-09-11,2007,130000,1677,-128323,0.11689
74257,Holy Flame of the  Martial World,1983-06-10,1983,0,0,0,0.009961
74276,Advertising and the End of the World,1998-01-01,1998,0,0,0,0.00118
74286,The Hasty Heart,1949-12-02,1949,0,0,0,0.363774
74289,Samurai Reincarnation,1981-06-06,1981,0,0,0,0.947615
74294,The Ballroom,2007-11-25,2007,0,0,0,0.140747
74295,Crime and Punishment,1983-12-02,1983,0,0,0,1.473622
74302,K√∂yden ƒ∞ndim ≈ûehire,1974-01-01,1974,0,0,0,0.307221
74306,God Bless America,2011-09-09,2011,0,122550,122550,10.00161
74308,Detachment,2011-04-24,2011,0,72689,72689,4.179477
74310,Hell and Back Again,2011-10-04,2011,0,0,0,0.990359
74312,Between Two Fires,2010-10-13,2010,0,0,0,0.032325
74314,Bulldog Drummond's Secret Police,1939-03-29,1939,0,0,0,0.104121
74336,The Quiet Family,1998-04-25,1998,0,0,0,2.428
74340,Amazing Grace and Chuck,1987-05-22,1987,0,0,0,0.382554
74343,Sonny Boy,1990-10-26,1990,0,0,0,0.000844
74349,Antonio das Mortes,1969-05-20,1969,0,0,0,1.00529
74379,Kidnap Syndicate,1975-08-27,1975,0,0,0,0.134354
74384,San Giovanni decollato,1940-12-12,1940,0,0,0,0.400952
74387,Goon,2012-01-06,2012,0,6483963,6483963,8.817924
74394,The Holding,2011-09-09,2011,3000000,0,-3000000,1.430827
74395,Hangin' With The Homeboys,1991-04-05,1991,0,0,0,2.675068
74397,The Psychopath,1966-02-04,1966,0,0,0,0.285177
74402,The Murderer Lives at Number 21,1942-08-07,1942,0,0,0,1.252491
74405,Sharpe's Company,1994-01-01,1994,0,0,0,1.624921
74406,Queen: Days of Our Lives,2011-05-29,2011,0,0,0,2.129679
74415,A Heartbeat Away,2011-03-11,2011,8292000,0,-8292000,1.07762
74417,The Great Kidnapping,1973-11-16,1973,0,0,0,0.049823
74420,San Quentin,1946-12-16,1946,0,0,0,0.220049
74430,Thumb Tripping,1972-10-01,1972,0,0,0,0.003076
74436,The World in His Arms,1952-10-09,1952,0,0,0,0.976834
74437,The Secret Fury,1950-02-21,1950,0,0,0,0.2738
74447,The Hammer,2010-10-26,2010,0,0,0,1.282498
74457,Redemption Road,2011-08-26,2011,0,0,0,0.266642
74458,Mere Brother Ki Dulhan,2011-09-09,2011,5510000,18050000,12540000,1.838865
74460,"Aries Spears: Hollywood, Look I'm Smiling",2011-03-22,2011,0,0,0,0.116648
74461,Knights of Badassdom,2013-01-21,2013,0,0,0,6.281872
74464,Little Tony,1998-04-30,1998,0,0,0,0.124481
74465,We Bought a Zoo,2011-12-22,2011,50000000,120081841,70081841,10.563152
74469,The Story of Louis Pasteur,1936-02-22,1936,0,0,0,0.762512
74471,The Dead,2010-08-30,2010,0,0,0,3.298062
74474,Varian's War,2001-04-22,2001,0,0,0,1.002011
74477,Ocean of Pearls,2008-12-14,2008,0,0,0,0.444205
74481,Darna Mana Hai,2003-06-25,2003,0,0,0,0.215285
74485,A Man Named Pearl,2006-10-20,2006,0,0,0,0.145447
74491,Confessions of an Ugly Stepsister,2002-03-10,2002,0,0,0,0.353119
74493,Ballad,2009-09-05,2009,0,0,0,2.031284
74495,Bandage,2010-01-16,2010,0,0,0,0.421065
74505,Lovely Molly,2012-05-18,2012,1000000,0,-1000000,8.361319
74510,Kevin Hart: Laugh at My Pain,2011-09-09,2011,0,0,0,6.554298
74513,Special Forces,2011-11-02,2011,10000000,10759,-9989241,5.3584
74518,Territories,2010-10-19,2010,0,0,0,1.126036
74523,Born To Race,2011-03-19,2011,0,0,0,6.483418
74525,"Sleep, My Love",1948-02-18,1948,0,0,0,0.971227
74527,Tension at Table Rock,1956-10-03,1956,0,0,0,0.337901
74529,The Sins of Rachel Cade,1961-04-02,1961,0,0,0,0.051666
74534,The Best Exotic Marigold Hotel,2011-11-28,2011,10000000,136836156,126836156,9.23046
74535,Adventures of Captain Wrongel,1979-06-06,1979,0,0,0,0.263948
74536,The Son of No One,2011-11-04,2011,15000000,0,-15000000,11.314303
74544,Accident,1967-02-05,1967,600000,0,-600000,1.68989
74545,The Saint In London,1939-06-30,1939,0,0,0,1.068317
74546,Pulsar,2010-08-12,2010,0,0,0,0.403924
74549,The Shunning,2011-04-16,2011,0,0,0,0.457497
74550,The Smiling Ghost,1941-09-06,1941,0,0,0,0.038129
74555,Evil Things,2009-06-17,2009,20000,0,-20000,0.818556
74558,The Sun Behind the Clouds: Tibet's Struggle for Freedom,2010-01-20,2010,0,0,0,0.006237
74561,Amsterdam Heavy,2011-09-12,2011,500000,0,-500000,1.568293
74578,A Matter of Taste,2000-04-26,2000,0,0,0,0.502596
74579,Blessed and Cursed,2010-01-01,2010,0,0,0,0.08602
74580,Peek-a-boo,1954-10-15,1954,0,0,0,0.785695
74581,Sisters of the Gion,1936-10-15,1936,0,0,0,0.717874
74585,Indiscretion of an American Wife,1953-04-02,1953,0,0,0,0.895958
74586,Rabies,2010-12-02,2010,500000,0,-500000,2.743079
74593,Bill Cosby: 49,1987-04-01,1987,0,0,0,0.071716
74604,Sh! The Octopus,1937-12-14,1937,0,0,0,0.106838
74608,Weekender,2011-09-01,2011,0,0,0,0.964072
74626,False Trail,2011-09-15,2011,0,0,0,2.354815
74629,Attack of the 50 Ft. Woman,1993-12-11,1993,0,0,0,1.554208
74639,Overheard 2,2011-08-18,2011,8000000,0,-8000000,1.172189
74643,The Artist,2011-05-15,2011,15000000,133432856,118432856,11.440948
74645,Mondo Candido,1975-02-21,1975,0,0,0,0.002001
74656,Attention! Bandits!,1951-01-01,1951,0,0,0,0.780505
74657,The Violent Four,1968-03-29,1968,0,0,0,0.83746
74661,The Indecent Woman,1991-05-26,1991,0,0,0,3.403166
74666,Jaffa,2009-06-10,2009,0,0,0,0.552703
74674,Supercl√°sico,2011-03-17,2011,3400000,0,-3400000,1.030146
74681,Made in Jamaica,2006-09-13,2006,0,0,0,0.042518
74684,"Massa√Ø, les guerriers de la pluie",2004-12-22,2004,0,0,0,0.0745
74689,Mon oncle Antoine,1971-11-12,1971,0,0,0,0.007963
74692,Rare Birds,2001-09-09,2001,5000000,0,-5000000,1.788953
74694,Heidi,1993-07-18,1993,0,0,0,0.983016
74695,The Hyperboloid of Engineer Garin,1965-01-01,1965,0,0,0,1.537332
74705,The Adventures of Tom Sawyer and Huckleberry Finn,1981-01-01,1981,0,0,0,0.408185
74711,City Zero,1989-01-01,1989,0,0,0,0.865015
74714,Di√™n Bi√™n Phu,1992-03-04,1992,30000000,0,-30000000,0.234366
74717,Courtyard of the Ballads,1942-01-23,1942,0,0,0,0.499009
74718,O Costa d'√Åfrica,1954-09-19,1954,0,0,0,1.424842
74719,"That's Entertainment, Part II",1976-05-17,1976,0,0,0,0.661367
74722,Sexaholix... A Love Story,2002-01-01,2002,0,0,0,0.215474
74725,Kill List,2011-09-02,2011,500000,171760,-328240,15.014569
74726,Juan of the Dead,2011-10-14,2011,0,0,0,4.121133
74727,Long Pigs,2010-05-18,2010,250000,0,-250000,1.277626
74746,Joe Hill,1971-08-25,1971,0,0,0,0.304231
74753,The Sleeping Tiger,1954-06-21,1954,0,0,0,0.301792
74759,Mine Own Executioner,1947-11-22,1947,0,0,0,0.551786
74767,The Wise Guys,1965-10-22,1965,0,0,0,0.825397
74777,Absentia,2011-03-03,2011,70000,0,-70000,4.54174
74779,Robotropolis,2011-09-02,2011,0,0,0,1.47175
74790,"Dance Party, USA",2006-03-12,2006,0,0,0,0.242261
74809,Un Papillon sur l'√©paule,1978-05-03,1978,0,0,0,1.393837
74810,The Sheep Has Five Legs,1954-09-24,1954,0,0,0,0.680772
74822,Judge Fayard Called the Sheriff,1977-01-12,1977,0,0,0,0.257018
74829,The Killing of Satan,1983-06-10,1983,0,0,0,0.056354
74830,The Lie,2011-11-18,2011,0,0,0,0.459659
74831,The Devil's Wedding Night,1973-04-01,1973,0,0,0,0.926611
74836,Idaho Transfer,1973-06-15,1973,0,0,0,0.00022
74840,Nobody Will Speak of Us When We're Dead,1995-09-16,1995,0,0,0,0.632308
74842,Legend of the Millennium Dragon,2011-01-01,2011,0,0,0,1.99264
74849,The Star Wars Holiday Special,1978-12-01,1978,0,0,0,4.099014
74852,Vertical,1966-06-19,1966,0,0,0,0.846384
74860,White: The Melody of the Curse,2011-06-09,2011,0,0,0,1.93372
74877,Son of Morning,2011-01-01,2011,0,0,0,0.599894
74878,Cloportes,1965-10-01,1965,0,0,0,0.254885
74879,Once Upon a Time in Anatolia,2011-09-23,2011,0,138730,138730,4.433261
74884,Vanessa,1977-03-10,1977,0,0,0,0.49856
74896,The Fox,1967-12-13,1967,0,0,0,0.429236
74899,The Fan,1981-05-15,1981,0,0,0,0.519465
74903,Almanac of Fall,1984-08-15,1984,0,0,0,0.79921
74911,Step By Step,1946-08-23,1946,0,0,0,0.222951
74919,Pitbull,2005-04-09,2005,0,0,0,0.547948
74921,Ajlawju,1999-06-18,1999,0,0,0,0.081376
74922,Zr√≥bmy sobie wnuka,2003-10-10,2003,0,0,0,0.450898
74924,Zotz!,1962-10-03,1962,0,0,0,0.103135
74935,Helicopter String Quartet,2005-01-01,2005,0,0,0,0.002374
74938,The Dark Side of the Heart,1992-05-21,1992,0,0,0,1.08614
74942,Soul of the Game,1996-04-20,1996,0,0,0,0.213655
74944,War of the Buttons,2011-09-12,2011,0,0,0,4.357984
74945,War of the Buttons,2011-09-20,2011,0,0,0,8.028926
74946,Feast of All Saints,2001-11-11,2001,0,0,0,0.731121
74948,Steppenwolf,1974-01-01,1974,0,0,0,0.343203
74949,The Fruit Is Ripe,1977-01-20,1977,0,0,0,1.512118
74950,Breakout,2007-01-18,2007,0,0,0,0.377012
74955,Screaming Masterpiece,2005-04-30,2005,0,0,0,0.739587
74961,Fast and Furry-Ous,1949-09-17,1949,0,0,0,0.850109
74974,Code Name: Emerald,1985-09-07,1985,0,0,0,0.658885
74997,The Human Centipede 2 (Full Sequence),2011-10-06,2011,0,0,0,16.257143
74998,Seeking Justice,2011-09-02,2011,17000000,12355798,-4644202,10.250997
75000,The Black Power Mixtape 1967-1975,2011-09-09,2011,0,0,0,0.385288
75001,Mollo tutto,1995-03-31,1995,0,0,0,0.208569
75004,Poongsan,2011-06-23,2011,0,0,0,0.315971
75006,Moby Dick,2011-06-09,2011,0,0,0,1.797129
75007,S.I.S.,2008-08-24,2008,0,0,0,0.681523
75012,Three Violent People,1957-02-09,1957,0,0,0,0.255811
75015,How I Unleashed World War II Part III: Among Friends,1970-04-06,1970,0,0,0,0.202468
75018,Great Migrations,2010-11-06,2010,0,0,0,0.627535
75020,Gag,2006-01-11,2006,0,0,0,0.709738
75025,Tracks,2005-09-09,2005,0,0,0,0.877393
75027,Checkpoint,2003-11-23,2003,0,0,0,0.073223
75028,The Coconut Revolution,2000-12-31,2000,0,0,0,0.00324
75033,Winnie Mandela,2011-09-16,2011,15000000,0,-15000000,0.740141
75046,Battle Hymn,1957-02-14,1957,0,0,0,0.739256
75063,Rainbow Bridge,1972-03-01,1972,0,0,0,0.266692
75066,The President,1961-01-03,1961,0,0,0,0.563185
75074,Touchback,2011-04-13,2011,0,0,0,1.609267
75086,The Unholy Four,1970-03-11,1970,0,0,0,0.511693
75090,Beware the Gonzo,2010-04-22,2010,0,0,0,0.581783
75100,Attack on the Pin-Up Boys,2007-07-26,2007,0,0,0,1.11738
75101,Red Victoria,2008-03-01,2008,5000,0,-5000,0.074225
75130,Catlow,1971-10-01,1971,0,0,0,5.275286
75132,Ollie Hopnoodle's Haven of Bliss,1988-08-05,1988,0,0,0,0.016421
75133,Sharpe's Enemy,1994-06-01,1994,0,0,0,1.846418
75134,Sharpe's Honour,1994-06-08,1994,0,0,0,1.317935
75136,Sharpe's Gold,1995-04-01,1995,0,0,0,1.13192
75137,Sharpe's Battle,1995-04-19,1995,0,0,0,1.577834
75138,Sharpe's Sword,1995-04-26,1995,0,0,0,1.26878
75140,Sharpe's Regiment,1996-05-01,1996,0,0,0,1.804632
75141,Huckleberry Finn,1974-05-24,1974,0,0,0,0.773371
75142,Sharpe's Siege,1996-05-08,1996,0,0,0,1.525021
75143,Sharpe's Mission,1996-05-15,1996,0,0,0,0.978978
75145,Citizen Cohn,1992-08-22,1992,0,0,0,0.209787
75151,Big Bad Love,2001-10-11,2001,0,0,0,0.437438
75162,Hurricane,1979-04-12,1979,0,0,0,0.323301
75170,Third Star,2010-06-01,2010,0,0,0,2.380795
75174,The Grey,2012-01-26,2012,25000000,77278331,52278331,14.31675
75179,Escort,2006-05-27,2006,0,0,0,0.6812
75190,Jeff Dunham: Controlled Chaos,2011-09-27,2011,0,0,0,0.798372
75193,A Buddha,2005-07-14,2005,0,0,0,0.152454
75198,Bienvenue √† bord,2011-10-05,2011,12000000,0,-12000000,4.826919
75203,Day of the Panther,1988-06-28,1988,0,0,0,0.000578
75204,Imaginaerum,2012-11-10,2012,4275000,0,-4275000,2.937484
75224,Tintin and I,2003-08-13,2003,0,0,0,0.657594
75229,Babycall,2011-10-07,2011,0,0,0,2.522415
75232,Puzzled Love,2010-06-06,2010,0,0,0,0.042805
75233,"Oslo, August 31st",2011-08-31,2011,0,0,0,4.993565
75244,A Feast At Midnight,1994-11-01,1994,0,0,0,0.254535
75250,The Locusts,1997-10-03,1997,0,10082,10082,0.53204
75258,Secret of the Wings,2012-08-17,2012,0,0,0,9.32058
75262,The Long Recess,1972-06-06,1972,0,0,0,0.264246
75282,Scenes from the Suburbs,2011-03-01,2011,0,0,0,1.015569
75294,The Invisible Man,1984-01-12,1984,0,0,0,0.077218
75298,The Fountain,1989-09-08,1989,0,0,0,0.004948
75300,The Last Ride,2012-06-22,2012,0,0,0,1.02433
75301,Being Elmo: A Puppeteer's Journey,2011-10-21,2011,0,286201,286201,6.94881
75311,The People vs. George Lucas,2010-03-14,2010,0,0,0,2.466945
75315,Texas,1941-10-09,1941,0,0,0,0.775765
75317,Dabbe,2006-02-09,2006,500000,0,-500000,0.553881
75318,Hood of the Living Dead,2005-01-01,2005,0,0,0,0.620939
75329,Dimensions,2011-09-20,2011,0,0,0,0.62706
75336,I'm Photogenic,1980-03-21,1980,0,0,0,0.417172
75337,Too Tough to Die: A Tribute to Johnny Ramone,2006-04-26,2006,0,0,0,0.148078
75341,Budrus,2010-10-08,2010,0,0,0,0.00831
75345,I Melt with You,2011-12-09,2011,0,0,0,7.587509
75350,American Friends,1991-03-22,1991,0,0,0,0.003553
75363,The Spy in Black,1939-10-07,1939,4668069,0,-4668069,1.381515
75364,Ivul,2010-01-20,2010,0,0,0,0.405958
75375,The Trap: What Happened to Our Dream of Freedom,2007-03-11,2007,0,0,0,0.668038
75386,Haiku Tunnel,2001-09-07,2001,0,251058,251058,0.100465
75393,The Power of Fear,2006-06-06,2006,0,0,0,0.495092
75400,Henri Cartier-Bresson: The Impassioned Eye,2003-04-11,2003,0,0,0,0.138304
75404,The Lizard,2004-03-31,2004,0,0,0,0.509785
75438,Pregnant,2011-07-21,2011,2000000,8000000,6000000,0.397106
75442,Eames: The Architect & The Painter,2011-11-18,2011,0,0,0,1.030773
75446,Carbon Nation,2011-02-11,2011,0,0,0,0.111059
75450,Enemies of the People,2009-11-24,2009,0,0,0,0.148382
75452,People in the Sun,2011-03-04,2011,0,0,0,0.328181
75465,The Conman,1998-12-18,1998,0,0,0,0.557097
75469,Oka!,2011-10-14,2011,0,0,0,0.509306
75471,Twisted Desire,1996-05-13,1996,0,0,0,0.227354
75490,Imaginary Crimes,1994-10-14,1994,0,0,0,0.286402
75491,The Rabbi's Cat,2011-05-31,2011,0,0,0,2.941289
75506,World Without End,1956-03-25,1956,0,0,0,4.241987
75507,Dragon Crusaders,2011-09-27,2011,0,0,0,1.498691
75510,The Purchase Price,1932-07-23,1932,0,0,0,1.089928
75531,Isn't She Great,2000-01-28,2000,36000000,3003296,-32996704,0.907927
75532,Dov'√® la libert√†...?,1954-02-25,1954,0,0,0,0.081606
75537,Son of Sam,2008-09-06,2008,0,0,0,0.087492
75547,Nowhere to Hide,2009-04-03,2009,0,0,0,0.238203
75552,The Mountain Men,1980-05-01,1980,0,0,0,0.983739
75555,The Fear,1995-01-20,1995,0,0,0,0.268043
75562,Shun Li and the Poet,2011-09-23,2011,0,0,0,1.240613
75564,The Galaxy Invader,1985-04-01,1985,0,0,0,0.002001
75576,Answers to Nothing,2011-12-02,2011,0,0,0,0.719529
75577,Brian Eno: Another Green World,2010-01-12,2010,0,0,0,0.007221
75578,Mariken,2000-12-07,2000,0,0,0,0.133634
75579,Dad Savage,1998-06-05,1998,3500000,0,-3500000,1.174856
75595,Little Birds,2011-01-23,2011,0,0,0,9.920479
75596,The Night the Lights Went Out in Georgia,1981-05-29,1981,0,0,0,0.837251
75604,Suburban Knights,2011-09-20,2011,0,0,0,0.755692
75608,Dead Birds,1963-10-01,1963,0,0,0,0.072811
75612,Oblivion,2013-04-10,2013,120000000,286168572,166168572,14.654053
75622,Rampart,2011-11-23,2011,12000000,972512,-11027488,5.874878
75623,The Howling: Reborn,2011-10-18,2011,0,0,0,1.079467
75626,For the Love of a Dog,2008-03-01,2008,1000000,0,-1000000,0.080345
75629,Evangelion: 3.0 You Can (Not) Redo,2012-11-17,2012,0,60487945,60487945,7.764883
75634,Sharpe's Challenge,2006-04-23,2006,0,0,0,4.234721
75638,Red Lights,2012-03-02,2012,14000000,13551174,-448826,11.535478
75641,Voyage of the Damned,1976-12-22,1976,0,0,0,1.12301
75656,Now You See Me,2013-05-29,2013,75000000,117698894,42698894,17.852022
75657,Screwed,2011-06-03,2011,3,0,-3,1.059273
75674,Act of Valor,2012-02-24,2012,12000000,81272766,69272766,12.159818
75680,The PHD movie,2011-08-12,2011,0,0,0,0.466915
75686,Hexed,1993-01-22,1993,0,0,0,0.852997
75710,Stranger on the Prowl,1952-03-12,1952,0,0,0,0.002209
75713,Treasure Guards,2011-09-30,2011,0,0,0,1.21771
75719,Paul Goodman Changed My Life,2011-10-19,2011,0,0,0,0.007063
75720,One Life,2011-07-19,2011,0,0,0,5.389068
75725,Films to Keep You Awake: The Christmas Tale,2005-12-25,2005,0,0,0,1.150925
75733,Perceval,1978-02-07,1978,0,0,0,0.346814
75735,Zombie Apocalypse,2011-10-29,2011,0,0,0,2.438909
75736,Catch.44,2011-12-08,2011,7000000,0,-7000000,5.799422
75744,Saheb Biwi Aur Gangster,2011-09-23,2011,0,0,0,0.558603
75745,Force,2011-09-23,2011,0,0,0,1.549113
75748,To Forget Venice,1979-04-14,1979,0,0,0,0.080457
75752,Too Late Blues,1961-11-07,1961,0,0,0,3.833088
75754,Silent Action,1975-04-05,1975,0,0,0,0.000783
75757,America The Beautiful 2: The Thin Commandments,2011-10-12,2011,0,0,0,0.077663
75759,Roller Boogie,1979-12-31,1979,0,0,0,1.851179
75760,American Teacher,2011-05-03,2011,0,0,0,0.488224
75761,John Dies at the End,2012-01-23,2012,0,0,0,9.143819
75770,The Case of the Curious Bride,1935-04-13,1935,0,0,0,0.262367
75778,Wild About Harry,2000-12-31,2000,0,0,0,0.705208
75780,Jack Reacher,2012-12-20,2012,60000000,218340595,158340595,12.789812
75785,The Other F Word,2011-11-02,2011,0,0,0,1.083836
75793,Elstree Calling,1930-02-01,1930,0,0,0,1.453276
75799,The Roots of Heaven,1958-10-15,1958,0,0,0,0.522564
75802,Hysteria,2011-06-06,2011,0,9504139,9504139,14.331454
75803,Catching Hell,2011-09-27,2011,0,0,0,0.331212
75804,The Toll of the Sea,1922-11-26,1922,0,0,0,0.994973
75808,The Black Marble,1980-03-07,1980,0,0,0,0.267315
75810,The Perfect Roommate,2011-07-21,2011,0,0,0,1.183015
75822,Hercules and the Circle of Fire,1994-11-05,1994,0,0,0,1.129236
75826,Hercules and the Lost Kingdom,1994-05-02,1994,0,0,0,0.766579
75834,Hercules in the Underworld,1994-11-07,1994,0,0,0,4.213454
75840,Saai sau kwong lung,2002-01-01,2002,0,0,0,0.004641
75848,The Happy Hooker,1975-01-01,1975,0,0,0,0.0339
75861,To Write Love on Her Arms,2015-03-13,2015,3400000,0,-3400000,11.783784
75865,Loser Takes All,2002-11-15,2002,0,0,0,0.039267
75874,Patton Oswalt: Finest Hour,2011-09-05,2011,0,0,0,0.129504
75877,The Holy Innocents,1984-04-04,1984,0,0,0,1.207703
75878,Sacrificio: Who Betrayed Che Guevara,2001-01-17,2001,0,0,0,0.071988
75880,Belle of the Nineties,1934-09-21,1934,0,0,0,0.10924
75886,Pedro,2008-09-07,2008,0,0,0,0.309326
75888,Blood on the Sun,1945-04-26,1945,0,0,0,1.130503
75889,The House on Carroll Street,1988-03-04,1988,0,0,0,1.742499
75892,Blood and Sand,1989-09-22,1989,0,0,0,1.334127
75896,Rascals,2011-10-06,2011,0,0,0,0.228228
75897,Sams in Gefahr,2003-12-10,2003,0,0,0,0.847841
75900,My Week with Marilyn,2011-10-17,2011,6400000,35057696,28657696,12.203066
75901,The Conquest of Everest,1953-12-09,1953,0,0,0,0.14958
75903,The Uncanny,1977-08-24,1977,0,0,0,0.57948
75905,Fragment of Fear,1970-01-01,1970,0,0,0,0.429745
75910,Lifted,2010-08-13,2010,0,0,0,0.821529
75926,Shaka Zulu,1986-11-24,1986,24000000,0,-24000000,0.661658
75931,The Cat,2011-07-07,2011,0,0,0,2.393574
75938,Twilight's Last Gleaming,1977-02-09,1977,0,0,0,0.520752
75944,The Jackpot!,1991-12-18,1991,0,0,0,0.574686
75945,The Other Family,2011-03-25,2011,0,0,0,0.654032
75947,Charlie Bubbles,1967-07-15,1967,0,0,0,0.383941
75948,The Sorcerer and the White Snake,2011-09-27,2011,0,0,0,7.661339
75950,The Heat's On,1943-12-02,1943,0,0,0,0.531012
75958,So Sweet... So Perverse,1969-10-31,1969,0,0,0,0.158707
75963,Going Ape!,1981-04-10,1981,0,0,0,0.137095
75964,George Harrison: Living in the Material World,2011-10-05,2011,0,0,0,3.117495
75969,Men in the City 2,2011-09-06,2011,0,0,0,1.713808
75976,It's All True,1993-10-17,1993,0,0,0,0.001393
75981,La France,2007-11-21,2007,0,0,0,0.239318
75989,Lady in White,1962-07-02,1962,0,0,0,0.11059
76000,The L-Shaped Room,1962-11-20,1962,0,0,0,0.551158
76002,Kotch,1971-09-17,1971,0,0,0,1.88749
76010,The last summit,2010-06-01,2010,0,0,0,0.121912
76011,My Blue Heaven,1950-09-15,1950,0,0,0,0.001358
76012,The Da Vinci Treasure,2006-05-23,2006,850,0,-850,0.127383
76013,No Rest for the Wicked,2011-09-21,2011,0,0,0,1.87646
76018,The Happening,1967-03-01,1967,0,0,0,0.159193
76025,Shame,2011-10-02,2011,6500000,17693675,11193675,11.72049
76040,9/11: The Falling Man,2006-03-16,2006,0,0,0,0.510555
76043,RFK Must Die The Assassination Of Bobby Kennedy,2007-11-20,2007,0,0,0,0.093564
76047,Tv√• killar och en tjej,1983-03-25,1983,0,0,0,0.005792
76059,Oesje!,1997-10-29,1997,0,0,0,0.081376
76076,The Time of Your Life,1948-09-03,1948,0,0,0,0.124445
76081,Tarzan and the Valley of Gold,1966-07-01,1966,0,0,0,0.391716
76083,Tarzan the Fearless,1933-08-11,1933,0,0,0,0.756556
76084,Tarzan's Fight for Life,1958-08-15,1958,0,0,0,0.37709
76094,The Trail of the Lonesome Pine,1936-03-13,1936,0,0,0,0.517872
76097,Gangs,2009-10-01,2009,0,0,0,0.657883
76099,The Colonel,2006-11-15,2006,3900000,0,-3900000,0.076146
76101,Freerunner,2011-09-14,2011,5000000,0,-5000000,4.096897
76102,N Is a Number: A Portrait of Paul Erd√∂s,1993-05-13,1993,0,0,0,0.102862
76105,Hunger,2001-01-13,2001,10000,0,-10000,0.001194
76112,Jig,2011-11-30,2011,0,0,0,0.071002
76115,The Phantom of the Opera at the Royal Albert Hall,2011-09-27,2011,0,0,0,2.419737
76116,Alluda Majaka,1995-02-01,1995,0,0,0,1.042726
76117,Not as a Stranger,1955-07-01,1955,0,0,0,0.294175
76121,Tight Spot,1955-03-19,1955,0,0,0,1.157943
76122,Marvel One-Shot: The Consultant,2011-09-12,2011,500000,0,-500000,4.964486
76127,Vegucated,2011-01-09,2011,0,0,0,1.276738
76142,Cameraman: The Life and Work of Jack Cardiff,2010-05-05,2010,0,0,0,0.887268
76155,Seventh Heaven,1993-03-01,1993,0,0,0,0.070218
76157,Il bell'Antonio,1960-03-04,1960,0,0,0,0.435287
76162,Stephen Fry In America - New World,,,0,0,0,0.05048
76163,The Expendables 2,2012-08-08,2012,100000000,312573423,212573423,14.881566
76164,Bong of the Dead,2011-02-04,2011,0,0,0,0.665687
76170,The Wolverine,2013-07-23,2013,120000000,415440673,295440673,3.918287
76171,Turbulence 2: Fear of Flying,1999-12-27,1999,0,0,0,3.990811
76172,Monaco Forever,1984-01-01,1984,0,0,0,0.589204
76176,Da Hip Hop Witch,2000-10-31,2000,0,0,0,0.221645
76180,Empire of Dreams: The Story of the Star Wars Trilogy,2004-09-12,2004,0,0,0,5.796763
76198,The Slap,1974-10-23,1974,0,0,0,1.10577
76199,Hollow,2011-09-06,2011,0,0,0,0.061459
76200,Just Before Nightfall,1971-03-31,1971,0,0,0,0.762996
76202,Wait until spring Bandini,1989-11-01,1989,0,0,0,0.089074
76203,12 Years a Slave,2013-10-18,2013,20000000,187000000,167000000,30.316249
76207,Pleasure Party,1975-01-15,1975,0,0,0,0.0
76211,Sitting Pretty,1948-01-01,1948,0,0,0,3.115951
76226,Familiar Ground,2011-01-06,2011,0,0,0,0.45431
76229,Phone Call from a Stranger,1952-02-01,1952,0,0,0,0.324705
76234,Living Will...,2011-10-04,2011,300000,0,-300000,0.236172
76235,Hunger,1966-08-19,1966,0,0,0,0.47293
76237,Bananaz,2008-02-07,2008,0,0,0,0.075089
76264,Bopha!,1993-09-16,1993,12000000,212483,-11787517,0.074126
76268,My Son,2006-03-07,2006,0,0,0,1.344876
76277,The Marriage of Balzaminov,1964-06-06,1964,0,0,0,1.026644
76282,Trevor Noah: Crazy Normal,2011-07-25,2011,0,0,0,0.008274
76285,Percy Jackson: Sea of Monsters,2013-08-07,2013,90000000,174578751,84578751,10.338222
76286,Ski Party,1965-06-30,1965,0,0,0,0.795808
76287,Johnny 2.0,1998-09-12,1998,0,0,0,0.270593
76289,Terminus,1987-01-28,1987,0,0,0,0.410204
76297,All's Faire in Love,2009-05-15,2009,0,0,0,0.531051
76312,Me and Charly,1978-03-19,1978,0,0,0,0.720125
76323,Eye of the Eagle,1997-03-21,1997,0,0,0,0.23176
76329,Happy New Year,1973-04-13,1973,0,0,0,1.146448
76330,Wild Man Blues,1997-01-16,1997,0,425788,425788,0.312753
76333,Extraterrestrial,2011-09-11,2011,0,0,0,1.959847
76338,Thor: The Dark World,2013-10-29,2013,170000000,644571402,474571402,34.905447
76341,Mad Max: Fury Road,2015-05-13,2015,150000000,378858340,228858340,29.36178
76344,Two for the Seesaw,1962-11-24,1962,0,0,0,1.345865
76346,The Ballad of Nessie,2011-04-13,2011,0,0,0,1.527842
76348,Us Two,1979-05-23,1979,4100000,0,-4100000,0.022568
76349,1911,2011-07-03,2011,30000000,108348,-29891652,3.835131
76350,A Man and a Woman: 20 Years Later,1986-05-13,1986,0,0,0,0.119266
76354,Video Girl,2011-10-11,2011,5000000,0,-5000000,0.462471
76360,6 Days to Air: The Making of South Park,2011-10-09,2011,0,0,0,1.775803
76372,Night People,1954-03-11,1954,0,0,0,0.9534
76380,Swedenhielms,1935-04-08,1935,0,0,0,0.021164
76382,Eternally Yours,1939-10-07,1939,0,0,0,0.077341
76395,The Soldier,1982-06-01,1982,0,0,0,0.829343
76397,Zoot Suit,1981-10-02,1981,0,0,0,1.128317
76399,She Gods of Shark Reef,1958-08-01,1958,0,0,0,0.222564
76403,DNA,1997-03-07,1997,0,0,0,1.795548
76406,Tokyo-Ga,1985-04-26,1985,0,0,0,2.306683
76411,Times Square,1980-10-17,1980,0,0,0,0.02158
76420,DC Showcase: Catwoman,2011-10-18,2011,0,0,0,2.748168
76421,Role/Play,2010-06-03,2010,0,0,0,0.585417
76422,My Louisiana Sky,2001-05-12,2001,0,0,0,0.052039
76424,Master Harold... and the Boys,2010-03-17,2010,0,0,0,0.726843
76438,Racketeer,2007-11-08,2007,800000,0,-800000,0.703172
76452,A Brief Vacation,1973-08-14,1973,0,0,0,0.41816
76464,Something to Sing About,1937-09-30,1937,0,0,0,0.367546
76465,The Strawberry Blonde,1941-02-22,1941,0,0,0,0.85457
76468,Adam,1983-10-10,1983,0,0,0,0.078865
76474,Doc Martin,2001-01-01,2001,0,0,0,1.407014
76475,Doc Martin and the Legend of the Cloutie,2003-04-30,2003,0,0,0,0.517872
76477,Saint Maybe,1998-11-22,1998,0,0,0,0.679299
76483,Murder on a Honeymoon,1935-02-22,1935,0,0,0,0.078197
76487,The Devil Inside,2012-01-06,2012,1000000,101758490,100758490,5.747675
76489,The Three Stooges,2012-04-13,2012,30000000,54819301,24819301,13.371056
76492,Hotel Transylvania,2012-09-20,2012,85000000,358375603,273375603,16.231945
76493,The Dictator,2012-05-15,2012,65000000,179379533,114379533,7.446085
76494,What to Expect When You're Expecting,2012-05-17,2012,40000000,79700000,39700000,7.271503
76498,Heartworn Highways,1976-05-01,1976,0,0,0,0.113782
76499,Barbary Coast,1935-10-13,1935,0,0,0,0.780882
76516,Meet the Applegates,1991-02-01,1991,5000000,485772,-4514228,0.399156
76532,The Adopted,2011-11-23,2011,0,0,0,1.877117
76533,By the Sea,1982-04-12,1982,0,0,0,0.008326
76535,Marvel One-Shot: A Funny Thing Happened on the Way to Thor's Hammer,2011-10-25,2011,500000,0,-500000,4.591036
76543,Tyrannosaur,2011-10-07,2011,0,22321,22321,4.548774
76544,Man of Tai Chi,2013-07-04,2013,25000000,2054941,-22945059,11.829231
76547,Felix and Lola,2001-03-07,2001,0,0,0,0.219383
76568,The Sheepman,1958-05-07,1958,0,0,0,4.544583
76575,La Marcia Su Roma,1962-01-01,1962,0,0,0,0.603519
76589,Justice League: Doom,2012-02-28,2012,0,0,0,5.803594
76600,Avatar 2,2020-12-16,2020,0,0,0,6.020055
76609,Rebellion,2011-11-16,2011,0,0,0,1.59284
76617,Texas Chainsaw 3D,2013-01-03,2013,20000000,47241945,27241945,7.214828
76636,Xala,1975-10-01,1975,0,0,0,0.050018
76638,Surviving Life (Theory and Practice),2010-09-16,2010,0,0,0,0.999634
76640,The Last Stand,2013-01-12,2013,30000000,0,-30000000,10.691321
76642,"Le printemps, l'automne et l'amour",1955-04-12,1955,0,0,0,0.001754
76649,Pompeii,2014-02-18,2014,130000000,117831631,-12168369,12.204174
76651,Jenny,1936-09-18,1936,0,0,0,0.160888
76681,Wacko,1982-11-12,1982,0,0,0,1.04407
76684,Masti,2004-04-09,2004,0,0,0,1.084702
76686,The Green Wave,2012-08-10,2012,0,0,0,0.177082
76696,Sidewalls,2011-02-01,2011,11000000,0,-11000000,3.649501
76703,Quadrille,1938-01-29,1938,0,0,0,0.387779
76706,Christmas Mail,2010-12-01,2010,0,0,0,0.832924
76714,The Journey,1959-02-19,1959,0,0,0,2.035099
76726,Chronicle,2012-02-01,2012,15000000,145000000,130000000,12.47441
76737,Princess Iron Fan,1941-01-01,1941,0,0,0,0.087558
76746,Vdrebezgi,2011-10-06,2011,400,0,-400,0.196508
76750,Holy Flying Circus,2011-10-19,2011,0,0,0,1.298334
76754,Giants and Toys,1958-06-22,1958,0,0,0,1.178603
76757,Jupiter Ascending,2015-02-04,2015,176000003,183987723,7987720,21.463465
76758,The Flowers of War,2011-12-15,2011,94000000,95311434,1311434,6.587711
76760,Labyrinth of Dreams,1997-02-15,1997,0,0,0,0.10653
76764,Who?,1974-04-18,1974,0,0,0,0.370791
76772,Deadlier Than the Male,1956-04-13,1956,0,0,0,0.580102
76775,Lovers of Paris,1957-10-18,1957,0,0,0,0.061906
76777,Marie-Octobre,1959-04-24,1959,0,0,0,0.445952
76784,All Stars 2: Old Stars,2011-10-10,2011,0,0,0,1.186702
76785,Roadie,2011-08-20,2011,0,0,0,1.475596
76788,Mankatha,2011-08-31,2011,6100000,28000000,21900000,1.145752
76790,The Chosen One: Legend of the Raven,1998-05-26,1998,0,0,0,0.125107
76793,Le bal des casse-pieds,1992-02-12,1992,0,0,0,0.005489
76794,Heaven Is a Playground,1991-10-04,1991,0,0,0,0.06908
76800,The Last Rites of Joe May,2011-10-28,2011,0,0,0,0.527218
76804,The Cat and the Canary,1927-09-09,1927,0,0,0,0.424931
76808,The Heineken Kidnapping,2011-10-27,2011,0,0,0,2.781244
76809,Black Rose Ascension,1975-01-01,1975,0,0,0,0.000189
76812,Black Butterfly,2017-05-26,2017,0,0,0,20.058633
76815,Barely Legal,2011-01-01,2011,1000000,0,-1000000,1.761457
76816,The Age of the Earth,1980-11-17,1980,0,0,0,0.63143
76817,A Journey into Bliss,2004-04-16,2004,0,0,0,0.102574
76821,Hotel America,1981-12-02,1981,0,0,0,0.317099
76822,Tales of Terror from Tokyo and All Over Japan: The Movie,2004-01-01,2004,0,0,0,0.410645
76825,Morning Patrol,1987-10-08,1987,0,0,0,1.074156
76829,Lovers Like Us,1975-11-26,1975,0,0,0,0.931462
76833,The Witch's Curse,1962-04-11,1962,0,0,0,0.08323
76846,A Guy and a Gal,1975-06-25,1975,0,0,0,0.5448
76848,A Woman's Face,1938-10-31,1938,0,0,0,0.452745
76850,Subramaniapuram,2008-07-04,2008,0,0,0,0.517078
76851,Grand Slam,1967-09-28,1967,0,0,0,0.723613
76853,Slumming,2006-02-10,2006,0,0,0,0.45877
76857,The Theory of Flight,1999-01-22,1999,0,0,0,0.836911
76864,Tic Tac,1997-10-31,1997,0,0,0,0.212894
76871,The Widow Couderc,1971-09-15,1971,0,0,0,1.211223
76875,Games,1967-09-17,1967,0,0,0,0.590414
76891,Jerry and Tom,1998-12-04,1998,0,0,0,1.071015
76940,"Hard Revenge, Milly: Bloody Battle",2009-07-11,2009,0,0,0,0.277164
76960,Rules of Single Life,2011-04-01,2011,0,0,0,0.007064
76964,The Thirteenth Guest,1932-08-09,1932,0,0,0,0.217303
76996,Love and Other Catastrophes,1996-08-01,1996,0,0,0,0.915298
77000,Bar Sport,2011-10-21,2011,5000000,0,-5000000,2.585503
77010,The Living Dead Girl,1982-10-23,1982,0,0,0,1.605782
77012,Mr. Belvedere Goes to College,1949-04-15,1949,0,0,0,0.280137
77016,End of Watch,2012-09-20,2012,7000000,48126384,41126384,7.45279
77022,The Haunted House,1929-12-02,1929,0,0,0,0.612755
77029,Death Walks on High Heels,1971-11-19,1971,0,0,0,1.264036
77041,Amongst Friends,1993-11-03,1993,0,0,0,0.111323
77051,The Cutlass,1973-01-01,1973,0,0,0,0.082778
77056,Rendezvous in Paris,1995-03-22,1995,0,0,0,0.227128
77057,Children of Hiroshima,1952-08-06,1952,0,0,0,0.293856
77060,"Mary Poppins, Goodbye",1983-06-06,1983,0,0,0,2.402161
77064,Public Access,1993-01-01,1993,0,0,0,1.292256
77067,DeadHeads,2011-04-29,2011,0,0,0,2.41568
77068,War of the Dead,2011-10-22,2011,0,0,0,1.331937
77073,Six Weeks,1982-12-24,1982,0,0,0,0.367499
77074,Romantic Comedy,1983-10-07,1983,0,0,0,1.076058
77076,Dr. Goldfoot and the Girl Bombs,1966-11-09,1966,0,0,0,0.592836
77078,A Little Night Music,1977-12-01,1977,0,0,0,0.00273
77079,Django Strikes Again,1987-10-22,1987,0,0,0,0.540326
77084,3 A.M.,2001-07-01,2001,0,0,0,1.065499
77094,The Billionaire,2011-10-20,2011,0,0,0,0.984083
77117,Sunny,2011-05-04,2011,3550000,48000000,44450000,2.700233
77118,I Accidentally Domed Your Son,2004-01-01,2004,0,0,0,0.039597
77120,A League of Ordinary Gentlemen,2004-05-05,2004,0,0,0,0.006645
77121,A Night to Remember,1942-12-10,1942,0,0,0,0.131188
77123,A Royal Scandal,1945-03-26,1945,0,0,0,0.866375
77124,Sing a Song of Sex,1967-02-23,1967,0,0,0,0.775235
77128,Absolution,1978-06-05,1978,0,0,0,0.296216
77133,The Abyss,1910-09-12,1910,0,0,0,0.331569
77137,The Barber of Rio,1996-01-01,1996,0,0,0,0.515906
77147,On the Dark Continent,1993-01-01,1993,0,0,0,0.067378
77161,American Raspberry,1977-09-12,1977,0,0,0,0.106259
77165,And God Said to Cain,1970-02-05,1970,0,0,0,0.753915
77166,Saint Jack,1979-12-05,1979,0,0,0,0.016204
77171,More Brains! A Return to the Living Dead,2011-10-18,2011,0,0,0,1.259948
77172,Pride and Prejudice,1980-01-13,1980,0,0,0,0.073979
77173,The Blood Beast Terror,1968-02-01,1968,0,0,0,1.17773
77174,ParaNorman,2012-08-03,2012,60000000,107139399,47139399,10.425038
77175,Quick,2011-07-21,2011,0,0,0,2.1771
77185,Two Days,2011-09-08,2011,16670000,0,-16670000,1.08016
77194,The Boy Who Saw the Wind,2000-07-22,2000,0,0,0,0.00245
77197,True Women,1997-05-18,1997,0,0,0,5.677012
77198,Broadway Bill,1934-11-30,1934,0,0,0,0.521533
77210,Design for Living,1933-12-29,1933,0,0,0,2.063066
77221,Black Gold,2011-12-21,2011,40000000,5446000,-34554000,6.652197
77221,Black Gold,2011-12-21,2011,40000000,5446000,-34554000,6.475665
77223,Paradise Road,1997-04-11,1997,16000000,0,-16000000,1.462139
77233,Mr. North,1988-07-22,1988,0,1221366,1221366,0.192513
77234,The Numbers Station,2013-04-18,2013,10000000,0,-10000000,7.112624
77235,You're So Cupid,2010-11-06,2010,0,0,0,0.836069
77241,Bir Avu√ß Deniz,2011-03-11,2011,0,0,0,0.775921
77245,The Prisoner of Shark Island,1936-02-28,1936,0,0,0,3.16183
77246,David and Lisa,1998-11-01,1998,0,0,0,0.459044
77248,Genius Party Beyond,2008-10-11,2008,0,0,0,0.703821
77250,The Hurricane,1937-11-05,1937,2000000,0,-2000000,0.329549
77257,Exorcismo,1975-03-10,1975,0,0,0,0.605524
77261,Five,2011-10-10,2011,0,0,0,1.627043
77269,Urbanized,2011-09-09,2011,0,0,0,1.259725
77270,Nick Cave and The Bad Seeds: God Is in the House,2001-01-01,2001,0,0,0,0.436963
77280,"Mercredi, folle journ√©e !",2001-03-28,2001,0,0,0,0.10645
77283,The Lawless Heart,2002-06-28,2002,0,0,0,0.441662
77285,Floating Clouds,1955-01-15,1955,0,0,0,1.747874
77287,The Householder,1963-10-20,1963,0,0,0,0.00213
77291,Orfeu,1999-04-21,1999,0,0,0,0.311017
77292,Resurrected,1989-03-12,1989,0,0,0,0.024529
77294,Three from Prostokvashino,1978-06-06,1978,0,0,0,1.18076
77304,Junior and Karlson,1968-01-01,1968,0,0,0,0.513688
77314,The Cabinet of Dr. Ramirez,1991-12-04,1991,0,0,0,0.0375
77322,The Orator,2011-02-21,2011,0,0,0,0.221383
77331,One in a Million,1995-08-25,1995,0,0,0,0.161001
77332,Urbania,2000-01-24,2000,0,0,0,0.445233
77333,Leo the Last,1970-09-04,1970,0,0,0,0.784126
77334,The Terrace,1980-02-08,1980,0,0,0,0.978367
77338,The Intouchables,2011-11-02,2011,13000000,426480871,413480871,16.086919
77348,Alien Nation: Body and Soul,1995-10-10,1995,0,0,0,0.219827
77350,Unzipped,1995-08-11,1995,0,0,0,0.786023
77352,Notebooks on Cities and Clothes,1989-01-01,1989,0,0,0,0.00243
77360,Place without Limits,1978-04-28,1978,0,0,0,0.000308
77365,Into the Abyss,2011-11-11,2011,0,0,0,3.551127
77381,Intimate Lighting,1965-04-08,1965,0,0,0,0.142299
77403,Disco Godfather,1979-09-04,1979,0,0,0,0.246615
77412,Romance,1930-08-26,1930,0,0,0,0.782383
77434,What's Cooking?,2000-01-20,2000,0,0,0,0.877264
77439,Where The Road Meets The Sun,2011-06-29,2011,0,0,0,0.231304
77444,The Corridor,2012-03-30,2012,0,0,0,1.633246
77448,That's Entertainment! III,1994-07-01,1994,0,0,0,2.788375
77449,Epitaph,2007-08-01,2007,0,0,0,1.096971
77451,The Things of Love,1989-01-01,1989,0,0,0,0.002538
77458,When Pigs Have Wings,2011-09-21,2011,0,0,0,1.921613
77459,A Monster in Paris,2011-10-12,2011,25000000,0,-25000000,7.093805
77460,Beur sur la ville,2011-10-11,2011,0,0,0,1.45553
77461,Where Do We Go Now?,2011-05-16,2011,0,0,0,3.809202
77462,A Happy Event,2011-09-27,2011,0,0,0,3.274786
77468,Fourteen Sucks,2004-10-29,2004,0,0,0,0.304105
77469,Your Friends & Neighbors,1998-02-04,1998,5000000,4710749,-289251,1.564774
77473,Kunskapens pris - balladen om den vilsne vandraren,2007-01-27,2007,0,0,0,0.074118
77495,Sleep Tight,2011-10-14,2011,5000000,0,-5000000,7.0713
77499,Barbie: A Perfect Christmas,2011-07-01,2011,0,0,0,6.97712
77504,Never to Lose,2005-09-29,2005,0,0,0,0.669981
77512,Montana,2008-02-07,2008,0,0,0,0.40151
77514,A Friend of the Deceased,1997-09-10,1997,0,0,0,0.117304
77519,The Libertine,2000-03-15,2000,0,0,0,1.434689
77528,Bounty Hunters,2011-04-19,2011,0,0,0,0.853292
77534,Fat Stupid Rabbit,2007-03-29,2007,0,0,0,0.442366
77546,The Queen of Spades,1949-03-16,1949,0,0,0,1.05775
77553,Hotel,1967-01-19,1967,0,0,0,1.750965
77560,Faust,2011-09-08,2011,0,0,0,2.341677
77561,EVA,2011-10-28,2011,7000000,0,-7000000,4.788492
77564,Cruelty,2007-05-17,2007,0,0,0,0.387757
77571,What Ever Happened to Aunt Alice?,1969-08-20,1969,0,0,0,0.875307
77583,Long-Term Relationship,2006-01-01,2006,0,0,0,0.182228
77585,Balls to the Wall,2011-04-30,2011,0,0,0,0.555595
77586,The Hagstone Demon,2011-09-27,2011,0,0,0,0.192393
77593,C.H.O.M.P.S.,1979-12-21,1979,0,0,0,0.009919
77600,Jasne B≈Çƒôkitne Okna,2007-01-07,2007,0,0,0,0.038584
77606,Right on Track,2003-03-21,2003,0,0,0,0.800038
77621,Within Our Gates,1920-01-12,1920,0,0,0,0.769742
77625,Moving Target,1988-02-08,1988,0,0,0,0.139717
77632,Kid Vengeance,1977-01-01,1977,0,0,0,0.068859
77633,Big Shot's Funeral,2001-12-21,2001,0,0,0,3.500979
77635,Miss Bala,2011-09-11,2011,0,0,0,2.477698
77641,Four Rode Out,1970-02-02,1970,0,0,0,0.213998
77642,Night of the Sorcerers,1974-12-16,1974,0,0,0,0.001058
77645,The Redhead from Wyoming,1953-01-08,1953,0,0,0,0.154625
77649,The Upturned Glass,1947-06-17,1947,0,0,0,0.305131
77650,Bullfighter and the Lady,1951-04-26,1951,0,0,0,0.410445
77660,The Fifth Seal,1976-10-07,1976,0,0,0,0.178354
77663,Killing Season,2013-07-12,2013,0,39881,39881,13.382027
77664,And You Thought Your Parents Were Weird!,1991-11-15,1991,0,402539,402539,0.000578
77669,The Earth Dies Screaming,1964-10-14,1964,0,0,0,0.478936
77670,Kansas,1988-09-23,1988,0,0,0,0.537607
77673,The Vengeance of the Winged Serpent,1984-11-28,1984,0,0,0,0.948754
77678,Talk About a Stranger,1952-04-18,1952,0,0,0,0.09903
77680,El robobo de la jojoya,1991-12-20,1991,0,3370574,3370574,0.481394
77710,My Uncle Killed a Guy,2004-12-12,2004,0,0,0,1.419311
77716,The Cup,2011-11-13,2011,0,0,0,0.725869
77720,100 grams for Bravery,1976-01-01,1976,0,0,0,0.573899
77728,Giorgino,1994-10-05,1994,15000000,0,-15000000,2.659592
77744,Kitty Foyle,1940-12-27,1940,0,0,0,3.487313
77745,Zenda,2009-01-08,2009,0,0,0,0.331763
77759,Vacations in Prostokvashino,1980-06-06,1980,0,0,0,1.011045
77762,Winter in Prostokvashino,1984-06-06,1984,0,0,0,0.561723
77765,The Klansman,1974-10-25,1974,5000000,0,-5000000,0.397297
77770,Women,1965-06-06,1965,0,0,0,0.275712
77771,Touki Bouki,1973-07-01,1973,0,0,0,0.043903
77775,Young People,1940-08-30,1940,0,0,0,0.165246
77776,La Dilettante,1999-07-07,1999,0,0,0,0.201405
77780,Twister,1989-06-01,1989,0,0,0,0.720198
77785,Madison County,2012-05-08,2012,0,0,0,0.836653
77786,The Net,2003-10-01,2003,0,0,0,0.012315
77787,Tribulation,2000-01-14,2000,0,0,0,0.57391
77794,I Was Monty's Double,1958-10-21,1958,0,0,0,0.148986
77801,Miss Representation,2011-01-20,2011,750000,0,-750000,1.298666
77805,Lovelace,2013-08-08,2013,10000000,1585582,-8414418,6.383512
77821,The Cost of Love,2011-01-01,2011,300000,0,-300000,0.195984
77822,The Winslow Boy,1948-09-24,1948,0,0,0,0.836101
77825,The Personals,1998-03-13,1998,0,0,0,0.447366
77829,A Hole in the Head,1998-01-01,1998,0,0,0,0.142337
77845,Lone Hero,2002-04-12,2002,0,0,0,0.567991
77850,School Spirit,1985-10-30,1985,0,0,0,1.070452
77852,Enigma,2009-05-30,2009,0,0,0,0.043624
77855,Of Love and Other Demons,2009-03-26,2009,0,0,0,0.656982
77859,Ringing Bell,1978-03-11,1978,0,0,0,0.640594
77860,The Comedy Man,1964-09-03,1964,0,0,0,0.001798
77861,The Execution of Private Slovik,1974-03-13,1974,0,0,0,0.45009
77862,Anatolian Eagles,2011-10-28,2011,0,0,0,1.094478
77864,That Girl in Yellow Boots,2010-09-27,2010,0,0,0,0.823333
77866,Contraband,2012-01-12,2012,25000000,63100000,38100000,10.595067
77874,InSight,2011-09-02,2011,0,17011,17011,1.323333
77875,Playing for Keeps,2012-11-29,2012,35000000,0,-35000000,13.270616
77876,Crazy Wisdom,2011-11-25,2011,0,0,0,0.044585
77877,The Lucky One,2012-04-19,2012,25000000,99357138,74357138,7.740762
77878,The Lady,2011-11-30,2011,0,3759582,3759582,11.155052
77879,The Reunion,2011-10-21,2011,6000000,0,-6000000,1.849497
77880,The Whale,2011-09-09,2011,0,0,0,0.961196
77881,Crime After Crime,2011-07-01,2011,0,58840,58840,0.235518
77882,The Rise and Rise of Michael Rimmer,1970-11-12,1970,0,0,0,0.003402
77883,The Possession,2012-08-30,2012,14000000,85446075,71446075,7.286477
77887,Hawaiian Vacation,2011-06-16,2011,0,0,0,11.315849
77889,Brides of Blood,1968-06-10,1968,0,0,0,0.721315
77908,Trois,2000-02-11,2000,200000,1160268,960268,0.06431
77910,For Lovers Only,2011-07-12,2011,0,0,0,0.890792
77915,The Sandpiper,1965-06-23,1965,0,0,0,1.198796
77921,Miracle In Lane 2,2000-05-13,2000,0,0,0,1.022494
77922,Laila,1929-10-14,1929,0,0,0,0.216233
77925,Lola,1970-01-01,1970,0,0,0,0.550063
77930,Magic Mike,2012-06-28,2012,7000000,167221571,160221571,8.732425
77931,The Smurfs 2,2013-07-30,2013,105000000,347434178,242434178,10.640864
77936,The School of Flesh,1998-11-18,1998,0,0,0,1.085907
77939,The False Servant,2000-03-08,2000,0,0,0,0.10775
77944,La peggior settimana della mia vita,2011-10-27,2011,11000000,12935800,1935800,5.010563
77946,Shiloh 2: Shiloh Season,1999-07-02,1999,0,0,0,0.530506
77948,The Cold Light of Day,2012-04-04,2012,20000000,16863583,-3136417,11.112153
77949,The Awakening,2011-08-17,2011,4798235,209696,-4588539,9.336568
77950,Turbo,2013-07-11,2013,135000000,282570682,147570682,8.979753
77951,Walking With Dinosaurs,2013-12-18,2013,80000000,126546518,46546518,8.883866
77953,The Campaign,2012-08-09,2012,0,104907746,104907746,7.581463
77955,Under the Skin,1997-11-28,1997,1000000,0,-1000000,0.364631
77957,Angels Crest,2011-12-30,2011,0,0,0,6.123723
77958,My Tomorrow,2011-11-04,2011,0,0,0,0.049799
77960,Desire Under the Elms,1958-03-12,1958,0,0,0,0.207169
77964,That Certain Woman,1937-09-18,1937,0,0,0,0.074806
77966,Red-Headed Woman,1932-06-25,1932,0,0,0,0.656431
77985,Maria's Lovers,1984-01-27,1984,0,0,0,1.631723
77986,A Key to the Bedroom,2003-04-18,2003,0,0,0,0.038161
77987,Only God Forgives,2013-05-30,2013,4800000,10337387,5537387,6.069475
78022,My Kingdom,2011-09-08,2011,0,0,0,0.645316
78028,Lionheart,1987-08-14,1987,0,0,0,0.200057
78041,Big Trouble,1986-05-30,1986,0,0,0,0.329531
78047,Treasure Buddies,2012-01-31,2012,0,0,0,5.470977
78049,The Scorpion King 3: Battle for Redemption,2012-01-17,2012,5000000,0,-5000000,6.922123
78056,U2: From the Sky Down,2011-10-29,2011,0,0,0,0.333467
78071,Successive Slidings of Pleasure,1974-03-07,1974,0,0,0,0.942421
78072,Nails,2003-10-01,2003,0,0,0,0.077777
78075,Abby,1974-12-25,1974,0,0,0,0.303398
78076,Hell Up In Harlem,1973-12-01,1973,0,0,0,0.957581
78080,Beethoven's Christmas Adventure,2011-11-08,2011,0,0,0,4.482895
78088,Earthling,2011-03-14,2011,0,0,0,0.9121
78093,Alyce Kills,2011-09-14,2011,0,0,0,3.521225
78094,Sunday Too Far Away,1975-06-01,1975,0,0,0,0.000308
78096,The Two Mr. Kissels,2008-11-15,2008,0,0,0,0.233742
78098,As If I Am Not There,2010-07-26,2010,0,0,0,0.509502
78101,Many Wars Ago,1970-09-16,1970,97,0,-97,0.96872
78115,The Other,2007-05-10,2007,0,0,0,0.576009
78117,Eros + Massacre,1969-10-15,1969,0,0,0,0.72679
78124,Impy's Wonderland,2008-05-01,2008,0,0,0,1.224625
78128,Miss Kicki,2009-04-01,2009,0,0,0,0.489634
78132,For the Matches,1980-01-18,1980,0,0,0,0.402254
78133,A Home of Our Own,1993-11-05,1993,12000000,1703282,-10296718,4.497919
78140,Billy Jack Goes to Washington,1977-04-16,1977,0,0,0,0.357885
78143,A Gathering of Old Men,1987-05-10,1987,0,0,0,0.079589
78146,Tough Guys Don't Dance,1987-09-18,1987,5000000,858250,-4141750,0.957019
78149,"An Alan Smithee Film: Burn, Hollywood, Burn",1998-02-20,1998,10000000,45779,-9954221,1.453096
78163,School in the Crosshairs,1981-07-11,1981,0,0,0,0.005351
78174,Van Gogh: Brush with Genius,2009-03-25,2009,0,0,0,0.189802
78177,Lianna,1983-01-18,1983,300,0,-300,0.957027
78182,Elena,2011-05-21,2011,0,0,0,3.523847
78187,Pablo Francisco: They Put it Out There,2011-11-22,2011,0,0,0,0.284354
78193,"She No Longer Talks, She Shoots",1972-08-23,1972,0,0,0,0.002001
78202,Underwater Impressions,2002-08-21,2002,0,0,0,0.186092
78206,Chicken with Plums,2011-10-25,2011,12000000,1428291,-10571709,3.78207
78208,His Brother,2003-05-15,2003,0,0,0,0.703107
78210,Mademoiselle,2001-03-21,2001,0,0,0,0.150525
78215,Into the White,2012-03-06,2012,0,704,704,9.572066
78224,Certain Prey,2011-11-06,2011,0,0,0,0.780905
78228,I Am,2005-11-04,2005,0,0,0,0.768844
78231,Babymother,1998-09-11,1998,0,0,0,0.072567
78233,The Policeman,1971-06-05,1971,0,0,0,0.002001
78235,Bad Medicine,1985-11-22,1985,0,2685453,2685453,2.945479
78237,On Probation,2005-09-29,2005,0,0,0,1.450114
78239,Full Eclipse,1993-11-27,1993,0,0,0,0.55186
78247,Night Terrors,1993-11-09,1993,0,0,0,1.011941
78248,Adanggaman,2000-08-31,2000,0,28,28,0.071765
78250,Blood Shack,1971-01-01,1971,0,0,0,0.011656
78256,The End of the Affair,1955-02-23,1955,0,0,0,0.402828
78258,Venus & Fleur,2004-06-23,2004,0,0,0,0.116116
78263,In Custody,1994-04-15,1994,0,0,0,0.002152
78265,This Woman Is Dangerous,1952-02-09,1952,0,0,0,0.968817
78274,Music for One Apartment and Six Drummers,2001-09-13,2001,0,0,0,0.178995
78278,Special Delivery,2002-12-11,2002,0,0,0,0.013177
78281,For Sale,1998-08-26,1998,0,0,0,0.384772
78282,Paul dans sa vie,2006-05-03,2006,0,0,0,0.078565
78285,The Old Lady Who Walked in the Sea,1991-09-18,1991,0,0,0,0.573423
78293,Right Now,2004-12-08,2004,0,0,0,0.236106
78294,Panic Button,2011-08-27,2011,0,0,0,4.599941
78307,On the Outs,2004-09-11,2004,0,0,0,0.254917
78308,Blood Runs Cold,2011-10-03,2011,5000,0,-5000,0.621907
78309,Answer This!,2011-10-13,2011,0,0,0,0.597181
78313,Stopped on Track,2011-12-19,2011,0,0,0,1.065109
78315,The Cross of Lorraine,1943-11-12,1943,0,0,0,4.480694
78318,Juarez,1939-06-10,1939,0,0,0,0.657739
78320,Blood and Concrete,1991-09-13,1991,0,0,0,0.897851
78321,Dog Day,1984-01-10,1984,0,0,0,0.485186
78323,Bablo,2011-10-13,2011,0,2252547,2252547,0.939805
78326,Black Thursday,2011-02-25,2011,0,0,0,0.455823
78327,The Dark Horse,1932-06-16,1932,0,0,0,0.077934
78329,Three Men in a Boat,1975-12-31,1975,0,0,0,0.098035
78331,The Solid Gold Cadillac,1956-08-22,1956,0,0,0,0.441071
78338,Alex Is Lovesick,1986-01-01,1986,0,0,0,0.46758
78339,Memory Lane,2011-10-22,2011,300,0,-300,0.473176
78340,Not Everybody's Lucky Enough to Have Communist Parents,1993-12-01,1993,0,0,0,0.359566
78344,Bonjour Monsieur Shlomi,2003-04-03,2003,0,0,0,0.298155
78353,Lucky Lady,1975-12-25,1975,13000000,24441725,11441725,0.000657
78354,Thoroughbreds Don't Cry,1937-12-03,1937,0,0,0,0.074841
78355,"Tell Me That You Love Me, Junie Moon",1970-05-11,1970,0,0,0,0.262854
78358,A Matter of Time,1976-10-07,1976,0,0,0,0.079472
78359,Mister Blot's Academy,1984-01-30,1984,0,0,0,1.084496
78362,Snow Beast,2011-10-04,2011,0,0,0,1.725014
78363,My Little Princess,2011-06-29,2011,0,0,0,3.336273
78364,The Slugger's Wife,1985-03-29,1985,0,1878561,1878561,0.000308
78373,"Dancer, Texas Pop. 81",1998-05-01,1998,0,565592,565592,0.567444
78375,CyberTracker,1994-08-22,1994,0,0,0,1.14583
78377,Idiot in Paris,1967-03-22,1967,0,0,0,1.288713
78381,Twixt,2011-09-10,2011,7000000,0,-7000000,3.836293
78383,Nurse 3-D,2013-09-28,2013,10,10000000,9999990,5.192042
78387,Heber Holiday,2007-09-15,2007,500000,0,-500000,0.15748
78399,The Savior,1971-09-01,1971,0,0,0,0.119013
78400,The City Below,2010-09-15,2010,0,0,0,0.955198
78401,Tangerine,2008-10-23,2008,0,0,0,0.05633
78402,Killer Crocodile,1989-11-15,1989,0,0,0,0.425363
78403,Born Bad,2011-07-11,2011,0,0,0,0.40735
78406,Steal Big Steal Little,1995-09-29,1995,25000000,6278139,-18721861,1.522412
78432,Before Your Eyes,2009-09-19,2009,0,0,0,0.521868
78441,Jitters,2010-08-27,2010,2000000,0,-2000000,0.552098
78450,The Terrorizers,1986-01-01,1986,0,0,0,0.730328
78461,Beneath the Darkness,2011-10-21,2011,7300000,0,-7300000,2.803973
78463,My Best Enemy,2011-02-16,2011,0,0,0,0.466254
78464,The Liquidator,2011-04-07,2011,0,0,0,2.955175
78475,Life for Two,1958-09-24,1958,0,0,0,0.163485
78476,My Worst Nightmare,2011-09-12,2011,0,0,0,3.517298
78478,You Don't Choose Your Family,2011-11-09,2011,0,0,0,2.739771
78479,Jackpot,2006-02-17,2006,0,0,0,0.652781
78480,Monsieur Lazhar,2011-09-10,2011,0,6581915,6581915,8.811218
78492,Ken,1964-03-14,1964,0,0,0,0.66192
78504,Restitution,2011-10-28,2011,0,0,0,0.7031
78507,Spies,1928-03-22,1928,0,0,0,1.350301
78522,Prime Evil,1988-01-01,1988,0,0,0,0.063059
78526,The Last Dispatch,2005-07-29,2005,0,0,0,0.002368
78527,Jimmy Carter Man from Plains,2007-10-26,2007,0,108282,108282,0.109565
78531,One Bright Shining Moment,2005-09-16,2005,0,15504,15504,0.037986
78534,How to Keep the Red Lamp Burning,1965-10-28,1965,0,0,0,0.494739
78537,Lady Killer,1937-09-15,1937,0,0,0,0.124359
78539,All About Love,2001-04-11,2001,0,0,0,0.693538
78546,The Antichrist,1974-11-22,1974,0,0,0,7.677022
78547,Une femme d'ext√©rieur,2000-01-26,2000,0,0,0,0.036477
78550,Seven Ways from Sundown,1960-09-25,1960,0,0,0,0.586262
78552,Sweet Sixteen,1983-03-18,1983,0,0,0,0.369025
78563,The Giants,2011-05-20,2011,0,0,0,0.588546
78566,Gangsters,1977-01-01,1977,0,0,0,0.00068
78568,"Late August, Early September",1998-09-14,1998,0,0,0,0.977617
78570,Top Cat The Movie,2011-09-16,2011,0,0,0,3.753514
78571,Being Flynn,2012-03-02,2012,0,540152,540152,4.494016
78572,All the Boys Are Called Patrick,1959-10-03,1959,0,0,0,0.244688
78573,The Gerson Miracle,2004-01-01,2004,100,0,-100,0.644469
78595,Nightshift,2001-03-14,2001,0,0,0,0.065549
78604,Michael,2011-05-12,2011,0,0,0,2.932292
78646,She Monkeys,2011-01-31,2011,1,0,-1,1.006534
78657,Ouch,2000-09-06,2000,0,0,0,0.053858
78691,Slam Dance,1987-10-02,1987,0,406881,406881,0.488789
78694,The Fearless Four,1997-10-02,1997,0,0,0,0.142535
78696,Ruudi,2006-02-24,2006,0,0,0,0.116183
78698,Big Miracle,2012-02-02,2012,40000000,24719215,-15280785,6.159379
78701,Kisna: The Warrior Poet,2005-01-21,2005,0,0,0,0.176189
78705,Live-In Maid,2004-09-21,2004,0,0,0,0.9422
78713,Pollyanna,2003-01-01,2003,0,0,0,0.375943
78715,Toomelah,2011-05-16,2011,0,0,0,0.541323
78734,In Old Chicago,1937-04-14,1937,0,0,0,2.599163
78789,Tomorrow We Move,2004-03-03,2004,0,0,0,0.270612
78802,Wings of Courage,1996-09-18,1996,0,0,0,0.745542
78812,Escape by Night,1960-07-31,1960,0,0,0,0.883096
78827,Deewangee,2002-10-25,2002,0,0,0,0.524556
78854,Scialla!,2011-11-18,2011,0,0,0,2.125994
78992,The Passenger,2006-03-22,2006,0,0,0,0.115645
78997,Jimi Hendrix: Voodoo Child,2010-09-18,2010,0,0,0,0.220829
78998,Desire,1936-04-11,1936,0,0,0,0.814748
78999,Virtual JFK: Vietnam If Kennedy Had Lived,2008-09-17,2008,0,0,0,0.040081
79000,Tales of the Night,2011-07-20,2011,0,0,0,1.101575
79008,Jinxed!,1982-10-22,1982,0,0,0,0.019442
79009,The End of Old Times,1990-02-01,1990,0,0,0,0.035199
79016,Homevideo,2011-08-18,2011,0,0,0,0.80436
79025,A Hero of Our Times,1955-01-01,1955,0,0,0,0.145509
79031,A Loving Father,2002-11-13,2002,0,0,0,0.399371
79034,La Californie,2006-10-26,2006,0,0,0,0.004195
79040,Nova Zembla,2011-11-23,2011,0,0,0,4.16771
79042,If a Tree Falls: A Story of the Earth Liberation Front,2011-06-22,2011,0,0,0,0.977799
79043,The Story of Marie and Julien,2003-09-10,2003,0,0,0,0.359482
79048,C'est la vie,2001-11-07,2001,0,0,0,0.001714
79051,Ninette,2005-08-12,2005,0,0,0,0.472872
79054,The Revenge of the Teenage Vixens from Outer Space,1985-01-01,1985,0,0,0,0.007449
79070,Sleepless Night,2011-11-14,2011,2500000,3358,-2496642,2.942355
79072,Falling,2006-09-08,2006,2705100,0,-2705100,0.447234
79073,Messages Deleted,2009-02-05,2009,0,0,0,1.653787
79078,11/11/11,2011-11-01,2011,0,0,0,0.523321
79090,Why We Fight: The Battle of Britain,1943-10-10,1943,0,0,0,0.071763
79094,Return of Django,1967-05-26,1967,0,0,0,0.038696
79106,Sherlock Holmes: Incident at Victoria Falls,1992-05-24,1992,0,0,0,0.106986
79108,Starbuck,2011-01-01,2011,0,0,0,5.79967
79113,A Princess for Christmas,2011-12-03,2011,0,0,0,6.73437
79118,Hamsun,1996-04-19,1996,0,0,0,0.937559
79120,Weekend,2011-09-22,2011,8000,484592,476592,4.727171
79133,"Dylan Moran: Yeah, Yeah",2011-11-14,2011,0,0,0,0.881995
79137,Russell Howard: Right Here Right Now,2011-11-14,2011,0,0,0,0.150373
79145,John Cleese - The Alimony Tour Live,2011-08-11,2011,0,0,0,0.121652
79151,Love You You,2011-10-13,2011,0,0,0,0.780776
79156,9 Star Hotel,2007-07-22,2007,0,0,0,0.003741
79161,51 Birch Street,2006-10-18,2006,0,0,0,0.228169
79163,95 Miles to Go,2006-04-07,2006,0,2203,2203,0.003568
79172,Surviving Progress,2011-11-04,2011,0,0,0,0.238258
79179,God's Country,1985-06-07,1985,0,0,0,0.00022
79180,Libel,1959-10-23,1959,0,0,0,0.153857
79190,Jabberwock Dragon Siege,2011-09-09,2011,0,0,0,1.488831
79192,Apache Vengeance,1971-10-01,1971,0,0,0,0.000578
79194,God's Gun,1976-01-01,1976,0,0,0,0.260415
79201,God Bless Ozzy Osbourne,2011-04-24,2011,0,0,0,0.420825
79210,Chatrapathi,2005-09-30,2005,0,0,0,0.240434
79212,The Extreme Tragic Story of Celal Tan and His Family,2011-11-16,2011,300000,0,-300000,0.524527
79216,The Magic Ring,1979-01-01,1979,0,0,0,0.050018
79218,Ice Age: A Mammoth Christmas,2011-11-24,2011,0,0,0,7.009931
79221,Letters to Santa,2011-11-11,2011,0,0,0,1.805839
79224,War of the Arrows,2011-08-10,2011,8000000,49000000,41000000,7.030308
79234,Wandering Sagittarius,1993-06-06,1993,0,0,0,0.008939
79236,Young Love,2001-08-30,2001,0,0,0,0.898698
79247,Wyjazd Integracyjny,2011-11-04,2011,0,0,0,0.143968
79255,The Mortician,2011-02-15,2011,0,0,0,2.704503
79257,Mother Lode,1982-09-23,1982,0,0,0,0.717144
79280,Sweet Lies,2008-12-17,2008,0,0,0,0.14898
79306,Snowriders,1996-10-17,1996,0,2035470,2035470,0.001223
79308,Virtue,1932-10-25,1932,0,0,0,0.024489
79316,Devil's Due,2014-01-08,2014,7000000,36433975,29433975,10.591125
79319,The Incubus,1982-08-27,1982,0,0,0,1.011264
79327,The Littlest Angel,2011-11-07,2011,0,0,0,0.498207
79329,Treevenge,2008-07-07,2008,0,0,0,2.341853
79331,The Gunfight at Dodge City,1959-05-01,1959,0,0,0,3.408795
79343,Les fourmis rouges,2007-11-14,2007,0,0,0,0.04033
79354,Engeyum Eppodhum,2011-09-16,2011,0,0,0,0.299933
79361,Jonas,2012-01-05,2012,0,0,0,0.716933
79362,Sommer der Gaukler,2011-12-22,2011,0,0,0,0.154501
79363,Dementia,1955-12-22,1955,0,0,0,0.736475
79365,The Jayne Mansfield Story,1980-10-29,1980,0,0,0,0.483373
79367,The Venetian Affair,1967-01-18,1967,0,0,0,0.114933
79372,Tortilla Flat,1942-05-21,1942,0,0,0,0.822419
79374,Blind,2011-08-10,2011,0,0,0,1.826986
79376,Woman of Antwerp,1948-09-03,1948,0,0,0,0.368717
79378,Debtocracy,2011-04-06,2011,0,0,0,0.241109
79382,I Wish,2011-06-11,2011,0,0,0,2.512335
79401,Gone to Earth,1950-11-06,1950,0,0,0,0.230063
79404,Treacle Jr.,2010-10-06,2010,0,0,0,0.112839
79406,Samurai Assassin,1965-01-03,1965,0,0,0,1.196723
79419,The First Snow of Winter,1998-12-25,1998,0,0,0,0.092718
79426,Crime Boss,1972-08-08,1972,0,0,0,0.00022
79431,Farts of Fury,2011-03-17,2011,0,0,0,0.011724
79433,Ronal the Barbarian,2011-09-27,2011,0,0,0,9.021421
79434,A-1 Headline,2004-09-09,2004,0,0,0,0.851813
79435,Night Wind,1999-03-03,1999,0,0,0,0.203538
79456,Gone with the Pope,2010-03-12,2010,0,0,0,0.792189
79464,Rockstar,2011-11-11,2011,10920000,19660000,8740000,2.009033
79465,Loosies,2012-02-01,2012,0,0,0,4.54588
79466,One Spy Too Many,1966-08-05,1966,0,0,0,1.112717
79474,"Not Love, Just Frenzy",1996-11-15,1996,0,0,0,0.217406
79475,The Green,2011-11-22,2011,0,0,0,0.467233
79483,Jimmy Carr: Being Funny,2011-11-21,2011,0,0,0,0.309219
79500,Prehysteria!,1993-06-30,1993,0,0,0,0.411968
79506,Getting Away with It the Italian Way,1962-05-04,1962,0,0,0,0.002225
79509,The Ambulance,1989-11-23,1989,0,0,0,1.756955
79515,Black Tar Heroin: The Dark End of the Street,2000-03-17,2000,0,0,0,0.232074
79516,TEKKEN: Blood Vengeance,2011-07-26,2011,0,0,0,5.81731
79519,Shades of Ray,2008-10-18,2008,0,0,0,1.394956
79521,Miracle in the Rain,1956-03-31,1956,0,0,0,0.504255
79526,Duska,2007-10-04,2007,0,0,0,0.18933
79528,Secrets of the Tribe,2010-01-22,2010,0,0,0,0.043862
79544,The Wicker Tree,2011-08-27,2011,7750000,0,-7750000,1.367916
79548,Gone,2012-02-23,2012,0,18100189,18100189,9.384244
79550,Rogue River,2012-01-16,2012,2000000,0,-2000000,2.281582
79553,The Front Line,2011-07-20,2011,10000000,0,-10000000,4.13924
79554,Jess + Moss,2011-01-23,2011,0,0,0,0.317656
79570,Beat the Drum,2003-10-10,2003,2000000,0,-2000000,0.211156
79572,Execution Squad,1972-02-25,1972,0,0,0,0.074429
79580,Home,2011-11-03,2011,0,0,0,0.807773
79591,Ten Minutes Older: The Cello,2002-09-03,2002,0,0,0,1.203539
79593,The Tie That Binds,1995-09-08,1995,14000000,5780000,-8220000,1.820419
79594,The Sixth,1981-12-18,1981,0,0,0,0.001429
79596,The Emperor's Nightingale,1949-04-15,1949,0,0,0,0.190507
79599,The Hunchback of Notre-Dame,1986-01-01,1986,0,0,0,0.093542
79611,Target,2011-06-26,2011,0,73000,73000,1.042112
79615,Square Dance,1987-03-01,1987,0,225358,225358,0.200027
79628,TT3D: Closer to the Edge,2011-04-22,2011,0,0,0,2.73673
79631,Merlusse,1938-03-16,1938,0,0,0,0.358163
79640,The One,2011-10-07,2011,0,0,0,0.199472
79644,Godfrey: Black By Accident,2011-08-30,2011,0,0,0,0.116337
79645,The Grissom Gang,1971-05-28,1971,0,0,0,0.532225
79649,Eyes of a Stranger,1981-02-11,1981,800000,0,-800000,0.717502
79678,Introducing... Janet,1981-01-01,1981,0,0,0,0.550453
79683,Bad Man's River,1971-12-03,1971,0,0,0,1.163004
79684,Contraband,1940-05-11,1940,4490331,0,-4490331,0.075064
79690,J.J. Cale - To Tulsa And Back (On tour with J.J. Cale),2006-06-13,2006,0,0,0,0.350938
79694,The Apparition,2012-08-23,2012,17000000,9627492,-7372508,7.683008
79697,Butter,2011-09-03,2011,0,175706,175706,8.328357
79698,The Lovers,2015-02-13,2015,27000000,0,-27000000,2.183423
79699,A Warrior's Heart,2011-12-02,2011,2500000,0,-2500000,7.72479
79700,RUSH: Time Machine,2011-11-08,2011,0,0,0,0.977775
79701,Gena the Crocodile,1969-12-30,1969,0,0,0,0.881504
79707,Children Who Chase Lost Voices,2011-05-07,2011,0,0,0,5.458619
79708,Pink Floyd: Behind the Wall,2005-01-01,2005,0,0,0,0.822613
79720,Santa and the Ice Cream Bunny,1972-01-01,1972,0,0,0,0.142255
79721,Extinction: The G.M.O. Chronicles,2011-01-01,2011,0,0,0,1.526679
79722,Dark Rising 2:  Summer Strikes Back,2011-08-09,2011,0,0,0,0.849195
79723,New Kids Nitro,2011-12-07,2011,0,0,0,2.73888
79728,Nicostratos the Pelican,2011-06-29,2011,0,0,0,1.310385
79730,Sea Wife,1957-10-16,1957,0,0,0,0.738815
79731,Suraj Ka Satvan Ghoda,1993-01-02,1993,0,0,0,0.171156
79733,Vysotsky: Thank God I'm Alive,2011-12-01,2011,12000000,0,-12000000,0.945733
79735,Shoot Out,1971-08-16,1971,0,0,0,0.562821
79737,Au Pair 3: Adventure in Paradise,2009-03-15,2009,0,0,0,0.21929
79743,What Became of Us,2009-12-11,2009,0,0,0,0.00589
79750,The Assassin of Rome,1972-01-01,1972,0,0,0,0.000864
79754,Verbo,2011-11-04,2011,0,0,0,1.241674
79757,Tempest,1928-05-27,1928,0,0,0,0.574687
79761,The Iron Mask,1929-02-21,1929,0,0,0,0.351862
79767,Rolling Family,2004-09-06,2004,0,0,0,0.469667
79771,Chillerama,2011-10-14,2011,0,0,0,3.644134
79773,Blood in the Mobile,2010-11-29,2010,0,0,0,0.306712
79775,The Old Man and the Sea,1990-03-25,1990,0,0,0,0.96425
79777,In the Land of Blood and Honey,2011-12-23,2011,10000000,303877,-9696123,2.772269
79778,The Odds,2012-03-02,2012,0,0,0,0.183403
79779,Pastorela,2011-11-11,2011,0,0,0,0.967735
79781,The Last Fall,2012-03-09,2012,0,0,0,0.561833
79782,Venice,2010-05-25,2010,0,0,0,0.14713
79783,Camilla,1994-11-25,1994,8500000,250993,-8249007,0.50525
79785,Harlequin,1980-03-28,1980,0,0,0,0.504405
79816,Thank God He Met Lizzie,1997-11-20,1997,0,0,0,0.402696
79818,A Christmas Memory,1997-12-21,1997,0,0,0,0.239863
79823,Schizoid,1980-09-01,1980,0,0,0,0.156142
79825,Falling Overnight,2011-11-11,2011,50000,0,-50000,0.372805
79827,The Intruder,1962-05-14,1962,0,0,0,1.44562
79829,For Neda,2010-06-14,2010,0,0,0,0.242245
79833,The Infinite Worlds of H.G. Wells,2001-08-05,2001,0,0,0,0.091346
79836,Il giorno in pi√π,2011-12-02,2011,0,0,0,1.273677
79838,The Flying Doctors of East Africa,1970-05-02,1970,0,0,0,0.011938
79842,SeaFood,2011-10-07,2011,2219684,0,-2219684,1.845126
79850,Holidays by the Sea,2011-06-29,2011,0,0,0,0.492842
79853,38 Parrots,1976-07-13,1976,0,0,0,0.249778
79854,18 Meals,2010-06-12,2010,0,0,0,0.896178
79860,Mirrored Mind,2006-11-05,2006,0,0,0,0.153654
79869,Bigfoot: The Unforgettable Encounter,1994-01-01,1994,0,0,0,0.233885
79871,Crazy Love,1993-06-15,1993,0,0,0,1.575255
79877,Tender Scoundrel,1966-12-12,1966,0,0,0,1.928445
79887,Rings on Her Fingers,1942-03-20,1942,0,0,0,0.277579
79888,The Cemetery Club,1993-02-03,1993,0,0,0,0.562187
79890,Khodorkovsky,2011-11-17,2011,0,0,0,1.658213
79892,Tower of Nesle,1955-03-18,1955,0,0,0,0.808367
79893,Breaking the Taboo,2011-06-03,2011,2000000,0,-2000000,1.252385
79896,The Revenant,2009-08-16,2009,0,0,0,8.156758
79906,Occupant,2011-10-14,2011,0,0,0,1.325986
79908,Outing Riley,2004-01-01,2004,0,0,0,0.431054
79909,Boys Love Gekijouban,2007-08-01,2007,0,0,0,1.240719
79911,Weasels Rip My Flesh,1979-01-01,1979,400,0,-400,0.001736
79919,Harvest,2011-02-16,2011,0,0,0,0.821261
79920,Boys Life 3,2000-11-16,2000,0,0,0,0.300894
79921,Special Section,1975-04-23,1975,0,0,0,0.520171
79924,Oh Happy Day,2007-01-01,2007,0,0,0,0.178514
79927,The Pope Must Die,1991-06-21,1991,0,0,0,9.015632
79934,The Clown,2011-10-28,2011,0,0,0,2.587144
79935,Fortress,2012-04-01,2012,5000000,0,-5000000,1.362616
79940,Tim and Eric's Billion Dollar Movie,2012-03-02,2012,0,0,0,1.870115
79950,Naked Souls,1996-05-18,1996,0,0,0,0.270176
79964,The Good Humor Man,1950-06-01,1950,0,0,0,0.319215
79968,Gang Bullets,1938-11-10,1938,0,0,0,0.034202
79983,Padre nuestro,2007-10-05,2007,54166,0,-54166,0.312837
79990,Desi Boyz,2011-11-25,2011,0,0,0,1.875217
79995,Late Bloomers,2011-07-13,2011,0,0,0,1.241076
79997,80 Million,2011-11-25,2011,0,0,0,0.637913
80012,Face of Terror,2004-02-28,2004,0,0,0,0.37175
80015,Hollywoo,2011-12-07,2011,0,0,0,4.511758
80019,Larry Flynt: The Right to Be Left Alone,2007-01-01,2007,0,0,0,0.076093
80027,Kings of the Sun,1963-12-18,1963,0,0,0,0.443636
80030,Her Highness and the Bellboy,1945-11-11,1945,0,0,0,0.716533
80031,The Magnet,1950-10-01,1950,0,0,0,0.216391
80032,I Love Melvin,1953-03-20,1953,0,0,0,0.200861
80034,Earth's Final Hours,2011-05-31,2011,1800000,0,-1800000,1.396593
80035,The Watch,2012-07-26,2012,68000000,68267862,267862,13.276971
80038,Friends with Kids,2011-09-09,2011,0,12186625,12186625,7.907571
80041,The Runway,2010-07-10,2010,0,0,0,0.166675
80046,Red Line 7000,1965-11-09,1965,0,0,0,0.846066
80047,Rowing with the Wind,1988-01-01,1988,0,0,0,0.00469
80048,Rid Of Me,2011-11-18,2011,0,0,0,0.233401
80054,Primrose Path,1940-03-22,1940,0,0,0,0.061705
80059,The Tattooed Widow,1998-03-10,1998,0,0,0,0.012333
80067,The Suspicious Death of a Minor,1975-08-12,1975,0,0,0,0.896633
80070,On the Edge,2001-08-10,2001,7000000,0,-7000000,0.544866
80080,Fruit of Paradise,1970-07-31,1970,0,0,0,0.103347
80082,Tiger in the Smoke,1956-11-27,1956,0,0,0,0.876439
80086,The Son of Monte Cristo,1940-12-05,1940,0,0,0,0.525543
80089,Parasite Dolls,2003-05-22,2003,0,0,0,0.737868
80090,Noose,1948-09-28,1948,0,0,0,0.449781
80094,The Apple Game,1977-01-16,1977,0,0,0,0.00022
80105,Fuga de cerebros 2,2011-12-02,2011,0,0,0,0.96936
80115,The Happiest Girl in the World,2009-05-08,2009,0,0,0,0.209044
80122,Captain Thunder,2011-10-07,2011,0,0,0,0.892609
80125,Woman in Love,2011-12-15,2011,0,0,0,3.265632
80136,Pingpong,2006-05-19,2006,0,0,0,3.439043
80142,Sleeping Betty,2007-01-01,2007,0,0,0,0.219727
80145,"Excuse Me Darling, But Lucas Loved Me",1997-01-30,1997,0,0,0,0.072695
80147,Coming & Going,2011-07-15,2011,0,0,0,1.32237
80151,Never Take Sweets from a Stranger,1960-03-04,1960,0,0,0,3.454116
80153,Code 37,2011-10-26,2011,0,0,0,0.387954
80155,Incognito from St.Petersburg,1977-01-01,1977,0,0,0,0.175357
80156,Gadar: Ek Prem Katha,2001-06-15,2001,0,0,0,0.52361
80168,The Wild Party,1929-04-06,1929,0,0,0,0.369766
80169,Thrive,2011-11-11,2011,0,0,0,1.179601
80177,Mercenaries,2011-09-01,2011,0,0,0,0.788562
80178,Little Man,2006-04-07,2006,0,0,0,0.666729
80184,The Hidden Face,2011-09-16,2011,0,0,0,9.412493
80188,Boy Wonder,2010-08-11,2010,0,0,0,5.376548
80193,The Big Stampede,1932-10-08,1932,0,0,0,0.247007
80196,Invisible Stripes,1939-12-30,1939,0,0,0,1.250248
80198,Swedish Auto,2006-06-27,2006,0,0,0,0.017336
80200,Velocity Trap,1999-02-22,1999,0,0,0,0.316238
80210,The Undefeated,2011-07-15,2011,1000000,0,-1000000,0.187487
80211,Weekend Pass,1984-02-03,1984,0,21058000,21058000,0.442148
80215,Indie Game: The Movie,2012-05-18,2012,0,0,0,7.843916
80218,Plain Dirty,2003-01-20,2003,0,0,0,0.125076
80219,Homeless to Harvard: The Liz Murray Story,2003-04-07,2003,0,0,0,5.091993
80220,Peppermint Soda,1977-12-14,1977,0,0,0,0.859103
80241,Green Fire,1954-12-29,1954,0,0,0,0.454731
80243,Unknown Pleasures,2002-06-06,2002,0,0,0,0.737946
80256,Garter Snake,2011-08-05,2011,0,0,0,0.890978
80264,The Strange One,1957-04-12,1957,0,0,0,0.013542
80267,Cocaine: One Man's Seduction,1983-08-08,1983,0,0,0,0.007321
80271,LOL,2012-02-10,2012,11000000,0,-11000000,10.005198
80274,Ender's Game,2013-10-23,2013,110000000,125537191,15537191,12.500305
80276,Dookudu,2011-09-23,2011,0,0,0,0.468642
80277,Maktub,2011-12-16,2011,0,0,0,0.631061
80278,The Impossible,2012-09-09,2012,42000000,180274123,138274123,10.027434
80280,[REC]¬≥ Genesis,2012-03-30,2012,0,10158000,10158000,5.335003
80281,Oosaravelli,2011-10-06,2011,0,0,0,0.978568
80284,Enlightened blood,2008-04-25,2008,0,0,0,0.257484
80287,Rent-a-Cop,1987-11-28,1987,0,0,0,0.912369
80294,Suspicious River,2000-09-09,2000,0,0,0,0.748643
80296,Forbidden Love Game,1975-06-06,1975,0,0,0,0.721798
80301,A Christmas Wedding Tail,2011-11-19,2011,0,0,0,0.965948
80303,That's Cunning! Shijo Saidai no Sakusen?,1996-08-10,1996,0,0,0,0.142684
80304,Casa De Mi Padre,2012-03-15,2012,0,0,0,5.00162
80310,Children's Island,1980-12-25,1980,0,0,0,2.459595
80314,Young Thugs: Nostalgia,1998-09-26,1998,0,0,0,0.249609
80316,Phffft!,1954-11-10,1954,0,0,0,0.528521
80318,The Motel Life,2012-11-16,2012,0,0,0,14.244826
80320,These Thousand Hills,1959-07-24,1959,0,0,0,0.454578
80321,Madagascar 3: Europe's Most Wanted,2012-06-06,2012,145000000,746921274,601921274,13.829042
80324,Innocent Sorcerers,1960-12-17,1960,0,0,0,0.407564
80327,I Am I,2013-04-27,2013,112000,0,-112000,0.774427
80337,These Amazing Shadows,2011-01-22,2011,0,0,0,1.263586
80343,Lady Dragon,1992-03-13,1992,0,0,0,0.013945
80346,Nobody Knows Anything!,2003-10-01,2003,0,0,0,4.362874
80350,Tough and Deadly,1995-02-14,1995,0,0,0,0.426887
80351,The Castaway Cowboy,1974-08-01,1974,0,0,0,0.022568
80362,Savage,2011-03-11,2011,900000,0,-900000,0.371581
80364,Easy Living,1937-07-16,1937,0,0,0,1.170418
80368,The Doctor and the Devils,1985-10-04,1985,0,0,0,2.993009
80374,Toto and the King of Rome,1951-01-01,1951,0,0,0,0.386718
80379,Louis C.K.: Live at the Beacon Theater,2011-12-10,2011,250000,1000000,750000,4.297654
80382,The Hireling,1973-06-10,1973,0,0,0,0.089317
80384,Breaking Wind,2012-03-27,2012,0,0,0,3.488991
80386,Queen: Made in Heaven,1997-02-01,1997,0,0,0,0.00122
80387,Carol Channing: Larger Than Life,2012-01-20,2012,0,0,0,0.023955
80389,Get the Gringo,2012-03-15,2012,35000000,0,-35000000,6.195103
80394,Galerions Rion,2004-04-06,2004,0,0,0,0.002497
80410,In the Name of the King 2: Two Worlds,2011-11-03,2011,4500000,0,-4500000,4.515396
80427,Platform,2000-09-04,2000,0,0,0,0.622742
80432,The Wayshower,2011-04-10,2011,0,0,0,0.328428
80435,Lovers of Hate,2010-02-11,2010,0,0,0,0.258371
80437,The Finger,2011-05-26,2011,0,0,0,0.007498
80440,A Burning Hot Summer,2011-09-28,2011,0,0,0,3.440695
80441,We Still Kill the Old Way,1967-02-22,1967,0,0,0,0.991732
80443,It's a Hard Life,1964-04-22,1964,0,0,0,0.072218
80468,Some Guy Who Kills People,2011-04-14,2011,300000,0,-300000,3.0645
80469,Groenten uit Balen,2011-12-14,2011,0,0,0,0.839601
80470,Modigliani of Montparnasse,1958-04-04,1958,0,0,0,0.767372
80471,Beloved/Friend,1999-01-29,1999,0,0,0,0.600431
80472,Garbage Prince,2011-07-29,2011,0,0,0,0.0105
80473,Black Day Blue Night,1996-07-25,1996,0,0,0,0.481012
80518,Fullmetal Alchemist: The Sacred Star of Milos,2011-07-02,2011,0,7401480,7401480,2.463401
80520,Second Nature,2003-06-22,2003,0,0,0,1.002023
80521,All Mine to Give,1957-11-13,1957,0,0,0,0.150874
80523,Steal a Pencil for Me,2007-01-01,2007,0,0,0,0.039765
80527,Stargate SG-1: Children of the Gods - Final Cut,2009-07-21,2009,0,0,0,3.828454
80530,Magic Beyond Words: The JK Rowling Story,2011-07-18,2011,0,0,0,4.786893
80539,Panjaa,2011-12-09,2011,6,0,-6,0.260921
80544,A Christmas Wish,2011-11-20,2011,0,0,0,1.253431
80545,Wedding Belles,2007-03-29,2007,0,0,0,0.42911
80555,Wind Across the Everglades,1958-09-11,1958,0,0,0,0.153594
80556,The Chess Players,1977-10-02,1977,0,0,0,0.813813
80560,Wanda,1970-09-01,1970,0,0,0,0.337334
80572,Intruder in the Dust,1949-11-22,1949,0,0,0,2.038165
80582,Dying To Have Known,2006-05-05,2006,0,0,0,0.110046
80585,Rock of Ages,2012-06-13,2012,75000000,59418613,-15581387,12.558042
80591,W.E.,2011-09-01,2011,15000000,868439,-14131561,4.974482
80592,The Man from Monterey,1933-07-15,1933,0,0,0,0.430045
80595,The Frightened City,1961-09-01,1961,0,0,0,0.219878
80596,The Magic Box,1951-01-01,1951,0,0,0,0.401331
80597,My Perestroika,2010-01-24,2010,0,0,0,0.347137
80601,Seduction,1973-01-01,1973,0,0,0,1.80927
80607,Daffy Duck's Movie: Fantastic Island,1983-08-05,1983,0,0,0,1.437609
80608,Naked Paradise,2002-06-13,2002,0,0,0,0.020294
80609,Au Pair II,2001-04-22,2001,0,0,0,0.319967
80613,"Eversmile, New Jersey",1989-09-11,1989,0,0,0,0.511066
80616,The More the Merrier,1943-03-26,1943,0,0,0,0.827541
80617,Mythbusters Holiday Special,2006-12-06,2006,0,0,0,1.186651
80618,He's Mine Not Yours,2011-12-06,2011,0,0,0,0.117226
80624,The Godsend,1980-01-25,1980,0,0,0,0.516016
80633,The Hands of Orlac,1960-12-01,1960,0,0,0,0.64846
80639,They Won't Forget,1937-10-09,1937,0,0,0,0.434492
80647,Chanbara Striptease,2008-06-06,2008,0,0,0,0.635127
80648,Heart of Stone,2001-09-26,2001,0,0,0,0.077256
80653,Savage Beasts,1984-01-11,1984,0,0,0,0.350577
80659,Get Well Soon,2001-12-20,2001,0,0,0,0.720653
80660,The Perfect Husband,2004-02-12,2004,0,0,0,0.528891
80662,Guilty of Romance,2011-09-30,2011,0,0,0,3.638912
80670,"Siberia, Monamour",2011-03-08,2011,0,0,0,1.999736
80677,The Law,1959-01-25,1959,0,0,0,0.478178
80680,Baby Needs a New Pair of Shoes,1974-11-01,1974,0,0,0,0.11544
80699,Miss Julie,2011-07-07,2011,0,0,0,0.266035
80701,The Master and Margaret,1972-07-15,1972,0,0,0,0.750173
80705,Westfront 1918,1930-05-23,1930,0,0,0,1.059412
80708,The Divorcee,1930-04-19,1930,340,0,-340,0.648708
80709,The Borrowers,2011-12-25,2011,0,0,0,1.852427
80713,Alone,1999-03-05,1999,0,0,0,0.454971
80717,Violeta Went to Heaven,2011-08-11,2011,0,0,0,0.149482
80720,You'll Find Out,1940-11-22,1940,0,0,0,0.506712
80742,School of Seduction,2004-09-17,2004,0,0,0,0.496216
80746,The Age of Love,1954-01-09,1954,0,0,0,0.003157
80754,Love in First Class,1980-08-12,1980,0,0,0,0.354072
80767,Jiro Dreams of Sushi,2011-06-11,2011,0,2550508,2550508,7.789413
80771,There Goes My Heart,1938-10-14,1938,0,0,0,0.038042
80775,Away All Boats,1956-08-16,1956,0,0,0,0.765089
80787,Codebreaker,2011-11-21,2011,0,0,0,3.605686
80799,All Is Forgiven,2007-09-26,2007,0,0,0,0.259367
80801,Scabbard Samurai,2011-06-11,2011,0,0,0,1.754357
80805,Simhadri,2003-07-09,2003,0,0,0,0.835405
80806,Above and Beyond,1952-12-31,1952,0,0,0,0.397083
80809,Perry Mason Returns,1985-12-01,1985,0,0,0,0.159935
80831,Sang Pemimpi,2009-12-17,2009,0,0,0,0.083371
80837,Dead Genesis,2010-08-10,2010,15000,0,-15000,0.293401
80844,The Other Side of Midnight,1977-06-08,1977,0,0,0,0.517164
80849,"Good Evening, Mr. Wallenberg",1990-10-05,1990,0,0,0,0.411203
80850,Goin' to Town,1935-04-25,1935,0,0,0,0.665062
80853,Tennessee Johnson,1942-12-01,1942,0,0,0,0.043458
80880,Aarya,2004-05-07,2004,0,0,0,0.331045
80881,The City Without Jews,1924-07-25,1924,0,0,0,0.15037
80890,The Great Gatsby,1949-07-13,1949,0,0,0,0.213435
80911,Payday,1973-09-22,1973,760000,0,-760000,0.20268
80918,Broadway Rhythm,1944-01-19,1944,0,0,0,0.001753
80919,Game 6,2005-03-10,2005,0,0,0,4.396455
80920,Repentance,2014-02-28,2014,5000000,1189612,-3810388,1.962873
80928,Babes in the Woods,1932-11-19,1932,16855,0,-16855,1.6785
80941,Two Girls and a Sailor,1944-06-14,1944,0,0,0,0.128616
80957,Pressed,2011-02-18,2011,0,0,0,1.579853
80960,Masquerade in Vienna,1934-09-27,1934,0,0,0,0.218456
80961,√á√∂p√ß√ºler Kralƒ±,1977-08-09,1977,0,0,0,0.329258
80965,Blind Date,1984-06-01,1984,0,0,0,0.028517
80970,Schoolgirl Hitchhikers,1973-08-16,1973,0,0,0,0.048597
80973,The Girl from the Naked Eye,2012-06-15,2012,1100000,0,-1100000,5.439326
80988,Young Aphrodites,1963-06-06,1963,0,0,0,0.709258
80990,Parental Guidance,1996-06-06,1996,0,0,0,4.195102
80992,Two Queens and One Consort,1981-10-01,1981,0,0,0,8.488578
81001,Kiss Me Goodbye,1982-12-22,1982,0,0,0,5.022445
81003,Kung Fu Panda: Secrets of the Masters,2011-12-12,2011,0,0,0,4.401424
81005,Jack the Giant Slayer,2013-02-27,2013,195000000,197687603,2687603,11.606061
81009,Invitation to Hell,1984-05-24,1984,0,0,0,0.153382
81010,Ticket Out,2011-07-20,2011,0,0,0,1.06945
81021,Spork,2010-04-24,2010,0,0,0,1.233222
81022,Widows,2011-08-18,2011,0,0,0,0.310541
81025,Salmon Fishing in the Yemen,2011-09-10,2011,5000000,34564651,29564651,6.753328
81030,Summer Storm,1944-07-14,1944,0,0,0,1.066544
81038,This Is the Night,1932-04-08,1932,0,0,0,0.109829
81048,Running Time,1997-12-18,1997,130000,1596,-128404,0.471913
81060,Happy,2006-01-27,2006,0,0,0,0.190998
81086,Sex Up Your Life!,2005-03-24,2005,0,0,0,0.428519
81110,The Eagle and the Hawk,1933-05-06,1933,0,0,0,0.2197
81111,Born to Be Bad,1934-05-18,1934,0,0,0,0.349978
81113,Thirty Day Princess,1934-05-18,1934,0,0,0,0.471635
81115,Wings in the Dark,1935-02-01,1935,0,0,0,0.47148
81116,Big Brown Eyes,1936-04-03,1936,0,0,0,0.467456
81120,Love on the Dole,1941-06-28,1941,0,0,0,0.31582
81167,Woody Allen: A Documentary,2011-11-20,2011,0,0,0,2.945649
81178,When You're in Love,1937-02-12,1937,0,0,0,0.183121
81179,Snowmageddon,2011-12-10,2011,0,0,0,5.27578
81182,Lost Christmas,2011-12-11,2011,1875600,0,-1875600,1.205248
81188,Rise of the Guardians,2012-11-21,2012,145000000,306941670,161941670,10.943775
81189,Love Letters of a Portuguese Nun,1977-03-10,1977,0,0,0,2.622537
81202,The Practice of Beauty,2011-11-24,2011,0,0,0,0.114122
81213,Loneliness in the Net,2006-01-01,2006,0,0,0,0.719651
81215,Kinyarwanda,2011-01-24,2011,400000,0,-400000,0.163781
81217,Szamanka,1996-05-10,1996,0,0,0,1.213651
81219,Life as a Fatal Sexually Transmitted Disease,2000-09-08,2000,0,0,0,0.307278
81220,Everything Put Together,2001-11-02,2001,500000,0,-500000,0.118774
81223,Brunet wieczorowƒÖ porƒÖ,1976-10-18,1976,0,0,0,0.411879
81225,Abendland,2011-03-31,2011,0,0,0,0.496605
81229,Hacker,2002-01-01,2002,0,0,0,0.294256
81231,Konopielka,1982-01-01,1982,0,0,0,0.368542
81232,Foster,2011-02-10,2011,0,0,0,2.347008
81242,The Client,2011-09-29,2011,0,0,0,0.914398
81244,Alien Nation: The Enemy Within,1996-11-12,1996,0,0,0,0.33895
81246,Alien Nation: The Udara Legacy,1997-07-29,1997,0,0,0,0.316642
81250,Geek Charming,2011-11-11,2011,0,0,0,5.04144
81273,The Dirty Picture,2011-12-02,2011,0,0,0,1.153466
81274,The Challengers,1990-10-14,1990,0,0,0,0.004026
81294,Rudolph the Red-Nosed Reindeer,1948-01-01,1948,0,0,0,0.319215
81296,Supermarket Woman,1996-06-15,1996,0,0,0,0.596047
81297,"Och, Karol",1985-10-21,1985,0,0,0,0.002001
81303,Holiday Wishes,2006-12-12,2006,0,0,0,0.129605
81309,Man - Woman Wanted,1973-04-22,1973,0,0,0,0.20497
81310,Winnie the Pooh and the Blustery Day,1968-12-20,1968,0,0,0,1.054814
81312,Just Love Me,2006-01-20,2006,0,0,0,0.579309
81313,Squint Your Eyes,2003-10-24,2003,0,0,0,0.248723
81315,The Doll,1968-11-07,1968,0,0,0,0.083572
81318,Hijacking Agatha,1993-08-20,1993,0,0,0,0.036281
81332,A Christmas Kiss,2011-11-12,2011,0,0,0,6.278291
81338,Mickey's Good Deed,1932-12-17,1932,0,0,0,0.489646
81342,Delicacy,2011-12-20,2011,0,9696204,9696204,5.96903
81346,To Begin Again,1982-03-01,1982,0,0,0,0.286929
81347,Likainen pommi,2011-09-23,2011,900000,0,-900000,0.294353
81365,Tis kakomoiras,1963-06-18,1963,0,0,0,0.56789
81367,Slappy and the Stinkers,1998-01-23,1998,0,0,0,0.920655
81382,The Case of the Whitechapel Vampire,2002-10-27,2002,0,0,0,0.489897
81389,The Last Summer,2007-07-04,2007,0,0,0,0.041792
81390,A Lonely Place to Die,2011-04-09,2011,4000000,25345000,21345000,6.780752
81391,252: Signal of Life,2008-12-06,2008,0,0,0,0.669505
81393,12 Dates of Christmas,2011-12-11,2011,0,0,0,7.020737
81396,Jimmy the Gent,1934-03-17,1934,0,0,0,0.184557
81399,The Bakery Girl of Monceau,1963-01-01,1963,0,0,0,0.996818
81400,The Ride,1994-09-13,1994,30000,0,-30000,0.400418
81401,The Turin Horse,2011-02-15,2011,0,0,0,4.340571
81409,Fury of Achilles,1962-09-23,1962,0,0,0,0.126808
81414,Ingrid,2010-04-30,2010,0,0,0,0.022858
81416,Annie Claus is Coming to Town,2011-12-10,2011,0,0,0,0.368966
81420,Christmas Magic,2011-12-18,2011,0,0,0,0.691204
81424,The Cat Came Back,1988-06-22,1988,0,0,0,0.006668
81434,Archie's Final Project,2009-02-07,2009,0,0,0,0.814463
81435,Microphone,2011-01-26,2011,0,0,0,0.155331
81436,The Legend of Bigfoot,1976-01-01,1976,0,0,0,0.112265
81438,Deck the Halls,2011-12-20,2011,0,0,0,0.36799
81440,"Good Luck Charlie, It's Christmas!",2011-12-02,2011,0,0,0,4.708525
81442,The Independent,2000-11-10,2000,0,0,0,1.345586
81446,The Baytown Outlaws,2012-08-27,2012,4000000,0,-4000000,7.379497
81450,Love Begins,2011-09-17,2011,0,0,0,0.776742
81457,Computer Beach Party,1987-01-01,1987,0,0,0,0.003553
81460,Hindsight,2011-08-31,2011,0,0,0,1.722761
81462,Short Eyes,1977-09-28,1977,0,0,0,0.699145
81463,Mad Foxes,1981-01-01,1981,0,161362,161362,1.857454
81464,"Guru, The Mad Monk",1970-01-05,1970,0,0,0,0.041681
81470,The Guy From Harlem,1977-09-01,1977,0,0,0,1e-06
81472,Kill Squad,1982-06-01,1982,0,0,0,0.016901
81475,Julie Darling,1983-03-01,1983,2000000,0,-2000000,0.079137
81477,Mad Doctor of Blood Island,1969-09-18,1969,0,0,0,0.306937
81481,Silenced,2011-09-22,2011,2200000,31500000,29300000,4.385574
81509,Virgin Report,1972-01-01,1972,0,0,0,0.342716
81512,Many Rivers to Cross,1955-02-04,1955,0,0,0,0.215725
81515,Vidal Sassoon: The Movie,2010-04-23,2010,0,0,0,0.205883
81521,Bloodlock,2008-12-31,2008,100000,0,-100000,0.219055
81522,What?,1972-12-07,1972,0,0,0,1.338179
81524,Foreign Parts,2010-08-09,2010,0,0,0,0.112771
81527,Aurora,2011-03-11,2011,0,0,0,0.528701
81530,Blackrock,1997-05-01,1997,0,0,0,0.172242
81534,The Parade,2011-10-31,2011,1500000,0,-1500000,2.037221
81537,One Night in A City,2007-01-25,2007,0,0,0,0.627843
81538,Watermarks,2004-12-10,2004,0,0,0,0.005683
81540,Teknolust,2002-01-01,2002,0,0,0,0.531351
81541,Women in Cell Block 7,1973-07-05,1973,0,0,0,0.41473
81543,So Much So Fast,2006-10-09,2006,0,0,0,0.074118
81549,Everything's Gonna Be Great,1998-11-27,1998,0,0,0,0.750959
81551,King Uncle,1993-02-05,1993,0,0,0,0.141445
81556,The Foster Boy,2011-11-03,2011,0,0,0,1.521391
81560,Cannonball Wedlock,2011-04-01,2011,0,0,0,0.088343
81576,Garbo: The Spy,2009-12-04,2009,0,0,0,0.234954
81579,One Lucky Elephant,2011-06-08,2011,0,0,0,0.044894
81581,Make Believe,2011-05-13,2011,0,0,0,0.077778
81583,45365,2010-06-18,2010,0,0,0,0.046692
81586,Vincent: A Life in Color,2008-11-14,2008,0,0,0,0.004988
81589,Must Read After My Death,2007-12-15,2007,0,0,0,0.158931
81600,Stille Nacht,2004-09-16,2004,0,0,0,0.643499
81604,The Scarlet Flower,1952-06-05,1952,0,0,0,0.220647
81616,At Ellen‚Äôs Age,2010-08-06,2010,0,0,0,0.123257
81619,Better This World,2011-04-23,2011,0,0,0,0.575473
81622,Cinema Komunisto,2010-01-29,2010,0,0,0,0.168405
81623,The Colors of the Mountain,2011-04-27,2011,0,0,0,0.847384
81626,The Dish & the Spoon,2011-03-12,2011,0,0,0,0.398922
81633,Hospitalit√©,2010-10-24,2010,0,0,0,0.157878
81634,Jean Gentil,2012-04-20,2012,0,0,0,0.085868
81644,Letters from the Big Man,2011-11-11,2011,0,0,0,0.385077
81646,Marathon Boy,2010-01-01,2010,0,0,0,0.081112
81649,Pink Saris,2010-09-14,2010,0,0,0,0.041178
81654,The Strange Type,1963-02-28,1963,0,0,0,0.424585
81657,The Redemption of General Butt Naked,2011-01-01,2011,0,0,0,0.112945
81660,The Selling,2011-04-29,2011,0,0,0,0.124818
81666,Sing Sing,1983-10-15,1983,0,0,0,0.444312
81670,Jock of the Bushveld,2011-07-29,2011,0,0,0,1.865894
81672,Passionate,1974-06-06,1974,0,0,0,5.453126
81675,The Bear,2011-05-06,2011,700000,0,-700000,0.125349
81678,Madonna of the Seven Moons,1945-01-22,1945,0,0,0,0.247752
81684,The Gruffalo's Child,2011-12-25,2011,0,0,0,5.617157
81687,Lloyd's of London,1936-11-29,1936,0,0,0,0.310115
81694,Suing The Devil,2011-08-26,2011,97,0,-97,0.586482
81699,Bhowani Junction,1956-05-01,1956,0,0,0,0.441029
81700,The Wool Cap,2004-11-20,2004,0,0,0,0.012693
81704,Romeos,2011-12-08,2011,0,0,0,0.959662
81707,The Wise Kids,2011-07-09,2011,0,0,0,0.579012
81708,My Grandfather's People,2011-11-25,2011,0,6086224,6086224,1.391176
81716,We Were Here,2011-09-09,2011,0,0,0,1.235847
81720,Gangster Story,1959-12-01,1959,75000,0,-75000,0.429974
81724,Laughter in Paradise,1951-01-10,1951,0,0,0,1.747894
81751,Casanova Brown,1944-08-23,1944,0,0,0,0.546994
81760,Ditto,2000-05-27,2000,0,0,0,0.234961
81765,How Beer Saved the World,2011-01-30,2011,0,0,0,0.151734
81772,The Concorde Affair,1979-03-23,1979,0,0,0,0.816083
81775,The Audience,1972-01-01,1972,0,0,0,0.802046
81780,A golpes,2005-11-04,2005,0,0,0,0.334828
81782,Kurukshetra,2000-11-09,2000,0,0,0,0.054117
81783,Children of the Secret State,2001-03-29,2001,0,0,0,0.212863
81787,The Future Is Woman,1984-09-15,1984,0,0,0,0.060908
81792,Vibrator,2003-12-06,2003,0,0,0,0.525805
81796,Lockout,2012-04-12,2012,20000000,32204030,12204030,8.772263
81824,Just Between Friends,1986-03-21,1986,0,0,0,0.159657
81828,My Summer Story,1994-09-23,1994,0,70,70,1.073743
81829,Bulldog Drummond,1929-05-02,1929,550000,0,-550000,0.721118
81830,The Rocky Saga: Going the Distance,2011-12-27,2011,0,0,0,0.488689
81831,The Boom,1963-09-24,1963,0,0,0,0.275855
81836,To Rome with Love,2012-04-20,2012,17000000,73244881,56244881,7.812646
81843,Let Him Be,2009-01-01,2009,0,0,0,0.004706
81847,The Dawn Patrol,1930-08-20,1930,0,0,0,0.578592
81850,Space Adventure Cobra,1982-07-03,1982,0,0,0,1.267278
81857,Alps,2011-09-01,2011,0,0,0,2.747289
81867,Breakaway,2011-09-30,2011,0,0,0,1.263592
81870,Flying Swords of Dragon Gate,2011-12-15,2011,35000000,0,-35000000,18.147447
81871,The Dolls,1965-01-27,1965,0,0,0,0.093616
81878,Forbidden,1949-02-28,1949,0,0,0,0.233108
81887,Murder by Phone,1982-12-01,1982,0,0,0,0.284564
81894,Getting It On,1983-08-01,1983,0,0,0,7.4e-05
81895,MacGyver: Lost Treasure of Atlantis,1994-05-14,1994,0,0,0,0.967882
81899,Trek Nation,2011-11-30,2011,0,0,0,2.242117
81900,Scooby-Doo! Music of the Vampire,2012-03-13,2012,0,0,0,3.164035
81937,Dynamite Brothers,1974-05-01,1974,0,0,0,0.038888
81949,An Unforgettable Summer,1994-05-15,1994,0,65352,65352,0.826372
81972,The Hunters,2011-12-27,2011,0,0,0,1.358005
81976,Alone in the Wilderness Part II,2011-12-02,2011,0,0,0,0.517268
81981,Girl with Hyacinths,1950-03-06,1950,0,0,0,0.565417
81996,Bandit's Silver Angel,1994-04-10,1994,0,0,0,0.755849
82020,The Carpenter,1988-08-27,1988,0,0,0,1e-06
82027,Crows,1994-09-12,1994,0,0,0,0.518065
82028,Black Out,2012-01-25,2012,0,0,0,1.755129
82029,Itin√©raire bis,2011-08-03,2011,0,0,0,0.869853
82036,The Bohemian Girl,1936-02-14,1936,0,0,0,1.096928
82040,Most,2003-06-11,2003,0,0,0,0.329601
82046,The Count of Monte Cristo,1954-01-14,1954,0,0,0,1.31503
82066,"Oh, Serafina!",1976-01-01,1976,0,0,0,0.207749
82077,Bella Mafia,1997-11-16,1997,0,0,0,1.00796
82079,Sons of Perdition,2010-04-24,2010,0,0,0,0.193355
82080,Rimini Rimini,1987-02-27,1987,0,0,0,2.2236
82083,"Rimini, Rimini: A Year Later",1988-01-01,1988,0,0,0,0.409892
82088,Zvenigora,1928-04-13,1928,0,0,0,0.305708
82094,The Pied Piper,1986-09-01,1986,0,0,0,1.541458
82096,The Painted Veil,1934-11-23,1934,947000,1120000,173000,0.631309
82098,With the Lives of Others,1966-08-24,1966,0,0,0,1.097957
82099,A Holiday Engagement,2011-11-28,2011,0,0,0,1.985297
82100,Flower Girl,2009-11-13,2009,0,0,0,0.118387
82101,Mourning Becomes Electra,1947-11-19,1947,0,0,0,0.732442
82103,"Me, You, Them",2000-08-17,2000,1900000,2070806,170806,1.075939
82106,After Office Hours,1935-02-22,1935,0,0,0,0.306936
82113,A Day in Court,1953-06-06,1953,0,0,0,1.256144
82114,"Goodnight, Ladies and Gentlemen",1976-10-28,1976,0,0,0,1.11611
82115,Skew,2011-04-19,2011,0,0,0,1.213249
82120,Tables Turned on the Gardener,1895-12-27,1895,0,0,0,1.963421
82124,Mouna Raagam,1986-08-15,1986,0,0,0,0.437959
82134,I Want to Marry Ryan Banks,2004-01-18,2004,0,0,0,0.560975
82136,This Is Not a Movie,2011-01-28,2011,0,0,0,1.999297
82151,Haack ...The King of Techno,2004-01-19,2004,0,0,0,0.037986
82153,Thunder and Mud,1990-02-12,1990,0,0,0,0.12075
82157,Die Blindg√§nger,2004-10-26,2004,0,0,0,0.00253
82178,Torch Singer,1933-09-08,1933,0,0,0,0.073011
82181,Hellcats of the Navy,1957-05-01,1957,0,0,0,0.864578
82185,Bad Seed,1934-07-05,1934,0,0,0,0.248086
82191,Flight of the Doves,1971-04-02,1971,0,0,0,0.442775
82203,The Girl in the Red Velvet Swing,1955-10-01,1955,0,0,0,0.624335
82237,"Thank You, Jeeves!",1936-06-30,1936,0,0,0,0.009626
82239,Love Is News,1937-02-26,1937,0,0,0,0.488481
82243,Gumnaam,1965-02-06,1965,0,0,0,0.277045
82257,Winner Take All,1932-07-16,1932,0,0,0,0.001247
82260,Taxi!,1932-01-23,1932,0,0,0,0.683789
82265,Las bicicletas son para el verano,1984-01-20,1984,0,0,0,0.151026
82269,Crazy Horse,2011-10-05,2011,0,0,0,0.488944
82279,O princeznƒõ Jasnƒõnce a l√©taj√≠c√≠m ≈°evci,1987-12-01,1987,0,0,0,0.869604
82283,It,1927-02-15,1927,0,0,0,0.594437
82309,Hansel and Gretel,1982-01-01,1982,116000,0,-116000,0.101458
82311,Wild River,1960-05-01,1960,0,0,0,1.669808
82313,Shoot First And Pray You Live,2008-12-04,2008,0,0,0,0.045914
82321,The Loneliest Planet,2011-08-10,2011,0,0,0,1.72815
82326,Koran by Heart,2011-10-24,2011,0,0,0,0.048765
82327,Goodbye First Love,2011-07-04,2011,4500000,0,-4500000,3.00927
82341,"Acapulco, prima spiaggia... a sinistra",1983-02-02,1983,0,0,0,0.007963
82342,Paradise girls,2005-03-05,2005,0,0,0,0.002353
82350,Finch√© c'√® guerra c'√® speranza,1974-12-20,1974,0,0,0,0.147757
82362,Footprints,1975-02-01,1975,0,0,0,0.17201
82368,Love and Larceny,1960-01-01,1960,0,0,0,0.129135
82377,Secret Santa,2003-12-14,2003,0,0,0,0.539942
82386,Ranma ¬Ω: One Flew Over the Kuno's Nest,1994-08-20,1994,0,0,0,0.482893
82390,The Paperboy,2012-09-14,2012,12500000,1353868,-11146132,5.526878
82394,Swiss Miss,1938-05-20,1938,700000,0,-700000,1.185614
82395,My Pet Monster,1986-01-01,1986,0,0,0,0.052013
82397,Safe in Hell,1931-12-12,1931,0,0,0,1.308584
82401,Can of Worms,1999-04-10,1999,0,0,0,0.419212
82404,Colossal Youth,2006-05-26,2006,0,0,0,0.557702
82405,Dawn of the World,2009-05-27,2009,0,0,0,0.040436
82406,Le Grand Chef,2007-10-31,2007,0,0,0,0.157941
82407,Bloodsuckers from Outer Space,1984-01-03,1984,0,0,0,0.788792
82409,Mutum,2007-11-15,2007,0,0,0,0.04944
82414,Forbidden to Forbid,2007-10-10,2007,0,0,0,0.185747
82418,Outlaw Justice,1999-01-24,1999,0,0,0,1.046119
82424,Small Fry,2011-11-23,2011,0,0,0,9.858179
82430,Arabian Adventure,1979-07-08,1979,0,0,0,3.730289
82432,Kiss The Bride,2002-10-16,2002,0,0,0,0.97787
82437,Following Sean,2006-05-05,2006,0,0,0,0.252168
82447,The Stig-Helmer Story,2011-12-25,2011,0,0,0,1.076739
82448,Simon & the Oaks,2011-12-08,2011,0,0,0,1.607621
82450,Hamilton: In the Interest of the Nation,2012-03-02,2012,6629445,0,-6629445,7.287815
82460,Bye Bye Braverman,1968-02-21,1968,0,0,0,0.112515
82465,Child's Play,1972-12-12,1972,0,0,0,0.549801
82466,Chop,2011-05-07,2011,0,0,0,0.63181
82469,The Kick,2011-11-03,2011,3500000,0,-3500000,1.782494
82470,The Art of Getting Along,1954-12-28,1954,0,0,0,0.391239
82473,Askari,2001-12-01,2001,0,0,0,0.009694
82474,7th Heaven,1927-01-01,1927,0,0,0,3.491261
82477,Countdown,2011-09-29,2011,6000000,0,-6000000,1.950159
82481,The Bachelor,1955-12-30,1955,0,0,0,0.595003
82485,Transit,2012-01-02,2012,5000000,0,-5000000,3.760079
82492,On the Ice,2011-12-14,2011,0,0,0,0.919294
82495,Gamer,2001-03-21,2001,0,0,0,0.759754
82501,The Woman in the Fifth,2011-11-16,2011,0,0,0,5.829328
82505,House at the End of the Street,2012-09-21,2012,6900000,44287131,37387131,8.513457
82507,Sinister,2012-03-29,2012,3000000,77712439,74712439,12.490637
82510,Hollywood Sex Wars,2011-10-03,2011,0,0,0,1.180964
82519,Restaurant,1998-04-18,1998,0,0,0,0.014898
82520,Return,2011-05-14,2011,0,0,0,1.151359
82523,Montenegro,1981-10-09,1981,0,0,0,0.011917
82525,Savages,2012-07-06,2012,45000000,82966152,37966152,13.248022
82529,Combat Girls,2011-06-28,2011,0,0,0,5.259607
82532,"Jeff, Who Lives at Home",2011-09-13,2011,10000000,4417580,-5582420,5.872794
82533,Damsels in Distress,2012-04-06,2012,0,0,0,5.910385
82545,Texasville,1990-09-28,1990,0,0,0,0.370342
82549,Toothless,1997-10-05,1997,0,0,0,1.082052
82550,Roberto Succo,2001-05-14,2001,0,0,0,0.230554
82567,Sujata,1960-01-01,1960,0,0,0,0.259973
82575,Indian,2001-10-26,2001,0,0,0,0.448792
82576,Erotikon,1920-11-08,1920,0,0,0,0.206258
82594,Spine Tingler! The William Castle Story,2007-11-08,2007,0,0,0,0.116412
82598,21 Hours at Munich,1976-11-07,1976,0,0,0,1.682989
82618,Girl in Progress,2012-05-11,2012,5000000,0,-5000000,2.795503
82620,Undefeated,2011-03-13,2011,0,0,0,2.095496
82622,Violet Tendencies,2010-04-24,2010,0,0,0,0.495445
82623,T-Rex: Back to the Cretaceous,1998-10-23,1998,0,0,0,0.311387
82624,The Forgiveness of Blood,2011-02-18,2011,0,0,0,0.904979
82626,16-love,2012-01-20,2012,0,0,0,1.33834
82627,Man On a Mission: Richard Garriott's Road to the Stars,2010-03-14,2010,0,0,0,0.043649
82631,Won't Back Down,2012-09-28,2012,0,5310554,5310554,2.401289
82633,Lawless,2012-08-29,2012,26000000,53676580,27676580,7.968423
82634,Pinprick,2009-11-05,2009,0,0,0,0.087904
82639,Diana Vreeland: The Eye Has to Travel,2012-09-21,2012,0,0,0,0.598646
82642,Dive!,2010-02-05,2010,0,0,0,0.119402
82649,Lunopolis,2009-01-01,2009,0,0,0,0.730848
82650,Diary of a Wimpy Kid: Dog Days,2012-08-02,2012,22000000,77112176,55112176,10.225555
82654,Warm Bodies,2013-01-31,2013,35000000,116980662,81980662,10.430238
82655,The Oregonian,2011-01-24,2011,0,0,0,0.841542
82657,Flight 7500,2014-05-16,2014,0,0,0,5.265969
82662,L'industriale,2011-01-13,2011,0,0,0,1.025725
82663,,,,0,0,0,0.0
82664,Reality XL,2012-01-12,2012,0,0,0,0.009451
82667,Five Bloody Graves,1969-10-31,1969,0,0,0,0.479849
82675,Taken 2,2012-09-27,2012,45000000,376141306,331141306,16.376482
82676,Everyday Sunshine:  The Story of Fishbone,2011-10-07,2011,0,0,0,0.060696
82679,Fun Size,2012-10-25,2012,14000000,11417362,-2582638,6.891823
82682,Gangster Squad,2013-01-10,2013,60000000,105200903,45200903,8.581558
82684,Chasing Mavericks,2012-10-25,2012,0,0,0,8.965733
82685,Division III: Football's Finest,2011-10-14,2011,0,0,0,1.162596
82686,Jane's Journey,2011-09-06,2011,0,0,0,1.831371
82687,The Guilt Trip,2012-12-19,2012,40000000,41863726,1863726,7.479014
82688,El Bulli: Cooking in Progress,2011-09-15,2011,0,0,0,0.119766
82690,Wreck-It Ralph,2012-11-01,2012,165000000,471222889,306222889,13.697597
82693,Silver Linings Playbook,2012-09-08,2012,21000000,205738714,184738714,14.488111
82695,Les Mis√©rables,2012-12-18,2012,61000000,441809770,380809770,13.52408
82696,Hope Springs,2012-08-07,2012,30000000,114281051,84281051,7.255301
82698,Ladies vs Ricky Bahl,2011-12-09,2011,0,0,0,1.236107
82700,After Earth,2013-05-30,2013,130000000,243843127,113843127,10.747642
82702,How to Train Your Dragon 2,2014-06-12,2014,145000000,609123048,464123048,12.256689
82703,Mr. Peabody & Sherman,2014-02-07,2014,145000000,272912430,127912430,9.493838
82708,The Poll Diaries,2010-12-17,2010,0,0,0,1.1303
82716,The Watermill Princess,1994-06-01,1994,0,0,0,0.793461
82731,The Three Musketeers,1921-08-28,1921,1500000,0,-1500000,0.310953
82737,War,2002-03-14,2002,0,0,0,1.522084
82743,Inbred,2011-09-30,2011,0,0,0,3.610042
82745,Estamos Juntos,2011-06-03,2011,0,0,0,0.570909
82760,Avalon,2011-09-11,2011,0,0,0,0.231768
82762,New York in the 50's,2001-02-09,2001,0,0,0,0.001262
82767,¬°A volar joven!,1947-12-23,1947,0,0,0,0.20475
82776,El ministro y yo,1977-01-01,1977,0,0,0,0.035443
82781,Our Town,2003-05-24,2003,0,0,0,0.003441
82792,Pepe,1960-12-21,1960,0,0,0,0.300826
82806,Prova a volare,2007-08-24,2007,0,0,0,0.246259
82817,Unforgivable,2011-08-17,2011,0,0,0,0.808349
82819,The Captive Heart,1946-04-29,1946,0,0,0,0.75857
82825,Kahaani,2012-03-09,2012,1200000,16000000,14800000,3.174936
82827,Taste of Life,1988-12-30,1988,0,0,0,0.002001
82838,The Rack,1956-11-02,1956,0,0,0,1.088216
82857,"Tsirk Sgorel, i Klouny Razbezhalis",1998-03-23,1998,0,0,0,0.639829
82858,Sweet Deceptions,1960-10-15,1960,0,0,0,0.053123
82865,"God Said, 'Ha!'",1998-05-14,1998,0,0,0,0.054592
82866,Fog City Mavericks,2007-10-24,2007,0,0,0,0.01696
82868,I Don't Buy Kisses Anymore,1992-04-24,1992,0,0,0,0.146178
82877,The Gospel of Judas,2006-04-05,2006,0,0,0,0.078586
82881,Tangled Ever After,2012-01-13,2012,0,0,0,9.953967
82911,Thurgood,2011-02-24,2011,0,0,0,1.322114
82916,The Last Ronin,2010-12-18,2010,0,0,0,0.249301
82929,In the Family,2011-11-04,2011,0,0,0,0.527607
82932,I Am,2011-02-11,2011,0,0,0,5.575762
82935,Dragonslayer,2011-11-04,2011,0,0,0,0.096228
82937,Madison Avenue,1962-01-07,1962,0,0,0,0.037892
82939,Crab Trap,2010-03-12,2010,0,0,0,0.21794
82941,Breathing,2011-09-30,2011,0,0,0,1.271808
82942,'Master Harold'... and the Boys,1985-01-01,1985,0,0,0,0.00022
82944,Something Wild,1961-12-23,1961,0,0,0,0.911178
82962,Killer Force,1976-01-14,1976,0,0,0,0.985855
82963,Valerie,1957-08-01,1957,0,0,0,0.402153
82966,Two Weeks in September,1967-06-07,1967,0,0,0,0.125803
82967,Beauty Day,2011-06-10,2011,0,0,0,0.760027
82968,Blood of My Blood,2011-09-27,2011,0,0,0,0.755637
82970,"Ride Him, Cowboy",1932-08-27,1932,0,0,0,0.723038
82990,Paranormal Activity 4,2012-10-17,2012,5000000,142817992,137817992,6.188286
82992,Fast & Furious 6,2013-05-06,2013,160000000,788679850,628679850,1.657637
82999,Penumbra,2012-02-02,2012,0,0,0,0.858068
83001,Hollywood High,1976-12-01,1976,0,0,0,1e-06
83007,Comin' at Ya!,1981-07-24,1981,0,0,0,0.24036
83013,Bungee Jumping of Their Own,2001-02-03,2001,0,0,0,0.208569
83015,The Happiest Days of Your Life,1950-01-01,1950,0,0,0,0.390579
83036,Titanic Town,1998-08-08,1998,0,0,0,0.002534
83040,Battle for Brooklyn,2011-06-17,2011,0,0,0,0.053443
83052,Young Girls in Black,2010-05-18,2010,0,0,0,0.087967
83059,Disfigured,2008-07-29,2008,0,0,0,0.0424
83078,Blue City,1986-05-02,1986,0,0,0,0.310867
83079,Crystal Heart,1986-02-01,1986,0,0,0,0.329879
83088,Saint Seiya: Warriors of the Final Holy Battle,1989-03-18,1989,0,0,0,1.304154
83090,Saint Seiya: Evil Goddess Eris,1987-07-18,1987,0,0,0,3.565311
83091,Saint Seiya: The Heated Battle of the Gods,1988-03-12,1988,0,0,0,1.401616
83098,Two Sisters From Boston,1946-06-06,1946,0,0,0,0.004122
83099,Escape from Fort Bravo,1953-12-04,1953,0,0,0,1.060091
83105,The Boy in Blue,1986-01-17,1986,0,0,0,0.625342
83114,Tatsumi,2011-09-15,2011,800,0,-800,0.592222
83119,I Am a Camera,1955-07-21,1955,0,0,0,0.248431
83121,The Long Hair of Death,1964-12-30,1964,0,0,0,0.157906
83122,If You Meet Sartana Pray for Your Death,1968-08-14,1968,0,0,0,0.76346
83124,Light the Fuse... Sartana Is Coming,1970-12-24,1970,0,0,0,0.017521
83125,The Color Wheel,2011-04-01,2011,19000,0,-19000,0.720345
83132,St. Louis Blues,1958-04-07,1958,0,0,0,0.157373
83136,"Have a Good Funeral, My Friend... Sartana Will Pay",1970-10-08,1970,0,0,0,0.470792
83140,"I Am Sartana, Trade Your Guns for a Coffin",1970-08-07,1970,0,0,0,0.294246
83147,Doc,1971-08-01,1971,0,0,0,0.799801
83183,Tales of a Golden Geisha,1990-06-02,1990,0,0,0,0.013328
83185,A Love Movie,2003-05-20,2003,0,0,0,0.327211
83186,Wrong,2012-09-05,2012,0,0,0,11.349635
83188,Camel Spiders,2011-03-04,2011,500000,0,-500000,5.280066
83191,Treasure Island,2012-01-01,2012,0,0,0,2.044566
83195,Tropical Fish,1995-08-01,1995,0,0,0,0.094572
83201,Puss in Boots: The Three Diablos,2011-12-08,2011,0,0,0,12.018446
83209,Mahler on the Couch,2010-06-24,2010,0,0,0,0.26706
83214,A Gentle Breeze in the Village,2007-08-04,2007,0,0,0,1.56224
83215,Fragments of an Alms-Film,1972-01-01,1972,0,0,0,0.35
83221,The Forsaken Land,2006-01-25,2006,0,0,0,0.144899
83223,Rats: Night of Terror,1984-08-03,1984,0,0,0,1.940675
83226,The Last Dive,1992-09-18,1992,0,0,0,0.195443
83228,Come and Go,2003-06-03,2003,0,0,0,0.083636
83229,Hovering Over the Water,1986-10-02,1986,0,0,0,0.074857
83230,Trails,1978-05-19,1978,0,0,0,0.040663
83232,Portrait of Jason,1967-09-29,1967,0,0,0,0.333788
83233,Silvestre,1982-05-06,1982,0,0,0,0.041978
83234,April,1961-01-01,1961,0,0,0,0.227948
83235,There Once Was a Singing Blackbird,1970-01-01,1970,0,0,0,0.092543
83266,"It's Not You, It's Me",2004-10-28,2004,0,0,0,0.764109
83271,A√±o Mariano,2000-08-11,2000,0,0,0,0.06928
83272,The Woman in the Septic Tank,2011-08-03,2011,0,0,0,0.227735
83284,Dennis,2007-08-23,2007,0,0,0,0.42725
83288,Virtual Combat,1995-07-11,1995,0,0,0,0.326423
83292,The Suckling,1990-01-01,1990,0,0,0,0.009919
83295,The Black Gestapo,1975-03-01,1975,0,0,0,0.001736
83297,Crazy Thunder Road,1980-05-24,1980,0,0,0,0.000603
83299,Female,2005-01-01,2005,0,0,0,0.115966
83310,"If Footmen Tire You, What Will Horses Do?",1971-01-01,1971,0,0,0,0.000603
83330,The Catechism Cataclysm,2011-10-19,2011,0,0,0,0.315696
83342,Blutzbr√ºdaz,2011-12-28,2011,0,0,0,0.992885
83345,The Mosquito Net,2010-11-04,2010,0,0,0,1.093239
83346,It's Impossible to Learn to Plow by Reading Books,1988-01-01,1988,3000,0,-3000,0.012313
83354,The True Story of Jesse James,1957-03-22,1957,0,0,0,1.626869
83360,North West Mounted Police,1940-10-22,1940,0,0,0,0.86196
83361,McCinsey's Island,1998-02-23,1998,0,0,0,0.165538
83363,Offerings,1989-01-01,1989,0,0,0,0.00022
83382,Players,2012-01-06,2012,0,0,0,0.468012
83384,Dark Horse,2011-09-05,2011,0,0,0,1.897238
83388,American Translation,2011-06-07,2011,0,0,0,1.815576
83389,From Up on Poppy Hill,2011-07-16,2011,0,0,0,8.791024
83401,Climate of Change,2010-05-12,2010,0,0,0,0.009596
83403,Conception,2011-01-01,2011,0,0,0,0.594675
83406,Northeast,2012-01-12,2012,0,0,0,0.009421
83413,Blood Freak,1972-01-01,1972,0,0,0,0.170058
83415,Body Slam,1987-05-21,1987,0,0,0,1e-06
83429,Evenings on a Farm near Dikanka,1961-12-30,1961,0,0,0,1.203389
83430,Altiplano,2009-11-25,2009,0,0,0,0.166009
83435,The Foundling,1939-06-06,1939,0,0,0,0.621041
83443,Girl Model,2011-09-08,2011,0,0,0,1.904093
83444,No Path Through Fire,1968-06-01,1968,0,0,0,0.275895
83446,Oblomov,1980-09-08,1980,0,0,0,0.950216
83451,Poto and Cabengo,1980-01-01,1980,0,0,0,0.025827
83456,What Men Still Talk About,2011-12-29,2011,0,17808683,17808683,1.565713
83459,The Mechanic Gavrilov's Beloved Woman,1982-03-08,1982,0,0,0,0.853395
83461,Monologue,1972-01-01,1972,0,0,0,0.000844
83473,7 Nights Of Darkness,2011-11-08,2011,0,0,0,1.001794
83475,The Debut,1970-10-12,1970,0,0,0,0.006777
83479,Ultrasuede: In Search of Halston,2011-09-23,2011,0,0,0,0.458737
83481,Heroes,2010-10-22,2010,0,0,0,0.477999
83486,Flights in Dreams and in Reality,1982-01-01,1982,0,0,0,0.300037
83491,My Friend Ivan Lapshin,1984-12-26,1984,0,0,0,1.002979
83492,Success,1984-06-06,1984,0,0,0,0.439429
83495,Mirror for a Hero,1987-12-13,1987,0,0,0,0.015894
83500,Two Ninas,2000-12-01,2000,0,0,0,0.071497
83501,Comedy of the Strict Regime,1992-11-07,1992,0,0,0,0.00022
83505,El Bonaerense,2002-09-19,2002,0,0,0,0.695413
83519,Witchcraft,1964-03-01,1964,0,0,0,0.710265
83524,Intergirl,1989-01-21,1989,0,0,0,0.547897
83539,Letter Never Sent,1960-06-27,1960,0,0,0,1.451473
83540,Dreams of a Life,2011-08-16,2011,0,0,0,0.834786
83542,Cloud Atlas,2012-10-26,2012,102000000,130482868,28482868,13.494246
83552,This Is Not a Film,2011-09-27,2011,0,0,0,1.617378
83562,Privates on Parade,1983-03-18,1983,0,0,0,0.535723
83564,La luna,2011-01-01,2011,0,0,0,7.331398
83566,Iran Is Not the Problem,2008-07-28,2008,2,0,-2,0.075397
83567,Somersault in a Coffin,1996-04-01,1996,0,0,0,0.976886
83573,Happy End,2011-09-23,2011,0,0,0,0.681647
83579,The Hound of the Baskervilles,1983-11-03,1983,0,0,0,1.190271
83581,Some Voices,2000-08-25,2000,0,0,0,0.794749
83583,The Chateau Meroux,2011-08-09,2011,1750000,0,-1750000,0.444127
83587,Zombie Girl: The Movie,2009-08-09,2009,0,0,0,0.341733
83588,Middle of Nowhere,2012-10-12,2012,0,0,0,1.50978
83589,Shut Up and Play the Hits,2012-01-22,2012,0,0,0,0.93568
83593,A Paralyzing Fear: The Story of Polio in America,1998-03-04,1998,0,0,0,0.001188
83599,Calendar,1993-06-03,1993,0,0,0,0.730484
83613,Hellgate,1989-02-03,1989,0,0,0,0.001021
83614,You Are My Only Love,1993-02-01,1993,0,0,0,0.724248
83617,Fluke,2008-10-23,2008,0,0,0,0.051122
83633,Pigskin Parade,1936-10-23,1936,0,0,0,0.10884
83651,The Chaos Class,1975-04-01,1975,0,0,0,0.869393
83660,Paradise Lost 3: Purgatory,2011-10-10,2011,0,0,0,2.84239
83664,The Man with a Cloak,1951-11-27,1951,0,0,0,0.338909
83665,Betrayed,1954-09-07,1954,0,0,0,1.021838
83666,Moonrise Kingdom,2012-05-16,2012,16000000,68263166,52263166,8.692433
83667,Payment on Demand,1951-02-03,1951,0,0,0,0.795493
83670,"Hard, Fast and Beautiful",1951-05-23,1951,0,0,0,0.119839
83678,Glasbl√•sarns barn,1998-02-27,1998,0,0,0,0.397563
83683,I Can Get it For You Wholesale,1951-04-05,1951,0,0,0,0.044533
83686,The Words,2012-09-07,2012,6000000,13231461,7231461,6.089971
83706,The Viral Factor,2012-01-19,2012,0,0,0,1.970566
83714,Angie,1994-03-04,1994,0,0,0,0.603104
83716,Fake,2010-06-09,2010,0,0,0,1.243187
83718,What Happened Was...,1994-09-09,1994,0,0,0,0.534606
83721,The Great Magician,2011-12-22,2011,15000000,0,-15000000,1.542334
83723,The Deadly Tower,1975-10-18,1975,0,0,0,0.607337
83726,Beyond Therapy,1987-02-27,1987,0,0,0,0.647205
83727,The Theatre Bizarre,2011-07-15,2011,0,0,0,1.66657
83728,The Broken Tower,2012-04-27,2012,0,0,0,5.120097
83729,Offroad,2012-01-11,2012,0,0,0,0.763509
83732,Bombay Beach,2011-10-14,2011,0,0,0,0.274196
83735,Angel Dog,2011-03-19,2011,1000000,0,-1000000,0.306456
83738,"After Fall, Winter",2012-01-27,2012,0,0,0,0.309293
83746,Broom-Stick Bunny,1956-02-25,1956,0,0,0,0.424586
83750,Devil May Hare,1954-06-19,1954,0,0,0,0.541314
83754,You Are My Pet,2011-11-10,2011,0,0,0,1.174051
83761,Life and Nothing More...,1992-09-01,1992,0,0,0,1.183477
83765,Feed the Kitty,1952-02-02,1952,0,0,0,1.267325
83770,On the Road,2012-05-22,2012,25000000,8784318,-16215682,7.323283
83782,Letters of a Novice,1960-12-01,1960,0,0,0,0.200607
83785,Her Fatal Flaw,2006-11-24,2006,0,0,0,0.250327
83788,Crime on a Summer Morning,1965-07-07,1965,0,0,0,0.333545
83801,Presumed Guilty,2011-09-07,2011,6965576,0,-6965576,2.494324
83802,The Gong Show Movie,1980-05-23,1980,0,0,0,0.494148
83816,Internes Can't Take Money,1937-04-16,1937,0,0,0,0.118748
83817,Madam Satan,1930-09-20,1930,0,0,0,0.20618
83827,In the Darkness of the Night,2004-10-21,2004,0,0,0,0.428643
83831,Charley-One-Eye,1973-04-18,1973,0,0,0,0.000431
83834,The Child,1977-06-02,1977,0,0,0,0.000578
83838,B.F.'s Daughter,1948-04-02,1948,0,0,0,0.062259
83849,The Night That Panicked America,1975-10-31,1975,0,0,0,0.099183
83857,Windows,1980-01-18,1980,0,0,0,0.400023
83860,October Baby,2011-10-30,2011,0,5355847,5355847,1.604527
83865,Ivan Tsarevich & the Grey Wolf,2011-12-29,2011,0,0,0,1.362905
83868,Female,1933-11-11,1933,0,0,0,0.727147
83869,As Cool as I Am,2013-06-21,2013,0,0,0,2.440124
83876,The Avenging Eagle,1978-09-13,1978,0,0,0,0.470995
83880,Super Shark,2011-12-08,2011,0,0,0,0.774131
83889,Businessman,2012-01-13,2012,0,0,0,0.663859
83890,LUV,2013-01-18,2013,0,134634,134634,0.829262
83896,Sand Sharks,2011-12-20,2011,0,0,0,2.498266
83897,Uprise,2008-04-30,2008,0,0,0,0.080879
83899,You're Next,2011-09-10,2011,0,14347000,14347000,6.464826
83900,Livid,2011-12-06,2011,5000000,0,-5000000,2.32335
83902,Na Tum Jaano Na Hum,2002-05-09,2002,350000,6100000,5750000,0.736613
83903,Vaah! Life Ho Toh Aisi!,2005-12-23,2005,0,0,0,0.352947
83907,Underwater Love,2011-04-22,2011,0,0,0,0.974656
83909,66 Scenes from America,1982-03-27,1982,0,0,0,0.15241
83912,New Scenes from America,2002-01-01,2002,0,0,0,0.061288
83944,Sketches of Kaitan City,2010-12-18,2010,0,0,0,0.079007
83957,Rapture,1965-08-23,1965,0,0,0,1.02754
83965,The Thirteenth Year,1999-05-15,1999,0,0,0,1.265599
83980,The Trial of Billy Jack,1974-11-13,1974,7,0,-7,0.0339
83989,In Old Arizona,1928-12-25,1928,0,0,0,0.348543
83994,My Sex Life... or How I Got Into an Argument,1996-05-01,1996,0,0,0,0.270279
83995,The Angry Silence,1960-03-10,1960,0,0,0,0.700598
84001,Forest of Bliss,1986-01-01,1986,0,0,0,0.004351
84002,Of Freaks and Men,1998-05-20,1998,0,0,0,0.557552
84012,The Invisible Frame,2009-11-11,2009,0,0,0,0.447313
84016,The Portuguese Nun,2009-08-09,2009,0,0,0,0.187456
84023,The Adopted Son,1998-08-11,1998,0,0,0,0.176254
84026,The Gleaners and I: Two Years Later,2002-12-18,2002,0,0,0,0.299014
84028,Warsaw Bridge,1989-01-01,1989,0,0,0,0.005645
84030,Prince and the Evening Star,1979-09-30,1979,0,0,0,0.006195
84035,Boulevard,1960-11-30,1960,0,0,0,0.368994
84038,Night at the Crossroads,1932-04-18,1932,0,0,0,0.637378
84050,Fanny,1961-06-28,1961,0,0,0,0.670182
84056,Un'estate al mare,2008-06-27,2008,0,0,0,0.996423
84058,From Hell It Came,1957-08-25,1957,0,0,0,0.630434
84060,Cruel Jaws,1995-05-05,1995,0,0,0,1.012248
84062,Darktown Strutters,1975-10-07,1975,0,0,0,0.002538
84066,Bonnie and Clyde Italian Style,1982-01-01,1982,0,0,0,0.770641
84071,Night Game,1989-09-15,1989,0,337812,337812,1.714152
84079,A Time to Love and a Time to Die,1958-07-09,1958,0,0,0,1.640077
84084,Wilson,1944-08-01,1944,2995000,2000000,-995000,0.773081
84085,The Pied Piper,1942-08-21,1942,0,0,0,0.074506
84086,One Foot in Heaven,1941-11-01,1941,0,0,0,0.114071
84087,Blossoms in the Dust,1941-07-25,1941,0,0,0,0.692357
84089,"Maradona, the Hand of God",2007-03-29,2007,0,0,0,0.571269
84090,The Citadel,1938-10-29,1938,0,0,0,0.613117
84094,Railways,2010-05-29,2010,0,0,0,0.024898
84097,One Night of Love,1934-09-15,1934,0,0,0,0.415097
84099,Here Comes the Navy,1934-07-21,1934,0,0,0,0.141963
84100,Flirtation Walk,1934-12-01,1934,0,0,0,0.323876
84104,Shriek of the Mutilated,1974-08-02,1974,0,0,0,0.146623
84105,Frenemies,2012-01-13,2012,0,0,0,7.96175
84106,Captains of the Sands,2011-10-07,2011,4500000,0,-4500000,0.242023
84108,Alabama's Ghost,1973-02-02,1973,0,0,0,0.026351
84109,Private's Progress,1956-02-17,1956,0,0,0,0.66463
84111,You Are the Apple of My Eye,2011-08-19,2011,0,0,0,2.991067
84114,"Namu, the Killer Whale",1966-08-01,1966,0,0,0,0.147599
84116,"Grandview, U.S.A.",1984-08-03,1984,0,0,0,8.143655
84119,Goodbye Again,1961-05-23,1961,0,0,0,1.390181
84140,Dangerous Men,2005-09-23,2005,0,0,0,0.524688
84152,Dollman vs. Demonic Toys,1993-10-13,1993,0,0,0,1.05016
84154,Donald Glover: Weirdo,2011-11-19,2011,0,0,0,0.582617
84165,2 Days in New York,2012-03-28,2012,8000000,1653792,-6346208,4.68182
84166,28 Hotel Rooms,2012-01-21,2012,0,0,0,2.296686
84167,About The Pink Sky,2012-01-25,2012,0,0,0,0.011637
84169,Ai Weiwei: Never Sorry,2012-06-14,2012,0,181107,181107,2.643111
84170,Five Broken Cameras,2011-11-23,2011,0,0,0,1.591943
84171,About Face: Supermodels Then and Now,2012-07-23,2012,0,0,0,0.622835
84172,The Ambassador,2011-10-05,2011,0,0,0,0.684441
84173,The Atomic States Of America,2012-01-23,2012,0,0,0,0.04353
84174,Bachelorette,2012-08-06,2012,3000000,11947954,8947954,10.893224
84175,Beasts of the Southern Wild,2012-06-29,2012,1800000,21107746,19307746,5.550496
84176,Bestiary,2012-10-19,2012,0,0,0,0.085207
84177,Big Boys Gone Bananas!*,2011-11-19,2011,0,0,0,0.296487
84178,Black Rock,2012-01-21,2012,0,0,0,8.732143
84179,Bones Brigade: An Autobiography,2012-01-21,2012,110,0,-110,1.045944
84180,California Solo,2012-11-30,2012,0,0,0,1.081898
84184,Celeste & Jesse Forever,2012-08-03,2012,0,3094813,3094813,6.348565
84185,Chasing Ice,2012-10-01,2012,0,1328467,1328467,8.883705
84186,China Heavyweight,2012-07-06,2012,0,0,0,0.045108
84187,The Comedy,2012-11-09,2012,0,0,0,0.839771
84188,Compliance,2012-08-23,2012,0,319285,319285,7.563444
84190,Detropia,2012-09-07,2012,0,0,0,0.647258
84191,The End of Love,2013-03-01,2013,0,8326,8326,1.346317
84192,Escape Fire: The Fight to Rescue American Healthcare,2012-10-05,2012,0,0,0,0.115688
84193,Ethel,2012-01-20,2012,0,0,0,0.023001
84194,Excision,2012-09-12,2012,0,0,0,12.493245
84195,Father‚Äôs Chair,2013-03-15,2013,0,0,0,1.121686
84196,A Fierce Green Fire,2013-03-01,2013,0,0,0,0.164883
84197,Filly Brown,2013-04-19,2013,0,0,0,0.445222
84198,A Place at the Table,2012-03-22,2012,0,0,0,1.673307
84198,A Place at the Table,2012-03-22,2012,0,0,0,0.501046
84199,The First Time,2012-10-19,2012,0,0,0,5.731701
84200,"For a Good Time, Call...",2012-08-31,2012,850000,1243961,393961,10.378756
84201,For Ellen,2012-02-12,2012,0,0,0,1.703802
84203,Goats,2012-08-10,2012,3000000,0,-3000000,3.375751
84204,Grabbers,2012-08-10,2012,0,0,0,9.609614
84207,Remember My Name,1978-02-10,1978,0,0,0,0.324251
84209,Busting,1974-02-27,1974,0,0,0,0.795192
84211,Safety Patrol,1998-03-29,1998,0,0,0,0.071852
84214,"Come Back, Little Sheba",1952-12-24,1952,0,0,0,2.601441
84226,The Day,2011-09-15,2011,0,0,0,4.731001
84228,Julia X,2011-09-24,2011,4000000,0,-4000000,2.22594
84233,Don't Hang Up,1975-01-01,1975,0,0,0,0.140147
84237,Humanity and Paper Balloons,1937-08-25,1937,0,0,0,0.284625
84240,Ghost,2012-01-13,2012,0,0,0,0.059593
84242,Stories of Lost Souls,2004-11-12,2004,0,0,0,0.748956
84248,La T√™te d'un Homme,1933-02-18,1933,0,0,0,0.100005
84249,The Exiles,1961-07-13,1961,0,0,0,0.243613
84254,The Adventures of Sherlock Holmes and Dr. Watson: The Hound of the Baskervilles,1981-01-02,1981,0,0,0,1.617422
84259,Hearts of the West,1975-10-08,1975,0,0,0,0.001655
84273,Storm Over Asia,1928-11-10,1928,0,0,0,1.680835
84274,Disraeli,1929-11-01,1929,0,0,0,0.401707
84275,The Dragon Lives Again,1977-03-25,1977,0,0,0,0.124803
84278,The Group,1966-03-04,1966,0,0,0,1.052642
84281,Hello I Must Be Going,2012-09-07,2012,0,0,0,10.993583
84283,I Am Not a Hipster,2013-01-09,2013,0,0,0,0.391314
84284,The House I Live In,2012-10-05,2012,0,0,0,1.339277
84285,Von Richthofen and Brown,1971-06-30,1971,0,0,0,0.359821
84286,How to Survive a Plague,2012-09-20,2012,0,0,0,1.204651
84287,The Imposter,2012-07-13,2012,0,0,0,8.970709
84288,The Invisible War,2012-01-20,2012,0,0,0,7.473701
84289,Black Roses,1988-11-01,1988,0,0,0,0.506961
84290,Keep the Lights On,2012-02-25,2012,0,0,0,6.651607
84295,Skippy,1931-04-25,1931,0,0,0,0.360311
84296,Trader Horn,1931-05-23,1931,0,0,0,0.372404
84298,Arrowsmith,1931-12-26,1931,0,0,0,0.233012
84299,Bad Girl,1931-08-13,1931,0,0,0,0.735185
84300,L,2012-01-23,2012,0,0,0,0.267263
84302,The Last Elvis,2012-04-25,2012,0,0,0,0.678927
84303,Smilin' Through,1932-09-24,1932,0,0,0,0.439499
84305,Lay the Favorite,2012-06-22,2012,26350000,1576687,-24773313,5.153138
84306,Liberal Arts,2012-09-14,2012,0,327345,327345,7.113542
84308,"Madrid, 1987",2011-09-22,2011,0,0,0,1.735369
84309,Marina Abramoviƒá: The Artist Is Present,2012-01-01,2012,0,0,0,2.629961
84312,Mosquita y Mari,2012-08-03,2012,0,0,0,0.789746
84316,My Brother the Devil,2012-01-22,2012,0,0,0,1.926106
84317,Nobody Walks,2012-10-19,2012,0,24995,24995,3.705199
84318,The Other Dream Team,2012-09-28,2012,0,0,0,0.50755
84319,An Oversimplification of Her Beauty,2012-01-30,2012,0,0,0,0.00791
84323,Price Check,2012-11-16,2012,0,0,0,4.707256
84324,The Super Cops,1974-03-20,1974,0,0,0,0.204949
84326,Putin‚Äôs Kiss,2011-11-19,2011,0,0,0,0.063559
84327,The Queen of Versailles,2012-07-06,2012,0,714544,714544,3.589099
84328,Red Hook Summer,2012-08-10,2012,0,0,0,1.134888
84329,Robot & Frank,2012-08-16,2012,2500000,3325038,825038,9.291494
84330,Room 237,2012-10-26,2012,0,0,0,6.154844
84332,Safety Not Guaranteed,2012-06-08,2012,750000,4007792,3257792,7.067494
84333,Save the Date,2012-12-14,2012,0,0,0,3.687905
84334,Searching for Sugar Man,2012-06-30,2012,0,0,0,6.245191
84336,Shadow Dancer,2012-02-12,2012,6300000,419953,-5880047,4.38806
84337,Me and My Gal,1932-12-04,1932,0,0,0,0.429111
84338,Simon Killer,2012-04-12,2012,0,0,0,1.473161
84340,Sleepwalk with Me,2012-08-24,2012,0,0,0,2.944038
84341,Smashed,2012-09-12,2012,500000,376597,-123403,4.893812
84342,Something from Nothing: The Art of Rap,2012-06-15,2012,0,288312,288312,6.328119
84344,Teddy Bear,2012-01-22,2012,0,0,0,1.481425
84346,The Tsunami and the Cherry Blossom,2011-09-12,2011,0,0,0,0.083014
84347,Under African Skies,2012-05-11,2012,0,0,0,0.45347
84348,V/H/S,2012-07-28,2012,0,100345,100345,7.820787
84350,We‚Äôre Not Broke,2012-01-19,2012,0,0,0,0.216468
84351,West of Memphis,2012-12-25,2012,0,0,0,2.80109
84352,The Violent Enemy,1967-05-01,1967,0,0,0,0.022183
84354,Young & Wild,2012-03-29,2012,0,0,0,5.635687
84355,Your Sister's Sister,2011-09-11,2011,125000,3200000,3075000,10.850569
84362,Devil Hunter,1980-12-05,1980,0,0,0,1.439215
84364,A Woman's Secret,1949-03-05,1949,0,0,0,0.335752
84365,Whiplash,1948-12-24,1948,0,0,0,0.515831
84368,Manichitrathazhu,1993-12-25,1993,0,0,0,0.927886
84383,I Am Bruce Lee,2012-02-09,2012,0,0,0,12.903901
84391,My Sucky Teen Romance,2011-03-15,2011,0,0,0,0.879848
84397,Double Dynamite,1951-12-25,1951,0,0,0,0.284199
84401,Sholem Aleichem: Laughing In The Darkness,2012-02-24,2012,500000,845188,345188,0.086226
84404,Bully,2011-04-23,2011,1100000,0,-1100000,2.599768
84407,The Pruitt-Igoe Myth,2012-01-20,2012,0,0,0,1.371394
84418,Asylum of Satan,1972-01-01,1972,0,0,0,0.000347
84419,House of Horrors,1946-03-29,1946,0,0,0,0.222814
84420,Magic Christmas Tree,1964-12-19,1964,0,0,0,0.002323
84422,Don't Open Till Christmas,1984-12-07,1984,0,0,0,0.912179
84425,Shadows in an Empty Room,1976-03-09,1976,0,0,0,0.28812
84427,House of Tolerance,2011-09-20,2011,0,0,0,3.604863
84442,Oxygen,2009-07-08,2009,0,0,0,0.666187
84449,Remains,2011-12-06,2011,750000,0,-750000,2.145192
84450,Buster e Billie,1974-08-21,1974,0,0,0,0.139507
84465,Made For Each Other,1971-12-12,1971,0,0,0,0.035376
84473,The Iron Rose,1973-04-12,1973,0,0,0,1.318222
84479,The Invader,2011-11-23,2011,0,0,0,1.064526
84493,Metamorphoses,1978-05-03,1978,0,0,0,0.09555
84496,Zig Zag,1970-05-01,1970,0,0,0,0.478794
84499,Million Dollar Mystery,1987-06-12,1987,0,0,0,0.005351
84505,Kongo,1932-10-01,1932,0,0,0,0.108541
84508,The Ghost of Yotsuya,1959-07-01,1959,0,0,0,1.272301
84511,Banning,1967-12-13,1967,0,0,0,0.008677
84520,The Bunny Game,2010-01-01,2010,0,0,0,1.687991
84540,A Girl in Every Port,1952-02-13,1952,0,0,0,0.109981
84562,Vine of the Soul: Encounters with Ayahuasca,2010-07-23,2010,0,0,0,0.191046
84567,Between Heaven and Hell,1956-10-11,1956,0,0,0,0.866993
84569,Chosin,2010-09-10,2010,0,0,0,0.041185
84572,The Mars Underground,2007-05-09,2007,0,0,0,0.180741
84575,Tooth Fairy 2,2012-03-06,2012,5000000,0,-5000000,2.795621
84577,7 Below,2012-04-16,2012,6000000,0,-6000000,2.254853
84584,Devil of the Desert Against the Son of Hercules,1964-06-27,1964,0,0,0,0.220672
84586,Relax... It's Just Sex,1998-06-26,1998,0,0,0,0.407322
84601,The Wearing of the Grin,1951-07-28,1951,0,0,0,0.233572
84617,The Dot and the Line: A Romance in Lower Mathematics,1965-12-31,1965,0,0,0,0.923465
84626,Nukie,1988-10-19,1988,0,0,0,0.498547
84628,The Survivor,1981-07-09,1981,0,0,0,0.432661
84633,Quest of the Delta Knights,1993-10-01,1993,0,0,0,0.442903
84636,The Immortal Story,1968-06-01,1968,0,0,0,0.621392
84642,Wedding in White,1972-10-20,1972,0,0,0,0.038478
84643,Danger!! Death Ray,1967-01-28,1967,0,0,0,0.341901
84655,The Black Orchid,1958-02-11,1958,0,0,0,0.2325
84656,Fires Were Started,1943-04-12,1943,0,0,0,0.141664
84658,Bonnie's Kids,1973-02-08,1973,0,0,0,1.135255
84660,The Flower in Hell,1958-04-19,1958,0,0,0,0.429134
84672,Routine Pleasures,1986-04-30,1986,0,0,0,0.044807
84690,Oxy-Morons,2011-10-02,2011,3500000,0,-3500000,0.086584
84693,Naram Garam,1981-02-28,1981,0,0,0,0.31086
84701,San Pietro,1945-05-03,1945,0,0,0,0.914855
84705,Beyond Our Ken,2004-11-11,2004,0,0,0,0.011516
84708,Captive Wild Woman,1943-06-04,1943,0,0,0,0.627449
84710,Jungle Woman,1944-06-01,1944,0,0,0,0.143223
84711,Jungle Captive,1945-06-25,1945,0,0,0,0.082086
84718,Mystery of Edwin Drood,1935-02-04,1935,0,0,0,0.255674
84719,Man Made Monster,1941-03-28,1941,0,0,0,0.14576
84720,The Brute Man,1946-10-01,1946,0,0,0,0.342308
84724,Stitches,1985-11-01,1985,0,0,0,0.068551
84727,Woman Wanted,1999-08-14,1999,0,0,0,0.607257
84728,Black Girl,1972-11-09,1972,0,0,0,0.2875
84729,Casablanca Express,1989-12-22,1989,0,0,0,0.000308
84730,"Csocs√≥, avagy √©ljen m√°jus elseje!",2001-12-06,2001,0,0,0,0.092977
84734,Venetian Bird,1952-10-01,1952,0,0,0,0.103727
84735,So Fine,1981-09-25,1981,0,0,0,1.09807
84739,Break Free,2003-01-01,2003,0,0,0,0.143174
84741,Courage,2009-07-12,2009,0,0,0,0.499442
84742,Donner Pass,2012-11-15,2012,300000,0,-300000,2.136647
84760,Robot Holocaust,1986-04-14,1986,0,0,0,0.002001
84765,Perfumed Nightmare,1977-01-01,1977,0,0,0,0.009192
84771,Lovelines,1984-11-02,1984,0,0,0,1.3e-05
84772,Hell's Hinges,1916-03-05,1916,0,0,0,0.316238
84774,Alice in Wonderland,1981-01-31,1981,0,0,0,0.320034
84777,Gimme an 'F',1984-11-16,1984,0,0,0,0.005645
84782,Don Quixote,1957-05-23,1957,0,0,0,0.714608
84784,Pandemonium,1982-04-01,1982,0,0,0,0.175473
84796,Play It As It Lays,1972-10-19,1972,0,0,0,0.000431
84797,As Luck Would Have It,2011-11-30,2011,0,0,0,1.293108
84801,Summer School,1978-05-01,1978,0,0,0,0.164734
84805,The Fat Albert Halloween Special,1977-10-24,1977,0,0,0,0.052886
84820,The Mad Masters,1955-08-24,1955,0,0,0,0.344463
84823,Santa Claus Has Blue Eyes,1966-04-25,1966,0,0,0,0.323573
84827,The Life of Reilly,2006-03-12,2006,0,0,0,0.009687
84831,Trenchcoat,1983-03-11,1983,0,0,0,0.122817
84834,Double Indemnity,1973-10-13,1973,0,0,0,0.64384
84839,The Comic,1969-11-19,1969,0,0,0,0.140017
84844,A Dandy in Aspic,1968-04-02,1968,0,0,0,0.193278
84847,Cinderella Liberty,1973-12-18,1973,0,0,0,0.485032
84848,Blood,2006-02-01,2006,478000,0,-478000,0.170569
84857,My Life in Orange,2011-08-18,2011,0,0,0,0.688986
84858,Agneepath,2012-01-25,2012,11097000,49028000,37931000,2.589507
84865,Ma L'Amore... S√¨,2006-10-20,2006,0,0,0,0.003796
84875,The Well-Digger's Daughter,1940-12-20,1940,0,0,0,0.090592
84880,The Great White Silence,1924-05-10,1924,0,0,0,0.36117
84892,The Perks of Being a Wallflower,2012-09-20,2012,13000000,33400000,20400000,12.775679
84903,The Marrying Kind,1952-02-01,1952,0,0,0,1.196486
84904,"Italy: Love It, or Leave it",2011-09-14,2011,0,0,0,0.128687
84905,Somewhere in Sonora,1933-05-27,1933,0,0,0,0.295744
84906,The Telegraph Trail,1933-03-18,1933,0,0,0,0.177405
84907,Playback,2012-03-09,2012,7500000,0,-7500000,2.263493
84908,Lawless Range,1935-11-04,1935,0,0,0,0.104367
84911,Coming Home,2003-01-08,2003,0,0,0,0.090448
84912,Murder in the Private Car,1934-06-29,1934,0,0,0,0.309998
84917,The City Dark,2012-01-20,2012,0,0,0,0.171364
84922,Mahler,1974-04-04,1974,0,0,0,1.352467
84925,Profit Motive and the Whispering Wind,2007-07-05,2007,0,0,0,0.038824
84942,The Watermen,2011-12-25,2011,1150000,0,-1150000,0.896197
84944,The White Reindeer,1952-07-25,1952,0,0,0,0.38921
84951,Witchcraft II: The Temptress,1990-05-20,1990,80000,0,-80000,0.145241
84954,Secrets of a Soul,1926-03-24,1926,0,0,0,0.198451
84956,Warning Shadows,1923-10-16,1923,0,0,0,0.590881
84971,Penguin Pool Murder,1932-12-09,1932,0,0,0,0.320909
84972,Chronicle of a Summer,1961-10-20,1961,0,0,0,0.405373
84984,The House of the Yellow Carpet,1983-09-09,1983,0,0,0,0.001586
84986,Screamtime,1983-01-01,1983,0,0,0,0.038308
84993,Next of Kin,1982-09-30,1982,0,0,0,0.768481
84994,Rocktober Blood,1984-01-01,1984,0,0,0,0.000308
84997,They're Playing with Fire,1984-04-01,1984,0,0,0,1.746702
85009,Too Scared to Scream,1985-01-04,1985,0,0,0,0.332156
85013,Hyper Sapien: People from Another Star,1986-12-01,1986,0,0,0,9e-06
85014,Shaolin Drunkard,1983-07-09,1983,0,0,0,0.000308
85023,A Name for Evil,1973-01-01,1973,0,0,0,0.00335
85024,Shatter Dead,1994-12-13,1994,0,0,0,0.200978
85025,Memory Lane,2010-11-24,2010,0,0,0,0.24086
85032,Kotoko,2011-11-26,2011,0,0,0,1.044171
85033,Caf√© de Flore,2011-11-17,2011,0,0,0,11.102969
85038,Welcome to the North,2012-01-18,2012,6000000,35000000,29000000,5.219214
85039,Life 2.0,2010-01-22,2010,0,0,0,0.874264
85043,Tere Naal Love Ho Gaya,2012-02-24,2012,0,0,0,0.841267
85047,"London, Paris, New York",2012-03-02,2012,2640000,0,-2640000,0.33515
85050,Agent Vinod,2012-03-23,2012,0,0,0,1.20962
85052,Housefull 2,2012-04-05,2012,0,0,0,1.047079
85058,First Monday in October,1981-08-21,1981,0,0,0,0.384338
85087,Dreams of Dust,2008-01-30,2008,0,0,0,0.110208
85097,The Matador,2008-11-20,2008,0,0,0,0.009423
85107,Slow Action,2010-01-01,2010,0,0,0,0.119934
85110,Dog Star Man: Part I,1962-01-01,1962,0,0,0,0.321059
85125,I for India,2005-11-29,2005,0,0,0,0.039662
85126,Hickey & Boggs,1972-10-04,1972,0,0,0,0.801399
85129,Variety,1983-09-10,1983,0,0,0,0.009919
85160,Slaughterhouse,1987-08-28,1987,0,0,0,1.5568
85162,Deadly Dreams,1988-10-26,1988,0,0,0,0.136398
85163,Destroyer,1988-04-01,1988,0,0,0,0.233781
85184,Nightmares,1980-10-30,1980,0,0,0,0.410078
85196,The Forest,1982-01-01,1982,0,0,0,0.001133
85200,Island of Blood,1982-01-08,1982,0,0,0,0.009335
85204,American Nightmare,1983-03-17,1983,0,0,0,0.246148
85207,Airborne,2012-03-15,2012,0,0,0,1.536225
85220,The Thieving Hand,1908-02-01,1908,0,0,0,0.188317
85221,Fantasmagorie,1908-08-17,1908,0,0,0,1.276073
85230,The Clown at Midnight,1999-02-09,1999,0,0,0,0.620747
85231,The Lone Wolf Meets a Lady,1940-05-30,1940,0,0,0,0.071784
85232,The Lone Wolf Strikes,1940-01-26,1940,0,0,0,0.116017
85236,Chosen Survivors,1974-12-05,1974,0,0,0,0.281567
85239,Mantis in Lace,1968-01-01,1968,0,0,0,0.660875
85242,Underworld,1996-06-01,1996,0,0,0,0.005555
85247,Killer,1994-09-14,1994,0,0,0,0.422224
85255,...tick... tick... tick...,1970-01-09,1970,0,0,0,0.829587
85262,Cracked Nuts,1931-04-18,1931,0,0,0,0.054984
85265,The Child,2000-05-10,2000,0,0,0,0.162737
85268,Cleopatra Wong,1978-11-10,1978,0,0,0,0.070604
85277,Happy Family,2006-12-14,2006,800000,966214,166214,0.170979
85285,The Empty Canvas,1963-12-04,1963,0,0,0,0.629324
85290,The Hawaiians,1970-06-17,1970,0,0,0,0.729092
85293,Harriet Craig,1950-11-02,1950,0,0,0,0.744993
85304,John Lennon - Plastic Ono Band,2008-04-29,2008,0,0,0,0.108041
85312,Making the Boys,2011-03-11,2011,0,0,0,0.173956
85317,Six Degrees of Celebration 2,2011-12-15,2011,0,0,0,0.85273
85325,Citizen's Band,1977-09-29,1977,0,0,0,1.799462
85327,Rich Kids,1979-08-01,1979,0,0,0,0.42168
85328,The Pompatus of Love,1996-07-26,1996,0,0,0,0.537795
85330,Out At The Wedding,2007-01-01,2007,0,0,0,0.713735
85336,Madonna's Pig,2011-11-09,2011,0,0,0,0.133641
85339,More Wild Wild West,1980-10-07,1980,0,0,0,0.109194
85340,A One-Way Trip to Antibes,2011-09-30,2011,0,0,0,0.203917
85341,The Wild Wild West Revisited,1979-05-09,1979,0,0,0,0.022989
85346,Undertow,1949-12-01,1949,0,0,0,0.462497
85349,Tomie: Unlimited,2011-05-14,2011,0,0,0,2.06907
85350,Boyhood,2014-06-05,2014,4000000,44349000,40349000,6.430591
85365,Tony Arzenta,1973-08-23,1973,0,0,0,0.42723
85367,Vice Squad,1953-07-31,1953,0,0,0,0.488169
85373,StreetDance 2,2012-03-30,2012,0,0,0,5.728471
85377,Young Black Jack,2011-04-23,2011,0,0,0,0.040265
85389,Natimorto,2011-04-29,2011,0,0,0,0.009693
85393,The Booth,2005-11-05,2005,0,0,0,0.163544
85394,33 Scenes from Life,2008-11-07,2008,0,0,0,0.731141
85398,One Thousand and One Nights,1969-06-14,1969,0,0,0,0.665574
85411,The Three Stooges,2000-04-24,2000,0,0,0,0.309153
85414,Brake,2012-03-22,2012,0,0,0,9.213358
85420,Movie Movie,1978-11-01,1978,0,0,0,0.018017
85424,Hotel E,1992-01-01,1992,0,0,0,0.035346
85428,No. 12: Heaven and Earth Magic,1962-01-01,1962,0,0,0,0.394192
85429,Pretty Devils,2000-02-09,2000,0,0,0,0.220359
85430,Girl Play,2004-07-11,2004,1000000,0,-1000000,0.479002
85431,Take Me Home,2011-03-02,2011,0,0,0,9.702695
85434,Frozen Silence,2011-12-16,2011,0,0,0,1.51059
85435,A Few Best Men,2011-10-14,2011,12468389,29007412,16539023,6.116093
85439,"Snowflake, the White Gorilla",2011-12-23,2011,0,0,0,1.00567
85442,To Catch a Spy,1971-09-06,1971,0,0,0,0.014346
85444,Wrinkles,2011-09-19,2011,2000000,0,-2000000,1.525646
85446,Step Up Revolution,2012-07-26,2012,33000000,140470746,107470746,7.859968
85449,Skylab,2011-09-19,2011,0,0,0,7.502597
85463,Atelier Fontana,2011-02-27,2011,0,0,0,1.309157
85469,Einer wie Bruno,2012-04-12,2012,0,0,0,0.163113
85472,Only the Strong Survive,2002-01-14,2002,0,0,0,0.317166
85483,Something Evil,1972-01-21,1972,0,0,0,0.759953
85494,Captive Women,1952-10-10,1952,0,0,0,0.001739
85498,The Maze,1953-07-26,1953,0,0,0,0.548048
85502,East Meets West,2011-11-24,2011,0,0,0,0.170936
85504,The Sin of Madelon Claudet,1931-10-23,1931,0,0,0,0.398635
85505,Min and Bill,1930-11-29,1930,0,0,0,0.336991
85507,Coquette,1929-04-06,1929,0,0,0,0.457598
85509,Joy of Sex,1984-08-03,1984,0,0,0,0.156912
85510,Ladybug Ladybug,1963-12-23,1963,0,0,0,0.476712
85511,California Dreaming,1979-04-01,1979,0,0,0,0.442119
85512,Jaws of Satan,1981-07-24,1981,0,0,0,1.026078
85514,The Quiet American,1958-02-08,1958,0,0,0,0.538973
85516,Requiem for a Village,1975-12-01,1975,0,0,0,0.049563
85518,Confidence Girl,1952-06-20,1952,0,0,0,0.315559
85521,The Cool World,1963-01-01,1963,0,0,0,0.693882
85525,The Day He Arrives,2011-09-08,2011,0,11,11,1.042432
85533,Whores' Glory,2011-09-09,2011,0,0,0,1.477577
85535,David Holzman's Diary,1967-01-01,1967,0,0,0,0.177696
85540,Dr. Kildare Goes Home,1940-09-06,1940,0,0,0,0.285855
85542,Trishna,2011-09-08,2011,0,0,0,2.477815
85543,Bonsai,2011-09-02,2011,0,0,0,0.326654
85544,Back to Stay,2011-08-08,2011,0,0,0,0.438869
85545,Elles,2011-09-09,2011,4000000,911466,-3088534,9.921433
85546,A Better Life,2012-01-03,2012,0,0,0,1.678135
85547,The First Man,2011-09-09,2011,0,0,0,0.345772
85548,Windwalker,1980-12-12,1980,0,18,18,1.178642
85549,Las Acacias,2011-10-14,2011,0,0,0,0.471995
85550,Tale of Cinema,2005-05-27,2005,0,0,0,0.800976
85556,Speaking Parts,1989-09-29,1989,0,0,0,1.132456
85559,Archangel,1990-09-01,1990,0,0,0,0.170087
85564,Nature of the Beast,1995-10-23,1995,0,0,0,1.352512
85566,Rage,2010-05-01,2010,0,0,0,0.140985
85574,The Seventh Cross,1944-07-24,1944,0,0,0,0.283062
85580,Flyin' Ryan,2003-04-30,2003,0,0,0,0.003331
85581,Time Of My Life,2012-01-25,2012,0,0,0,0.639326
85588,Dadetown,1995-09-02,1995,0,0,0,0.037353
85589,Zero Kelvin,1995-09-29,1995,2535000,0,-2535000,0.472335
85593,Bag It,2011-09-01,2011,0,0,0,0.587847
85598,Streetwalkin',1985-09-20,1985,0,0,0,0.268344
85602,Jaguar Lives!,1979-08-09,1979,0,0,0,0.013577
85609,The Outrage,1964-10-08,1964,0,0,0,2.610968
85610,Half Shot at Sunrise,1930-10-04,1930,0,0,0,0.075996
85611,The Stranglers of Bombay,1959-12-04,1959,0,0,0,0.606787
85613,Kentucky Kernels,1934-11-02,1934,0,0,0,0.089309
85615,The Lion,1962-08-19,1962,0,0,0,0.288509
85616,Svend,2011-11-25,2011,0,0,0,0.122403
85620,Blood and Roses,1960-09-14,1960,0,0,0,0.523773
85621,Men in Hope,2011-08-25,2011,0,0,0,1.517652
85628,The Third Prince,1982-12-01,1982,0,0,0,1e-06
85633,Hot Pepper,1973-11-22,1973,0,0,0,0.035295
85637,Always for Pleasure,1978-05-02,1978,0,0,0,0.104287
85638,The Scarlet Letter,1926-08-09,1926,0,0,0,0.284522
85639,Run for Cover,1955-04-29,1955,0,0,0,0.513931
85640,The Caretakers,1963-08-21,1963,0,0,0,0.001353
85642,Garlic Is As Good As Ten Mothers,1980-10-12,1980,0,0,0,0.191218
85643,In Heaven There Is No Beer?,1984-05-23,1984,0,0,0,0.074231
85644,Riot,1969-01-15,1969,0,0,0,0.078393
85648,Showdown,1973-06-20,1973,0,0,0,0.874587
85651,Youngblood,1978-05-24,1978,0,0,0,0.115396
85652,Mamitas,2012-04-27,2012,0,0,0,0.155409
85654,Fire with Fire,1986-05-09,1986,0,0,0,0.812368
85656,Karate-Robo Zaborgar,2011-10-15,2011,0,0,0,0.178482
85657,The Dynamiter,2011-10-21,2011,250000,0,-250000,0.907111
85658,All In This Tea,2007-04-14,2007,0,0,0,0.003682
85670,Night Flight,1933-10-06,1933,0,0,0,0.409615
85672,Too Hot to Handle,1977-02-18,1977,0,0,0,0.295014
85673,TNT Jackson,1974-06-08,1974,0,0,0,0.307549
85674,The Twilight People,1972-06-01,1972,0,0,0,0.035207
85677,The Constant Nymph,1943-06-23,1943,0,0,0,0.432041
85685,The Godless Girl,1929-03-31,1929,0,0,0,0.636876
85689,The Son of the Sheik,1926-09-05,1926,0,0,0,0.135371
85690,Shattered Glass,2002-10-31,2002,0,0,0,0.108241
85692,A Man Vanishes,1967-07-08,1967,0,0,0,1.088719
85693,Hammy's Boomerang Adventure,2006-10-17,2006,0,0,0,1.012941
85695,Ruby,1977-06-23,1977,0,0,0,0.595368
85696,We'll Take Manhattan,2012-03-03,2012,0,0,0,0.807075
85699,Zettl,2012-02-01,2012,0,0,0,0.983056
85702,Trava: Fist Planet,2003-05-03,2003,0,0,0,1.760848
85708,The Stoneman Murders,2009-02-13,2009,0,0,0,0.005061
85709,Dooman River,2010-08-28,2010,0,0,0,0.288618
85711,Fuck Up,2012-03-16,2012,0,0,0,1.166698
85715,Arsenal,1929-02-25,1929,0,0,0,0.811576
85721,"Burzynski, the Movie",2010-10-28,2010,0,0,0,0.564465
85729,My Boyfriend an Angel,2011-12-20,2011,0,0,0,1.866189
85735,Love Lasts Three Years,2011-12-10,2011,0,0,0,5.019821
85739,A.C.A.B.: All Cops Are Bastards,2012-01-27,2012,5000000,0,-5000000,8.842243
85741,Free Men,2011-09-28,2011,0,0,0,0.660023
85743,Play,2011-05-15,2011,0,0,0,1.720825
85753,Perry Mason: The Case of the Killer Kiss,1993-11-29,1993,0,0,0,0.391217
85755,Perry Mason: The Case of the Heartbroken Bride,1992-10-30,1992,0,0,0,0.2875
85758,Perry Mason: The Case of the Glass Coffin,1991-05-14,1991,0,0,0,0.053218
85763,The 7th Dawn,1964-09-02,1964,0,0,0,0.119106
85765,Boom!,1968-05-26,1968,0,0,0,0.372306
85766,The Frozen North,2006-12-25,2006,0,0,0,0.310486
85768,Greetings to the Devil,2011-08-11,2011,0,0,0,1.101517
85769,Reconstruction,1970-08-31,1970,0,0,0,0.004425
85778,Maya Lin: A Strong Clear Vision,1995-11-10,1995,0,0,0,0.001608
85783,The Star,1952-12-11,1952,0,0,0,1.049345
85784,The Double,1971-01-01,1971,0,0,0,0.081011
85787,Swan Lake,1981-03-13,1981,0,0,0,0.083899
85788,Margaret Thatcher: The Long Walk to Finchley,2008-01-01,2008,500,0,-500,0.223236
85790,The Old Crocodile,2005-01-01,2005,0,0,0,0.072941
85793,Legend of the Forest,1987-12-18,1987,0,0,0,0.014473
85813,Murari,2001-02-17,2001,0,0,0,0.262724
85814,Youth Runs Wild,1944-09-01,1944,0,0,0,0.003753
85819,Some Days Are Better Than Others,2011-06-03,2011,0,0,0,0.254358
85820,Mademoiselle Fifi,1944-01-01,1944,0,0,0,0.128057
85821,Littlerock,2010-04-23,2010,0,0,0,0.288557
85822,Free Radicals: A History of Experimental Film,2012-08-03,2012,0,0,0,0.080017
85827,Island of the Blue Dolphins,1964-09-10,1964,0,0,0,0.402139
85834,M√©diterran√©e,1963-04-23,1963,0,0,0,0.26304
85836,Hara-Kiri: Death of a Samurai,2011-10-15,2011,0,0,0,7.898847
85837,Detroit 9000,1973-08-01,1973,0,0,0,0.37055
85840,Little Boy Lost,1953-09-21,1953,0,0,0,0.039915
85841,The Glory Brigade,1953-05-20,1953,850000,0,-850000,0.051071
85844,Women of the Night,1948-05-26,1948,0,0,0,0.530321
85854,The Saga of the Viking Women and Their Voyage to the Waters of the Great Sea Serpent,1957-12-01,1957,0,0,0,0.587937
85860,The FP,2011-03-13,2011,0,0,0,0.558158
85870,My Way,2012-03-14,2012,27563396,29193330,1629934,7.847574
85872,Le Chef,2012-03-07,2012,0,306724,306724,5.691572
85873,GhostWatcher,2002-10-19,2002,0,0,0,0.173751
85876,The Student Prince in Old Heidelberg,1928-01-30,1928,0,0,0,0.472314
85878,Starry Starry Night,2011-11-03,2011,0,0,0,3.572172
85883,The Woman Who Drinks,2001-03-09,2001,0,0,0,0.187194
85886,Old Man Made in Spain,1969-03-17,1969,0,0,0,0.470673
85887,A Taste of Romance,2012-01-14,2012,0,0,0,1.241474
85889,Filth,2013-09-23,2013,5000000,9114264,4114264,14.970485
85901,Chasing Two Hares,1961-12-21,1961,0,0,0,0.87052
85904,The Inner Scar,1972-02-02,1972,0,0,0,0.000578
85910,The Rolling Stones - Let's Spend the Night Together,1982-10-29,1982,0,0,0,0.716763
85916,Rat Pfink a Boo Boo,1966-09-01,1966,0,0,0,0.195161
85926,Strangers When We Meet,1960-06-29,1960,0,0,0,0.632174
85927,India Song,1975-06-04,1975,0,0,0,0.675717
85941,"Jasper, Texas",2003-06-08,2003,0,0,0,0.315825
85942,Model Shop,1969-02-11,1969,0,0,0,0.114096
85944,Tom Papa: Live in New York City,2011-07-01,2011,0,0,0,0.252319
85948,Liar's Moon,1982-09-01,1982,0,0,0,0.036974
85949,Collision Earth,2011-03-24,2011,0,0,0,1.135123
85956,The New Year,2010-07-30,2010,0,0,0,0.19856
85959,Cafe Noir,2009-09-01,2009,0,0,0,0.443406
85963,Great Directors,2010-07-02,2010,0,0,0,0.218364
85966,Night Call Nurses,1972-06-01,1972,75000,0,-75000,0.000578
85968,Candy Stripe Nurses,1974-05-01,1974,0,0,0,0.001393
85971,Summer School Teachers,1974-08-01,1974,0,0,0,0.000431
85984,Off the Menu: The Last Days of Chasen's,1998-06-19,1998,0,0,0,0.051061
85988,Sixpack,2011-09-02,2011,0,0,0,0.229656
86000,Always,2011-10-20,2011,0,0,0,4.149212
86004,Talaash,2012-11-30,2012,8510000,0,-8510000,3.81691
86023,The Intruder,1999-11-19,1999,0,0,0,0.550019
86040,"To Sir, with Love II",1996-04-07,1996,0,0,0,0.626382
86049,Follow Me!,1972-07-18,1972,0,0,0,0.130634
86059,The Comedians,1967-10-31,1967,0,5200000,5200000,2.86317
86063,Bottled Life: Nestle's Business with Water,2012-01-26,2012,0,0,0,0.724011
86068,The House Where Evil Dwells,1982-05-14,1982,0,0,0,0.579947
86077,4 Elements,2006-11-30,2006,0,0,0,0.074221
86081,Regeneration,1915-09-12,1915,0,0,0,0.720077
86082,Why We Fight: The Nazis Strike,1943-01-01,1943,0,0,0,0.889638
86084,Why We Fight: The Battle of China,1944-01-01,1944,0,0,0,0.052711
86087,Hell's Highway,1932-09-23,1932,0,0,0,0.2851
86093,Cookie,1989-08-23,1989,0,0,0,0.456397
86096,The Children,1985-02-01,1985,0,0,0,0.252545
86097,For the Love of Movies: The Story of American Film Criticism,2009-03-01,2009,0,0,0,0.348386
86099,Valerie,2007-04-26,2007,0,0,0,0.563695
86118,This Way Up,2008-04-24,2008,0,0,0,0.670487
86120,The Fighting Lady,1944-12-21,1944,0,0,0,0.07617
86126,A Cab for Three,2001-08-02,2001,0,0,0,0.218845
86131,Child of Rage,1992-09-24,1992,0,0,0,0.299491
86133,The Next Man,1976-11-10,1976,0,0,0,0.258973
86154,La Fuga,2001-05-24,2001,0,0,0,0.336344
86157,Torpedo Bombers,1983-08-01,1983,0,0,0,0.72925
86168,I Could Go on Singing,1963-03-07,1963,0,0,0,0.914649
86172,Stray Dog,2007-05-11,2007,0,0,0,0.003591
86177,Teenage Gang Debs,1966-11-04,1966,0,0,0,0.001313
86182,The Cat and the Canary,1979-11-01,1979,0,0,0,0.175357
86186,Perfect Body,1997-09-08,1997,0,0,0,0.193592
86190,Adventures Of A Taxi Driver,1976-04-30,1976,0,0,0,0.418006
86193,The Incredible 2-Headed Transplant,1971-04-28,1971,0,0,0,0.697569
86201,Welcome Home Brother Charles,1975-11-11,1975,0,0,0,0.041
86207,Lunch Wagon,1981-09-01,1981,0,0,0,0.018644
86209,Fighting Mad,1976-02-21,1976,600000,0,-600000,0.094378
86210,Jailbait Babysitter,1977-09-02,1977,0,0,0,0.004351
86211,Deep Blues,1992-04-01,1992,0,0,0,1e-06
86215,The Cloth,2012-10-28,2012,2000000,0,-2000000,3.733898
86221,The Sleep Room,1998-03-31,1998,0,0,0,0.1115
86223,Russian Terminator,1989-12-12,1989,0,0,0,0.039352
86225,The Day They Robbed the Bank of England,1960-09-04,1960,0,0,0,0.468764
86231,The In Crowd,1988-02-01,1988,0,124880,124880,0.755195
86232,An American Tragedy,1931-08-22,1931,0,0,0,0.491424
86233,The Other Side of the Mountain,1975-11-14,1975,0,0,0,0.039473
86234,The Amulet of Ogum,1974-05-21,1974,0,0,0,0.207397
86235,Bad Girl Island,2009-01-01,2009,0,0,0,1.013005
86236,Dying Room Only,1973-09-18,1973,0,0,0,0.034545
86239,The Pack,1977-11-20,1977,0,0,0,0.035862
86240,All Fall Down,1962-04-11,1962,0,0,0,5.285622
86241,Welcome to L.A.,1976-11-12,1976,0,0,0,1.011199
86244,Verboten!,1959-03-25,1959,0,0,0,0.229034
86251,Strike Commando,1987-08-26,1987,0,0,0,0.51686
86252,Deadbeat at Dawn,1988-01-01,1988,0,0,0,0.00195
86254,Crash Landing,2006-07-11,2006,0,0,0,0.306947
86256,Tarkan and the Blood of the Vikings,1971-01-01,1971,0,0,0,0.776091
86258,The Brave Bulls,1951-04-18,1951,0,0,0,0.001177
86261,Oki's Movie,2010-09-16,2010,0,0,0,1.114075
86262,Like You Know It All,2009-05-14,2009,0,0,0,0.260593
86266,The Power of Kangwon Province,1998-04-04,1998,0,0,0,0.236194
86267,The Day a Pig Fell into the Well,1996-05-04,1996,0,0,0,0.700989
86269,Mutant Hunt,1987-06-01,1987,0,0,0,0.024529
86271,Three on a Meathook,1973-01-01,1973,0,0,0,0.04586
86274,Hunky Dory,2011-10-25,2011,0,0,0,0.915237
86279,Fakta Ladh Mhana,2011-08-05,2011,10,0,-10,0.223797
86282,Tie Xi Qu: West of the Tracks,2002-04-26,2002,0,0,0,0.43462
86283,Snapshot,1979-06-01,1979,0,0,0,0.000729
86284,Paper Lion,1968-10-23,1968,0,0,0,0.98558
86295,Treasure of the Yankee Zephyr,1981-11-28,1981,0,0,0,1.495604
86297,Tall Story,1960-04-06,1960,0,0,0,0.463448
86303,Subarnarekha,1965-10-13,1965,0,0,0,0.119106
86304,All Superheroes Must Die,2011-10-26,2011,0,0,0,5.928982
86305,Exit Humanity,2011-10-16,2011,300000,0,-300000,1.77348
86320,Twenty Years Later,1984-12-03,1984,0,0,0,0.004218
86321,Playing,2007-01-01,2007,0,0,0,0.93861
86324,Santiago,2007-08-24,2007,0,0,0,0.144707
86326,Phantom of the Mall: Eric's Revenge,1989-12-01,1989,0,0,0,1e-06
86331,Desire,2011-09-14,2011,1344000,0,-1344000,13.621581
86332,The Redeemer: Son of Satan!,1978-04-07,1978,0,0,0,0.611242
86337,Gor,1987-05-08,1987,0,0,0,1.237557
86360,Sunnyside Up,1929-12-25,1929,0,0,0,0.401213
86363,Gun The Man Down,1956-11-15,1956,0,0,0,0.353156
86369,Mina Tannenbaum,1994-03-02,1994,0,0,0,0.400813
86381,Tell Them Anything You Want: A Portrait of Maurice Sendak,2009-10-14,2009,0,0,0,0.009824
86382,They Fought for Their Motherland,1975-11-01,1975,0,0,0,0.954861
86391,All Together,2011-08-12,2011,0,7211180,7211180,2.997222
86404,La balance,1982-11-10,1982,0,0,0,1.384396
86410,The Hounds,2011-08-01,2011,0,0,0,0.101706
86412,The Fantastic Flying Books of Mr Morris Lessmore,2011-01-30,2011,0,0,0,1.901101
86413,"Come Back, Africa",1959-01-01,1959,0,0,0,0.381912
86416,The Chance of a Lifetime,1943-10-26,1943,0,0,0,0.044321
86431,Sinbad,1971-11-25,1971,0,0,0,1e-06
86440,I'm Gonna Explode,2008-09-26,2008,0,0,0,0.270064
86455,"The Cartoonist: Jeff Smith, BONE and the Changing Face of Comics",2009-05-22,2009,0,0,0,0.00737
86457,Call Her Savage,1932-11-27,1932,0,0,0,0.384612
86458,Mixed Blood,1984-10-01,1984,0,0,0,0.004425
86462,The Candy Tangerine Man,1975-05-01,1975,0,0,0,0.009192
86463,D.O.A.,1980-09-12,1980,0,0,0,0.005351
86467,Bel Ami,2012-03-09,2012,9000000,8303261,-696739,7.720692
86472,A Long Ride from Hell,1968-04-05,1968,0,0,0,0.117699
86482,The Man Who Had His Hair Cut Short,1966-09-05,1966,0,0,0,0.265271
86483,Big Bad Mama II,1987-10-01,1987,0,0,0,0.018017
86493,She Devils of the SS,1972-12-31,1972,0,0,0,1.533603
86495,Oliver Sherman,2011-02-04,2011,0,0,0,0.827873
86497,Wide Open,1974-12-18,1974,0,0,0,1.078596
86500,Picasso and Braque Go to the Movies,2008-09-07,2008,0,0,0,0.330366
86508,Love Camp,1977-10-13,1977,0,0,0,1.642674
86517,It's Such a Beautiful Day,2011-11-17,2011,0,0,0,0.576007
86520,Himiko,1974-03-09,1974,0,0,0,0.008939
86522,Louis Theroux: The Ultra Zionists,2011-02-03,2011,0,0,0,0.688975
86531,"You, Me and Him",2007-03-16,2007,0,0,0,0.34048
86532,Paths of Hate,2011-03-27,2011,0,0,0,0.477559
86541,Ghost Graduation,2012-02-03,2012,0,0,0,2.801721
86543,Rose Hill,1997-04-20,1997,0,0,0,0.625766
86549,August,2011-06-09,2011,0,0,0,1.547762
86555,Take This Waltz,2011-11-25,2011,0,0,0,5.735158
86556,11 Minutes Ago,2007-04-26,2007,0,0,0,0.115974
86576,Paap,2003-12-20,2003,0,0,0,0.22653
86577,Happy,2011-04-09,2011,700000,0,-700000,1.517025
86593,Wild Bill,2011-10-21,2011,0,0,0,3.879808
86594,In Search of Ancient Astronauts,1973-01-05,1973,0,0,0,0.00222
86597,The Tall Man,2012-03-19,2012,18200000,0,-18200000,7.96508
86598,The UFO Incident,1975-10-20,1975,0,0,0,0.171122
86600,The Internecine Project,1974-07-24,1974,0,0,0,1.672384
86603,Bare Knuckles,1977-09-08,1977,0,0,0,0.000157
86604,Tom Dick and Harry,1941-06-13,1941,0,0,0,0.8313
86608,Track of the Cat,1954-11-27,1954,0,0,0,0.822756
86616,The Young Savages,1961-05-24,1961,0,0,0,0.57796
86632,Mad Ron's Prevues from Hell,1987-01-01,1987,0,0,0,0.02158
86633,The Alien Factor,1978-05-12,1978,0,0,0,0.001586
86637,Ricco,1973-08-27,1973,0,0,0,0.334965
86640,Massacre in Dinosaur Valley,1985-01-01,1985,0,0,0,2.123816
86643,House of Whipcord,1974-04-19,1974,0,0,0,1.754011
86647,Blue Rita,1977-07-08,1977,0,0,0,0.436091
86655,A Married Couple,1969-01-01,1969,0,0,0,0.040663
86658,Zombie Christ,2010-10-27,2010,5000,0,-5000,0.137117
86664,Crazed Fruit,1956-07-12,1956,0,0,0,0.435303
86666,Gate of Flesh,1964-05-31,1964,0,0,0,1.853596
86667,Grip of the Strangler,1958-07-03,1958,0,0,0,0.487567
86680,The Unholy,1988-04-22,1988,0,0,0,0.945352
86682,They Call Me Macho Woman,1991-01-01,1991,0,0,0,0.200919
86685,The Item,1999-01-01,1999,0,0,0,0.071764
86700,Zodiac: The Race Begins...,2006-01-26,2006,0,0,0,0.148602
86703,2-Headed Shark Attack,2012-01-17,2012,0,0,0,7.198828
86705,John Mulaney: New In Town,2012-01-31,2012,0,0,0,1.53828
86707,Silence,2011-12-09,2011,2100000,0,-2100000,0.793103
86709,Last Man Standing,2011-06-07,2011,0,0,0,0.185515
86713,Marcello Marcello,2008-02-01,2008,0,0,0,0.288397
86718,7Aum Arivu,2011-10-26,2011,16000000,98900000,82900000,2.252517
86726,Under the Boardwalk: The Monopoly Story,2011-03-04,2011,0,0,0,0.920233
86727,Le Crabe-Tambour,1977-11-09,1977,0,0,0,0.780497
86732,Red Psalm,1972-03-09,1972,0,0,0,1.712319
86750,Warrendale,1967-01-01,1967,0,0,0,0.391584
86751,Dying at Grace,2003-01-01,2003,0,0,0,0.293094
86759,Rosewood Lane,2011-10-15,2011,0,0,0,2.16938
86763,Chattahoochee,1989-09-16,1989,0,0,0,1.777657
86764,Suzanne's Career,1963-02-01,1963,0,0,0,1.486399
86768,5 Steps to Danger,1957-01-30,1957,0,0,0,0.904551
86772,The Black Raven,1943-05-31,1943,0,0,0,0.43484
86777,China Gate,1957-05-22,1957,0,0,0,0.790953
86778,A Carol for Another Christmas,1964-12-28,1964,0,0,0,0.151184
86782,Patterns,1956-03-27,1956,0,0,0,0.504412
86785,The Moment of Truth,1965-03-03,1965,0,0,0,0.542389
86791,Gunsmith Cats: Bulletproof!,1995-11-01,1995,0,0,0,0.462376
86792,Dead Awake,2001-11-06,2001,0,0,0,0.407369
86812,Sound of My Voice,2011-01-22,2011,0,0,0,5.209056
86814,News from Home,1977-06-08,1977,0,0,0,0.082319
86816,The Legend of Lylah Clare,1968-08-21,1968,0,0,0,1.287517
86817,The Cosmonaut,2013-05-17,2013,1138340,0,-1138340,0.643925
86819,Alois Nebel,2011-09-04,2011,0,0,0,1.298504
86820,4:44 Last Day on Earth,2011-09-07,2011,0,17801,17801,7.716763
86821,Ayn Rand & the Prophecy of Atlas Shrugged,2011-11-01,2011,0,0,0,0.318283
86822,Voyage of Time: Life's Journey,2017-04-13,2017,0,0,0,6.913581
86823,Intimidation,1960-03-23,1960,0,0,0,0.345223
86825,Stoker,2013-02-28,2013,12000000,12077441,77441,7.222816
86828,Absolutely Anything,2015-06-26,2015,0,7200039,7200039,14.998954
86829,Inside Llewyn Davis,2013-10-06,2013,11000000,32935319,21935319,10.838063
86834,Noah,2014-03-20,2014,125000000,362637473,237637473,14.924487
86835,Knight of Cups,2015-02-08,2015,0,566006,566006,6.88947
86837,Amour,2012-07-01,2012,8900000,29844753,20944753,7.663947
86838,Seven Psychopaths,2012-09-07,2012,15000000,19422261,4422261,9.643538
86843,With Great Power: The Stan Lee Story,2010-07-24,2010,0,0,0,2.017343
86850,The Island President,2012-03-28,2012,0,76398,76398,0.395813
86868,La V√©rit√© si je Mens ! 3,2012-01-31,2012,25496629,40924982,15428353,3.81584
86889,Bram Stoker's Dracula,1974-02-08,1974,0,0,0,1.158388
86901,The Face of Marble,1946-01-19,1946,0,0,0,0.162634
86913,Wishful Thinking,1996-12-09,1996,0,0,0,0.326778
86920,Floods of Fear,1958-11-18,1958,0,0,0,0.180575
86942,Tusk,1980-03-01,1980,0,0,0,0.208837
86955,Body and Soul,1925-11-09,1925,0,0,0,0.203673
86956,Sanders of the River,1935-05-10,1935,0,0,0,0.104391
86959,Getting It Right,1989-05-05,1989,0,0,0,0.112213
86970,1st to Die,2003-02-23,2003,0,0,0,0.231932
86971,Miami Magma,2011-12-01,2011,0,0,0,0.55172
86975,Alambrista!,1977-10-16,1977,0,0,0,0.435052
86979,The Road Builder,1971-05-12,1971,0,0,0,1.236245
86980,Once Upon A Time in Phuket,2011-12-31,2011,0,0,0,1.159178
86983,Stockholm East,2011-10-21,2011,0,0,0,0.635034
86985,ID:A,2011-11-24,2011,0,0,0,1.636085
86987,Jackpot,2011-12-02,2011,0,0,0,1.50476
86990,Let There Be Light,1946-12-16,1946,0,0,0,0.232099
86997,The Message,1976-03-09,1976,0,0,0,0.000308
87017,Leo's Room,2010-01-20,2010,0,0,0,0.57483
87018,The One Warrior,2011-11-06,2011,0,0,0,0.848018
87022,Taking Chances,2011-10-12,2011,0,0,0,0.388295
87035,Razend,2011-10-12,2011,0,0,0,1.76176
87060,The Proud Valley,1940-04-06,1940,0,0,0,0.691801
87061,The Extraordinary Voyage,2011-12-08,2011,0,0,0,5.233307
87063,In Vanda's Room,2001-03-02,2001,0,0,0,0.677205
87065,Louie Bluie,1985-01-01,1985,0,0,0,0.014346
87078,Suture,1993-09-14,1993,0,102780,102780,1.298224
87081,Prince of Broadway,2008-09-03,2008,0,20400,20400,0.154868
87090,Business as Usual,1987-01-01,1987,0,0,0,0.0
87093,Big Eyes,2014-12-24,2014,10000000,28883511,18883511,7.412826
87098,The Desert of Forbidden Art,2011-03-18,2011,0,0,0,0.093639
87101,Terminator Genisys,2015-06-23,2015,155000000,440603537,285603537,30.188198
87115,Knight Without Armour,1937-07-23,1937,0,0,0,0.223223
87122,A Man Called Sarge,1990-02-02,1990,0,0,0,0.040273
87123,Heat Lightning,1934-03-03,1934,0,0,0,0.092141
87148,Monster Dog,1984-01-01,1984,0,0,0,0.150223
87151,The Naked Face,1984-06-01,1984,0,0,0,1.136892
87169,The Low Life,1995-11-01,1995,0,0,0,0.580534
87178,The Whisperer in Darkness,2011-03-12,2011,0,0,0,1.58888
87190,Pharaoh's  Army,1995-01-01,1995,50,0,-50,0.837911
87194,Se√±or Droopy,1949-04-09,1949,0,0,0,0.697746
87199,"I Travel Because I Have to, I Come Back Because I Love You",2009-06-24,2009,0,0,0,0.11061
87204,Everyone Loves Alice,2002-10-04,2002,0,0,0,0.571805
87229,King's Road,2010-03-26,2010,0,0,0,0.008498
87233,Clerks - The Flying Car,2002-02-27,2002,0,0,0,0.900507
87235,Crackers,1984-02-17,1984,0,0,0,0.768664
87245,The Damned,1947-09-19,1947,0,0,0,0.461157
87267,The Fixer,1968-12-08,1968,0,0,0,0.49965
87293,Beyond,2012-03-29,2012,0,0,0,1.672718
87296,"Oh, Bomb!",1964-04-18,1964,0,0,0,0.039782
87300,Alice in Wonderland,1915-01-15,1915,0,0,0,0.140291
87302,Alien Space Avenger,1989-08-01,1989,0,0,0,0.097503
87308,Shirin,2008-01-20,2008,0,0,0,1.780902
87311,Love's Everlasting Courage,2011-10-01,2011,0,0,0,0.515637
87321,Mikey,1992-11-12,1992,0,0,0,0.782992
87335,The Weekend Murders,1970-10-15,1970,0,0,0,0.526944
87339,The Guard from the Underground,1992-06-16,1992,0,0,0,0.008267
87343,Moms on Strike,2002-03-17,2002,0,0,0,0.069422
87349,Outcast of the Islands,1951-11-15,1951,0,0,0,0.803371
87358,Hornet's Nest,1970-09-08,1970,0,0,0,0.188856
87362,High Crime,1973-08-12,1973,0,0,0,0.005984
87368,17 Girls,2011-06-13,2011,4141459,201607,-3939852,5.109329
87380,Absent,2011-06-19,2011,0,0,0,1.652781
87387,The Agony and Ecstasy of Phil Spector,2008-12-31,2008,0,0,0,0.14904
87388,In the Arms of a Killer,1992-01-05,1992,0,0,0,0.00022
87392,Sambizanga,1973-04-25,1973,0,0,0,0.014895
87394,Dogora,2004-11-04,2004,0,0,0,0.053087
87408,Goodbye,2011-09-07,2011,0,0,0,0.298416
87415,From the Clouds to the Resistance,1979-11-07,1979,0,0,0,0.020031
87417,Slither,1973-03-07,1973,0,0,0,0.94414
87421,Riddick,2013-09-02,2013,38000000,98337295,60337295,9.596377
87428,That's My Boy,2012-06-14,2012,70000000,58058367,-11941633,8.923755
87436,The ABCs of Death,2013-06-28,2013,0,21660,21660,5.839324
87440,Struck by Lightning,2012-04-20,2012,0,22930,22930,8.546197
87462,Relentless,1989-08-30,1989,0,0,0,0.349371
87481,Quitting,2001-09-07,2001,0,0,0,0.214632
87489,Document of the Dead,1985-06-21,1985,0,0,0,0.783454
87492,Foxcatcher,2014-05-19,2014,24000000,12096300,-11903700,8.10357
87496,The Company You Keep,2012-09-06,2012,0,19633027,19633027,5.367502
87499,The East,2013-05-31,2013,6500000,2401510,-4098490,6.53667
87502,Flight,2012-11-02,2012,31000000,161772375,130772375,10.973822
87503,Eugenie,1970-02-20,1970,0,0,0,1.192835
87504,Hyde Park on Hudson,2012-12-07,2012,0,8887603,8887603,3.724207
87506,Pan,1995-03-24,1995,0,0,0,0.037362
87514,Skyjacked,1972-05-24,1972,0,0,0,2.70306
87516,Oldboy,2013-11-14,2013,30000000,4861022,-25138978,7.882353
87531,The Sea of Grass,1947-04-25,1947,0,0,0,1.086187
87533,Bulletproof,1988-04-20,1988,5000000,807947,-4192053,0.183677
87541,The Unknown Soldier,2006-09-21,2006,0,0,0,0.050234
87561,A Song of Love,1950-01-01,1950,0,0,0,2.525216
87567,The Big Wedding,2013-04-25,2013,35000000,21819348,-13180652,6.651605
87587,The Pill,2011-12-16,2011,0,0,0,1.78658
87588,Highly Dangerous,1950-12-06,1950,0,0,0,0.113621
87593,Kevin,2011-01-01,2011,0,0,0,0.072106
87612,You Can't Get Away with Murder,1939-03-23,1939,0,0,0,0.108023
87621,Chain Lightning,1950-02-18,1950,0,0,0,0.855721
87628,A Ghost in Monte Carlo,1990-01-01,1990,0,0,0,0.485255
87636,Animation Runner Kuromi,2001-03-30,2001,0,0,0,0.053369
87654,Death Is a Caress,1949-08-29,1949,0,0,0,0.073742
87673,No Blood Relation,1932-12-16,1932,0,0,0,0.216055
87677,La Cucaracha,1998-05-14,1998,0,0,0,0.995424
87683,Krakatoa: The Last Days,2006-05-07,2006,0,0,0,0.506519
87706,The Dark,1979-04-27,1979,0,0,0,0.880585
87719,Savage Abduction,1973-01-01,1973,0,0,0,0.001429
87729,Jefferson in Paris,1995-03-31,1995,14000000,2474000,-11526000,1.596058
87734,There's Always Vanilla,1971-12-01,1971,0,0,0,0.144258
87737,Autoerotic,2011-07-22,2011,0,0,0,0.459301
87759,The Blizzard,1965-02-10,1965,0,0,0,0.117771
87774,Bucktown,1975-07-02,1975,0,0,0,0.231973
87788,The Legend of Nigger Charley,1972-03-16,1972,0,0,0,0.129052
87790,Brotherhood of Death,1976-09-14,1976,0,0,0,0.840378
87799,Circus,1936-05-25,1936,0,0,0,0.656464
87817,What's New About Love?,2012-02-09,2012,0,0,0,0.164015
87818,Movie 43,2013-01-01,2013,6000000,32438988,26438988,10.895427
87820,Uncle Kent,2011-01-17,2011,0,0,0,0.617696
87825,Trouble with the Curve,2012-09-21,2012,0,0,0,6.032041
87826,Here Comes the Boom,2012-10-11,2012,0,73100172,73100172,13.409588
87827,Life of Pi,2012-11-20,2012,120000000,609016565,489016565,14.045042
87835,Inkubus,2011-10-28,2011,0,0,0,0.460958
87847,Simple Things,2007-02-02,2007,0,0,0,0.135919
87851,New Muslim Cool,2009-10-14,2009,0,0,0,0.004707
87852,Microwave Massacre,1983-08-31,1983,0,0,0,0.084197
87874,Werewolf,1995-01-01,1995,350000,0,-350000,0.475216
87881,The Casino Murder Case,1935-03-15,1935,0,0,0,0.065943
87884,The Teacher,1974-05-29,1974,0,0,0,0.57091
87894,Mr. Wu,1927-03-26,1927,0,0,0,0.104209
87897,Homebodies,1974-09-01,1974,0,0,0,1e-06
87906,Tuareg: Desert Warrior,1984-03-12,1984,0,0,0,0.00442
87908,The Island 2: The Hunt for the Lost Treasure,2011-12-22,2011,0,0,0,0.271513
87909,Kidco,1984-04-13,1984,0,0,0,1e-06
87911,Sweeney Todd: The Demon Barber of Fleet Street,1936-03-01,1936,0,0,0,0.307397
87914,Lady Scarface,1941-09-26,1941,0,0,0,0.598395
87925,The Last Journey,1936-04-27,1936,0,0,0,0.039118
87936,Beautiful Stranger,1954-07-13,1954,0,0,0,0.114253
87939,Two Smart People,1946-06-04,1946,0,0,0,0.493802
87943,Sisters in Law,2005-09-03,2005,0,0,0,0.07316
87945,Chain Camera,2001-01-19,2001,0,0,0,0.001258
87952,Yeast,2008-03-01,2008,0,0,0,0.132897
87953,Cheerful Wind,1981-01-01,1981,0,0,0,0.003553
87966,Valley of the Dragons,1961-10-31,1961,0,0,0,0.210554
87983,The Clown,1953-01-16,1953,0,0,0,0.100398
87992,Where Once We Walked,2010-10-28,2010,0,0,0,0.076474
87995,Ek Ajnabee,2005-12-09,2005,0,0,0,0.213796
88005,Seeking a Friend for the End of the World,2012-06-22,2012,10000000,9636289,-363711,6.947533
88012,Sparrows Can't Sing,1963-03-26,1963,0,0,0,0.194467
88013,Poor Pierrot,1892-10-28,1892,0,0,0,0.673164
88018,The Skeleton Dance,1929-08-21,1929,5485,0,-5485,1.310476
88030,Tigrero: A Film That Was Never Made,1994-01-01,1994,0,0,0,0.18343
88034,The Hypothesis of the Stolen Painting,1978-04-04,1978,0,0,0,0.339143
88036,Sparkle,2012-08-17,2012,14000000,24637469,10637469,2.24386
88042,Parental Guidance,2012-12-25,2012,25000000,119772232,94772232,11.746053
88051,On the Bowery,1957-03-18,1957,0,0,0,0.639828
88057,A Beginner's Guide to Endings,2010-09-17,2010,0,0,0,0.564126
88059,Brothers,2011-03-18,2011,0,0,0,0.007073
88061,"So Evil, So Young",1963-01-01,1963,0,0,0,0.001662
88065,The Werewolf of Washington,1973-10-01,1973,0,0,0,0.206647
88067,Cover-Up,1991-02-22,1991,0,0,0,0.305743
88075,"Walk Softly, Stranger",1950-10-14,1950,0,0,0,0.540117
88107,Double Trouble,1992-02-14,1992,0,0,0,1.678869
88126,Romanovin kivet,1993-11-26,1993,0,0,0,0.212205
88138,Dear Pillow,2004-01-18,2004,0,0,0,0.214455
88174,Whispers in the Dark,1992-08-06,1992,0,0,0,0.38585
88176,The Lost One,1951-09-07,1951,0,0,0,0.568075
88192,Dr. Ehrlich's Magic Bullet,1940-01-03,1940,0,0,0,0.938416
88209,Daughter of Shanghai,1937-12-17,1937,0,0,0,0.386572
88224,Manny & Lo,1996-01-22,1996,500000,431326,-68674,1.143656
88237,Boca,2010-10-03,2010,0,0,0,0.454604
88253,Down Twisted,1987-03-01,1987,0,0,0,0.620626
88264,The White Bus,1967-12-01,1967,0,0,0,0.190389
88266,Erik the Conqueror,1961-12-07,1961,0,0,0,0.810123
88269,"I Flunked, But...",1930-04-11,1930,0,0,0,0.160931
88271,Where Now Are the Dreams of Youth?,1932-10-13,1932,0,0,0,0.270456
88273,A Royal Affair,2012-03-29,2012,8000000,7594693,-405307,8.168448
88274,Hello! How Are You?,2010-05-28,2010,0,0,0,0.493434
88276,Zorns Lemma,1970-01-01,1970,0,0,0,0.772591
88284,Barbara,2012-03-08,2012,0,4129250,4129250,4.912681
88285,Newsfront,1978-07-29,1978,0,0,0,0.003013
88286,Kwik Stop,2001-04-21,2001,0,0,0,0.391217
88288,It  Happens Every Spring,1949-06-10,1949,0,0,0,0.208891
88293,American Scary,2006-10-21,2006,0,0,0,0.162407
88302,Pirosmani,1969-01-01,1969,0,0,0,0.210885
88309,The Purple Taxi,1977-05-20,1977,0,0,0,0.495735
88318,Secrets of Eden,2012-02-04,2012,0,0,0,3.573543
88320,A Woman's Vengeance,1948-01-29,1948,0,0,0,0.058827
88334,Palimpsest,2006-08-18,2006,0,0,0,0.193724
88338,Running Hot,1984-02-01,1984,500000,0,-500000,0.11065
88348,The Zebra Killer,1974-07-01,1974,0,0,0,0.065427
88359,Cops and Robbers,1973-08-17,1973,0,0,0,0.018297
88375,Chandler,1971-12-01,1971,0,0,0,0.020476
88376,Visit to a Small Planet,1960-01-01,1960,0,0,0,0.342638
88377,Robo Vampire,1988-01-01,1988,2500000,0,-2500000,0.075562
88390,Black Eye,1974-05-17,1974,0,0,0,0.208072
88395,Violent Summer,1959-11-13,1959,0,0,0,0.906731
88418,Wolfsburg,2003-02-13,2003,3510000,0,-3510000,0.310841
88421,Wavelength,1967-01-01,1967,0,0,0,1.455266
88423,The Quiet Room,1996-03-21,1996,0,0,0,0.064705
88435,Tattooed Life,1965-11-13,1965,0,0,0,0.500516
88451,"Yes, Giorgio",1982-09-24,1982,19000000,0,-19000000,0.046658
88478,Any Questions for Ben?,2012-02-09,2012,114,0,-114,1.031792
88486,Queens Of Evil,1970-12-11,1970,0,0,0,0.00022
88491,Chapiteau-Show,2011-12-12,2011,2000000,393816,-1606184,0.74156
88496,Liza Minnelli: Liza With a Z,1972-09-10,1972,0,0,0,1e-06
88518,Angel of Destruction,1994-01-01,1994,0,0,0,0.186027
88527,Cruel Story of Youth,1960-06-03,1960,0,0,0,1.374058
88528,Fighting Delinquents,1960-11-23,1960,0,0,0,0.001346
88529,Good-for-Nothing,1960-07-05,1960,0,0,0,0.666972
88534,Av√©,2012-03-09,2012,0,0,0,0.555376
88535,"Detective Bureau 2-3: Go to Hell, Bastards!",1963-01-27,1963,0,0,0,0.567631
88557,Pok√©mon the Movie White: Victini and Zekrom,2011-07-16,2011,0,0,0,2.531439
88558,A Town Like Alice,1956-03-01,1956,0,0,0,1.330324
88562,Assassination,1964-10-30,1964,0,0,0,0.257222
88564,Fate of a Man,1959-08-01,1959,0,0,0,0.622605
88573,Headshot,2011-09-11,2011,0,0,0,0.767896
88580,The Acid Eaters,1968-02-01,1968,0,0,0,0.107058
88583,The Pursuit of Happiness,1971-02-23,1971,0,0,0,0.363595
88599,Karen Cries on the Bus,2011-05-13,2011,0,0,0,0.148442
88609,Listen to Britain,1942-04-01,1942,0,0,0,0.513932
88641,There Goes My Baby,1994-09-02,1994,10500000,123509,-10376491,0.377787
88658,Cold Feet,1989-05-19,1989,0,0,0,0.02485
88665,The Snake God,1970-11-28,1970,0,0,0,0.000133
88722,Gourmet Club,2004-11-29,2004,0,0,0,0.117104
88727,Bloody Angels,1998-12-26,1998,0,0,0,0.072099
88737,The Glory Stompers,1967-01-01,1967,0,0,0,0.233983
88744,The Woman with the 5 Elephants,2010-01-09,2010,0,0,0,0.511713
88751,Journey to the Center of the Earth,2008-07-10,2008,45000000,101702060,56702060,10.419974
88762,The Great Piggy Bank Robbery,1946-07-20,1946,0,0,0,0.523463
88794,J. Edgar,2011-11-09,2011,35000000,84606030,49606030,9.529382
88811,"Goodbye South, Goodbye",1996-01-01,1996,0,0,0,0.549914
88812,The Hucksters,1947-08-27,1947,0,0,0,0.1486
88818,The Object of Beauty,1991-04-12,1991,0,0,0,0.902187
88844,Code Blue,2011-09-29,2011,0,0,0,0.547712
88860,Three Days,1992-12-12,1992,0,0,0,0.536387
88863,Caught Up,1998-02-27,1998,0,0,0,5.824019
88865,Queen of the Sun,2010-04-01,2010,0,0,0,0.189735
88875,The Effect of Gamma Rays on Man-in-the-Moon Marigolds,1972-12-20,1972,0,0,0,0.473593
88893,Scream of Stone,1991-01-01,1991,0,0,0,0.736081
88905,Monster Island,2004-03-07,2004,0,0,0,0.230155
88912,A Child Is Waiting,1963-02-13,1963,0,0,0,9.539316
88920,Love Never Dies,2012-02-08,2012,0,0,0,2.199476
88922,The Oily Maniac,1976-09-18,1976,0,0,0,1.618503
88930,All in a Night's Work,1961-01-01,1961,0,0,0,0.313856
88937,"Abar, the First Black Superman",1977-03-01,1977,0,0,0,0.000308
88947,A Dollar Between the Teeth,1967-01-10,1967,0,0,0,0.287228
88949,A Bullet for Sandoval,1969-08-19,1969,0,0,0,0.004857
88950,'Gator Bait,1974-06-01,1974,0,0,0,0.908897
88953,The Ear,1970-01-01,1970,0,0,0,1.133398
89008,The Oranges,2011-09-09,2011,0,366377,366377,13.869345
89049,The Staircase,2004-06-01,2004,0,0,0,0.779002
89056,Double Game,1977-10-13,1977,0,0,0,0.0
89059,Don Juan,1926-08-06,1926,0,0,0,0.223252
89065,Beautiful City,2005-02-20,2005,0,0,0,0.825054
89068,Deep Core,2000-10-21,2000,0,0,0,0.210885
89070,Stone,2012-01-19,2012,0,0,0,0.644585
89072,Ginger,1971-03-01,1971,0,0,0,0.488615
89086,Stanley and Livingstone,1939-08-18,1939,0,0,0,0.485406
89092,Hostile Witness,1968-11-01,1968,0,0,0,0.349938
89116,The Professor and His Beloved Equation,2006-01-21,2006,5000000,0,-5000000,0.216996
89126,Harlan: In the Shadow of Jew S√ºss,2009-04-23,2009,0,0,0,0.145908
89145,Angels' Alley,1948-03-07,1948,0,0,0,0.1446
89156,Rose,2011-06-09,2011,1365068,0,-1365068,0.999947
89158,The President's Lady,1953-05-21,1953,0,0,0,0.164909
89183,Positive I.D.,1986-10-28,1986,0,0,0,0.003013
89185,Radio Rebel,2012-02-17,2012,0,0,0,5.15245
89187,Beware of Pity,1946-07-22,1946,0,0,0,0.437779
89191,Saving Face,2012-03-08,2012,0,0,0,0.475948
89199,Trash,1970-10-05,1970,0,0,0,0.293657
89237,Electrick Children,2012-02-10,2012,0,0,0,7.164645
89242,East of Sudan,1964-10-02,1964,85,0,-85,0.80404
89247,"Daddy, I'm A Zombie",2012-01-10,2012,0,0,0,1.885686
89269,After the Fall,2010-10-09,2010,0,0,0,0.16021
89271,The Milky Way,2007-11-02,2007,0,0,0,0.04038
89280,My Brother Tom,2001-11-16,2001,0,0,0,1.04103
89287,The Fairy,2011-05-11,2011,0,0,0,1.2922
89292,Hard Promises,1991-09-14,1991,0,0,0,0.002001
89307,Perry Mason: The Case of the Scandalous Scoundrel,1987-11-15,1987,0,0,0,0.063616
89309,Ryna,2005-06-03,2005,1100000,0,-1100000,0.282646
89315,Terror Express,1980-01-10,1980,0,0,0,0.003013
89325,Darling Companion,2012-04-20,2012,0,0,0,1.629119
89326,96 Minutes,2011-10-14,2011,0,0,0,3.432947
89330,Poliisin poika,1998-11-01,1998,0,0,0,0.320671
89333,Catwalk,1995-12-08,1995,0,0,0,0.976707
89337,Blood Ties,1991-05-27,1991,0,0,0,0.452682
89345,Bloody Murder,2000-09-12,2000,0,0,0,0.238675
89351,Daddy's Deadly Darling,1972-04-07,1972,0,0,0,0.873368
89403,Dear God No!,2011-10-21,2011,0,0,0,0.576314
89417,Get to Know Your Rabbit,1972-06-01,1972,0,0,0,0.000844
89433,Big Bullet,1996-06-25,1996,0,0,0,0.945427
89440,"Father, Son & Holy Cow",2011-08-04,2011,0,0,0,0.011504
89445,Eggshells,1969-01-01,1969,100000,0,-100000,0.055097
89453,Love,2005-04-21,2005,0,0,0,0.013023
89455,360,2012-07-25,2012,0,1663931,1663931,7.104451
89456,Outside Satan,2011-10-19,2011,0,0,0,2.255865
89458,Crayon Shin-chan: Pursuit of the Balls of Darkness,1997-04-19,1997,0,0,0,0.596529
89462,An Inn in Tokyo,1935-11-21,1935,0,0,0,0.702012
89463,Perry Mason: The Case of the Sinister Spirit,1987-05-24,1987,0,0,0,0.00363
89481,How To Stop Being A Loser,2011-11-18,2011,1750000,0,-1750000,0.855113
89482,Warriors,2002-03-22,2002,0,0,0,0.94879
89484,Home from the Hill,1960-03-03,1960,0,0,0,0.893448
89488,Anna,1988-12-15,1988,0,0,0,0.117614
89492,This Is 40,2012-12-20,2012,35000000,88058786,53058786,11.418802
89501,Nameless Gangster,2012-02-02,2012,0,0,0,5.765418
89522,A Little Bit of Soul,1998-03-19,1998,0,0,0,0.353206
89531,Silent Sonata,2011-02-08,2011,2000000,0,-2000000,0.080811
89540,The Other Conquest,1999-04-01,1999,0,0,0,0.158029
89547,Bright Road,1953-04-17,1953,0,0,0,0.11619
89551,Bush Christmas,1947-07-28,1947,0,0,0,0.249638
89560,"Everything's Fine, We're Leaving",2000-06-27,2000,0,0,0,0.02065
89571,Five Days One Summer,1982-11-12,1982,0,0,0,0.341653
89573,Chandu the Magician,1932-09-18,1932,0,0,0,0.247304
89581,Child Bride,1938-03-02,1938,0,0,0,0.590598
89584,Conquest 1453,2012-02-16,2012,16000000,0,-16000000,3.032698
89587,Eyes of Crystal,2004-11-26,2004,0,0,0,0.887408
89591,Black Plague,2002-12-01,2002,0,0,0,0.901805
89593,Jerusalem Countdown,2011-08-26,2011,0,0,0,0.878891
89595,Sushi: The Global Catch,2012-06-07,2012,0,0,0,0.220045
89602,Crazy Mama,1975-06-01,1975,0,0,0,0.015278
89604,Big Love,2012-02-10,2012,2742651,0,-2742651,0.428404
89606,Hemo The Magnificent,1957-03-20,1957,0,0,0,0.054726
89623,"Leafie, a Hen Into the Wild",2011-07-28,2011,0,0,0,1.409111
89625,The Inextinguishable Fire,1969-07-26,1969,0,0,0,0.142761
89638,Steve Jobs: The Lost Interview,2012-05-11,2012,0,0,0,2.033402
89645,Bowery Buckaroos,1947-11-22,1947,0,0,0,0.00118
89647,Clash of the Wolves,1925-11-17,1925,0,0,0,0.039985
89651,Loaded Guns,1975-02-01,1975,0,0,0,0.082355
89652,Colt 38 Special Squad,1976-07-24,1976,0,0,0,0.004537
89656,Cool Breeze,1972-03-29,1972,0,0,0,0.540921
89659,Criminally Insane,1975-01-01,1975,30000,0,-30000,0.000308
89662,Curse of the Faceless Man,1958-08-14,1958,0,0,0,0.259001
89670,Body Of Water,2011-10-07,2011,1800000,0,-1800000,0.52762
89681,The Hour of the Furnaces,1968-09-08,1968,0,0,0,0.185
89688,Araya,1959-08-31,1959,0,0,0,0.418088
89691,ATM,2012-02-17,2012,3000000,3010,-2996990,8.950643
89702,The Yellow Cab Man,1950-04-07,1950,0,0,0,0.072656
89704,Happy People: A Year in the Taiga,2010-09-03,2010,0,338987,338987,2.409076
89708,Samsara,2011-09-16,2011,4000000,0,-4000000,9.491177
89720,Kiss of the Tarantula,1976-05-01,1976,0,0,0,0.040326
89722,Visions of Suffering,2006-09-26,2006,0,0,0,0.333848
89723,The Gorilla,1939-05-26,1939,0,0,0,0.223875
89738,The Crucifer of Blood,1991-11-04,1991,0,0,0,0.512575
89743,Movers & Shakers,1985-05-03,1985,0,0,0,0.087208
89750,"Pink Ribbons, Inc.",2011-09-11,2011,900000,25000,-875000,0.489328
89751,The Beatniks,1960-01-01,1960,0,0,0,0.211711
89756,Captive,1998-01-01,1998,0,0,0,0.077408
89757,Smoke and Flesh,1968-08-23,1968,0,0,0,0.036471
89763,The Girl in Lovers Lane,1960-06-16,1960,0,0,0,0.049748
89774,"Air: Eating, Sleeping, Waiting and Playing",1999-12-13,1999,0,0,0,0.076061
89785,Yesterday Girl,1966-09-05,1966,0,0,0,0.578015
89800,Harmful Insect,2001-03-16,2001,0,0,0,0.487234
89816,The Bear That Wasn't,1967-12-31,1967,0,0,0,0.036478
89817,Crimebusters,1976-06-17,1976,0,0,0,0.5
89823,The Big Animal,2000-08-25,2000,0,0,0,0.228677
89825,You Are Umasou,2010-10-15,2010,0,0,0,0.772307
89847,Modus Operandi,2010-09-10,2010,0,0,0,0.475206
89857,High Road,2012-03-06,2012,0,0,0,1.617761
89861,Stiff Upper Lips,1998-06-12,1998,0,0,0,0.882132
89868,Paws,1997-09-25,1997,137731,1778391,1640660,1.78367
89870,Brooklyn Boheme,2012-02-27,2012,0,0,0,0.228859
89872,Musical Chairs,2012-03-23,2012,0,0,0,0.009322
89873,Unraveled,2012-04-13,2012,0,0,0,0.212166
89874,First Position,2011-09-11,2011,0,0,0,1.554905
89877,The Reunion,2011-10-13,2011,1000000,0,-1000000,0.845789
89883,Stuck Between Stations,2011-11-04,2011,0,0,0,1.067357
89888,Wyatt Earp's Revenge,2012-03-06,2012,0,0,0,1.325306
89904,The Demolitionist,1995-03-09,1995,1000000,0,-1000000,0.425629
89909,Under the Boardwalk,1989-04-14,1989,0,147542,147542,0.114609
89921,White Fire,1984-07-05,1984,0,0,0,0.232757
89924,Wild Guitar,1962-12-01,1962,0,0,0,0.184487
89931,Oddballs,1984-04-06,1984,0,0,0,0.17695
89984,The Cuckoos,1930-05-04,1930,0,0,0,0.263423
89992,Curse,1987-01-01,1987,0,0,0,0.003013
89993,Racket Girls,1951-03-05,1951,0,0,0,0.072597
89995,The Frozen Dead,1966-10-15,1966,0,0,0,0.436768
89998,Crash of Moons,1954-07-10,1954,0,0,0,0.117066
90001,"Film, Film, Film",1968-01-01,1968,0,0,0,0.255359
90015,Bandidos,1967-10-15,1967,0,0,0,0.490439
90019,Magnum Cop,1978-02-03,1978,0,0,0,0.004974
90029,The Mad Butcher,1971-02-18,1971,0,0,0,0.322654
90030,The Monster of Piedras Blancas,1959-04-22,1959,0,0,0,0.116915
90034,The Tale of the Fox,1937-04-09,1937,0,0,0,0.327667
90041,La R√©gion Centrale,1971-01-01,1971,0,0,0,0.107544
90052,The Sign of Four,2001-03-23,2001,0,0,0,0.084953
90056,The Cameraman's Revenge,1912-10-27,1912,0,0,0,1.322024
90061,American Mullet,2001-01-01,2001,0,0,0,0.101773
90063,Vampires in Havana,1985-07-30,1985,0,0,0,0.035007
90079,Dirty O'Neil,1974-05-01,1974,0,0,0,0.116654
90086,Devil's Angels,1967-04-14,1967,0,0,0,0.150037
90092,Street Law,1974-09-17,1974,0,0,0,0.00022
90094,Mean Frank and Crazy Tony,1973-11-23,1973,0,0,0,0.357917
90100,Emergency Squad,1974-04-24,1974,0,0,0,0.007963
90110,Down and Dirty Duck,1974-07-01,1974,0,0,0,0.61991
90118,A Little Bit Zombie,2012-02-03,2012,0,0,0,1.623545
90120,Horrorvision,2001-02-13,2001,0,0,0,0.276968
90121,Death Force,1978-09-01,1978,0,0,0,0.017296
90122,The Trouble with Bliss,2011-10-01,2011,0,0,0,7.453375
90125,Marley,2012-04-20,2012,0,0,0,5.825337
90147,Life Without Principle,2011-10-20,2011,0,0,0,1.280213
90148,Of Love and Shadows,1994-05-10,1994,0,0,0,0.709209
90164,The Green Inferno,1988-05-01,1988,0,0,0,1.016743
90171,Cenizas del Paraiso,1997-08-07,1997,0,0,0,0.492503
90214,Cosi,1996-03-04,1996,0,0,0,0.947007
90228,Yoyo,1965-02-19,1965,0,0,0,0.591262
90231,Kill Zombie!,2012-02-16,2012,500000,0,-500000,1.275542
90272,The Fern Flower,1949-01-01,1949,0,0,0,0.006915
90291,Stalker,2010-10-17,2010,0,0,0,0.589819
90319,The Tale of Tsar Saltan,1984-01-01,1984,0,0,0,0.02822
90324,The English Surgeon,2009-07-24,2009,350000,0,-350000,0.528211
90351,Sympathy for the Underdog,1971-01-01,1971,0,0,0,0.03078
90358,General Spanky,1936-12-11,1936,0,0,0,0.001191
90369,Now Is Good,2012-05-25,2012,0,0,0,5.348025
90374,"Wood & Stock: Sexo, Or√©gano e Rock'n'Roll",2006-10-12,2006,0,0,0,0.003852
90376,"Love, Cheat & Steal",1993-12-05,1993,0,0,0,0.470468
90387,Gran Paradiso,2000-08-28,2000,0,0,0,0.001177
90395,Just Imagine,1930-11-23,1930,0,0,0,0.160329
90406,Tribute to a Bad Man,1956-03-30,1956,0,0,0,0.808828
90414,"I Love You, Don't Touch Me!",1997-01-21,1997,0,0,0,0.090048
90460,Whistling in the Dark,1941-08-08,1941,0,0,0,1.00896
90461,Whistling in Dixie,1942-12-01,1942,0,0,0,0.297851
90465,Whistling in Brooklyn,1943-12-01,1943,0,0,0,0.017699
90503,Mira,1971-03-04,1971,0,0,0,0.000578
90509,"Exhausted: John C. Holmes, the Real Story",1981-06-06,1981,0,0,0,0.691244
90511,Welfare,1975-09-23,1975,0,0,0,0.229237
90517,The Traveling Executioner,1970-01-01,1970,0,0,0,0.011938
90523,Dark Journey,1937-07-02,1937,0,0,0,0.315879
90532,Shala,2011-01-20,2011,0,0,0,0.211338
90540,The Price of Power,1969-12-18,1969,0,0,0,0.25471
90560,Red Angel,1966-10-01,1966,0,0,0,1.486509
90563,The April Fools,1969-05-23,1969,0,0,0,0.873674
90582,Tales from Muppetland: The Frog Prince,1971-05-12,1971,0,0,0,0.368141
90590,Policewomen,1974-02-09,1974,0,0,0,0.197425
90603,Beauty Is Embarrassing,2012-09-07,2012,0,0,0,0.790239
90616,Future War,1997-01-28,1997,0,0,0,0.616623
90617,Walter Defends Sarajevo,1972-11-30,1972,0,0,0,0.670488
90634,Hum Tumhare Hain Sanam,2002-05-24,2002,0,0,0,0.761757
90645,Fanatics,2012-02-24,2012,0,0,0,0.192786
90652,Decoder,1984-02-19,1984,0,0,0,0.536458
90659,The American Ruling Class,2005-04-26,2005,0,0,0,0.084939
90682,Love Is in the Air,2011-06-23,2011,0,0,0,0.058055
90715,Greaser's Palace,1972-07-31,1972,0,0,0,0.995824
90720,The Hellbenders,1967-02-02,1967,0,0,0,0.628567
90726,Hate for Hate,1967-08-18,1967,0,0,0,0.002383
90728,Hammer,1972-07-04,1972,0,0,0,0.267991
90762,"Goodbye, 20th Century",1998-11-17,1998,0,0,0,0.352075
90770,The Vanquished,1953-09-04,1953,0,0,0,0.152969
90781,Crac,1981-01-01,1981,0,0,0,0.153663
90785,Back in Business,1997-05-29,1997,0,0,0,0.073318
90799,Hi Diddle Diddle,1943-08-02,1943,0,0,0,0.113518
90800,Hi-De-Ho,1947-05-09,1947,0,0,0,0.036866
90802,The Last Round,1976-12-30,1976,0,0,0,0.005625
90806,Hot T-Shirts,1980-03-01,1980,0,0,0,0.190439
90807,Home of the Brave,1949-05-12,1949,0,0,0,0.216908
90816,Treasure of the Four Crowns,1983-01-21,1983,0,0,0,0.996101
90829,8 Days to Premiere,2008-01-25,2008,0,0,0,0.07436
90843,Baishe Srabon,2011-09-28,2011,0,0,0,0.123425
90873,Last Days Here,2011-04-29,2011,0,0,0,0.570293
90879,"Skatetown, U.S.A.",1979-10-01,1979,0,0,0,0.002001
90888,Monster High,1989-12-20,1989,0,0,0,0.105886
90908,Trans-Europ-Express,1966-01-01,1966,0,0,0,0.457576
90909,Sisyphus,1974-10-01,1974,0,0,0,0.035554
90928,Rhyme & Reason,1997-03-04,1997,0,0,0,0.915041
90930,Strip-Tease,1963-05-29,1963,0,0,0,0.024724
90932,"Listen, Darling",1938-10-21,1938,0,0,0,0.486031
90944,Tragic Ceremony,1972-12-20,1972,0,0,0,0.144706
90949,Pets,1974-02-01,1974,0,0,0,0.904194
90955,The Sky Dragon,1949-04-27,1949,0,0,0,0.267863
90956,The Feathered Serpent,1948-12-19,1948,0,0,0,0.6921
90957,Hold Your Man,1933-07-07,1933,260000,0,-260000,0.237941
90966,Magic Town,1947-10-07,1947,0,0,0,0.484279
90967,"When You Comin' Back, Red Ryder?",1979-02-09,1979,0,0,0,0.114547
90968,Plymouth Adventure,1952-11-28,1952,0,0,0,0.142267
90974,The Light at the Edge of the World,1971-07-16,1971,0,0,0,0.452215
90978,The Male Animal,1942-04-04,1942,0,0,0,0.233226
90980,On Our Merry Way,1948-02-03,1948,0,0,0,0.608104
90992,Toilet,2010-08-28,2010,0,0,0,1.180627
91001,The Marriage Chronicles,2012-02-14,2012,0,0,0,0.013644
91007,The Saint of Gamblers,1995-06-28,1995,0,13,13,0.08472
91010,Game Change,2012-03-09,2012,0,0,0,12.844171
91018,Linotype: The Film,2012-02-03,2012,0,0,0,1.688726
91030,This Ain‚Äôt California,2012-08-15,2012,0,0,0,0.76798
91041,High Tide,1990-12-26,1990,0,0,0,1.1e-05
91045,Money Play$,1998-08-21,1998,0,0,0,0.110641
91052,18 Years Old and Rising,2011-07-20,2011,0,0,0,1.269941
91060,Johnny Yuma,1966-08-11,1966,0,0,0,0.076034
91063,It's a Bikini World,1967-04-14,1967,0,0,0,0.273974
91067,The Ditch,2010-09-06,2010,0,0,0,0.16885
91070,L!fe Happens,2011-06-18,2011,930000,30905,-899095,10.114319
91073,Late Autumn,2010-09-10,2010,6200000,4820000,-1380000,1.077252
91076,Illuminata,1998-05-21,1998,0,0,0,0.837943
91088,The King of Pigs,2011-11-03,2011,130000,0,-130000,0.801462
91094,The Masseurs and a Woman,1938-07-07,1938,0,0,0,0.637537
91099,Your life in 65 minutes,2006-07-14,2006,0,0,0,0.324601
91101,Crave,2012-10-18,2012,0,0,0,1.561609
91122,16 to Life,2009-09-19,2009,0,0,0,0.48186
91138,The Horseplayer,1990-01-01,1990,0,0,0,0.0
91150,Apart from You,1933-04-01,1933,0,0,0,0.314355
91181,Thirteen Women,1932-09-16,1932,0,0,0,0.519567
91186,A Simple Life,2011-09-04,2011,0,2802459,2802459,2.711041
91198,Trapped in the Closet: Chapters 13-22,2007-08-21,2007,0,0,0,0.280241
91205,Bling: A Planet Rock,,,750000,0,-750000,0.0
91207,A Woman's Tale,1991-09-26,1991,0,0,0,0.114247
91208,Souls for Sale,1923-04-22,1923,0,0,0,0.21176
91217,Men Don't Leave,1990-02-02,1990,0,0,0,0.728037
91226,Demon Lover Diary,1980-01-04,1980,0,0,0,0.001393
91237,Loner,2008-09-18,2008,0,0,0,0.252091
91245,Battle Circus,1953-03-06,1953,0,0,0,0.351776
91250,I'm King Kong!: The Exploits of Merian C. Cooper,2005-11-22,2005,0,0,0,0.005566
91255,Death Walks at Midnight,1972-11-17,1972,0,0,0,0.816987
91259,Lady Cocoa,1975-12-01,1975,0,0,0,0.203476
91261,The Story of Asya Klyachina,1966-01-01,1966,0,0,0,1.058766
91262,Blood of the Beasts,1949-01-01,1949,0,0,0,1.235239
91265,Lightning Bolt,1967-01-01,1967,0,0,0,0.00119
91266,Lioness,2008-01-01,2008,0,0,0,0.046088
91292,Black Pond,2011-11-11,2011,0,0,0,0.635191
91311,The Trouble with the Truth,2011-10-21,2011,0,0,0,0.15837
91314,Transformers: Age of Extinction,2014-06-25,2014,210000000,1091405097,881405097,18.495599
91316,Deadline,2012-02-15,2012,0,0,0,0.232568
91322,Good for Nothing,2011-01-28,2011,0,0,0,0.429538
91325,Looking for Lenny,2011-01-01,2011,0,0,0,0.343017
91333,Recoil,2011-01-01,2011,0,0,0,1.614314
91334,Bad Blood: A Cautionary Tale,2010-07-28,2010,0,0,0,0.006025
91339,Kill Zone,1993-01-01,1993,0,0,0,0.074255
91342,Barbie in A Mermaid Tale 2,2012-02-23,2012,0,15489307,15489307,2.95792
91343,It's a Small World,1950-06-24,1950,0,0,0,0.240885
91352,The Swell Season,2011-04-22,2011,0,0,0,0.62378
91356,Comic-Con Episode IV: A Fan's Hope,2011-09-10,2011,0,0,0,2.728108
91367,Sing Your Song,2012-01-13,2012,0,29110,29110,0.216307
91380,Les aventures d'Ars√®ne Lupin,1957-03-22,1957,0,0,0,0.512135
91390,The Innocent,1993-09-16,1993,0,0,0,0.505207
91391,The Overbrook Brothers,2009-03-01,2009,0,0,0,0.009631
91396,The Dark Wind,1991-01-01,1991,0,0,0,0.002801
91410,Kinetta,2005-03-22,2005,0,0,0,0.191561
91417,Dragons: Gift of the Night Fury,2011-11-15,2011,0,0,0,8.453868
91419,All the Brothers Were Valiant,1953-11-13,1953,0,0,0,0.873435
91422,"Not With My Wife, You Don't!",1966-11-02,1966,0,0,0,0.353365
91426,Princess Yang Kwei Fei,1955-05-03,1955,0,0,0,1.318545
91443,Chronic Town,2010-10-26,2010,0,0,0,0.05283
91445,The Telephone,1988-01-22,1988,0,0,0,0.807818
91456,Top Banana,1954-02-22,1954,0,0,0,0.070863
91459,Italianamerican,1974-01-01,1974,0,0,0,0.945099
91470,Mammy,1930-03-26,1930,0,0,0,0.108898
91471,Man Friday,1975-03-04,1975,0,0,0,1.266184
91472,Man from Del Rio,1956-10-30,1956,0,0,0,0.776159
91477,Men of the Fighting Lady,1954-05-07,1954,0,0,0,0.128071
91480,Mockery,1927-08-13,1927,0,0,0,0.040078
91487,State of Siege,1972-12-30,1972,0,0,0,1.852757
91527,Vaastupurush,,,0,0,0,0.088886
91548,Ring of Fire II: Blood and Steel,1993-03-17,1993,0,0,0,0.22142
91549,The Moth Diaries,2011-09-06,2011,0,3838,3838,3.476938
91550,Violet & Daisy,2011-09-15,2011,0,0,0,5.927924
91551,Death of a Superhero,2011-05-04,2011,3,0,-3,9.646722
91552,The Year of the Tiger,2011-07-31,2011,0,0,0,0.129056
91556,Heartbreakers,1984-09-28,1984,0,0,0,0.054964
91563,Black Sun,2005-09-12,2005,0,0,0,0.110421
91571,And Hope to Die,1972-09-15,1972,0,0,0,0.000844
91580,Cool Blue,1990-02-27,1990,0,0,0,0.515866
91583,Perfect Friday,1970-11-10,1970,0,0,0,0.011064
91584,J.A.C.E.,2011-11-10,2011,0,0,0,0.393975
91586,Insidious: Chapter 2,2013-09-12,2013,5000000,0,-5000000,9.040324
91598,The Red Dwarf,1998-05-16,1998,0,0,0,0.113904
91603,The Magic of M√©li√®s,1997-01-01,1997,0,0,0,0.072361
91607,Who Is Harry Kellerman and Why Is He Saying Those Terrible Things About Me?,1971-06-15,1971,0,0,0,0.29967
91618,Terminal Island,1973-06-01,1973,0,0,0,0.7099
91624,The Last House on the Beach,1978-04-20,1978,0,0,0,0.002317
91627,Love Me Deadly,1973-01-05,1973,42500,0,-42500,0.517576
91628,Three Quarter Moon,2011-10-13,2011,0,0,0,0.520509
91673,Wolf and Calf,1984-01-01,1984,0,0,0,0.085553
91679,Starlet,2012-11-09,2012,0,0,0,4.77863
91683,Edge of Sanity,1989-04-14,1989,0,0,0,1.108322
91690,The Snows of Kilimanjaro,2011-11-16,2011,0,0,0,2.129725
91691,Ga-ga: Glory to the Heroes,1986-09-26,1986,0,0,0,0.008267
91694,Ace Attorney,2012-02-12,2012,0,0,0,1.406776
91715,The Taming of the Shrew,1929-10-26,1929,0,0,0,0.058433
91722,Norman... Is That You?,1976-09-29,1976,0,0,0,0.170552
91727,Night Must Fall,1937-04-30,1937,0,0,0,1.919229
91737,The Learning Tree,1969-08-06,1969,0,0,0,0.206367
91739,Much Ado About Nothing,2012-09-08,2012,0,0,0,5.455903
91745,Romeo & Juliet,2013-09-12,2013,0,1162635,1162635,4.494988
91767,Harry & Son,1984-03-02,1984,0,0,0,2.067288
91781,HealtH,1980-09-12,1980,6000000,0,-6000000,0.00243
91795,Neo Ned,2005-01-01,2005,0,0,0,0.485409
91796,Return from the Ashes,1965-11-16,1965,0,0,0,0.07673
91817,Fear No Evil,1981-01-19,1981,840000,0,-840000,0.114527
91873,Giliap,1975-11-16,1975,0,0,0,0.004425
91878,SS Camp 5: Women's Hell,1977-01-11,1977,0,0,0,0.004351
91891,The Unholy Rollers,1972-11-10,1972,0,0,0,0.003013
91893,The Spiders - The Golden Sea,1919-10-03,1919,0,0,0,0.301984
91901,The Bronte Sisters,1979-05-09,1979,0,0,0,0.835911
91902,Ecstasy,2011-09-10,2011,0,0,0,0.591078
91908,Rings,2005-03-08,2005,0,0,0,1.602998
91911,Behind the Burly Q,2010-04-23,2010,250000,23859,-226141,0.386717
91913,Volcano,2011-09-30,2011,0,0,0,1.240464
91921,Ecstasy of Order: The Tetris Masters,2012-02-23,2012,0,0,0,1.180907
91926,Crawl,2011-10-15,2011,0,0,0,1.365887
91929,The Arrival of Wang,2012-03-09,2012,0,0,0,0.409179
91930,The Perfect Family,2011-04-30,2011,0,0,0,6.078336
91950,Flamenco Flamenco,2010-11-19,2010,0,0,0,0.428917
91958,Less Is More,2000-07-21,2000,0,0,0,0.001636
91961,The Star Witness,1931-08-22,1931,0,0,0,0.856225
91973,Lollipop Monster,2011-02-14,2011,0,0,0,0.482273
91979,Will,2011-11-04,2011,0,0,0,1.222804
92000,Columbus Circle,2012-03-05,2012,10000000,0,-10000000,4.456647
92011,Assault on Devil's Island,1997-10-28,1997,0,0,0,0.236093
92038,Penny Pinchers,2011-11-10,2011,0,0,0,0.597333
92060,Michael Jackson's Thriller,1983-12-02,1983,1100000,0,-1100000,17.85649
92096,Vlad the Impaler: The True Life of Dracula,1979-01-08,1979,0,0,0,0.718655
92108,Baby sa jakies inne,2011-10-14,2011,1689118,0,-1689118,0.275503
92117,Like Water,2011-10-06,2011,325,0,-325,0.621056
92119,Caught Inside,2010-03-10,2010,0,0,0,0.723278
92132,White Dew,1983-06-06,1983,0,0,0,0.262044
92168,The Ugly Duckling,1931-12-17,1931,11909,0,-11909,0.240512
92171,The Thing: Terror Takes Shape,1998-01-01,1998,0,0,0,0.471943
92180,The Game Is Over,1966-06-22,1966,0,0,0,0.319446
92182,Silent House,2011-01-21,2011,2000000,13101672,11101672,10.239941
92189,The Mark of the Hawk,1957-12-01,1957,0,0,0,0.00939
92193,Shiva,2006-09-15,2006,0,0,0,0.079669
92208,Mom's Got a Date With a Vampire,2000-10-13,2000,0,0,0,1.449806
92233,Forbidden Photos of a Lady Above Suspicion,1970-11-19,1970,0,0,0,0.338166
92251,The Vixen,1969-11-07,1969,0,0,0,0.31337
92254,La Fin du Jour,1939-03-24,1939,0,0,0,0.44492
92257,Dance Program,1937-09-09,1937,0,0,0,0.164692
92269,Loving,1970-03-04,1970,0,0,0,0.689498
92272,The Organization,1971-10-20,1971,0,0,0,8.307157
92283,I Never Sang for My Father,1970-10-18,1970,0,0,0,0.815137
92285,Lies My Father Told Me,1975-09-26,1975,0,0,0,1e-06
92286,Falling Awake,2010-01-29,2010,0,0,0,0.082905
92287,One Is a Lonely Number,1972-06-19,1972,0,0,0,0.0339
92292,Star Spangled Girl,1971-12-22,1971,0,0,0,0.0
92298,The Sailor Who Fell from Grace with the Sea,1976-04-11,1976,0,0,0,0.000308
92299,The Thief Who Came to Dinner,1973-03-01,1973,0,0,0,0.479557
92307,The Final Comedown,1972-05-31,1972,0,0,0,0.000809
92309,The Monkey Hustle,1976-12-24,1976,0,0,0,0.070831
92311,"Summer Wishes, Winter Dreams",1973-10-21,1973,0,0,0,0.290992
92312,Django the Bastard,1969-11-08,1969,0,0,0,0.826487
92316,Yeti: The Giant of the 20th Century,1977-12-23,1977,0,0,0,0.38352
92321,Hotarubi no Mori e,2011-09-17,2011,0,0,0,0.005007
92323,Willie and Phil,1980-08-15,1980,0,0,0,0.3265
92326,Straight-Jacket,2004-02-01,2004,0,0,0,0.205774
92331,Beyond the Stars,1989-01-01,1989,0,0,0,0.989423
92332,The Spiders - The Diamond Ship,1920-02-02,1920,0,0,0,0.315662
92341,Bird of Paradise,1932-08-12,1932,0,0,0,0.487087
92348,In the Mirror of Maya Deren,2002-03-15,2002,0,0,0,0.32561
92349,Cinderella,1914-12-28,1914,0,0,0,0.361288
92352,Confession,1937-08-19,1937,0,0,0,0.254885
92371,Project: Shadowchaser,1992-07-02,1992,0,0,0,0.217767
92381,Phat Beach,1996-08-02,1996,0,0,0,0.879852
92384,Trois 2: Pandora's Box,2004-12-28,2004,0,0,0,0.202829
92389,Badge 373,1973-07-25,1973,0,0,0,0.089257
92391,Sket,2011-10-28,2011,0,0,0,6.635353
92393,Area 407,2012-04-27,2012,0,0,0,2.070949
92395,Evidence,2011-02-28,2011,0,0,0,2.299756
92397,Rites of Spring,2011-01-01,2011,0,0,0,1.017578
92398,Cassadaga,2011-10-22,2011,0,0,0,1.807519
92399,The Story of Dr. Wassell,1944-07-04,1944,0,0,0,0.11115
92401,The Red Beret,1953-08-11,1953,0,0,0,0.422094
92413,Poil de Carotte,1932-11-03,1932,0,0,0,0.083584
92424,The Art of Love,2011-11-23,2011,0,0,0,3.00035
92432,Sandra,1965-09-15,1965,0,0,0,1.026581
92452,Patton Oswalt: Werewolves and Lollipops,2007-07-10,2007,0,0,0,0.262641
92459,Appointment with Crime,1946-11-04,1946,0,0,0,0.300469
92464,Brutal Beauty: Tales of the Rose City Rollers,2010-01-09,2010,0,0,0,0.076471
92465,Ponterosa,2001-03-30,2001,350000,0,-350000,0.174596
92469,The Treasure of the Amazon,1985-05-30,1985,0,0,0,0.416609
92473,Mitsuko Delivers,2011-11-05,2011,0,0,0,0.361102
92475,Three Songs About Lenin,1934-11-06,1934,0,0,0,0.483934
92484,The Fourth State,2012-03-08,2012,0,0,0,1.183753
92493,Edwin Boyd: Citizen Gangster,2011-09-10,2011,5000000,0,-5000000,7.355123
92496,Ninja Academy,1989-08-17,1989,0,0,0,0.056566
92499,Spellbound,2011-12-01,2011,0,0,0,1.996356
92501,Hell's Highway: The True Story of Highway Safety Films,2003-06-27,2003,0,0,0,0.242952
92506,Four Horsemen,2012-03-14,2012,0,0,0,0.394626
92562,Metamorphosis : The Alien Factor,1990-11-05,1990,0,0,0,0.284147
92572,The Tiger and the Pussycat,1967-09-20,1967,0,0,0,0.274456
92586,Love in Rome,1960-11-24,1960,0,0,0,0.576276
92591,Bernie,2012-04-27,2012,5000000,9206470,4206470,5.875181
92603,Secrets of the Heart,1997-03-19,1997,0,0,0,0.68827
92620,The Color of Friendship,2000-02-05,2000,0,0,0,0.901429
92635,Snow White: A Deadly Summer,2012-03-16,2012,1000000,0,-1000000,0.77402
92647,Easy Money II,2012-08-16,2012,0,0,0,2.626464
92657,Lick the Star,1998-10-01,1998,0,0,0,0.772817
92662,The Hollywood Complex,2011-05-01,2011,0,0,0,0.400975
92663,Ashik Kerib,1988-01-01,1988,0,0,0,0.000308
92667,Black Fury,1935-05-18,1935,0,0,0,0.042219
92670,Silence,1971-11-13,1971,0,0,0,0.017861
92673,Hercules Against the Mongols,1963-11-29,1963,0,0,0,0.092081
92675,Deadbolt,1992-10-16,1992,0,0,0,0.51301
92681,T.N.T.,1998-01-09,1998,0,0,0,0.156926
92690,¬°M√°talo!,1970-10-22,1970,0,0,0,0.458827
92691,Without Memory,1996-12-28,1996,0,0,0,0.081467
92705,Sweden: Heaven and Hell,1968-09-04,1968,0,0,0,0.544758
92716,The Maltese Bippy,1969-06-18,1969,0,0,0,0.001648
92727,Ninja Death,1987-01-01,1987,0,0,0,0.0339
92728,Teen-Age Crime Wave,1955-11-01,1955,0,0,0,0.203781
92737,Under the Gun,1995-12-26,1995,0,0,0,0.038051
92751,Werewolf Woman,1976-03-18,1976,0,0,0,1.428941
92769,Relative Fear,1995-10-03,1995,0,0,0,0.499601
92771,Daddy,2004-09-09,2004,0,0,0,0.406193
92779,Seedpeople,1992-05-28,1992,0,0,0,0.609029
92780,"Aballay, the Man without Fear",2010-11-19,2010,0,0,0,0.11542
92787,Transylvania Twist,1989-10-01,1989,0,0,0,0.426793
92796,Black Magic,1949-08-19,1949,0,0,0,0.46916
92798,Duffy,1968-09-16,1968,0,0,0,0.290919
92802,Beer,1985-08-30,1985,0,0,0,0.240169
92804,Bigfoot,1970-10-21,1970,0,0,0,0.067229
92809,The Dead Talk Back,1957-12-31,1957,0,0,0,0.036475
92819,Give Us This Day,1949-10-14,1949,0,0,0,0.726669
92834,Vizontele Tuuba,2004-01-21,2004,3000000,13954476,10954476,0.808339
92837,To the Arctic,2012-04-20,2012,0,0,0,1.926557
92848,Andy Hardy's Blonde Trouble,1944-05-04,1944,0,0,0,0.51294
92850,Nightmare Factory,2011-10-27,2011,0,0,0,5.388447
92853,I Am Afraid,1977-10-06,1977,0,0,0,0.000431
92927,A Quiet Place in the Country,1968-11-14,1968,0,0,0,0.690595
92931,Perry Mason: The Case of the Ruthless Reporter,1991-01-06,1991,0,0,0,0.139299
92940,Perry Mason: The Case of the Wicked Wives,1993-12-17,1993,0,0,0,0.03839
92943,The Curse of Inferno,1996-12-30,1996,0,0,0,0.593734
92950,Wife! Be Like a Rose!,1935-08-15,1935,0,0,0,0.042069
92968,Time Freak,2011-02-10,2011,0,0,0,0.358068
92983,Businessmen,1962-06-06,1962,0,0,0,1.075938
92988,Die Totale Therapie,1996-01-01,1996,0,0,0,0.006331
92989,A Summer at Grandpa's,1984-11-24,1984,0,0,0,0.022686
92990,Yellow Earth,1984-08-19,1984,0,0,0,0.14231
93006,The Intimate Stranger,1956-06-01,1956,0,0,0,0.100488
93041,Daughter of Darkness,1948-01-21,1948,0,0,0,0.21049
93057,Princesse Tam Tam,1935-11-02,1935,0,0,0,0.141159
93061,Rock Around the Clock,1956-03-21,1956,0,0,0,0.288712
93064,Bawdy Tales,1973-01-01,1973,0,0,0,0.023982
93072,Riot on Sunset Strip,1967-03-01,1967,0,0,0,0.02567
93077,Rites of Passage,2012-04-24,2012,2500000,0,-2500000,1.885563
93084,Keyhole,2011-09-09,2011,0,21291,21291,3.388565
93087,Paul Williams Still Alive,2011-09-11,2011,0,0,0,0.254136
93091,Crazy Eyes,2012-07-06,2012,10000000,0,-10000000,0.198348
93103,The Last Gladiators,2012-04-22,2012,0,0,0,0.949301
93114,Quest,1996-01-01,1996,0,0,0,0.213612
93115,The 50 Worst Movies Ever Made,2004-07-13,2004,0,0,0,0.647313
93116,Valet Girls,1987-01-01,1987,0,0,0,0.693442
93122,Out of the Blue,2002-07-22,2002,0,0,0,0.10859
93142,Man Without a Memory,1974-08-23,1974,0,0,0,0.00363
93164,A River Called Titas,1973-04-26,1973,0,0,0,0.003013
93178,Peak: The Rescuers,2011-05-07,2011,0,0,0,0.158624
93188,Beloved,2011-08-17,2011,8978040,0,-8978040,2.023954
93193,Jigsaw,1962-08-21,1962,0,0,0,0.369703
93212,Waitress!,1981-05-13,1981,0,0,0,0.247702
93215,The First Turn-On!,1983-11-04,1983,0,0,0,0.264189
93222,Kvarteret Skatan reser till Laholm,2012-03-16,2012,0,0,0,0.495222
93230,Nobel's Last Will,2012-03-02,2012,0,0,0,2.762073
93260,Body of War,2007-09-11,2007,0,0,0,0.103932
93263,The Men's Club,1986-09-19,1986,0,0,0,3.421721
93289,Now Where Did the Seventh Company Get to?,1973-01-01,1973,0,0,0,4.059615
93313,Come and Get It,1936-11-06,1936,0,0,0,0.686815
93335,Desert Victory,1943-04-13,1943,0,0,0,0.042363
93338,"Johnny Cash: The Man, His World, His Music",1969-03-01,1969,0,0,0,0.037124
93350,No Looking Back,1998-03-27,1998,0,0,0,0.77403
93394,Elevator,2011-01-01,2011,5000000,0,-5000000,3.826243
93407,Animal,2005-01-11,2005,0,0,0,0.496652
93427,Town Without Pity,1961-10-10,1961,0,0,0,0.727819
93440,Hush!,2003-10-01,2003,0,0,0,0.994835
93456,Despicable Me 2,2013-06-25,2013,76000000,970761885,894761885,24.82355
93457,Split Decisions,1988-06-11,1988,0,0,0,0.837509
93461,Sexy boys,2001-12-26,2001,0,0,0,0.265977
93462,Who's the Caboose?,1997-04-10,1997,0,0,0,0.356685
93492,Gladiators 7,1962-10-11,1962,0,0,0,0.001626
93498,Card Subject To Change,2010-02-13,2010,0,0,0,0.089969
93511,Walkout,2006-03-18,2006,9500000,0,-9500000,0.471974
93519,Karan Arjun,1995-07-28,1995,0,0,0,2.193229
93521,Symphonie diagonale,1924-11-04,1924,0,0,0,0.710381
93528,Wild Is the Wind,1957-12-11,1957,0,0,0,1.276352
93553,Mysterious Object at Noon,2000-11-08,2000,0,0,0,0.404131
93556,Prairie Love,2011-01-01,2011,0,0,0,0.042355
93560,Batman and Robin,1949-05-26,1949,0,0,0,0.224261
93562,Law and Order,1953-05-13,1953,0,0,0,1.026493
93649,Reflection,,,0,0,0,0.0
93669,The Meetings of Anna,1978-10-08,1978,0,0,0,0.00195
93676,Someday This Pain Will Be Useful to You,2011-11-02,2011,8000000,0,-8000000,1.678409
93685,Swingers,2002-10-01,2002,0,0,0,0.833902
93708,"Cry, Onion!",1975-08-25,1975,0,39598448,39598448,1.62344
93715,Butchered,2010-01-01,2010,0,0,0,0.051973
93734,.hack Liminality: In the Case of Mai Minase,,,0,0,0,0.093036
93743,Happiness,1935-03-15,1935,0,0,0,0.300485
93775,The Member of the Wedding,1952-12-25,1952,0,0,0,0.770476
93782,Fate,2003-03-15,2003,0,0,0,0.005023
93828,Welcome to the Punch,2013-03-15,2013,8500000,9747,-8490253,7.67857
93834,The Overcoat,1952-10-03,1952,0,0,0,0.609615
93837,So Undercover,2012-01-01,2012,0,0,0,4.783716
93840,Blind Man,2012-03-06,2012,0,0,0,0.773371
93855,Posti in piedi in paradiso,2012-03-02,2012,10495000,0,-10495000,3.117252
93856,Chernobyl Diaries,2012-05-24,2012,0,18112929,18112929,6.76513
93858,Tabu,2012-02-14,2012,0,0,0,2.437961
93862,Goodbye Gemini,1970-08-06,1970,0,0,0,0.000308
93863,The Lady Without Camelias,1953-02-27,1953,0,0,0,0.415635
93890,I Eat Your Skin,1971-10-29,1971,0,0,0,0.103605
93891,Black Test Car,1962-06-30,1962,0,0,0,0.100765
93892,The Hoodlum Priest,1961-03-26,1961,0,0,0,0.141952
93904,Snowballs,2011-09-26,2011,0,0,0,0.502533
93907,Los Chicos,1959-01-01,1959,0,0,0,0.160941
93922,Getting Lucky,1989-12-31,1989,0,0,0,0.245105
93934,"Je, Tu, Il, Elle",1976-11-17,1976,0,0,0,1.125742
93935,Hot Resort,1985-01-01,1985,0,0,0,0.147318
93937,Dangerous Curves,1989-07-07,1989,0,0,0,0.063798
93939,The Shuttered Room,1967-06-27,1967,0,0,0,1.59328
93946,Hollow Reed,1996-06-24,1996,0,0,0,0.261217
94009,Born Reckless,1930-06-06,1930,0,0,0,0.365704
94047,My Way,2011-12-21,2011,25500000,0,-25500000,5.74216
94052,Azazel,2002-03-10,2002,0,0,0,0.629932
94055,The Peace Killers,1971-09-29,1971,0,0,0,0.00022
94065,Slaves in Bondage,1937-07-24,1937,0,0,0,0.072976
94066,Smithereens,1982-11-19,1982,0,0,0,0.183618
94067,Snake Dancer,1976-03-28,1976,0,0,0,0.073849
94069,Spasmo,1974-02-16,1974,0,0,0,0.456966
94092,Susan Slade,1961-11-08,1961,0,0,0,0.113315
94104,"3, 2, 1... Frankie Go Boom",2012-10-12,2012,0,0,0,1.920868
94105,Perry Mason: The Case of the Silenced Singer,1990-05-20,1990,0,0,0,0.000308
94108,Nobody's Children,1951-02-10,1951,0,0,0,0.982205
94123,The Cobweb,1955-06-07,1955,0,0,0,2.787176
94135,Yesterday's Enemy,1959-09-10,1959,0,0,0,0.791655
94139,Lust for Gold,1949-06-10,1949,0,0,0,1.121124
94170,Eight on the Lam,1967-04-26,1967,0,0,0,0.976647
94176,Destry,1954-12-01,1954,0,0,0,0.647708
94182,Torrid Zone,1940-05-25,1940,0,0,0,0.154237
94192,Great Day in the Morning,1956-05-16,1956,0,0,0,0.318788
94196,Zarafa,2012-01-25,2012,10750000,0,-10750000,0.855606
94201,El Condor,1970-06-19,1970,0,0,0,1.148948
94204,Meeting Evil,2012-05-03,2012,0,525,525,3.554939
94205,Exaella,2011-12-22,2011,0,0,0,0.083703
94209,The Chocolate Soldier,1941-11-01,1941,0,0,0,0.00118
94214,"Jails, Hospitals & Hip-Hop",,,0,10,10,0.009057
94225,Bless the Beasts & Children,1971-10-18,1971,0,0,0,1.027036
94228,Two Times Lotte,1950-12-01,1950,0,0,0,1.42614
94236,Street Knight,1993-03-12,1993,0,841,841,0.001393
94241,Sundown,1941-10-31,1941,0,0,0,0.206076
94248,"Sweet Jesus, Preacherman",1973-05-25,1973,0,0,0,0.002771
94251,"Tall, Dark and Handsome",1941-01-24,1941,0,0,0,0.001373
94260,The Alley Cats,1966-09-12,1966,0,0,0,0.083996
94326,All In: The Poker Movie,2012-03-23,2012,0,0,0,0.124581
94329,The Raid,2011-09-08,2011,1100000,4105187,3005187,10.528833
94331,Fightville,2011-03-12,2011,0,0,0,0.439409
94336,Dreileben: Beats Being Dead,2011-04-13,2011,0,0,0,0.085509
94340,Subdivision,2009-08-20,2009,0,0,0,0.195473
94344,The Loves of Pharaoh,1922-03-14,1922,0,0,0,0.170453
94348,Alex Cross,2012-10-18,2012,45000000,30353232,-14646768,8.279285
94352,Cirque du Soleil: Worlds Away,2012-11-09,2012,0,34153101,34153101,4.725759
94356,We the Party,2012-04-06,2012,0,0,0,0.234034
94363,Hick,2011-09-10,2011,0,0,0,6.21609
94365,The Human Centipede 3 (Final Sequence),2015-05-22,2015,0,0,0,5.360948
94380,Bad Ass,2012-04-12,2012,0,0,0,5.929797
94393,The Savage Innocents,1960-03-20,1960,0,0,0,1.393818
94405,The Far Horizons,1955-05-20,1955,0,0,0,0.186768
94440,The Boost,1988-12-23,1988,8000000,784990,-7215010,0.964399
94466,The Ceremony,1971-05-18,1971,0,0,0,0.133043
94468,Pieces of Dreams,1970-09-23,1970,0,0,0,0.00519
94478,You Instead,2011-09-16,2011,0,0,0,3.849058
94480,The Lost Missile,1958-12-01,1958,0,0,0,0.152389
94502,Starship,1984-12-13,1984,0,0,0,0.229369
94509,The Silence Before Bach,2007-12-21,2007,0,0,0,0.153329
94510,The Crowded Sky,1960-09-02,1960,0,0,0,0.100727
94513,Two Solutions for One Problem,1975-01-01,1975,0,0,0,0.115676
94525,A Page of Madness,1926-09-24,1926,0,0,0,1.174776
94527,Everything for Sale,1969-01-28,1969,0,0,0,0.482789
94529,My Cousin Rachel,1952-12-25,1952,0,0,0,0.697959
94532,Reel Love,2011-11-13,2011,0,0,0,0.947694
94533,The Badlanders,1958-09-03,1958,0,0,0,1.97046
94544,The Bronze Buckaroo,1939-01-01,1939,0,0,0,0.002307
94548,The Capture of Bigfoot,1979-11-01,1979,0,0,0,0.040567
94551,The Christine Jorgensen Story,1970-10-29,1970,0,0,0,7.4e-05
94555,Love On-Air,2012-01-05,2012,0,0,0,0.381946
94563,The Woodcarver,2012-03-05,2012,3000000,0,-3000000,0.008772
94568,Get Yourself a College Girl,1964-12-18,1964,0,0,0,0.003038
94570,The Kiss,1896-04-01,1896,0,0,0,0.898166
94583,The Gay Bed and Breakfast of Terror,2007-07-13,2007,0,0,0,0.250743
94585,Vig,1998-12-04,1998,0,0,0,0.63892
94587,Kony 2012,2012-03-05,2012,0,0,0,0.5483
94590,Angry Video Game Nerd: The Movie,2014-07-21,2014,325927,0,-325927,2.093933
94592,Vinylmania: When Life Runs at 33 Revolutions Per Minute,2012-01-01,2012,33000,0,-33000,0.196131
94608,The Happy Ending,1969-12-21,1969,0,0,0,0.263297
94618,Dreamboat,1952-07-26,1952,0,0,0,0.479288
94623,Directed by John Ford,1971-10-06,1971,0,0,0,0.353041
94630,Doctor Vlimmen,1977-02-23,1977,0,0,0,0.013996
94638,Outskirts,1933-03-24,1933,0,0,0,0.352988
94639,Jos√© & Pilar,2010-10-18,2010,0,0,0,1.474159
94641,O.S.S.,1946-05-26,1946,0,0,0,0.560277
94643,Rescued by Rover,1905-07-03,1905,37,0,-37,0.371776
94649,La libertad,2001-06-28,2001,0,0,0,0.245568
94653,Twilight of the Ice Nymphs,1997-09-09,1997,0,0,0,0.734854
94655,Eva,1962-10-03,1962,0,0,0,1.175325
94658,The Holy Mountain,1926-11-01,1926,0,0,0,0.158309
94659,Brothers and Sisters of the Toda Family,1941-03-01,1941,0,0,0,0.175833
94663,The Round-Up,1966-01-06,1966,0,0,0,1.112254
94664,My Way Home,1965-01-14,1965,0,0,0,0.078313
94666,Surviving Desire,1992-01-22,1992,0,0,0,0.306365
94671,Jayne Mansfield's Car,2012-02-13,2012,0,14836,14836,1.655794
94674,The Arrival of Joachim Stiller,1976-11-29,1976,0,0,0,0.009192
94696,Four Winds of Heaven,1962-06-01,1962,0,0,0,0.099098
94702,Dream of a Rarebit Fiend,1906-02-24,1906,0,0,0,0.510948
94706,The Quince Tree Sun,1992-10-01,1992,0,0,0,0.001655
94709,Garden of Delights,1967-01-01,1967,0,0,0,0.071799
94716,A Cottage on Dartmoor,1929-10-01,1929,0,0,0,0.465277
94720,The Dancer,2011-11-10,2011,0,0,0,0.158252
94725,To Sleep with Anger,1990-09-11,1990,0,0,0,0.83296
94727,Moana,1926-01-07,1926,0,0,0,0.435021
94739,The Duke Is Tops,1938-01-02,1938,0,0,0,0.328687
94741,The Don Is Dead,1973-11-14,1973,0,0,0,1.093557
94744,The Devil with Seven Faces,1971-12-09,1971,0,0,0,0.326571
94747,The Flesh Merchant,1956-05-18,1956,0,0,0,0.051591
94752,The Doll Squad,1973-09-19,1973,0,0,0,0.003013
94770,Anni difficili,1948-09-09,1948,0,0,0,0.036545
94771,One Hundred and One Nights,1995-01-25,1995,0,0,0,1.115938
94790,How to Become Myself,2007-04-28,2007,0,0,0,0.003961
94792,Made in Romania,2010-12-28,2010,2000000,0,-2000000,0.14258
94794,Blue,1993-08-19,1993,0,1718328,1718328,1.437622
94798,Abhijan,1962-09-27,1962,0,0,0,0.505604
94803,Variety,1925-11-16,1925,0,0,0,0.180465
94807,Heaven's Heart,2008-02-29,2008,0,0,0,0.113907
94809,Violent Naples,1976-08-07,1976,0,0,0,0.54489
94811,Devil Dogs of the Air,1935-02-09,1935,0,0,0,0.076001
94818,The Aggression Scale,2012-05-29,2012,0,0,0,1.302074
94820,The Flying Machine,2011-02-12,2011,0,0,0,0.529945
94831,The Fuller Brush Girl,1950-09-15,1950,0,0,0,0.052311
94841,Cell Count,2012-05-20,2012,0,0,0,0.27304
94854,Too Many Girls,1940-10-08,1940,0,0,0,1.007377
94857,Brother Can You Spare A Dime,1975-08-06,1975,0,0,0,0.037413
94874,Savage Weekend,1979-03-09,1979,0,0,0,0.316384
94881,Week-End at the Waldorf,1945-10-04,1945,0,0,0,0.314101
94887,Girls Against Boys,2012-05-17,2012,0,0,0,3.923609
94894,Angel's Dance,1999-01-01,1999,0,0,0,0.207369
94901,About Cherry,2012-02-14,2012,2500000,3003,-2496997,5.46567
94904,7 Days in Havana,2012-04-05,2012,3800000,0,-3800000,5.367997
94917,Summer and Smoke,1961-11-16,1961,0,0,0,0.669198
94935,The Temple,2011-11-04,2011,0,0,0,0.095935
94959,"Edward, My Son",1949-06-02,1949,0,0,0,0.108153
94965,Okkadu,2003-01-15,2003,0,0,0,0.309449
94996,On_Line,2002-02-28,2002,0,0,0,0.341883
95004,The Guardsman,1931-11-07,1931,0,0,0,0.169509
95006,The Killing of America,1981-09-05,1981,0,0,0,0.004948
95010,The Kiss of Her Flesh,1968-12-31,1968,0,0,0,0.099932
95012,The Iron Mistress,1952-11-19,1952,0,0,0,0.874703
95015,The Green Pastures,1936-08-01,1936,0,0,0,0.113381
95019,The Hills Run Red,1966-09-09,1966,0,0,0,0.523447
95029,The Hellfire Club,1961-02-03,1961,0,0,0,0.177689
95037,Time Out for Rhythm,1941-06-05,1941,0,0,0,0.162478
95043,The Devil,1972-01-01,1972,0,0,0,0.00022
95046,They Knew What They Wanted,1940-10-19,1940,0,0,0,0.290672
95056,I'm Not Jesus Mommy,2011-05-06,2011,0,0,0,0.413159
95060,Fort Massacre,1958-05-01,1958,0,0,0,0.126986
95077,"Dagmar's Hot Pants, Inc.",1971-10-01,1971,0,0,0,0.357989
95093,Gas,1981-07-01,1981,0,0,0,0.003665
95096,Highway Racer,1977-10-19,1977,0,0,0,0.125145
95108,Wild Honey,1972-03-22,1972,0,0,0,1e-05
95134,Blood and Sand,1922-08-05,1922,0,0,0,0.270647
95136,Bruno,2000-04-16,2000,10000000,0,-10000000,0.368794
95137,The Feminine Touch,1941-10-01,1941,0,0,0,0.703718
95140,Detention,2003-07-05,2003,5000000,0,-5000000,1.437403
95164,About Love,2005-04-12,2005,0,0,0,0.226655
95169,Four Sons,1928-02-13,1928,0,0,0,0.320026
95177,Sun Don't Shine,2012-03-10,2012,0,0,0,1.228391
95190,Phenomenon II,2003-11-01,2003,0,0,0,0.197158
95197,Hello Smile!,1956-02-29,1956,0,0,0,0.152825
95240,"My God, My God, Why Hast Thou Forsaken Me?",2005-05-18,2005,0,0,0,0.260891
95242,The Dying Swan,1917-01-17,1917,0,0,0,0.294366
95243,Vertical Features Remake,1978-12-01,1978,0,0,0,0.435497
95322,Moonfire,1973-01-01,1973,0,0,0,2.5e-05
95348,The Mysterious Island,1929-01-01,1929,0,0,0,0.071988
95358,The Pleasure Seekers,1964-12-25,1964,0,0,0,0.167422
95359,This Could Be the Night,1957-05-14,1957,0,0,0,0.158073
95372,The Lights of Ten Thousand Homes,1948-01-01,1948,0,0,0,0.353632
95375,"Young, Violent, Dangerous",1976-01-01,1976,0,0,0,0.035211
95383,$ellebrity,2013-01-11,2013,0,0,0,0.891024
95385,Beast,2011-10-15,2011,0,0,0,0.567637
95400,Perry Mason: The Case of the Reckless Romeo,1992-05-05,1992,0,0,0,0.012359
95402,Lonelyhearts,1958-01-01,1958,0,0,0,1.007012
95410,The Texican,1966-11-01,1966,0,0,0,0.593565
95414,The Mad Scientist,1941-09-26,1941,100000,0,-100000,0.330478
95431,The Flight,1970-01-01,1970,0,0,0,0.001393
95448,The Minister,2011-10-26,2011,0,0,0,2.136651
95453,One Fine Spring Day,2001-09-28,2001,0,0,0,1.722802
95466,Heart of America,2002-09-05,2002,3000000,0,-3000000,0.290726
95482,Green Fish,1997-02-07,1997,0,0,0,1.368056
95493,Final Voyage,2000-06-20,2000,0,0,0,0.213539
95503,Thirst for Love,1967-02-18,1967,0,0,0,0.119397
95504,Family Honeymoon,1948-12-06,1948,0,0,0,0.660586
95506,I Hate But Love,1962-01-01,1962,0,0,0,0.57764
95508,The Warped Ones,1960-09-03,1960,0,0,0,0.171429
95511,Kevin Smith: Burn in Hell,2012-02-11,2012,0,0,0,0.295883
95514,Boy Meets Girl,1994-07-30,1994,0,0,0,0.202054
95516,Cleanskin,2012-03-08,2012,0,0,0,6.402926
95536,A Talking Picture,2003-08-31,2003,0,0,0,0.502652
95538,To Die Like a Man,2009-10-06,2009,0,0,0,0.282474
95548,Baby the Rain Must Fall,1965-01-12,1965,0,0,0,0.598636
95551,The Mansion of Madness,1973-08-10,1973,0,0,0,0.00022
95552,Jungle Cavalcade,1941-07-03,1941,0,0,0,0.001177
95555,The Master Gunfighter,1975-10-03,1975,3500000,0,-3500000,1e-06
95556,The Liberation of L.B. Jones,1970-03-18,1970,0,0,0,0.117806
95560,The Monster Walks,1932-02-10,1932,0,0,0,0.136451
95565,The Muthers,1976-11-01,1976,0,0,0,0.574732
95578,Evel Knievel,2004-07-30,2004,0,0,0,0.108909
95597,Black Girl,1966-01-01,1966,0,0,0,0.515553
95600,The Chronicle of Anna Magdalena Bach,1968-02-03,1968,0,0,0,0.208349
95610,Bridget Jones's Baby,2016-09-14,2016,35000000,211952420,176952420,10.754139
95627,Frogs for Snakes,1998-08-14,1998,0,0,0,0.431876
95647,The Stone Raft,2002-09-19,2002,0,0,0,0.417025
95675,Wreckers,2011-12-16,2011,0,0,0,1.237533
95682,Long Night's Journey Into Day,2000-01-29,2000,0,0,0,0.07455
95700,Sicario,1994-07-20,1994,0,0,0,0.522592
95724,Man Wanted,1932-04-23,1932,0,0,0,0.145365
95730,Lisa,1989-08-26,1989,0,0,0,0.418774
95743,Foreign Student,1994-07-29,1994,0,0,0,0.002789
95744,La monta√±a rusa,2012-03-15,2012,0,0,0,0.578269
95752,The Other Side of the Mountain: Part II,1978-02-10,1978,0,0,0,0.000578
95755,Small Apartments,2012-03-10,2012,2000000,0,-2000000,3.222525
95756,The Antics Roadshow,2011-08-13,2011,0,0,0,0.04618
95758,The Sci-Fi Boys,2006-04-27,2006,0,0,0,0.221335
95771,Bush Mama,1979-09-01,1979,0,0,0,0.069994
95775,Clip,2012-01-27,2012,0,0,0,2.989182
95797,Waterloo Bridge,1931-09-01,1931,0,0,0,0.933263
95807,Ricochet,2011-11-30,2011,0,0,0,1.179703
95808,Brooklyn Castle,2012-10-19,2012,0,0,0,0.586854
95820,Love Bites,1993-01-01,1993,0,0,0,0.851883
95838,Blood for a Silver Dollar,1965-08-08,1965,0,0,0,1.17893
95853,Bunny Drop,2011-08-20,2011,0,0,0,0.978779
95854,The Prizefighter and the Lady,1933-11-10,1933,0,0,0,0.382382
95862,The Phantom of Paris,1931-09-12,1931,0,0,0,0.040144
95864,"10,000 Dollars for a Massacre",1967-03-03,1967,0,0,0,1.757598
95866,The Poor Little Rich Girl,1917-03-05,1917,0,0,0,0.90043
95874,Two-Faced Woman,1941-11-30,1941,0,0,0,0.519817
95892,Honor Thy Father,1973-03-01,1973,0,0,0,0.114804
95919,Love,2012-02-14,2012,0,0,0,0.950842
95943,The Road to Ruin,1934-05-14,1934,0,0,0,1.142764
95949,The Strip,1951-08-01,1951,0,0,0,0.088755
95956,The Temptress,1926-10-03,1926,0,0,0,0.640994
95963,The Walking Dead,1995-02-24,1995,0,0,0,0.620873
95966,Thomasine & Bushrod,1974-04-10,1974,0,0,0,0.003241
95977,The Man Behind The Gun,1953-01-31,1953,0,0,0,0.102997
95990,Heaven and Hell,1980-01-18,1980,0,0,0,0.043903
95997,Big Shot: Confessions of a Campus Bookie,2002-03-31,2002,0,0,0,0.11926
96001,Hard Labor,2011-05-12,2011,0,0,0,0.299194
96005,Courage,2011-11-18,2011,0,0,0,0.149618
96010,The Way I Spent the End of the World,2006-09-15,2006,0,0,0,1.459135
96011,Touch the Top of the World,2006-06-18,2006,0,0,0,0.374025
96026,Ramin,2011-04-01,2011,177,0,-177,0.048725
96035,The Big Swallow,1901-10-15,1901,0,0,0,0.374007
96087,Funeral Kings,2012-11-16,2012,0,0,0,0.459006
96088,Gregory Crewdson: Brief Encounters,2012-03-01,2012,0,0,0,0.837594
96089,Guns of Diablo,1965-01-29,1965,0,0,0,0.155478
96090,Seeking Asian Female,2012-03-12,2012,0,0,0,0.336686
96105,Bikini Summer,1991-01-01,1991,0,0,0,0.001021
96106,Battle of the Amazons,1973-08-11,1973,0,0,0,0.159935
96107,"H.M. Pulham, Esq.",1941-12-18,1941,0,0,0,0.003734
96108,See What I'm Saying: The Deaf Entertainers Documentary,2010-03-19,2010,0,0,0,0.076471
96112,Arjun,1985-04-20,1985,0,0,0,0.000603
96118,All These Women,1964-01-01,1964,0,0,0,0.617068
96128,Traffic in Souls,1913-11-24,1913,0,0,0,0.113363
96129,The Bad Bunch,1973-01-01,1973,0,0,0,0.001736
96131,Tribes,1970-11-10,1970,0,0,0,0.045657
96132,Three Tough Guys,1974-05-29,1974,0,0,0,0.017238
96133,Vengeance,1968-04-19,1968,0,0,0,0.003196
96147,Aankhen,1993-09-09,1993,0,0,0,0.594048
96159,Chameli Ki Shaadi,1986-02-21,1986,0,0,0,9e-06
96161,The Office Wife,1930-08-23,1930,0,0,0,0.036636
96167,Autopsy,1975-01-18,1975,0,0,0,0.172285
96171,Men of Respect,1990-01-18,1990,0,0,0,0.843494
96172,Design for Scandal,1941-12-01,1941,0,0,0,0.077249
96175,Skylark,1941-11-21,1941,0,0,0,0.557978
96186,The Magician,1898-01-01,1898,0,0,0,0.247933
96196,The Governess,1998-07-31,1998,0,0,0,0.666802
96217,La liga no es cosa de hombres,1972-04-03,1972,0,0,0,0.007675
96218,Heartbreak Hospital,2002-09-06,2002,0,0,0,0.0026
96231,August. Eighth,2012-02-22,2012,16000000,0,-16000000,2.225215
96238,Never Again,2002-07-12,2002,0,0,0,0.807369
96239,Remington and the Curse of the Zombadings,2011-08-31,2011,22361,721651,699290,0.673247
96243,I Start Counting,1970-10-27,1970,0,0,0,0.000844
96252,A Date with Judy,1948-07-29,1948,0,0,0,0.667169
96255,Three Came Home,1950-02-20,1950,0,0,0,0.122293
96279,After The Storm,2001-08-17,2001,0,0,0,0.663588
96287,Deficit,2007-05-21,2007,0,0,0,0.288025
96288,Paris Was a Woman,1996-02-19,1996,0,0,0,0.036471
96300,The Blue Planet,1981-03-11,1981,0,0,0,0.509914
96306,Anotherworld,2008-01-08,2008,40000,0,-40000,0.076201
96333,Weeds,1987-10-16,1987,0,0,0,0.11729
96334,Wild Rebels,1967-09-01,1967,0,0,0,0.146782
96337,Zandy's Bride,1974-05-19,1974,0,0,0,0.864361
96349,Working Girls,1986-05-28,1986,0,0,0,0.315658
96357,Headless Body in Topless Bar,1995-05-20,1995,0,0,0,0.001346
96366,Days of Glory,1944-06-16,1944,0,0,0,1.131074
96368,The Moment to Kill,1968-08-04,1968,0,0,0,0.119547
96382,Obsessed,2002-09-22,2002,0,0,0,1.704249
96393,What Alice Found,2003-01-25,2003,0,0,0,0.28813
96394,King and Country,1964-09-05,1964,0,0,0,1.641172
96395,The Winning of Barbara Worth,1926-10-14,1926,0,0,0,0.709828
96398,Paan Singh Tomar,2012-03-02,2012,0,0,0,1.422854
96399,For Greater Glory - The True Story of Cristiada,2012-06-01,2012,12000000,9622846,-2377154,4.482331
96404,A Breed Apart,1984-07-01,1984,3000000,0,-3000000,0.218525
96411,The Vulture,1982-07-29,1982,0,0,0,1e-06
96419,Oriana,1985-09-08,1985,0,0,0,0.055894
96433,My Friend Irma Goes West,1950-06-25,1950,0,0,0,0.124022
96451,If God Is Willing and da Creek Don't Rise,2010-08-23,2010,0,0,0,0.109599
96458,The Saga of Biorn,2011-02-18,2011,0,0,0,0.7753
96460,Violent City,1975-08-13,1975,0,0,0,0.001655
96461,Dance Me Outside,1995-03-10,1995,0,304852,304852,0.499984
96468,Tormented,2011-08-16,2011,0,0,0,0.511015
96477,Killer Cop,1975-03-27,1975,0,0,0,0.000211
96482,Bachelor Apartment,1931-04-15,1931,0,0,0,0.624834
96484,Conceiving Ada,1999-02-19,1999,0,0,0,0.563712
96495,Becoming Chaz,2011-01-20,2011,0,0,0,0.082658
96496,Burning Love,1983-09-15,1983,0,0,0,0.036059
96497,De Gulle Minnaar,1990-07-06,1990,0,0,0,0.01365
96525,Music in the Air,1934-12-13,1934,0,0,0,0.007897
96529,A Question of Silence,1982-02-18,1982,0,0,0,0.000603
96534,My Last Day Without You,2011-06-11,2011,1000000,0,-1000000,0.387594
96535,Patience (After Sebald),2012-01-27,2012,0,0,0,0.414932
96546,Fear,1954-11-05,1954,0,0,0,0.843535
96552,Pretpark Nederland,2006-10-18,2006,0,0,0,0.007849
96574,Gerhard Richter Painting,2012-03-14,2012,0,0,0,0.728104
96594,Een Maand Later,1987-09-17,1987,0,0,0,0.001655
96599,Eden,2012-03-11,2012,0,0,0,3.928695
96600,Grassroots,2012-06-22,2012,0,0,0,5.362377
96631,Piggy,2012-05-03,2012,900000,0,-900000,3.169856
96648,Asylum Blackout,2011-09-12,2011,0,0,0,2.401824
96664,Nightfall,2012-03-15,2012,0,0,0,1.462831
96683,Lewis Black: In God We Rust,2012-03-17,2012,0,0,0,0.426881
96700,Birth of the Blues,1941-11-07,1941,0,0,0,0.581963
96701,The Infernal Cakewalk,1903-06-12,1903,0,0,0,0.343031
96702,The Power and the Glory,1933-10-06,1933,0,0,0,0.143413
96712,The Puppetmaster,1993-09-13,1993,0,0,0,0.102332
96713,The Marriage Circle,1924-02-10,1924,212000,0,-212000,0.534386
96715,Ruby Bridges,1998-01-18,1998,0,0,0,0.107047
96716,The Bumblebee Flies Anyway,2000-01-01,2000,0,0,0,1.719196
96717,To New Shores,1937-08-30,1937,0,0,0,1.025918
96721,Rush,2013-09-02,2013,38000000,90247624,52247624,10.63552
96724,Anna Karenina,2012-09-06,2012,0,68929150,68929150,8.543311
96750,The Crisis of Civilization,2012-03-27,2012,0,0,0,0.09348
96767,Mrs. 'Arris Goes to Paris,1992-12-27,1992,0,0,0,0.00022
96769,Her Master's Voice,2012-03-11,2012,0,0,0,0.271013
96771,God's Gift To Women,1931-04-13,1931,0,0,0,0.00211
96793,Innocent Bystanders,1972-09-01,1972,0,0,0,0.529221
96821,Caesar Must Die,2012-02-11,2012,0,0,0,9.737921
96823,Quiz,2012-03-22,2012,0,0,0,1.031617
96828,A Touch of Larceny,1959-12-11,1959,0,0,0,0.122007
96846,The Swinger,1966-11-13,1966,0,0,0,0.078509
96872,Superstar Goofy,1991-01-01,1991,0,0,0,0.486432
96882,Accordion Player,1888-01-01,1888,0,0,0,0.212768
96888,Policeman,2011-07-09,2011,0,0,0,0.697833
96906,Perry Mason: The Case of the Maligned Mobster,1991-02-11,1991,0,0,0,0.19082
96912,The Last Time I Saw Archie,1961-05-27,1961,0,0,0,0.523947
96920,Repentance,1984-06-30,1984,0,215496,215496,0.933995
96921,In the Eyes of the World,1991-04-03,1991,0,0,0,0.117314
96924,Aziz Ansari: Dangerously Delicious,2012-03-20,2012,0,0,0,1.234042
96935,The Naked Maja,1958-12-20,1958,0,0,0,0.588101
96936,The Bling Ring,2013-06-12,2013,15000000,19145732,4145732,7.913029
96944,Resistance,2011-11-25,2011,0,0,0,1.122866
96951,Salom√©,1923-02-15,1923,350000,0,-350000,0.075235
96958,Something Has Happened,1987-01-01,1987,0,0,0,0.141205
96966,Raggedy Man,1981-09-18,1981,0,0,0,0.725026
96973,Jesus Henry Christ,2012-05-04,2012,0,0,0,6.662375
96985,Hot Summer in Barefoot County,1974-07-01,1974,0,0,0,0.000204
96987,The Do-Deca-Pentathlon,2012-07-06,2012,0,0,0,3.297648
96995,A Change of Heart,1998-07-19,1998,0,0,0,0.001601
96999,Smitty,2012-04-10,2012,0,0,0,1.024535
97006,Temptation: Confessions of a Marriage Counselor,2013-03-29,2013,0,0,0,2.557034
97008,Farmageddon,2011-07-08,2011,0,0,0,0.286949
97020,RoboCop,2014-01-30,2014,120000000,242688965,122688965,10.246549
97024,The Man in Possession,1931-07-04,1931,0,0,0,0.00119
97029,Ceddo,1977-06-01,1977,0,0,0,0.00243
97032,Too Early/Too Late,1982-02-17,1982,0,0,0,0.105885
97035,A Tale of the Wind,1988-09-09,1988,0,0,0,0.262016
97038,The Rose Seller,1998-05-13,1998,0,0,0,0.942627
97039,The Asthenic Syndrome,1990-08-01,1990,0,0,0,0.005351
97044,Aileen Wuornos: The Selling of a Serial Killer,1992-11-01,1992,0,0,0,1.138615
97046,Deseret,1995-02-07,1995,0,0,0,0.143416
97051,Would You Rather,2012-10-14,2012,0,0,0,8.332313
97073,Perry Mason: The Case of the Skin-Deep Scandal,1993-02-19,1993,0,0,0,0.000469
97082,Meet the Fokkens,2011-12-01,2011,0,0,0,0.120179
97088,The Great Sacrifice,1944-12-08,1944,0,0,0,0.128118
97108,The Life and Times of Rosie the Riveter,1980-09-27,1980,0,0,0,0.005645
97110,The Tyrannical Father,1941-09-19,1941,0,0,0,1.271178
97128,El √°ngel de Budapest,2011-12-22,2011,0,0,0,0.131282
97138,Student Seduction,2003-05-05,2003,0,0,0,0.312089
97149,Conflagration,1958-09-22,1958,0,0,0,0.665175
97187,Cyber City Oedo 808,1990-01-01,1990,0,0,0,0.008267
97193,You Belong to Me,1941-10-22,1941,0,0,0,0.265943
97206,Taboo,2002-01-14,2002,0,0,0,0.97592
97211,Dreams,1955-08-22,1955,0,0,0,0.84719
97241,A Short Film About John Bolton,2003-01-24,2003,0,0,0,0.386945
97251,Faces of Death: Fact or Fiction?,1999-01-01,1999,0,0,0,0.020448
97252,Okie Noodling,2001-03-10,2001,0,0,0,0.03911
97253,"The Old, Weird America: Harry Smith's Anthology of American Folk Music",2007-02-01,2007,0,0,0,0.003531
97274,Milton Glaser: To Inform & Delight,2008-10-27,2008,0,0,0,0.075294
97284,Film Ist.,1998-01-01,1998,0,0,0,0.001287
97310,One Nine Nine Four,2009-10-09,2009,100,0,-100,0.149418
97313,Bank Shot,1974-07-31,1974,0,0,0,1.413834
97327,Laughing Sinners,1931-05-31,1931,0,0,0,0.139413
97340,Black's Game,2012-03-11,2012,0,0,0,1.428455
97341,Deewane Huye Paagal,2005-11-25,2005,0,355962,355962,2.06066
97342,Vedam,2010-06-04,2010,0,0,0,0.307495
97350,Agnivarsha: The Fire and the Rain,2002-08-30,2002,0,25049,25049,0.047908
97353,Up In Smoke,1957-12-22,1957,0,0,0,0.197931
97361,'D',2005-06-03,2005,0,0,0,0.61062
97365,Rust and Bone,2012-05-17,2012,15400000,25762027,10362027,8.400049
97367,The Place Beyond the Pines,2013-03-20,2013,15000000,35485608,20485608,7.492658
97370,Under the Skin,2014-03-14,2014,13300000,5380251,-7919749,6.707974
97394,Stanley Kubrick's Boxes,2008-07-15,2008,0,0,0,0.834837
97397,Television Under The Swastika,1999-01-01,1999,0,0,0,0.002758
97399,This Is The Life,2008-02-08,2008,0,0,0,0.040758
97400,The Sweatbox,2002-09-13,2002,0,0,0,1.03829
97403,The Trail Of Tears: Cherokee Legacy,2006-02-01,2006,0,0,0,0.004985
97406,Georgia,1995-05-19,1995,0,0,0,4.093443
97414,Auschwitz: The Nazis and the 'Final Solution',2005-01-11,2005,0,0,0,1.052643
97421,Kansas Raiders,1950-08-19,1950,0,0,0,0.702263
97430,The Man with the Iron Fists,2012-11-02,2012,15000000,15608545,608545,8.310945
97434,Gambit,2012-11-07,2012,0,0,0,7.60849
97437,Hum Kisi Se Kum Nahin,2002-05-31,2002,0,0,0,0.170922
97447,Satin Rouge,2002-05-16,2002,0,0,0,0.669752
97449,Khamoshi: The Musical,1996-08-09,1996,0,0,0,0.530361
97481,The Confession,2011-07-01,2011,0,0,0,1.196328
97513,Window Water Baby Moving,1959-01-01,1959,0,0,0,0.83165
97514,Mothlight,1963-01-01,1963,0,0,0,1.440641
97519,Lost Horizon,1973-03-17,1973,12,0,-12,0.907629
97537,Beefcake,1998-09-01,1998,0,0,0,0.653879
97547,The Girl with the Red Hair,1981-09-17,1981,0,0,0,0.124225
97548,Family Law,2006-03-23,2006,0,0,0,0.22433
97559,Mako: The Jaws of Death,1976-07-01,1976,0,0,0,0.00022
97562,100 years of evil,2010-01-01,2010,0,0,0,0.042096
97584,"Joe Smith, American",1942-02-01,1942,0,0,0,0.078247
97593,Shark Kill,1976-05-20,1976,0,0,0,0.011938
97598,Kathleen,1941-12-18,1941,0,0,0,0.20783
97605,Extracted,2012-03-10,2012,0,0,0,10.855439
97607,Gimme the Loot,2012-09-23,2012,0,0,0,0.862563
97609,Somebody Up There Likes Me,2013-01-22,2013,0,0,0,0.52137
97610,Beware of Mr. Baker,2012-11-28,2012,0,0,0,2.449115
97614,Deadfall,2012-11-08,2012,12000000,66351,-11933649,8.435294
97618,One Man's Justice,1996-07-26,1996,0,0,0,0.153401
97630,Zero Dark Thirty,2012-12-19,2012,40000000,132820716,92820716,9.649303
97632,American Warships,2012-05-15,2012,0,1000000,1000000,3.985291
97643,The Tom Green Subway Monkey Hour,2002-03-24,2002,0,0,0,0.113206
97648,My Favorite Blonde,1942-04-02,1942,0,0,0,0.10982
97666,What a Mess!,1995-06-06,1995,1200000,0,-1200000,1.053532
97672,Suicides,2012-03-01,2012,0,0,0,0.43125
97683,Fat Kid Rules The World,2012-10-05,2012,0,0,0,1.150293
97686,The Jeffrey Dahmer Files,2013-02-15,2013,0,0,0,1.70827
97690,We Are Legion: The Story of the Hacktivists,2012-01-20,2012,0,0,0,4.13986
97707,Gesualdo: Death for Five Voices,1995-06-06,1995,0,0,0,0.179702
97716,Scaramouche,1923-09-15,1923,0,0,0,0.69791
97724,The Adonis Factor,2010-06-19,2010,100,0,-100,0.203511
97732,See Girl Run,2013-04-26,2013,0,0,0,0.898921
97733,Slacker 2011,2011-08-31,2011,0,0,0,0.032858
97735,The Spanish Main,1945-10-01,1945,0,0,0,0.455655
97754,My Mother Likes Women,2002-01-11,2002,0,0,0,1.068925
97762,Two Years at Sea,2011-09-10,2011,0,0,0,0.580902
97767,Always in My Heart,1942-03-14,1942,0,0,0,0.213969
97784,Teenage Cave Man,1958-07-01,1958,70000,0,-70000,0.830874
97790,Prison of the Dead,2000-08-22,2000,0,0,0,0.235143
97794,The Road,2011-11-30,2011,0,0,0,2.234864
97795,Emergo,2011-10-11,2011,0,0,0,7.177295
97797,Dead Daughters,2007-02-01,2007,1200000,0,-1200000,0.355732
97805,Wirey Spindell,2000-01-21,2000,0,0,0,0.098181
97829,Syncopation,1942-05-22,1942,0,0,0,0.001842
97831,Once Is Not Enough,1975-06-20,1975,0,0,0,0.207351
97844,Malady of Love,1987-09-30,1987,0,0,0,0.915431
97899,Magnificent Presence,2012-03-16,2012,0,0,0,6.2877
97910,Juke Girl,1942-05-30,1942,0,0,0,0.012195
97915,Point of Order!,1964-01-14,1964,0,0,0,0.139978
97933,The Chemical Brothers: Don't Think,2012-01-26,2012,0,0,0,0.433572
97936,Sweet November,1968-02-08,1968,0,0,0,0.327296
97938,Heart of the Country,2013-08-19,2013,0,0,0,1.0927
97942,Scared To Death,1981-03-01,1981,74000,0,-74000,0.120042
97943,Beijing Bastards,1993-08-01,1993,0,0,0,0.267565
97971,Chillers,1987-01-01,1987,250000,0,-250000,0.070623
97987,Human Cobras,1971-08-05,1971,80000,0,-80000,0.306997
97989,Neighboring Sounds,2012-02-01,2012,0,0,0,2.011049
97991,Her Cardboard Lover,1942-06-01,1942,0,0,0,0.03663
97995,Seven Years Bad Luck,1921-02-06,1921,0,0,0,0.141558
97995,Seven Years Bad Luck,1921-02-06,1921,0,0,0,0.141558
98010,Francis of Assisi,1961-07-12,1961,0,0,0,0.791888
98025,The Teasers,1975-10-31,1975,0,0,0,1.374672
98027,Seven Dead in the Cat's Eye,1973-04-12,1973,0,0,0,1.484046
98048,Dionysus in '69,1972-10-30,1972,0,0,0,0.14841
98060,Time Stood Still,1960-04-05,1960,0,0,0,0.072409
98064,The Source Family,2011-11-02,2011,0,0,0,0.296608
98065,Girl Walk // All Day,2011-12-08,2011,0,0,0,0.358534
98066,The Babymakers,2012-08-03,2012,0,0,0,4.001946
98068,Pilgrim Song,2012-03-10,2012,0,0,0,0.06516
98069,Charles Bradley: Soul of America,2012-03-09,2012,0,0,0,0.184723
98078,Judith of Bethulia,1914-03-08,1914,0,0,0,0.18545
98079,Untamed Youth,1957-05-10,1957,0,0,0,0.178728
98085,Operation Kid Brother,1967-04-20,1967,0,0,0,0.587177
98094,Pinball Summer,1980-06-27,1980,0,0,0,0.018017
98096,Live Music,2009-11-20,2009,0,0,0,0.011529
98103,Summer Job,1989-03-03,1989,0,0,0,0.003013
98106,Spasms,1983-01-01,1983,0,0,0,0.153038
98115,Harmony and Me,2010-01-15,2010,0,0,0,0.309816
98116,Pharaoh's Curse,1957-02-01,1957,0,0,0,0.520118
98120,Piazza Fontana: The Italian Conspiracy,2012-03-30,2012,0,0,0,2.051933
98122,Veerana,1988-05-06,1988,0,0,0,1.847034
98125,Honeymoon in Bali,1939-09-29,1939,0,0,0,0.304102
98130,Goldengirl,1979-10-06,1979,0,0,0,0.123389
98136,Hit Lady,1974-10-06,1974,0,0,0,0.171598
98162,The Painting,2011-11-22,2011,0,11229,11229,2.45174
98193,Death by Hanging,1968-02-02,1968,0,0,0,1.326898
98203,Captive,2012-09-05,2012,11180,24591,13411,0.660969
98205,War Witch,2012-02-17,2012,0,0,0,2.6341
98223,From the Orient with Fury,1965-09-24,1965,0,0,0,0.400047
98232,11 Flowers,2011-09-11,2011,0,0,0,0.312795
98246,The Sun,2005-02-17,2005,0,76,76,1.134351
98250,The Long Ride Home,2003-03-27,2003,3500000,0,-3500000,0.003301
98262,The Big Street,1942-08-13,1942,0,0,0,0.796132
98273,The Bastard,1968-10-29,1968,0,0,0,0.321059
98277,Paris Under Watch,2012-04-04,2012,0,0,0,1.127613
98289,Seven Waves Away,1957-04-17,1957,0,0,0,0.66431
98293,The Captain Hates the Sea,1934-11-02,1934,0,0,0,0.086883
98297,Green Sails,2000-01-01,2000,0,0,0,0.010338
98302,Love and the Frenchwoman,1960-09-23,1960,0,0,0,0.041026
98303,The Secret Life of Zoey,2002-08-19,2002,0,0,0,0.048961
98308,Teen Vamp,1988-01-01,1988,0,0,0,0.060535
98328,The Great Caruso,1951-04-16,1951,0,0,0,0.219972
98339,The Samaritan,2012-03-02,2012,12000000,2521,-11997479,11.52128
98344,Warriors of the Rainbow: Seediq Bale - Part 1: The Sun Flag,2011-04-09,2011,25000000,0,-25000000,1.744789
98349,Love Comes Lately,2007-09-09,2007,0,0,0,0.159727
98355,The Space Movie,1980-11-17,1980,0,0,0,0.12453
98357,Broken City,2013-01-18,2013,56000000,19701164,-36298836,12.136158
98364,The Actress,1953-09-25,1953,0,0,0,0.115546
98368,Ritual,2012-04-26,2012,200000,0,-200000,2.220049
98369,Blue Like Jazz,2012-04-13,2012,1250000,0,-1250000,1.891233
98370,Wonder Women!: The Untold Story of American Superheroines,2012-03-10,2012,0,0,0,0.111493
98377,Angelfist,1993-05-12,1993,0,0,0,0.285439
98398,The Lost Squadron,1932-03-12,1932,0,0,0,1.011163
98399,Stand by for Action,1942-12-31,1942,0,0,0,0.072259
98404,Destroyer,1943-08-19,1943,0,0,0,0.517981
98412,Flight of the Conchords: A Texan Odyssey,2006-10-19,2006,0,0,0,0.042821
98438,Thou Shalt Laugh,2006-11-07,2006,0,0,0,0.016884
98439,Thou Shalt Laugh 2 - The Deuce,2007-11-07,2007,0,0,0,0.003741
98440,Thou Shalt Laugh 3,2008-11-04,2008,0,0,0,0.005409
98456,The Girl on the Stone,2007-07-27,2007,0,0,0,0.041153
98480,Man Of The Century,1999-10-29,1999,0,33031,33031,0.007829
98482,Commandos Strike at Dawn,1942-12-30,1942,0,0,0,0.411482
98487,First Comes Courage,1943-07-29,1943,0,0,0,0.054867
98491,Wuthering Heights,1970-06-09,1970,0,0,0,1.090793
98498,The Last Bolshevik,1993-03-25,1993,0,0,0,0.149622
98499,Illtown,1996-07-09,1996,0,0,0,0.141163
98502,The Myth Of Fingerprints,1997-09-17,1997,2000000,458815,-1541185,0.228526
98505,Seventh Heaven,1997-12-17,1997,0,0,0,0.431005
98507,Shock Treatment,1964-07-22,1964,0,0,0,0.226374
98514,River of Grass,1995-08-04,1995,0,0,0,0.713518
98525,Heleno,2012-03-29,2012,0,0,0,2.082922
98532,Sensation,2011-11-04,2011,0,0,0,0.975404
98536,So Big!,1932-04-30,1932,0,0,0,0.108141
98541,Hungry for Change,2012-01-01,2012,0,0,0,1.486697
98545,"Peace, Love & Misunderstanding",2011-09-13,2011,0,539896,539896,8.359985
98548,People Like Us,2012-06-29,2012,16000000,12434778,-3565222,14.906621
98549,The Legend of Hell's Gate: An American Conspiracy,2011-03-03,2011,0,0,0,0.538002
98551,The Flaw,2011-01-21,2011,0,0,0,0.028745
98554,Serving Life,2011-07-28,2011,0,0,0,0.255898
98557,Dysfunctional Friends,2012-02-03,2012,1800000,0,-1800000,0.482957
98560,The Diary of Preston Plummer,2012-03-05,2012,0,0,0,0.172666
98566,Teenage Mutant Ninja Turtles,2014-08-07,2014,125000000,477200000,352200000,22.337973
98567,Chinese Zodiac,2012-12-20,2012,48000000,0,-48000000,11.02591
98568,Enter Nowhere,2011-10-22,2011,0,0,0,3.205782
98581,8 First Dates,2012-03-08,2012,0,0,0,1.301467
98582,Unit 7,2012-04-03,2012,3500000,0,-3500000,2.977321
98586,Winning Streak,2012-04-26,2012,0,0,0,2.774314
98596,Overdose,1983-09-04,1983,0,1334173,1334173,0.02158
98604,Cinderella,2012-02-14,2012,0,0,0,0.803588
98612,Above Us Only Sky,2011-09-15,2011,0,0,0,1.227323
98622,9,2005-04-21,2005,0,0,0,3.122855
98631,Himizu,2011-09-06,2011,0,0,0,3.161281
98635,What Did the Lady Forget?,1937-03-03,1937,0,0,0,0.428274
98636,Kisses,1957-07-23,1957,0,0,0,0.617028
98642,The Suit,2003-02-09,2003,0,0,0,0.09539
98644,Here,2011-01-21,2011,0,0,0,0.807712
98851,Parts: The Clonus Horror,1979-08-01,1979,257000,0,-257000,0.008673
98857,Scrat's Continental Crack-Up: Part 2,2011-11-16,2011,0,0,0,2.718478
98864,Resurrection,1980-09-26,1980,0,3910019,3910019,0.95581
98870,Think Of Me,2011-10-15,2011,0,0,0,0.386457
98886,Kumar√©,2012-06-20,2012,0,0,0,0.971157
98914,Mother,1926-10-11,1926,0,0,0,1.078462
98927,Mad Love,1985-02-27,1985,0,0,0,0.58424
98932,The Eye of the Storm,2011-09-07,2011,0,0,0,0.931926
98948,Abraham Lincoln vs. Zombies,2012-05-29,2012,150000,0,-150000,9.109894
98959,The game of truth,2004-09-24,2004,0,0,0,0.092138
98969,Le rouge et le noir,1954-10-29,1954,0,0,0,0.297475
98984,Eat a Bowl of Tea,1989-07-21,1989,0,0,0,0.079911
99002,Nenette and Boni,1997-01-29,1997,0,0,0,0.551124
99004,Carne de horca,1953-10-08,1953,0,0,0,0.083507
99006,Live Nude Girls Unite!,2000-10-06,2000,0,48752,48752,0.001272
99008,Hillbillys in a Haunted House,1967-05-01,1967,0,0,0,0.287059
99022,Stephen Fry: The Secret Life of the Manic Depressive,2006-09-19,2006,0,0,0,0.20278
99040,The Confessional,1995-09-29,1995,0,0,0,0.120789
99080,The Viking,1931-06-21,1931,0,0,0,0.002362
99080,The Viking,1931-06-21,1931,0,0,0,0.002362
99095,"Oggi, domani, dopodomani",1965-12-28,1965,0,0,0,0.114038
99099,Shogun's Joys of Torture,1968-09-28,1968,0,0,0,0.365884
99104,Bloodletting,1997-01-01,1997,10000,0,-10000,0.072171
99106,The Monster,1993-01-01,1993,0,0,0,0.000151
99119,Our Paradise,2011-09-28,2011,0,0,0,1.073478
99188,Gravity's Clowns,2009-05-23,2009,0,0,0,0.110835
99189,Werner Herzog Eats His Shoe,1980-12-01,1980,0,0,0,0.565573
99194,The Evictors,1979-04-17,1979,0,0,0,1.385336
99223,FDR: American Badass!,2012-09-24,2012,0,0,0,2.261326
99224,The Lawless Breed,1953-01-03,1953,0,0,0,0.442244
99229,Normal,2009-03-26,2009,0,0,0,1.35224
99234,Thunder Birds,1942-10-19,1942,0,0,0,0.079019
99236,Panama Hattie,1942-09-01,1942,0,0,0,0.001179
99242,Take Me Far Away,2009-09-11,2009,0,0,0,0.192028
99247,Mommies,2012-03-01,2012,0,0,0,0.653452
99251,Spin,2005-01-01,2005,0,0,0,0.41673
99254,Casey Jones,2011-09-18,2011,20000,0,-20000,0.572324
99258,The Rag Man,1925-02-16,1925,0,0,0,0.00411
99259,Eight Deadly Shots,1972-04-19,1972,0,0,0,0.000308
99261,The Bloodstained Shadow,1978-06-02,1978,0,0,0,0.689476
99272,Red Meadows,1945-12-26,1945,0,0,0,0.268068
99279,I am Fishead,2011-09-11,2011,0,0,0,0.042368
99283,Private Lives,1931-12-12,1931,0,0,0,0.220294
99312,Ordinary Miracles,2005-01-01,2005,0,0,0,0.165861
99313,√âdith et Marcel,1983-01-01,1983,0,0,0,0.061474
99318,The Shopworn Angel,1938-07-15,1938,0,0,0,0.550873
99319,Pleasure Cruise,1933-04-01,1933,0,0,0,0.162296
99324,Busses Roar,1942-08-18,1942,0,0,0,0.142022
99329,The Money Order,1968-11-27,1968,0,0,0,0.196975
99330,Happy Birthday,2008-12-18,2008,0,0,0,0.128911
99332,Eurocrime! The Italian Cop and Gangster Films That Ruled the '70s,2012-03-30,2012,0,0,0,0.438956
99339,Just Anybody,2008-04-02,2008,0,0,0,0.238914
99343,Next Floor,2008-10-03,2008,0,0,0,1.192509
99345,The Gallant Hours,1960-06-13,1960,0,0,0,0.389599
99351,The Green Years,1946-07-04,1946,0,0,0,0.054128
99361,Six Swedish Girls at a Pump,1980-09-19,1980,0,0,0,0.878137
99367,Date and Switch,2014-02-14,2014,0,0,0,4.380997
99368,All the Love You Cannes!,2002-05-16,2002,0,0,0,0.133291
99370,Got the Facts on Milk?,2011-08-30,2011,0,0,0,0.078655
99372,The Naked Edge,1961-06-30,1961,0,0,0,0.16769
99374,Honeymoon Hotel,1964-06-03,1964,0,0,0,0.573453
99377,The Big Mouth,1967-07-12,1967,0,0,0,0.136119
99424,Blood Hook,1987-04-01,1987,0,0,0,0.111017
99449,The Iguana with the Tongue of Fire,1971-08-24,1971,0,0,0,0.051916
99453,Derek,2008-02-19,2008,0,0,0,0.466088
99479,Entertaining Angels - The Dorothy Day Story,1996-09-27,1996,0,0,0,0.051135
99480,I am Jesus,2011-01-28,2011,0,0,0,0.053798
99495,Summer of Goliath,2011-07-08,2011,0,0,0,0.106521
99513,Stateless Things,2012-03-12,2012,0,0,0,0.101402
99534,Beautiful Wave,2011-01-01,2011,0,0,0,0.205447
99536,Satanis: The Devil's Mass,1970-03-01,1970,0,0,0,0.073258
99545,Night Monster,1942-10-20,1942,0,0,0,0.408008
99567,On Approval,1944-05-22,1944,0,0,0,0.412761
99579,"Farewell, My Queen",2012-03-21,2012,0,0,0,6.974885
99592,I Aim at the Stars,1960-08-19,1960,0,0,0,0.051171
99599,Daughter of the Nile,1987-08-22,1987,0,0,0,0.039924
99600,"Good Men, Good Women",1995-05-13,1995,0,0,0,0.476877
99608,Rain or Shine,1930-08-15,1930,0,0,0,0.51221
99627,"East Side, West Side",1949-12-22,1949,0,0,0,0.308694
99642,A New Life,2002-11-27,2002,0,0,0,0.866735
99647,Blue,2002-09-09,2002,0,0,0,0.4644
99648,Suddenly,2002-04-26,2002,0,0,0,0.214796
99650,Skyscraper,2011-09-15,2011,650000,0,-650000,0.199933
99657,Wings of Hope,2000-02-01,2000,0,0,0,0.305434
99698,A Thousand Months,2003-10-01,2003,0,0,0,0.252078
99708,Pope John Paul II,2005-12-04,2005,0,0,0,1.022919
99729,Central Airport,1933-04-15,1933,0,0,0,0.523341
99732,The Last Flight,1931-08-29,1931,0,0,0,0.211093
99738,Seven Invisible Men,2005-12-10,2005,0,0,0,0.062343
99749,Rampage,1987-09-01,1987,0,796368,796368,2.946078
99758,Swerve,2012-04-11,2012,0,0,0,1.321924
99760,El pico 2,1984-11-09,1984,0,930349,930349,0.699668
99762,Salem Falls,2011-11-19,2011,0,0,0,0.811679
99767,Their Own Desire,1929-12-27,1929,0,0,0,0.415156
99770,Ast√©rix and Ob√©lix: God Save Britannia,2012-10-17,2012,61000000,0,-61000000,9.722726
99785,The Conductor,2012-03-29,2012,0,0,0,0.433841
99802,A Day at the Beach,1972-04-17,1972,0,0,0,0.099567
99819,The Great Match,2006-04-21,2006,0,0,0,0.153223
99826,The Jimmy Show,2002-01-16,2002,0,0,0,0.231573
99846,Moonshine County Express,1977-06-01,1977,0,0,0,0.334056
99859,Crimetime,1996-08-01,1996,0,0,0,0.399332
99861,Avengers: Age of Ultron,2015-04-22,2015,280000000,1405403694,1125403694,37.37942
99863,Flight Angels,1940-05-18,1940,0,0,0,0.004679
99875,The Italian Straw Hat,1928-01-13,1928,0,0,0,0.322571
99877,The Waiting Room,2012-09-26,2012,0,0,0,1.198442
99879,Winter Nomads,2012-02-10,2012,0,0,0,0.199527
99880,Last Winter,2012-02-29,2012,0,0,0,0.776769
99883,The Wheelchair,1960-11-03,1960,0,0,0,1.095766
99885,Divine Intervention,,,0,0,0,0.001181
99896,The Custodian,2007-04-04,2007,0,0,0,0.62301
99898,Man on a Tightrope,1953-04-01,1953,0,0,0,0.261366
99904,The Prospects,2011-03-22,2011,0,0,0,0.043285
99909,The Angels Wash Their Faces,1939-08-26,1939,0,0,0,0.331236
99916,I Motorizzati,1962-11-29,1962,0,0,0,0.108328
99920,Confessions of a Nazi Spy,1939-05-06,1939,0,0,0,0.90327
99922,Dirigible,1931-04-04,1931,0,0,0,0.078026
99934,The Flying Fleet,1929-01-19,1929,0,0,0,0.008084
99946,Exit Smiling,1926-11-06,1926,0,0,0,0.202315
99977,Hot Stuff,1979-08-10,1979,0,0,0,0.215778
100010,Flight Command,1940-12-27,1940,0,0,0,0.769266
100017,Hounded,2006-08-06,2006,0,0,0,2.964103
100024,Bloodwork,2012-05-10,2012,0,0,0,1.099911
100032,The Great Los Angeles Earthquake,1990-11-11,1990,0,0,0,1.315925
100033,Mr. Thank You,1936-02-27,1936,0,0,0,0.23568
100042,Dumb and Dumber To,2014-11-12,2014,40000000,169837010,129837010,15.402597
100046,The Giant Mechanical Man,2012-04-27,2012,0,0,0,3.403206
100057,American Animal,2012-05-18,2012,0,0,0,0.369792
100061,Son of a Lion,2007-10-06,2007,0,0,0,0.224111
100063,Blackout,1978-08-25,1978,0,0,0,0.314595
100085,El tren de la memoria,2005-04-27,2005,0,0,0,0.039978
100086,Silent Waters,2003-08-15,2003,0,0,0,0.146994
100088,Black Gunn,1972-12-20,1972,0,0,0,1.786885
100089,Nazis at the Center of the Earth,2012-04-23,2012,0,0,0,2.554387
100110,Survival Quest,1988-09-09,1988,0,0,0,2.826282
100122,The Art of Dying,2000-05-31,2000,0,0,0,0.539706
100152,Mars,2004-11-11,2004,2000000,0,-2000000,0.380933
100167,No Way Home,1996-09-01,1996,0,0,0,0.565625
100179,London in the Raw,1965-04-23,1965,0,0,0,0.001649
100183,Outpost: Black Sun,2012-01-01,2012,3000000,0,-3000000,2.438754
100185,Return Home,1990-08-02,1990,0,0,0,1e-06
100196,Julian Po,1997-09-05,1997,0,0,0,0.300345
100205,Baby Snakes,1979-12-21,1979,0,0,0,0.075144
100215,Another Way,1982-05-01,1982,0,0,0,0.455195
100224,How Much Wood Would a Woodchuck Chuck,1976-10-30,1976,34000,0,-34000,0.103347
100241,"I, Frankenstein",2014-01-22,2014,65000000,71154592,6154592,9.415817
100243,Act of Violence,2008-01-16,2008,0,0,0,0.050808
100246,Gertie the Dinosaur,1914-09-15,1914,0,0,0,1.914726
100247,"Winsor McCay, the Famous Cartoonist of the N.Y. Herald and His Moving Comics",1911-04-08,1911,0,0,0,0.426007
100250,Tussenland,2002-04-27,2002,0,0,0,0.00246
100257,Quartet,1948-10-26,1948,0,0,0,0.482475
100270,Game of Werewolves,2011-10-07,2011,0,0,0,2.697544
100271,A Letter to Momo,2012-04-21,2012,0,6748712,6748712,9.491888
100272,Harold's Going Stiff,2011-05-06,2011,0,0,0,0.9135
100274,Comforting Skin,2011-10-10,2011,0,0,0,0.296009
100275,Eddie: The Sleepwalking Cannibal,2012-04-22,2012,0,1632,1632,2.025477
100287,My Avatar and Me,2010-11-10,2010,0,0,0,0.020993
100288,Black Sun,2007-06-15,2007,0,0,0,0.174121
100292,Ain't in It for My Health: A Film About Levon Helm,2010-11-24,2010,0,0,0,0.050396
100341,Nicky's Family,2011-01-04,2011,0,0,0,0.081204
100351,Sylvia,1965-02-10,1965,0,0,0,0.015735
100402,Captain America: The Winter Soldier,2014-03-20,2014,170000000,714766572,544766572,18.717704
100409,Over Your Cities Grass Will Grow,2011-10-27,2011,0,0,0,0.186806
100416,Demoted,2011-03-12,2011,0,0,0,2.492344
100420,Gabriel Over the White House,1933-03-31,1933,0,0,0,1.089754
100450,Trapped in the Closet: Chapters 1-12,2005-11-01,2005,0,0,0,0.843314
100461,The Christian Revolt,1962-03-21,1962,0,0,0,0.130231
100468,They Have Changed Their Face,1971-07-02,1971,0,0,0,0.070647
100490,Scarlett,1994-11-13,1994,0,0,0,1.288235
100493,The Devil's Carnival,2012-04-05,2012,500000,0,-500000,1.60037
100526,Thunder Rock,1942-12-04,1942,0,0,0,0.225312
100528,The War Against Mrs. Hadley,1942-08-07,1942,0,0,0,0.080791
100529,Lola Versus,2012-04-24,2012,0,252603,252603,4.296441
100532,Sun Kissed,2012-06-01,2012,300000,0,-300000,0.008235
100540,The Kill Hole,2012-08-28,2012,300000,0,-300000,0.220524
100544,Officer Down,2013-01-22,2013,12000000,0,-12000000,2.900804
100568,Floating,1999-10-08,1999,0,0,0,0.226247
100592,The Hand,1965-10-26,1965,0,0,0,0.467637
100594,The Book of Fate,2003-03-06,2003,0,0,0,0.203204
100605,December 7th,1943-01-01,1943,0,0,0,0.393776
100632,Always Leave Them Laughing,1949-11-26,1949,0,0,0,0.064841
100634,Counting Backwards,2007-01-01,2007,0,0,0,0.039184
100656,Four Sided Triangle,1953-06-15,1953,0,0,0,1.211299
100661,Terror Is a Man,1959-11-01,1959,0,0,0,0.204179
100669,Shark Swarm,2008-01-01,2008,0,0,0,2.012048
100671,The Witchmaker,1969-05-01,1969,0,0,0,0.175253
100681,Shanghai,2012-06-08,2012,0,0,0,1.469867
100683,Dragon Eyes,2012-05-10,2012,3000000,0,-3000000,2.527832
100747,Hitler's Madman,1943-06-10,1943,0,0,0,0.240743
100770,The Black Torment,1964-10-19,1964,0,0,0,0.409232
100776,Company: Original Cast Album,1970-01-01,1970,0,0,0,0.036891
100783,Yedyanchi Jatra,,,0,0,0,0.000177
100784,"Khrustalyov, My Car!",1998-05-20,1998,0,0,0,1.164722
100791,That still Karloson!,2012-03-15,2012,4000000,9938268,5938268,0.712585
100794,"Walking, Walking",1983-05-12,1983,0,0,0,0.5
100812,The Laughing Woman,1969-08-24,1969,0,0,0,0.107235
100813,Koch Brothers Exposed,2012-03-07,2012,0,0,0,0.062257
100814,Nazty Nuisance,1943-08-06,1943,0,0,0,0.268708
100825,Chely Wright: Wish Me Away,2011-06-22,2011,0,0,0,0.158129
100829,This is What Love in Action Looks Like,2011-01-28,2011,0,0,0,0.082306
100830,Radiostars,2012-04-11,2012,0,0,0,3.061471
100888,Closed Circuit,1978-01-01,1978,0,0,0,0.329186
100894,The Mayor of Hell,1933-06-24,1933,229,0,-229,0.873215
100898,North Sea Texas,2011-03-16,2011,0,0,0,5.599257
100910,Tender Comrade,1943-12-29,1943,0,0,0,0.354851
100914,Crows and Sparrows,1949-01-01,1949,0,0,0,0.036478
100923,Way of Blue Sky,2005-09-17,2005,0,0,0,0.073596
100973,Deadline,2001-10-24,2001,0,0,0,0.597424
100975,Just Looking,1999-10-21,1999,3000000,0,-3000000,0.484849
101006,Liverpool,2008-10-30,2008,0,0,0,0.411596
101024,I Love Hong Kong 2012,2012-01-20,2012,0,0,0,0.486025
101029,The Alley Tramp,1968-06-12,1968,0,0,0,0.115377
101030,The Golden Blade,1953-08-11,1953,0,0,0,0.982844
101056,The Millionaire Tour,2012-07-31,2012,0,0,0,2.040471
101124,Beijing Taxi,2011-06-25,2011,0,0,0,0.007214
101125,Class of '61,1993-04-12,1993,0,0,0,0.273414
101135,A Connecticut Yankee in King Arthur's Court,1989-12-18,1989,0,0,0,0.764068
101173,Coriolanus,2011-02-14,2011,7700000,1072602,-6627398,6.914615
101176,The Butterfly Room,2012-08-04,2012,0,1081,1081,6.569589
101179,Truth or Dare,2012-08-05,2012,0,0,0,4.711164
101183,The Third Lover,1962-05-02,1962,0,0,0,1.919569
101185,The Far Pavilions,1984-04-21,1984,0,0,0,1.178475
101190,Gangsters and Philantropists,1963-02-15,1963,0,0,0,0.123891
101206,Action in Arabia,1944-02-18,1944,0,0,0,0.09855
101217,Hanzo,1975-04-01,1975,0,0,0,0.384583
101226,Dear Heart,1964-12-02,1964,0,0,0,0.338929
101230,1-900,1994-09-01,1994,0,0,0,0.062128
101231,Gente Di Rispetto,1975-10-30,1975,0,0,0,0.00052
101242,Love Simple,2009-07-31,2009,0,0,0,0.333161
101267,Katy Perry: Part of Me,2012-06-28,2012,12000000,32726956,20726956,8.960713
101281,Bachelor Flat,1962-01-12,1962,0,0,0,0.002579
101288,Ten North Frederick,1958-05-22,1958,0,0,0,0.110003
101289,"See Here, Private Hargrove",1944-03-18,1944,0,0,0,0.079153
101293,Skinheads,1989-08-08,1989,0,0,0,0.206643
101297,"Tomorrow, the World!",1944-12-29,1944,0,0,0,0.469587
101299,The Hunger Games: Catching Fire,2013-11-15,2013,130000000,847423452,717423452,25.309139
101307,Rage,1972-11-22,1972,0,0,0,0.632678
101308,Ride Beyond Vengeance,1966-05-09,1966,0,0,0,0.999281
101320,The Spiral Staircase,2000-04-02,2000,0,0,0,0.441255
101325,The Forger,2011-03-09,2011,0,0,0,7.854465
101330,Light Years Away,1981-05-20,1981,0,0,0,0.702793
101338,Crane World,1999-06-17,1999,0,0,0,0.234759
101342,The Spousals of God,1999-10-15,1999,0,0,0,0.503167
101352,L'Antis√©mite,2012-03-21,2012,90000,0,-90000,0.011549
101362,A Cure for Love,1966-07-20,1966,0,0,0,0.021483
101363,The Wonderful Ice Cream Suit,1998-01-23,1998,0,0,0,0.086764
101376,The Queen and I,2008-11-20,2008,0,0,0,0.409213
101382,Utamaro and His Five Women,1946-12-17,1946,0,0,0,0.902028
101383,With Byrd at the South Pole,1930-06-28,1930,0,0,0,0.10214
101420,Burden of Evil,2012-04-22,2012,0,0,0,0.654759
101422,The Reincarnation of Peter Proud,1975-04-25,1975,0,0,0,0.914973
101444,The Hunters of the Golden Cobra,1982-08-11,1982,0,0,0,0.00022
101449,Jim Gaffigan: Mr. Universe,2012-04-11,2012,0,0,0,1.047845
101482,Lonesome,1928-06-20,1928,0,0,0,1.671902
101501,The Afflicted,2011-10-22,2011,180000,175742,-4258,0.437372
101503,Ali Baba Bunny,1957-02-09,1957,0,0,0,0.809105
101514,Quints,2000-08-18,2000,0,0,0,0.700412
101519,A Fantastic Fear of Everything,2012-06-07,2012,0,0,0,5.507377
101520,Reel Injun,2009-09-10,2009,0,0,0,0.673138
101538,The Gnomes' Great Adventure,1987-01-01,1987,0,0,0,0.377454
101553,Yankee,1966-08-25,1966,0,0,0,1.411467
101557,Westward the Women,1951-12-31,1951,0,0,0,1.074159
101566,Marathon,2002-10-15,2002,0,0,0,0.002354
101598,God Is My Co-Pilot,1945-04-07,1945,0,0,0,0.739619
101609,Pax Americana and the Weaponization of Space,2009-11-12,2009,0,0,0,0.062185
101652,Erotic Games in the Third Galaxy,1981-02-12,1981,0,0,0,0.00022
101653,The Magnificent Yankee,1950-12-20,1950,0,0,0,0.171711
101660,V,1983-05-01,1983,0,0,0,3.330159
101665,Hayabusa,2011-10-01,2011,0,0,0,0.060409
101669,Mother's Day,2010-09-23,2010,11000000,0,-11000000,5.165083
101715,Unguarded,2011-11-01,2011,0,0,0,0.061341
101724,Nailbiter,2013-05-28,2013,0,0,0,1.273737
101731,The Magic of Belle Isle,2012-07-06,2012,0,102388,102388,5.900375
101733,Zombie Ass: Toilet of the Dead,2011-09-24,2011,0,0,0,2.261585
101740,Inn of Evil,1971-09-11,1971,0,0,0,0.000498
101752,Tsumugi,2004-07-27,2004,0,0,0,0.461111
101766,A Barefoot Dream,2010-06-24,2010,0,0,0,0.791424
101772,The Last Chance,1945-11-27,1945,0,0,0,0.771458
101783,Zameen,2003-09-26,2003,0,0,0,0.362692
101791,Elfie Hopkins,2012-04-20,2012,0,0,0,1.134073
101801,Year of the Devil,2002-03-07,2002,0,0,0,0.329938
101803,Sam Peckinpah: Man of Iron,1993-06-29,1993,0,0,0,0.001021
101806,The Mad Doctor,1933-01-21,1933,0,0,0,1.85122
101818,Game Over,2006-02-24,2006,0,0,0,0.460863
101838,Game Over,2005-08-26,2005,0,0,0,0.209643
101852,Shuffle,2012-03-20,2012,500000,0,-500000,1.349308
101858,The Movies,1925-10-07,1925,0,0,0,0.003178
101860,Go Tigers!,2001-01-20,2001,0,0,0,0.03652
101887,Spinning Boris,2003-10-23,2003,0,0,0,0.209434
101897,Boris and Natasha,1992-04-17,1992,0,0,0,0.768828
101904,Through the Forest,2005-10-12,2005,0,0,0,0.312404
101908,Shanghai Dreams,2005-06-03,2005,0,0,0,0.334025
101915,Tess of the D'Urbervilles,2008-09-14,2008,0,0,0,1.783157
101916,"Live Once, Die Twice",2006-02-20,2006,0,0,0,0.374604
101917,Bluebird,2004-04-10,2004,0,0,0,0.039123
101929,Black River,1957-10-23,1957,0,0,0,0.524628
101956,El camino,2008-02-29,2008,0,0,0,0.195485
101965,Undo,1994-10-07,1994,0,0,0,0.975006
101968,An Insignificant Harvey,2011-10-07,2011,0,0,0,0.789767
101995,Inside,2012-04-13,2012,0,0,0,0.467011
101998,Foxfire,2012-09-24,2012,0,0,0,7.025918
102000,Sister,2012-02-13,2012,0,0,0,9.313199
102001,Like Someone in Love,2012-09-15,2012,0,0,0,3.015326
102016,Swimming Upstream,2002-01-01,2002,0,0,0,0.004189
102024,The Bridal Party in Hardanger,1926-12-26,1926,0,0,0,0.001223
102032,Nuremberg: Its Lesson for Today,1948-11-21,1948,0,0,0,0.00323
102038,Bombers B-52,1957-11-22,1957,0,0,0,0.943944
102039,Mock Up on Mu,2008-01-14,2008,0,0,0,0.107888
102041,Titanic: The Final Word with James Cameron,2012-04-08,2012,0,0,0,0.553871
102051,Unicorn City,2012-02-24,2012,0,0,0,1.495721
102053,Them Idiots: Whirled Tour,2012-03-12,2012,0,0,0,0.410033
102057,Divorce American Style,1967-06-21,1967,0,0,0,1.539648
102059,Collision Course,1988-04-22,1988,0,0,0,0.515425
102078,The Deep Six,1958-01-15,1958,0,0,0,0.71938
102081,The Key,1958-05-28,1958,0,0,0,2.029832
102091,Take the High Ground!,1953-10-30,1953,0,0,0,0.181525
102144,Mister 880,1950-09-29,1950,0,0,0,1.551932
102155,Hitler,1962-03-21,1962,0,0,0,0.986304
102161,Operation: Rabbit,1952-01-19,1952,0,0,0,0.288558
102165,The Mountain Road,1960-06-15,1960,0,0,0,0.223814
102195,Way Way Out,1966-10-26,1966,0,0,0,0.575961
102197,The Spy,2012-04-05,2012,6000000,4588176,-1411824,1.822246
102198,The Dive from Clausen's Pier,2005-07-25,2005,0,0,0,0.123866
102207,HOUBA! On the Trail of the Marsupilami,2012-04-03,2012,50000000,48600000,-1400000,10.409049
102222,The Philly Kid,2012-05-11,2012,5000000,0,-5000000,1.768855
102227,"Welcome Back, Mr. McDonald",1997-11-08,1997,0,0,0,1.186608
102234,Vares - The Path Of The Righteous Men,2012-01-06,2012,0,0,0,0.562559
102242,Something to Sing About,2000-06-10,2000,0,0,0,0.636558
102256,Marianne,2011-11-04,2011,0,0,0,0.084709
102272,The Sudden Wealth of the Poor People of Kombach,1971-04-14,1971,0,0,0,0.000308
102286,Fate Is the Hunter,1964-11-08,1964,0,0,0,1.640499
102288,Johnny Reno,1966-03-09,1966,0,0,0,0.289703
102289,Montana Belle,1952-11-07,1952,0,0,0,0.256382
102292,A Bottle in the Gaza Sea,2011-10-08,2011,0,0,0,1.083526
102295,Underwater!,1955-02-09,1955,3500000,0,-3500000,1.166809
102304,Whatever,1998-07-10,1998,0,0,0,0.291914
102305,August Evening,2007-06-21,2007,0,0,0,0.038979
102331,Vasermil,2007-10-25,2007,0,0,0,0.111595
102337,Summer in the Golden Valley,2003-04-16,2003,0,0,0,0.43338
102362,Dead Man Down,2013-03-08,2013,0,18074539,18074539,7.150388
102363,Bedouin,2011-01-01,2011,0,0,0,1.015759
102368,Iberia,2005-05-11,2005,0,0,0,0.266787
102382,The Amazing Spider-Man 2,2014-04-16,2014,200000000,705717432,505717432,26.23687
102384,Two Arabian Knights,1927-09-23,1927,0,0,0,0.38981
102406,Ill Gotten Gains,1997-12-05,1997,0,0,0,0.001178
102410,Fillmore,1972-06-14,1972,0,0,0,0.001133
102419,Hotel Reserve,1944-06-01,1944,0,0,0,0.955925
102420,A Cadaver Christmas,2011-04-02,2011,0,0,0,0.367626
102428,Salom√©,2002-11-22,2002,0,0,0,0.419337
102431,A Child's Christmas in Wales,1987-12-23,1987,0,0,0,0.002841
102444,Welcome to Blood City,1977-08-23,1977,0,0,0,0.298078
102461,A Single Girl,1995-05-29,1995,0,0,0,1.813577
102488,The Desperados,1969-02-28,1969,0,0,0,0.738382
102489,Alice and Martin,1998-10-23,1998,0,0,0,0.422789
102517,Sebastian Maniscalco: What's Wrong with People?,2012-01-05,2012,0,0,0,0.110506
102524,The Machine That Kills Bad People,1952-05-14,1952,0,0,0,0.332994
102526,White Cargo,1942-12-12,1942,0,0,0,0.375568
102527,44500 Max,2009-09-01,2009,0,0,0,0.04
102533,Stormy Weather,2003-09-07,2003,0,0,0,0.072955
102534,The Good Son,2011-03-25,2011,560000,0,-560000,0.219061
102541,The Patent Leather Kid,1927-09-01,1927,0,0,0,0.001402
102596,Follow Me: The Yoni Netanyahu Story,2012-05-18,2012,0,0,0,0.043642
102597,Big Leaguer,1953-08-19,1953,0,0,0,0.333192
102622,Classic Albums: Iron Maiden - The Number of the Beast,2001-12-04,2001,0,0,0,0.231819
102629,El Gringo,2012-05-10,2012,3000000,0,-3000000,3.9752
102630,Stash House,2012-05-11,2012,2000000,0,-2000000,2.391192
102632,Rowdy Rathore,2012-06-01,2012,6700000,31000000,24300000,1.312833
102639,Virginia,2010-05-18,2010,0,0,0,4.579336
102640,Union Square,2011-07-07,2011,0,0,0,0.375897
102651,Maleficent,2014-05-28,2014,180000000,758539785,578539785,19.467404
102668,Budz House,2011-10-25,2011,0,0,0,1.019489
102691,Bells from the Deep,1993-01-01,1993,517000,0,-517000,0.031002
102699,The Visitors,1972-02-02,1972,0,0,0,1.268148
102707,Domingo de carnaval,1945-10-22,1945,0,0,0,0.332315
102732,Little City,1997-04-04,1997,0,0,0,0.036814
102743,Gabi on the Roof in July,2010-02-27,2010,0,0,0,0.299291
102780,Byzantium,2012-09-09,2012,10000000,89237,-9910763,6.79497
102784,Two Rabbits,2012-01-20,2012,2000000,1620436,-379564,2.315249
102807,Carcasses,2009-08-25,2009,0,0,0,0.110592
102809,Disorder,2009-03-31,2009,0,0,0,0.16702
102812,FTA,1972-07-21,1972,0,0,0,0.9884
102814,The Beach Boys: An American Band,1985-11-22,1985,0,0,0,0.062098
102831,Chameleon Street,1989-05-01,1989,0,0,0,0.100464
102841,Rabbit Test,1978-04-09,1978,0,0,0,0.773488
102851,A Cube of Sugar,2012-02-29,2012,0,0,0,0.164875
102855,Don‚Äôt Stop Believin‚Äô: Everyman‚Äôs Journey,2013-03-16,2013,0,0,0,1.077671
102858,The Fourth Dimension,2012-06-27,2012,0,0,0,0.446731
102860,Found Memories,2011-09-02,2011,0,0,0,0.112679
102862,Informant,2013-09-13,2013,0,0,0,0.760774
102867,Only the Young,2012-05-01,2012,0,0,0,0.423216
102870,Unfair World,2012-02-02,2012,0,0,0,0.373164
102871,Summer Games,2011-09-01,2011,2000000,0,-2000000,0.804489
102873,¬°Vivan las Antipodas!,2011-11-05,2011,0,0,0,0.518148
102878,A Brother's Kiss,1997-04-25,1997,0,0,0,0.92491
102899,Ant-Man,2015-07-14,2015,130000000,519311965,389311965,26.882388
102901,Sighs of Spain,1939-10-16,1939,0,0,0,0.001263
102909,Joey,1997-12-26,1997,0,0,0,0.197417
102913,The Chasers,1959-08-24,1959,0,0,0,0.076157
102931,Silent Witness,2011-01-01,2011,0,0,0,0.929757
102933,Things Behind the Sun,2001-10-12,2001,0,0,0,0.480269
102935,War Don Don,2010-05-18,2010,0,0,0,0.006069
102938,Trackdown,1976-05-20,1976,0,0,0,0.748744
102947,First Daughter,1999-08-15,1999,0,0,0,0.617385
102949,Alive or Preferably Dead,1969-09-17,1969,0,0,0,0.351634
102959,Trinity and Sartana Are Coming,1972-05-30,1972,0,0,0,0.517359
102961,Seven,1979-09-07,1979,0,0,0,0.621895
103012,Lucky,2011-09-11,2011,0,0,0,0.41789
103014,'Twas the Night,2001-12-07,2001,0,0,0,0.982944
103048,China Gate,1998-11-27,1998,0,0,0,1.010084
103066,Any And Every Which Way,2010-02-27,2010,0,0,0,0.158873
103067,The Designated Victim,1971-04-22,1971,0,0,0,0.107642
103073,Ardh Satya,1983-08-19,1983,0,0,0,0.412037
103081,Cambridge Spies,2003-05-09,2003,0,0,0,0.402432
103119,Two Flags West,1950-10-12,1950,0,0,0,1.123451
103122,Desirable Teacher,1981-09-19,1981,0,0,0,1.983089
103161,Fake It So Real,2012-01-12,2012,0,0,0,0.18349
103162,Lenny Bruce: Swear to Tell the Truth,1998-10-21,1998,0,21350,21350,0.358968
103164,Copper Canyon,1950-11-15,1950,0,0,0,0.341571
103168,Apache Country,1952-05-30,1952,0,0,0,0.019403
103173,Dragon Age: Dawn of the Seeker,2012-02-11,2012,0,0,0,2.255852
103181,Sondheim! The Birthday Concert,2010-11-26,2010,0,0,0,0.120193
103194,Dinotasia,2012-05-04,2012,0,0,0,0.3246
103195,The Substance: Albert Hofmann's LSD,2011-11-17,2011,0,0,0,0.580576
103198,Unspeakable Acts,1990-01-15,1990,0,0,0,0.000603
103199,Tizoc,1956-06-15,1956,0,0,0,0.693274
103201,Extreme Justice,1993-01-01,1993,0,0,0,0.94439
103203,Camp de Thiaroye,1988-01-01,1988,0,0,0,0.351527
103205,I Thank a Fool,1962-09-14,1962,0,0,0,0.050135
103210,Fighting Back,1982-05-21,1982,0,0,0,0.812529
103212,Rakht,2004-09-22,2004,0,0,0,0.761261
103215,Anton Corbijn Inside Out,2012-03-22,2012,0,0,0,0.676956
103216,I picari,1987-01-01,1987,0,0,0,0.828636
103218,A Simple Story,1991-09-12,1991,0,0,0,0.000844
103236,Zanjeer,1973-05-11,1973,0,0,0,0.51255
103243,Vicky Donor,2012-04-20,2012,0,0,0,1.982419
103260,The Harlem Globetrotters on Gilligan's Island,1981-05-15,1981,0,0,0,0.708364
103269,Superman vs. The Elite,2012-06-12,2012,3500000,0,-3500000,6.247758
103299,Traces of Red,1992-11-13,1992,0,3206713,3206713,0.575656
103301,Babnik,1990-02-01,1990,0,0,0,0.032701
103307,My Seawoman,1990-06-01,1990,0,0,0,0.012313
103328,Holy Motors,2012-07-02,2012,0,641100,641100,7.34241
103332,Ruby Sparks,2012-07-25,2012,0,9128263,9128263,7.692815
103344,D√©pression et des Potes,2012-04-30,2012,0,0,0,1.217071
103370,Madea's Witness Protection,2012-06-29,2012,0,0,0,7.021866
103396,The Devil Strikes at Night,1957-09-19,1957,0,0,0,1.271944
103413,Second Best,1994-09-30,1994,0,0,0,0.882596
103425,The World According to Sesame Street,2006-05-21,2006,0,0,0,0.219281
103432,Outrage,1973-11-28,1973,0,0,0,0.109861
103433,Hillside Cannibals,2006-03-28,2006,0,0,0,0.230679
103462,Grandma Lo-Fi,2011-11-08,2011,0,0,0,0.017109
103475,The Soul of a Man,2003-05-16,2003,0,0,0,0.228235
103488,Encounter in the Third Dimension,1999-03-31,1999,0,0,0,0.060994
103489,All Access: Front Row. Backstage. Live!,2001-05-20,2001,0,0,0,0.001178
103502,Night #1,2011-10-12,2011,0,0,0,1.610014
103516,Private Romeo,2011-06-20,2011,0,0,0,1.690488
103528,God is the Bigger Elvis,2012-04-01,2012,0,0,0,0.151126
103539,Kelin,2009-06-26,2009,0,0,0,0.403549
103578,Prey,1977-10-05,1977,0,0,0,0.952106
103590,The Legend of Suram Fortress,1986-09-08,1986,0,0,0,0.394304
103597,Americano,2011-11-30,2011,0,0,0,1.616837
103601,Hollywood Vice Squad,1986-02-28,1986,0,0,0,0.097881
103612,Matilda,1978-06-22,1978,0,0,0,0.626222
103613,The Oldest Profession,1967-04-21,1967,0,119,119,0.98236
103620,Maniac,2012-12-26,2012,6000000,31081,-5968919,8.804658
103635,The Perfect Nanny,2000-03-15,2000,0,0,0,0.304519
103640,Ishaqzaade,2012-05-11,2012,0,0,0,1.196578
103648,Inherit the Wind,1999-05-29,1999,0,0,0,0.367253
103663,The Hunt,2012-08-28,2012,3800000,16800000,13000000,8.462801
103667,Murder by Proxy:  How America Went Postal,2010-01-01,2010,0,0,0,0.076587
103668,"The Strange History of Don't Ask, Don't Tell",2011-09-13,2011,0,0,0,0.053351
103675,Model by Day,1993-10-10,1993,0,0,0,0.219265
103678,Kiss Kiss... Bang Bang,1966-05-16,1966,0,0,0,0.70842
103686,Paradise: Love,2012-04-27,2012,3600000,24267,-3575733,4.645724
103688,Daydream Believers: The Monkees Story,2000-06-28,2000,0,0,0,0.07197
103689,Post Tenebras Lux,2012-11-22,2012,0,0,0,2.644964
103701,The Uncertainty Principle,2002-05-17,2002,0,0,0,0.187424
103706,Almost Angels,1962-09-26,1962,0,0,0,0.37851
103707,Afghan Luke,2011-09-23,2011,0,0,0,5.114346
103711,Charley and the Angel,1973-03-23,1973,0,0,0,0.18895
103713,Eminem AKA,2004-12-07,2004,0,0,0,0.388476
103717,You Ain't Seen Nothin' Yet,2012-09-01,2012,0,0,0,2.66364
103731,Mud,2013-05-01,2013,10000000,21587700,11587700,7.881579
103732,GLOW: The Story of the Gorgeous Ladies of Wrestling,2012-08-21,2012,33157,0,-33157,0.585551
103734,Herman's House,2012-10-12,2012,0,0,0,0.26625
103740,Beyond the Hills,2012-09-12,2012,0,124919,124919,4.750814
103742,In the Fog,2012-11-22,2012,0,0,0,1.951644
103745,Vesku,2010-09-03,2010,0,0,0,0.251178
103747,The Angels' Share,2012-06-01,2012,0,7034007,7034007,12.807728
103750,The Taste of Money,2012-05-17,2012,0,0,0,1.407309
103751,T√§√§ll√§ Pohjant√§hden alla II,2010-09-24,2010,0,0,0,0.555698
103753,In Another Country,2012-05-30,2012,0,0,0,2.576978
103758,Reality,2012-05-04,2012,0,0,0,2.890778
103785,Boats Out of Watermelon Rinds,2004-11-26,2004,0,0,0,0.567814
103793,Rosie,1998-11-18,1998,0,0,0,0.100686
103850,A Place Called Today,1972-06-15,1972,0,0,0,0.01575
103851,I Like to Hurt People,1985-06-01,1985,0,0,0,0.293125
103875,Mystery,2012-05-20,2012,0,0,0,1.422176
103894,Thieves by Law,2010-04-22,2010,0,0,0,0.171242
103902,Unfinished Sky,2007-08-04,2007,0,0,0,0.359818
103934,Too Young To Kiss,1951-11-22,1951,0,0,0,0.355166
103938,Today We Live,1933-03-03,1933,0,0,0,0.51328
103941,Embajadores en el infierno,1956-09-17,1956,0,0,0,0.223112
103947,3x3,2009-03-12,2009,0,0,0,0.285194
103953,Barren Illusion,1999-12-11,1999,0,0,0,0.059715
103960,Born American,1986-08-30,1986,0,0,0,0.286981
103970,Feeding Frenzy,2010-01-01,2010,0,0,0,0.582453
103971,Bloody Murder 2: Closing Camp,2003-02-18,2003,325000,0,-325000,1.261026
103972,Out of Bounds,2011-05-13,2011,0,0,0,0.623994
104041,Mousey,1974-05-24,1974,0,0,0,0.269864
104043,Old Enough,1984-08-24,1984,0,0,0,0.33517
104044,Roller Blade Warriors: Taken by Force,1989-04-28,1989,0,0,0,0.000823
104062,The Last Farm,2004-08-21,2004,0,0,0,0.385759
104067,America,1924-02-21,1924,0,0,0,0.013308
104081,The Lighthouse,1998-04-16,1998,0,0,0,0.090251
104083,Tulsa,1949-04-13,1949,0,0,0,0.91396
104086,The Man Who Sleeps,1974-04-24,1974,0,0,0,0.483924
104103,Portraits Chinois,1996-09-12,1996,0,0,0,0.127894
104106,The Disappearance of Garcia Lorca,1996-10-24,1996,0,0,0,0.728214
104108,The Craving,2008-01-01,2008,0,0,0,0.038949
104146,A Fish in the Bathtub,1999-03-01,1999,0,0,0,0.492555
104150,The Lottery,1996-09-29,1996,0,0,0,0.634148
104155,Mansome,2012-05-18,2012,0,0,0,2.345532
104171,"The Green, Green Grass of Home",1982-01-01,1982,0,0,0,0.217195
104172,Die letzte Rache,1982-11-04,1982,0,0,0,0.071004
104176,Voice of a Murderer,2007-02-01,2007,0,0,0,1.024488
104185,Alien Tornado,2012-04-21,2012,0,0,0,3.328685
104193,Boy,1969-07-26,1969,0,0,0,0.292384
104194,10+10,2011-04-01,2011,0,0,0,0.694146
104211,Berkeley Square,1933-09-15,1933,0,0,0,0.269518
104214,The Divine Lady,1929-03-31,1929,0,0,0,0.124298
104221,Emma,1932-01-02,1932,0,0,0,0.016421
104232,Nesting,2012-05-11,2012,0,0,0,0.185579
104237,Dragon Inn,1967-10-21,1967,0,0,0,2.31785
104239,Eden and After,1970-04-20,1970,0,0,0,1.143125
104241,Heroic Purgatory,1970-09-26,1970,0,0,0,0.213784
104242,I Will Walk Like a Crazy Horse,1973-11-22,1973,0,0,0,1.621611
104244,The Possessed,1965-07-01,1965,0,0,0,1.023733
104250,The Loving Story,2011-04-15,2011,0,0,0,1.213454
104251,Pastoral: To Die in the Country,1974-12-28,1974,0,0,0,1.703513
104259,The Big Heat,1988-09-22,1988,0,0,0,0.797537
104274,Blastfighter,1984-07-14,1984,0,0,0,1.313395
104275,"The Pit, the Pendulum and Hope",1984-01-01,1984,0,0,0,0.755721
104277,Blessing Bell,2003-11-22,2003,0,0,0,0.389411
104285,Desires,1977-01-01,1977,0,0,0,0.367558
104297,Scandalous John,1971-06-22,1971,0,0,0,0.002064
104301,The Good Mother,1988-11-04,1988,0,0,0,1.94247
104306,The Return of the Prodigal Son,1967-03-10,1967,0,0,0,0.947656
104308,The Spider Labyrinth,1988-08-25,1988,0,0,0,0.018017
104310,Oh! Blue Fish Island,1977-10-03,1977,0,0,0,0.180422
104317,The Woman Who Powders Herself,1972-01-01,1972,0,0,0,0.007223
104320,"Man, Woman and Beast",1977-01-01,1977,0,0,0,0.058556
104329,Last Passenger,2013-10-18,2013,0,0,0,7.872557
104334,Super Bitch,1973-03-05,1973,0,0,0,1.187098
104338,La belle captive,1983-02-16,1983,0,0,0,0.954204
104343,The Man Who Left His Will on Film,1970-06-27,1970,0,0,0,0.227914
104354,The Tree of Guernica,1975-01-01,1975,0,0,0,0.078182
104360,A White Dress for Marial√©,1972-11-30,1972,0,0,0,0.177013
104364,Nickelodeon,1976-12-21,1976,9000000,0,-9000000,0.832799
104374,Woman of the Lake,1966-08-27,1966,0,0,0,0.969826
104376,The Castle,1994-01-01,1994,0,0,0,0.69635
104378,A Study in Choreography for Camera,1945-12-18,1945,0,0,0,0.346655
104391,Darkened Room,2002-04-12,2002,0,0,0,0.944368
104394,Death of a Salesman,1951-12-20,1951,0,0,0,0.208379
104396,Dickson Experimental Sound Film,1894-08-31,1894,0,0,0,0.493914
104398,Dots,1940-01-01,1940,0,0,0,0.211812
104413,Screwball Hotel,1988-12-01,1988,0,0,0,0.051582
104427,The Affairs of Annabel,1938-09-09,1938,0,0,0,0.85685
104430,Noah's Ark,1928-11-01,1928,0,0,0,0.626515
104431,Kept and Dreamless,2005-06-06,2005,0,0,0,0.596184
104433,Old San Francisco,1927-09-04,1927,0,0,0,0.001321
104435,The Beehive,1982-10-11,1982,0,0,0,1.467886
104439,Raffles,1930-07-24,1930,0,0,0,1.507843
104449,A Perfect Couple,1979-04-06,1979,0,0,0,0.114628
104460,Playing Cards,1896-01-01,1896,0,0,0,0.325712
104462,A Terrible Night,1896-01-01,1896,0,0,0,1.017971
104465,Moonlight Whispers,1999-10-23,1999,0,0,0,0.381365
104466,The Vanishing Lady,1896-01-01,1896,0,0,0,0.788113
104469,A Nightmare,1896-01-01,1896,0,0,0,0.444257
104471,The Haunted Castle,1897-01-01,1897,0,0,0,0.791909
104473,The Surrender of Tournavos,1897-01-01,1897,0,0,0,0.471325
104474,Between Calais and Dover,1897-01-01,1897,0,0,0,0.250271
104476,The Bewitched Inn,1897-01-01,1897,0,0,0,0.235313
104477,After the Ball,1897-01-01,1897,0,0,0,0.782131
104480,"Divers at Work on the Wreck of the ""Maine""",1898-01-01,1898,0,0,0,0.250986
104485,The Four Feathers,1929-06-01,1929,0,0,0,0.415178
104505,No Rest for the Brave,2003-11-12,2003,0,0,0,0.212178
104513,Doug Stanhope: Before Turning the Gun on Himself,2012-03-12,2012,0,0,0,0.078867
104515,The Lord's Lantern in Budapest,1999-01-28,1999,0,0,0,0.142291
104522,My Love,2006-08-27,2006,0,0,0,0.921068
104524,Helter Skelter,2012-07-14,2012,0,0,0,3.530808
104528,Dogs,1976-11-11,1976,0,0,0,0.058682
104548,Demons,1971-02-13,1971,0,0,0,0.012236
104549,"Throw Away Your Books, Rally in the Streets",1971-04-24,1971,0,0,0,0.881483
104556,Annabel Takes a Tour,1938-11-10,1938,0,0,0,0.483098
104557,Doughboys,1930-08-30,1930,0,0,0,0.036897
104602,High Time,1960-09-16,1960,0,0,0,0.7348
104606,The Spiritual Boxer,1975-11-28,1975,0,0,0,0.45593
104607,Main Street,1956-10-26,1956,0,0,0,1.134103
104634,Angels of Sex,2012-05-04,2012,0,0,0,2.786267
104638,"Aqu√≠ llega Condemor, el pecador de la pradera",1996-06-27,1996,0,1705030,1705030,0.374
104644,A Reflection of Fear,1973-02-12,1973,0,0,0,0.04586
104659,A Small Circle of Friends,1980-03-12,1980,0,0,0,1.650613
104674,Bayou,1957-06-01,1957,0,0,0,0.563454
104694,Panorama pris d'un train en marche,1898-01-01,1898,0,0,0,0.179382
104696,The Famous Box Trick,1898-01-01,1898,0,0,0,0.076322
104697,Adventures of William Tell,1898-01-01,1898,0,0,0,0.357979
104700,The Astronomer's Dream,1898-01-01,1898,0,0,0,0.229221
104702,The Temptation of St. Anthony,1898-01-01,1898,0,0,0,0.493693
104704,The Devil in a Convent,1899-01-01,1899,0,0,0,0.55004
104709,Ghoul,2012-04-13,2012,0,0,0,0.33045
104710,Catastroika,2012-02-11,2012,0,0,0,0.721417
104711,Tom Sawyer,2011-11-17,2011,0,0,0,1.691429
104718,Other Worlds,2004-06-30,2004,0,0,0,0.76923
104720,Forever Amber,1947-10-10,1947,0,0,0,0.732319
104729,Midnight,1982-12-31,1982,0,0,0,0.127261
104732,Sexy Baby,2012-04-20,2012,0,0,0,0.270623
104739,From the East,1993-09-16,1993,0,0,0,0.164233
104744,Diary of a Shinjuku Thief,1969-02-15,1969,0,0,0,0.278203
104755,The Lords of Salem,2012-09-10,2012,1500000,1165882,-334118,9.981121
104776,Ana-ta-han,1953-06-28,1953,0,0,0,0.475386
104810,July Rain,1966-06-06,1966,0,0,0,0.425701
104848,The Forgotten Woman,2008-01-01,2008,0,0,0,0.003543
104852,Newark Athlete,1891-05-01,1891,0,0,0,0.806403
104858,Arirang,2011-05-13,2011,0,0,0,0.86294
104859,Mac & Devin Go to High School,2012-07-03,2012,0,0,0,4.137083
104863,Oh Dem Watermelons,1965-09-16,1965,0,0,0,0.10719
104866,Play Motel,1979-01-01,1979,0,0,0,0.224353
104871,Sicilia!,1999-09-15,1999,0,0,0,0.082011
104878,Trans,1998-09-11,1998,0,0,0,0.042209
104880,Shadows of Liberty,2012-04-27,2012,0,0,0,0.292859
104896,A Dog Of Flanders,1999-08-27,1999,0,0,0,0.513308
104927,The Third Eye,1966-06-11,1966,0,0,0,0.102133
104931,JLG/JLG: Self-Portrait in December,1995-03-08,1995,0,0,0,0.441965
104935,A Black Veil for Lisa,1968-08-11,1968,0,0,0,0.452131
104945,Without Knowing Anything About Her,1969-11-18,1969,0,0,0,0.001341
104954,"Anna: the Pleasure, the Torment",1973-11-27,1973,0,0,0,0.950951
104965,Bo Ba Bu,1998-01-01,1998,0,0,0,0.001223
104973,White Cannibal Queen,1980-09-15,1980,0,0,0,0.725614
104974,Captain Apache,1971-10-27,1971,0,0,0,1.018774
104989,The Sea Around Us,1953-06-30,1953,0,0,0,0.38837
104997,Rat King,2012-01-20,2012,0,0,0,0.933202
105001,Iceman,2014-04-17,2014,0,0,0,5.087694
105024,Stone Reader,2002-01-01,2002,0,0,0,0.41558
105033,The Sewers of Paradise,1979-03-14,1979,0,0,0,0.126553
105045,The Promise,1995-02-16,1995,0,0,0,0.122178
105045,The Promise,1995-02-16,1995,0,0,0,0.122178
105056,The Double Man,1967-04-25,1967,0,0,0,1.551225
105059,The Last Challenge,1967-12-22,1967,0,0,0,2.115803
105067,Monte Carlo,1930-08-27,1930,0,0,0,0.591217
105073,The Shadow Strikes,1937-10-29,1937,0,0,0,0.606175
105077,Battlestar Galactica: The Plan,2009-10-27,2009,0,0,0,6.190967
105078,Death Occurred Last Night,1970-09-04,1970,0,0,0,0.67037
105079,A Quiet Place to Kill,1970-02-20,1970,0,0,0,0.34105
105083,Il tuo dolce corpo da uccidere,1970-06-27,1970,0,0,0,0.000844
105085,Cold Eyes of Fear,1971-04-06,1971,0,0,0,0.47687
105087,Cross Current,1971-08-20,1971,0,0,0,0.131321
105093,Glass Ceiling,1971-05-03,1971,0,0,0,0.352005
105098,The Man with Icy Eyes,1971-04-10,1971,0,0,0,0.870134
105114,"So Sweet, So Dead",1972-07-18,1972,0,0,0,0.801926
105120,Who Killed the Prosecutor and Why?,1972-04-15,1972,0,0,0,0.117249
105121,Tchoupitoulas,2012-12-07,2012,0,0,0,0.48088
105130,Dangan Runner,1996-11-09,1996,0,0,0,0.451158
105133,Hard Luck Hero,2003-01-01,2003,0,0,0,0.494284
105136,Dead Run,2005-12-17,2005,0,0,0,0.105848
105145,The Flower with Petals of Steel,1973-11-13,1973,0,0,0,0.484404
105149,"My Wife, A Body to Love",1973-01-26,1973,0,0,0,0.001098
105153,Fencing,1892-01-01,1892,0,0,0,0.205474
105156,A Black Ribbon for Deborah,1974-09-01,1974,0,0,0,0.000354
105157,A Hand Shake,1892-01-01,1892,0,0,0,0.248422
105158,Edison Kinetoscopic Record of a Sneeze,1894-01-09,1894,0,0,0,0.312246
105168,Santa Claus,1898-09-01,1898,0,0,0,0.878122
105184,Trance,1982-06-04,1982,0,0,0,1.358396
105210,Thermae Romae,2012-04-28,2012,0,0,0,2.129707
105231,Fist of the North Star: The Legend of Kenshiro,2008-10-11,2008,0,0,0,1.069205
105232,"Clap, You're Dead",1974-01-01,1974,0,0,0,2e-06
105246,Basic Training,1985-11-01,1985,0,0,0,0.439659
105254,The Touch,1971-07-14,1971,6900000,6530000,-370000,0.659046
105287,Super 8 Stories,2001-10-10,2001,0,0,0,0.377525
105299,Siblings,2004-09-14,2004,500000,0,-500000,1.435388
105304,The Field of Enchantment,2011-12-19,2011,0,0,0,0.455067
105325,How to Hook Up Your Home Theater,2007-12-21,2007,0,0,0,2.325702
105347,How Tasty Was My Little Frenchman,1971-06-01,1971,0,0,0,1e-06
105348,A Report on the Party and the Guests,1966-12-30,1966,0,0,0,0.459359
105352,The Land Beyond the Sunset,1912-10-28,1912,0,0,0,0.173326
105371,Girls Rock!,2008-03-07,2008,0,0,0,0.00353
105384,Orders Signed in White,1974-11-13,1974,0,0,0,0.000284
105388,Every Second Counts,2009-01-01,2009,0,0,0,0.04
105398,Death Steps in the Dark,1977-02-17,1977,0,0,0,0.979431
105403,Blood and Diamonds,1977-01-01,1977,0,0,0,0.008134
105404,Garbo Talks,1984-10-12,1984,0,0,0,0.871504
105406,Who Was That Lady?,1960-04-15,1960,0,0,0,0.857156
105419,The Cuenca Crime,1980-02-01,1980,0,0,0,0.483662
105448,The Letter,1999-09-22,1999,0,0,0,0.348911
105454,How to Draw a Perfect Circle,2009-09-23,2009,0,0,0,1.635116
105465,The Art of Love,1965-06-30,1965,0,0,0,0.037318
105470,Immortal Love,1961-09-16,1961,0,0,0,0.223258
105503,The No Mercy Man,1973-01-01,1973,0,0,0,0.054685
105506,Grandmaster,2012-05-03,2012,120000,130000,10000,0.485424
105509,Angelina,1947-11-12,1947,0,0,0,1.325083
105526,Any Day Now,2012-12-14,2012,0,0,0,10.559109
105528,Cowgirls n' Angels,2012-05-25,2012,0,120680,120680,2.490032
105529,Down the Ancient Stairs,1975-01-01,1975,0,0,0,0.050841
105531,Jack & Diane,2012-11-02,2012,0,0,0,7.27853
105536,Sitting Bull,1954-10-06,1954,0,0,0,0.767732
105538,Codependent Lesbian Space Alien Seeks Same,2012-01-06,2012,0,0,0,0.681778
105539,The Salvation Hunters,1925-02-15,1925,0,0,0,0.249474
105548,Secrets,1933-03-16,1933,0,0,0,0.407266
105549,Maria Chapdelaine,1934-12-14,1934,0,0,0,0.002642
105551,"Swing High, Swing Low",1937-03-12,1937,0,0,0,0.354743
105554,The Forgotten Space,2010-12-31,2010,0,0,0,0.259098
105561,Patriocracy,2011-11-05,2011,0,0,0,0.126924
105567,The Union,2012-01-01,2012,0,0,0,0.355876
105572,Three Seats for the 26th,1988-11-23,1988,0,0,0,0.232116
105576,The Old Maid,1972-01-05,1972,0,0,0,1.364958
105583,Diaries Notes and Sketches,1969-12-01,1969,0,0,0,0.397825
105584,Peppermint Frappe,1967-10-09,1967,0,0,0,0.597655
105586,Shakespeare High,2012-03-09,2012,0,0,0,0.427762
105593,You Are Not I,1981-01-01,1981,0,0,0,0.037704
105616,In nome del popolo sovrano,1990-12-21,1990,0,0,0,0.022379
105627,The Joke,1969-02-28,1969,0,0,0,1.196003
105672,The Perfect Crime,1978-11-24,1978,0,0,0,0.001106
105676,Careless Love,2012-05-16,2012,0,0,0,0.085536
105678,God Save My Shoes,2012-03-30,2012,0,0,0,0.07686
105680,Love in the Buff,2012-03-30,2012,0,0,0,1.457016
105687,Heart of a Dog,1976-01-23,1976,0,0,0,0.19087
105693,The Suspect,1975-02-21,1975,0,0,0,0.1082
105702,Finding Truelove,2012-04-25,2012,0,0,0,0.008235
105703,The Boys from Fengkuei,1983-07-13,1983,0,0,0,0.080905
105711,Ritual in Transfigured Time,1946-01-01,1946,0,0,0,0.764136
105734,P & B,1983-12-10,1983,0,0,0,0.615923
105737,False as Water,1985-11-08,1985,0,0,0,0.160993
105757,Whity,1971-06-02,1971,0,0,0,0.989005
105759,The Black Hole,2008-01-01,2008,0,0,0,2.42106
105760,The Tribulations of Balthazar Kober,1988-12-26,1988,0,0,0,0.013577
105763,A Chef in Love,1996-06-06,1996,0,0,0,0.631834
105766,Musikanten,2006-03-03,2006,0,0,0,0.107696
105768,Flicka: Country Pride,2012-05-01,2012,0,0,0,1.578683
105770,The Bloody Olive,1997-04-01,1997,0,0,0,0.315143
105778,Edie & Thea: A Very Long Engagement,2009-06-21,2009,0,0,0,0.24747
105787,The Woman Who Wasn't There,2012-04-13,2012,0,0,0,0.76495
105789,Going Down in La-La Land,2011-05-01,2011,0,0,0,2.393033
105790,Booker's Place: A Mississippi Story,2012-04-27,2012,0,0,0,0.327944
105795,Joffrey: Mavericks of American Dance,2012-04-27,2012,0,0,0,0.00842
105829,The Wild East,1993-01-01,1993,0,0,0,1e-06
105833,Farewell to the Summer Light,1968-12-31,1968,0,0,0,0.210024
105843,"Goto, Island of Love",1969-09-01,1969,0,0,0,1.1084
105848,Street War,1976-01-01,1976,0,0,0,0.025145
105853,Violence for Kicks,1979-03-03,1979,0,0,0,0.073325
105859,Manhunt in the City,1975-08-05,1975,0,0,0,0.458266
105860,Gambling City,1975-01-23,1975,0,0,0,0.001435
105861,Last House in Istanbul,1974-01-01,1974,0,0,0,0.001113
105864,The Good Dinosaur,2015-11-14,2015,175000000,331926147,156926147,12.319595
105866,Libidomania,1979-01-01,1979,0,0,0,0.01401
105869,Mankillers,1987-11-03,1987,0,0,0,0.641417
105875,Cinderella,2002-08-06,2002,0,0,0,2.154873
105884,Ale e Franz - √à tanto che aspetti?,2002-12-31,2002,0,0,0,0.283765
105885,eCupid,2011-06-23,2011,0,0,0,1.809297
105891,Kawa,2010-10-17,2010,0,0,0,0.935171
105902,Craze,1974-05-15,1974,0,0,0,0.344707
105906,A Man Called Magnum,1977-08-07,1977,0,0,0,0.02553
105915,Lost in New York,1989-01-01,1989,0,0,0,0.003013
105942,ReGeneration,2010-05-24,2010,0,0,0,0.336324
105945,Memorial Day,2011-06-06,2011,4200000,0,-4200000,2.715787
105952,Huge,2010-06-18,2010,0,0,0,0.78636
105965,Beverly Hills Chihuahua 3 - Viva La Fiesta!,2012-09-03,2012,0,0,0,4.01161
105972,"OC87: The Obsessive Compulsive, Major Depression, Bipolar, Asperger's Movie",2012-05-25,2012,0,0,0,0.225695
105978,Neil Young Journeys,2012-06-29,2012,0,0,0,0.31064
105980,Dark Harbor,1999-12-31,1999,0,0,0,0.694388
105981,Lucky Star,1929-08-18,1929,0,0,0,1.333157
105983,Once Upon a Time in the North,2012-02-17,2012,0,0,0,0.817793
105989,Zombies: The Beginning,2007-05-01,2007,0,0,0,0.126624
105991,La Rizi√®re,2012-05-02,2012,0,0,0,0.008317
106006,Living with Michael Jackson: A Tonight Special,2003-02-06,2003,0,0,0,0.282701
106016,My Forbidden Past,1951-04-25,1951,0,0,0,0.97482
106017,The Angry Hills,1959-07-29,1959,0,0,0,0.655088
106020,Dr. Crippen,1964-02-14,1964,0,0,0,0.691282
106021,Erased,2012-09-27,2012,12000000,0,-12000000,9.329974
106028,Summer School,2006-10-05,2006,0,0,0,0.154578
106042,Rumble on the Docks,1956-12-01,1956,0,0,0,0.633906
106049,The Revisionaries,2012-04-21,2012,0,0,0,0.296815
106070,Zarkorr! The Invader,1996-04-30,1996,0,0,0,0.648666
106112,Flowers and Trees,1932-07-30,1932,15887,0,-15887,0.953016
106113,Don't Tell the Wife,1937-03-05,1937,0,0,0,0.411159
106124,Pearls of the Deep,1966-01-06,1966,0,0,0,0.179625
106129,Sudden Manhattan,1996-10-11,1996,0,0,0,0.344303
106131,I'll Take You There,1999-09-03,1999,0,0,0,0.05342
106134,Meanwhile,2011-11-29,2011,0,0,0,0.394111
106135,Crooked Arrows,2012-05-18,2012,13000000,1832541,-11167459,5.138409
106136,From Above,2014-02-03,2014,0,0,0,0.371546
106139,Convoy Busters,1978-12-23,1978,0,0,0,0.130991
106143,I'll Do Anything,1994-02-04,1994,40000000,0,-40000000,1.742974
106155,A Special Cop in Action,1976-11-27,1976,0,0,0,0.494893
106176,The Twelve Chairs,1962-12-17,1962,0,0,0,1.273735
106194,Bergman Island,2004-04-08,2004,0,0,0,0.143609
106196,Water-mirror of Granada,1955-01-01,1955,0,0,0,0.310877
106199,As√≠ es la vida...,2000-09-14,2000,0,0,0,0.785386
106219,Ticket of No Return,1979-11-09,1979,0,0,0,0.001182
106222,Pizza,2005-05-27,2005,0,0,0,1.061041
106224,The Inheritance,1976-10-21,1976,0,0,0,1.305989
106230,The Iron Ladies,2000-03-04,2000,0,0,0,0.290354
106254,The End of St. Petersburg,1927-12-13,1927,0,0,0,0.378451
106256,Sogni mostruosamente proibiti,1982-10-29,1982,0,0,0,0.271706
106259,The Fall of Berlin,1949-12-25,1949,0,0,0,0.066657
106263,National Lampoon's Attack of the 5 Ft. 2 Women,1994-09-08,1994,0,0,0,0.015298
106268,Breaking Point,1975-10-12,1975,0,0,0,0.158148
106280,Dark Tower,1989-03-29,1989,0,0,0,0.881779
106326,The Adventurers,1970-03-25,1970,0,0,0,0.756085
106337,Free Samples,2012-05-20,2012,0,0,0,1.891224
106344,Waiting for Lightning,2012-12-07,2012,0,0,0,0.739621
106348,Encounter at Raven's Gate,1988-12-01,1988,0,0,0,0.05143
106355,Captain America,1944-02-05,1944,0,0,0,1.591726
106358,Atom Man vs Superman,1950-07-20,1950,0,0,0,0.653664
106373,"That Day, on the Beach",1983-04-11,1983,0,0,0,0.076776
106388,As You Like It,1978-12-17,1978,0,0,0,0.11859
106394,The Fall of the House of Usher,1928-12-31,1928,0,0,0,0.338722
106402,The Severed Arm,1973-01-01,1973,0,0,0,0.505854
106406,Adam Had Four Sons,1941-03-27,1941,0,0,0,0.186787
106414,We Were Once a Fairytale,2008-06-17,2008,0,0,0,0.014741
106417,Kaiji 2: The Ultimate Gambler,2011-11-05,2011,0,15,15,1.13376
106446,Anything You Want,2010-09-10,2010,0,0,0,0.538857
106482,Pyrates,1991-12-18,1991,0,0,0,0.375724
106495,Little Big Shot,1935-09-07,1935,0,0,0,0.303469
106513,The Payoff,1942-11-24,1942,0,0,0,0.532798
106515,Ali Baba Goes To Town,1937-10-29,1937,0,0,0,0.496835
106537,Michael Jackson: Life of a Superstar,2008-12-31,2008,0,0,0,0.004706
106538,Un amour de femme,2001-01-01,2001,0,0,0,0.620213
106541,Cargo,2011-10-17,2011,0,0,0,1.09906
106546,Moscow Heat,2004-11-24,2004,0,1100000,1100000,1.123409
106573,Man of the World,1931-03-28,1931,0,0,0,0.536697
106591,Portrait of Wally,2012-05-11,2012,0,0,0,0.056598
106599,Imaginary Witness: Hollywood and the Holocaust,2004-01-01,2004,0,0,0,0.911984
106605,Kept Husbands,1931-02-22,1931,0,0,0,0.122458
106618,A Day in the Death of Joe Egg,1972-01-01,1972,0,0,0,0.945657
106622,"Blood, Sweat and Fear",1975-08-01,1975,0,0,0,0.2875
106623,Mark Shoots First,1975-12-22,1975,0,0,0,0.021225
106629,"Alfie, the Little Werewolf",2011-11-30,2011,0,0,0,1.53068
106635,It's Love I'm After,1937-11-20,1937,0,0,0,1.328313
106646,The Wolf of Wall Street,2013-12-25,2013,100000000,392000694,292000694,16.382422
106669,Never Travel on a One Way Ticket,1987-10-27,1987,0,0,0,0.000615
106671,Russian Symphony,1994-01-01,1994,0,0,0,0.148918
106679,House of Mortal Sin,1976-02-03,1976,0,0,0,0.561082
106682,The Comeback,1978-06-16,1978,0,0,0,0.253987
106685,Paris by Night,2012-01-03,2012,0,0,0,1.414594
106717,The Last Will and Testament of Rosalind Leigh,2012-11-09,2012,0,0,0,3.088085
106729,Natural Enemies,1979-11-01,1979,0,0,0,0.151357
106739,Low & Clear,2012-03-01,2012,0,0,0,0.091564
106742,Stolen Death,1938-01-01,1938,0,0,0,0.051519
106747,Machete Kills,2013-09-12,2013,12000000,15008161,3008161,9.251084
106807,The Fat and Lean Wrestling Match,1900-01-01,1900,0,0,0,0.225432
106813,Bonhoeffer: Agent of Grace,2000-06-14,2000,0,0,0,0.502653
106821,Four Jills in a Jeep,1944-03-17,1944,0,0,0,0.195853
106824,"Bomba, the Jungle Boy",1949-03-20,1949,0,0,0,0.492394
106825,Mother Wore Tights,1947-08-20,1947,0,0,0,0.025641
106826,Pillow to Post,1945-06-09,1945,0,0,0,0.425814
106828,Evidence,1995-10-02,1995,0,0,0,0.143966
106833,April Love,1957-11-27,1957,0,0,0,0.310517
106837,Different for Girls,1996-10-01,1996,0,0,0,0.533219
106845,Re-Kill,2015-10-16,2015,9500000,0,-9500000,11.860106
106848,Hamlet,1980-05-25,1980,0,0,0,0.48737
106849,Henry IV Part 1,1979-12-09,1979,0,0,0,0.0339
106851,Henry IV Part 2,1979-12-16,1979,0,0,0,0.061085
106876,The Black Panther,1977-12-26,1977,0,0,0,0.705454
106882,Kitty,1945-10-16,1945,0,0,0,0.986394
106887,The Green Wall,1970-04-04,1970,0,0,0,0.106034
106922,The incredible Paris Incident,1967-03-24,1967,0,0,0,0.28884
106938,Neverland,2011-12-03,2011,0,0,0,7.999749
106944,A Complicated Girl,1969-02-07,1969,0,0,0,0.023384
106968,The Road Killers,1994-05-07,1994,0,0,0,1.080956
106970,Stunt Squad,1977-07-27,1977,0,0,0,0.000844
107019,The Strange Vengeance of Rosalie,1972-06-16,1972,0,0,0,0.000431
107028,Green Ice,1981-05-01,1981,0,0,0,0.999876
107034,San Babila-8 P.M.,1976-05-26,1976,0,0,0,2.4e-05
107035,Chronicle of Poor Lovers,1954-09-15,1954,0,0,0,0.558461
107039,The Road To Love,2001-01-01,2001,0,0,0,0.328977
107052,Caf√® Express,1981-02-25,1981,0,0,0,1.073156
107056,The Dancing Hawk,1978-01-20,1978,0,0,0,4e-06
107068,The Sinful Nuns of Saint Valentine,1974-03-26,1974,0,0,0,1.31119
107073,The Prize,2011-02-15,2011,0,0,0,0.175473
107076,A Hill in Korea,1956-09-18,1956,0,0,0,1.289579
107081,I due della legione,1962-08-16,1962,0,0,0,0.052494
107096,Nemesis 3: Time Lapse,1996-06-18,1996,0,0,0,0.781245
107100,Seattle Superstorm,2012-03-31,2012,0,0,0,10.049661
107104,Beyond the Rising Moon,1988-05-14,1988,0,0,0,0.136234
107146,The Sell Out,1976-05-01,1976,0,0,0,0.076324
107170,Ghost Recon: Alpha,2012-05-03,2012,0,0,0,3.036216
107184,Kriminal,1966-12-23,1966,0,0,0,0.054221
107193,Three Supermen in the Jungle,1970-02-27,1970,0,0,0,0.003931
107203,Xingu,2012-04-06,2012,0,0,0,0.388045
107231,A Ticklish Affair,1963-08-18,1963,0,0,0,0.096838
107235,Architecture 101,2012-03-22,2012,0,0,0,2.52509
107239,Brothers O'Toole,1973-05-16,1973,0,0,0,9.1e-05
107246,Exposed,1983-04-22,1983,0,0,0,0.89857
107248,The Love Eterne,1963-04-02,1963,0,0,0,0.499419
107250,The Wandering Soul Murders,2001-01-09,2001,0,0,0,0.419783
107255,A Night for Dying Tigers,2010-09-10,2010,0,0,0,0.508032
107257,A Perfect Ending,2012-06-01,2012,0,0,0,6.056447
107262,A Real American Hero,1978-12-09,1978,0,0,0,0.334461
107282,Savages,1972-06-27,1972,0,0,0,0.417636
107287,Anna and the Wolves,1973-06-04,1973,0,0,0,0.019442
107308,The Golden Bat,1966-12-21,1966,0,0,0,0.019442
107311,Crackerjack,1994-08-18,1994,0,0,0,0.963647
107315,Below Zero,2011-10-22,2011,0,0,0,0.814039
107319,Wheels of Fire,1985-04-11,1985,0,0,0,1.08232
107321,Crossplot,1969-11-25,1969,0,0,0,0.855047
107327,Figures in a Landscape,1970-11-21,1970,0,0,0,0.758901
107352,Sweet Revenge,1987-02-06,1987,0,0,0,0.890514
107355,The Kidnapping Of The President,1980-08-15,1980,0,0,0,0.035914
107357,The Man Who Wouldn't Die,1994-06-13,1994,0,0,0,0.414859
107391,L'ange,1982-05-25,1982,0,0,0,0.017815
107393,Last Images of the Shipwreck,1989-09-09,1989,0,0,0,0.080751
107406,Oscenit√†,1980-02-14,1980,0,0,0,0.335692
107412,Silk,1986-12-01,1986,0,0,0,0.108872
107413,Snake Woman's Curse,1968-07-12,1968,0,0,0,0.037007
107420,The Sisterhood,1988-01-01,1988,0,0,0,0.449565
107426,Julio Begins in July,1979-12-01,1979,0,0,0,0.006964
107427,Drums Across the River,1954-06-01,1954,0,0,0,1.018422
107430,Full Moon High,1981-01-01,1981,0,0,0,0.462469
107443,The Brave One,1956-10-26,1956,0,0,0,0.745793
107445,Lost in Siberia,2012-05-10,2012,0,0,0,0.754398
107499,A Better Place,1997-09-01,1997,0,0,0,0.33244
107525,Saippuaprinssi,2006-02-10,2006,1300000,0,-1300000,0.006996
107548,Chori Chori Chupke Chupke,2001-03-09,2001,0,0,0,0.628061
107569,Memories of Me,1988-09-28,1988,0,0,0,0.849883
107587,The Day Silence Died,1999-07-02,1999,0,0,0,0.073531
107592,The Catered Affair,1956-06-14,1956,0,0,0,1.58171
107593,June Bride,1948-10-29,1948,0,0,0,0.642986
107596,Halloween with the New Addams Family,1977-10-31,1977,0,0,0,0.147783
107605,Bloodfist 2050,2005-08-04,2005,0,0,0,0.547756
107612,The Rocket from Calabuch,1956-09-28,1956,0,0,0,0.235894
107625,The Proud Ones,1956-05-15,1956,0,0,0,0.5407
107637,If You Were Young: Rage,1970-01-01,1970,0,0,0,0.151684
107641,Onimasa: A Japanese Godfather,1982-06-05,1982,0,0,0,0.662763
107643,Bloody Territories,1969-07-26,1969,0,0,0,0.437567
107667,Family,1996-10-01,1996,0,0,0,0.452189
107682,"C'est La Vie, Mon Cheri",1993-11-11,1993,0,0,0,0.818623
107693,Abraham's Valley,1993-09-01,1993,0,0,0,0.306179
107705,Byelorussian Station,1971-04-30,1971,0,0,0,0.289674
107743,Wedding Bell Blues,1996-10-18,1996,0,44000,44000,0.886134
107745,Saajan,1991-08-30,1991,0,0,0,0.037689
107753,Collaborator,2011-10-08,2011,0,0,0,0.218838
107767,I Am a Nymphomaniac,1971-08-11,1971,0,0,0,0.746856
107774,Pete 'n' Tillie,1972-12-17,1972,0,0,0,0.605685
107775,The Orheim Company,2012-03-02,2012,3500000,0,-3500000,1.03949
107781,The Club,1994-06-01,1994,0,0,0,0.573367
107808,The Yankles,2009-11-15,2009,0,0,0,0.087077
107811,21 & Over,2013-03-01,2013,13000000,48065672,35065672,11.29356
107812,Lovers and Liars,1979-04-24,1979,0,0,0,0.0779
107828,The Dragon Missile,1976-04-24,1976,0,0,0,0.52349
107846,Escape Plan,2013-10-09,2013,50000000,122915111,72915111,14.191611
107852,√áa br√ªle,2006-08-16,2006,0,0,0,0.004805
107874,Escape Me Never,1947-11-07,1947,0,0,0,0.340375
107876,Private Worlds,1935-04-19,1935,0,0,0,0.003137
107891,Ambush,1973-01-05,1973,0,0,0,0.566999
107916,Carmina or Blow Up,2012-07-05,2012,0,0,0,1.345369
107928,Gold of Rome,1961-11-26,1961,0,0,0,0.143037
107937,Bhoot,2003-05-30,2003,0,0,0,0.632239
107942,Swimming,2000-03-09,2000,0,0,0,0.269612
107946,Harvest,1999-01-09,1999,0,0,0,0.00118
107966,Loose in London,1953-05-24,1953,0,0,0,0.058772
107973,The Dolly Sisters,1945-11-14,1945,0,0,0,0.947421
107976,Black House,2007-06-21,2007,0,0,0,1.868427
107978,Cockpit,2012-07-13,2012,0,0,0,0.618969
107983,Golem,1980-03-18,1980,0,0,0,0.883965
107985,The World's End,2013-07-18,2013,20000000,46089287,26089287,9.830382
107999,The Bride Goes Wild,1948-03-03,1948,0,0,0,0.107722
108003,Call Me Bwana,1963-06-14,1963,0,0,0,0.094405
108010,Campus Rhythm,1943-11-19,1943,0,0,0,0.602071
108012,Caroline?,1990-04-29,1990,0,0,0,0.071971
108017,A Man There Was,1917-01-29,1917,0,0,0,1.322761
108021,A Dangerous Woman,1993-09-10,1993,0,0,0,3.491156
108048,"Gwen, the Book of Sand",1985-02-06,1985,0,0,0,0.075033
108055,Hallelujah I'm a Bum,1933-02-03,1933,0,0,0,0.511273
108059,City Limits,1984-01-01,1984,0,0,0,0.441135
108063,Atomic War Bride,1960-07-23,1960,0,0,0,0.111429
108147,Rise of the Animals,2012-05-01,2012,7000,0,-7000,0.204438
108155,The Love Trap,1929-08-04,1929,0,0,0,0.003304
108176,Daniel Tosh: Completely Serious,2007-06-17,2007,0,0,0,1.209576
108177,Demetri Martin. Person.,2007-01-14,2007,0,0,0,0.930462
108179,The Seed of Man,1969-01-01,1969,0,0,0,0.145102
108181,The Beast of Hollow Mountain,1956-08-01,1956,0,0,0,0.551855
108200,The Doctor Takes a Wife,1940-04-25,1940,0,0,0,0.559264
108204,Double Teamed,2002-01-18,2002,0,0,0,1.762558
108209,Kid Millions,1934-11-10,1934,0,0,0,0.160727
108213,King of Jazz,1930-04-20,1930,0,0,0,0.124659
108220,Star Spangled Rhythm,1942-03-05,1942,0,0,0,0.538301
108222,Tin Pan Alley,1940-11-29,1940,0,0,0,0.107838
108224,Whoopee!,1930-10-05,1930,0,0,0,0.235125
108227,The Face on the Milk Carton,1995-05-24,1995,0,0,0,1.286653
108228,A Fare to Remember,1999-03-11,1999,0,0,0,0.541818
108232,The Mating Season,1951-01-12,1951,0,0,0,2.227932
108235,Finding a Family,2011-10-15,2011,0,0,0,0.731987
108241,Next of Kin,1984-11-30,1984,0,0,0,1.046297
108246,Forty Little Mothers,1940-04-26,1940,0,0,0,0.205958
108251,Girl Fight,2011-10-03,2011,0,0,0,0.589503
108256,Good Sam,1948-09-01,1948,0,0,0,0.407785
108259,The Love She Sought,1990-10-21,1990,0,0,0,0.114537
108266,The Lone Ranger,1956-02-25,1956,0,0,0,0.889869
108267,The Lone Ranger and the Lost City of Gold,1958-01-01,1958,0,0,0,1.037915
108282,Murder on Flight 502,1975-11-21,1975,0,0,0,0.054559
108309,Portraits in a Sea of Lies,2010-05-21,2010,0,0,0,0.058236
108312,Native Son,1986-12-24,1986,2000000,1301121,-698879,0.910047
108316,The Alarmist,1998-10-23,1998,0,0,0,0.41735
108322,Tracks,1977-04-01,1977,0,0,0,0.761279
108331,The Good Herbs,2010-08-20,2010,0,0,0,0.567931
108345,The Command,1954-02-13,1954,0,0,0,0.552616
108346,Dreaming of Joseph Lees,1999-10-29,1999,2000000,7,-1999993,1.241349
108348,A Woman Rebels,1936-11-06,1936,0,0,0,0.34544
108353,How to Commit Marriage,1969-07-07,1969,0,0,0,0.295447
108365,The Proprietor,1996-09-09,1996,0,0,0,0.4319
108391,Stranger in My House,1999-01-01,1999,0,0,0,0.764271
108401,Star Maps,1997-07-23,1997,0,0,0,0.725694
108419,Empire,1964-08-02,1964,0,0,0,0.789978
108432,Sherlock Holmes and the Leading Lady,1991-12-06,1991,0,0,0,1.445692
108437,Tre colonne in cronaca,1990-03-09,1990,0,0,0,0.330152
108476,Trashed,2012-12-13,2012,0,0,0,0.914561
108497,Autumn Tale,2000-09-18,2000,0,0,0,0.106275
108501,Parole Violators,1994-01-01,1994,0,0,0,0.038981
108512,Three Resurrected Drunkards,1968-03-30,1968,0,0,0,0.664592
108523,Children of the Dark,2008-08-02,2008,0,0,0,0.567778
108535,Roma bene,1971-10-08,1971,0,0,0,0.294364
108540,Bill W.,2012-05-18,2012,0,0,0,0.04353
108548,Voyage to the Beginning of the World,1997-05-05,1997,0,0,0,1.536254
108553,Sibling Rivalry,1990-10-26,1990,0,0,0,1.243129
108564,Saint Joan,1957-05-08,1957,0,0,0,0.814008
108573,Svampe,1990-12-26,1990,0,0,0,3.3e-05
108574,A Child in the Crowd,1976-06-04,1976,0,0,0,0.20256
108582,Go Man Go,1954-01-27,1954,0,0,0,0.139958
108586,A Bunny's Tale,1985-02-25,1985,0,0,0,0.049482
108614,The Seminarian,2010-01-01,2010,0,0,0,0.992405
108632,The Show,1927-01-22,1927,0,0,0,0.380738
108634,Typhoon Club,1985-08-31,1985,0,0,0,0.89391
108636,Blue,2003-02-07,2003,0,0,0,0.088669
108639,Blush,2005-12-07,2005,0,0,0,0.122913
108646,Blowfish,2011-08-05,2011,0,0,0,0.092584
108648,The Bride from Hades,1968-06-15,1968,0,0,0,0.076951
108664,Isole,2011-05-10,2011,0,0,0,0.061275
108665,The Master,1980-05-23,1980,0,0,0,0.609531
108668,The Adventures of Hajji Baba,1954-10-01,1954,0,0,0,0.971048
108677,Frank Capra's American Dream,1997-01-01,1997,0,0,0,0.315744
108688,Cass Timberlane,1947-11-06,1947,0,0,0,0.19886
108705,Acla's Descent into Floristella,1992-09-10,1992,0,0,0,0.510588
108712,I Remember,2005-12-01,2005,0,0,0,0.362092
108716,In Cold Blood,1996-11-24,1996,0,0,0,1.593609
108723,Face-Off,1971-11-12,1971,600,0,-600,0.423668
108726,A Common Man,2013-06-30,2013,0,0,0,3.206962
108762,Life for Sale,2011-10-21,2011,0,0,0,0.369774
108788,Out of Mind: The Stories of H.P. Lovecraft,1998-01-01,1998,0,0,0,0.03652
108789,Hate Thy Neighbor,1968-07-26,1968,0,0,0,0.17341
108794,Sharpe's Revenge,1997-05-07,1997,0,0,0,1.638428
108798,The Haunted Castle,1969-12-20,1969,0,0,0,0.489269
108812,Until They Sail,1957-10-08,1957,0,0,0,0.906872
108822,Night and Day,1991-08-28,1991,0,0,0,1e-06
108827,Mirage,2004-09-11,2004,0,0,0,0.211851
108835,Labyrinth,2002-08-26,2002,0,0,0,0.225217
108843,Our Vines Have Tender Grapes,1945-09-06,1945,0,0,0,0.471653
108844,The Winning Team,1952-06-20,1952,0,0,0,0.424595
108852,The Youngest Profession,1943-02-26,1943,0,0,0,0.929373
108869,Toys in the Attic,1963-07-31,1963,0,0,0,0.925414
108879,Louis Theroux: Extreme Love - Autism,2012-04-19,2012,0,0,0,0.394282
108901,Terry Pratchett: Choosing to Die,2011-06-13,2011,0,0,0,0.112945
108917,Vito,2011-10-14,2011,0,0,0,0.676437
108923,The Mysterious Lady,1928-08-04,1928,337,551,214,0.76593
108930,Jim Gaffigan: Beyond the Pale,2006-02-07,2006,0,0,0,0.941286
108933,The Sleeping Car,1990-02-02,1990,0,0,0,0.582357
108949,Insiang,1976-12-25,1976,0,0,0,2.347695
108969,Winter People,1989-04-14,1989,0,0,0,1.301211
108972,Helpless,2012-03-08,2012,0,0,0,2.160501
108994,Green Dolphin Street,1947-11-05,1947,0,0,0,0.210988
109001,Shiva,1990-12-07,1990,0,0,0,0.331751
109008,Escape,1940-11-01,1940,0,0,0,0.319927
109016,Back Street,1941-02-07,1941,0,0,0,0.075713
109018,Athena,1954-11-04,1954,0,0,0,0.082134
109020,Rough Shoot,1953-05-15,1953,0,0,0,0.087975
109028,Mohra,1994-07-01,1994,0,0,0,0.798869
109048,Transistor Love Story,2001-12-28,2001,0,0,0,0.842766
109074,Day of the Reaper,1984-10-31,1984,0,0,0,8e-05
109080,Fist of the North Star: Legend of Raoh - Chapter of Death in Love,2006-03-11,2006,0,862,862,1.511957
109088,The Shaolin Avengers,1976-06-18,1976,0,0,0,1.181126
109091,The Counselor,2013-10-25,2013,25000000,71009334,46009334,14.723646
109097,Teen-Age Strangler,1964-01-01,1964,0,0,0,0.14085
109099,Passion,2012-09-07,2012,30000000,0,-30000000,10.260026
109102,Picture Mommy Dead,1966-11-02,1966,0,0,0,0.550792
109109,Horror Island,1941-03-28,1941,0,0,0,1.218141
109122,Night of the Blood Beast,1958-08-01,1958,0,0,0,0.821709
109133,The Cabinet of Caligari,1962-05-25,1962,0,0,0,0.630494
109161,The Squeeze,1987-07-10,1987,0,2228951,2228951,1.478446
109170,The Facts of Life Reunion,2001-11-18,2001,0,0,0,0.026809
109174,Silent Predators,1999-06-13,1999,0,0,0,0.823598
109175,Summer of the Monkeys,1998-10-30,1998,0,0,0,0.402235
109176,The Jungle Book: Mowgli's Story,1998-01-01,1998,0,0,0,1.339009
109213,The Zero Boys,1986-01-01,1986,0,0,0,1.176132
109235,The Kid from Brooklyn,1946-03-21,1946,0,0,0,0.430717
109251,The Promise,1979-03-08,1979,0,0,0,0.217476
109258,Bright Victory,1951-07-31,1951,0,0,0,0.457335
109259,Blume In Love,1973-06-17,1973,0,0,0,0.322993
109260,Journey to Portugal,2011-06-16,2011,0,0,0,0.042926
109261,On Air,2012-01-11,2012,0,0,0,1.212447
109262,Tiger Shark,1932-09-24,1932,0,0,0,1.350072
109264,This Is Elvis,1981-04-04,1981,5000000,2028612,-2971388,0.303062
109279,Hearts and Armour,1983-09-21,1983,0,0,0,0.407523
109298,The Big Bad Wolf,1934-04-14,1934,27878,0,-27878,1.323564
109301,Music Land,1935-10-05,1935,35055,0,-35055,0.717188
109323,Who Killed Cock Robin?,1935-06-28,1935,27715,0,-27715,0.430847
109326,X-Games The Movie,2009-08-21,2009,0,0,0,0.011836
109329,Three Little Wolves,1936-04-18,1936,0,0,0,0.635025
109354,The Kopeck,2002-06-07,2002,0,0,0,0.681085
109364,Guernica,1950-01-01,1950,0,0,0,0.43357
109379,The Peach Thief,1964-11-09,1964,0,0,0,0.193585
109380,‚Ä¶And the Fifth Horseman Is Fear,1965-02-12,1965,0,0,0,0.147002
109391,The We and the I,2012-09-12,2012,0,0,0,2.409066
109398,Our Trip to Africa,1966-01-01,1966,0,0,0,0.299673
109404,8,2012-03-03,2012,0,0,0,1.758414
109408,Nocturne,1980-01-01,1980,0,0,0,0.003108
109410,42,2013-04-12,2013,40000000,95020213,55020213,11.637224
109414,This Is the End,2013-06-12,2013,32000000,126041322,94041322,11.414048
109416,30 Beats,2012-07-20,2012,0,0,0,0.813846
109417,Battle of the Year,2013-09-21,2013,20000000,16549477,-3450523,5.0739
109418,Grown Ups 2,2013-07-11,2013,80000000,246984278,166984278,9.411725
109421,Side Effects,2013-02-07,2013,30000000,63372757,33372757,11.645847
109424,Captain Phillips,2013-10-10,2013,55000000,95000000,40000000,13.776068
109425,Blood Games,1990-12-12,1990,0,0,0,0.151671
109428,Evil Dead,2013-04-05,2013,17000000,97542952,80542952,12.01525
109431,Identity Thief,2013-02-07,2013,35000000,173965010,138965010,7.321172
109435,Street Scene,1931-09-05,1931,584000,0,-584000,0.533219
109439,The Hangover Part III,2013-05-23,2013,103000000,362000072,259000072,25.085639
109441,Don't Go Near the Water,1957-12-14,1957,0,0,0,0.365957
109443,Anchorman 2: The Legend Continues,2013-12-18,2013,50000000,173649015,123649015,7.600751
109445,Frozen,2013-11-27,2013,150000000,1274219009,1124219009,24.248243
109451,Cloudy with a Chance of Meatballs 2,2013-09-26,2013,78000000,248384621,170384621,14.412061
109453,Mothers and Daughters,2016-05-06,2016,0,0,0,5.012065
109455,Little Girl,2009-05-19,2009,0,0,0,0.327436
109456,Coffin Full of Dollars,1971-04-01,1971,0,0,0,0.517734
109459,A Necessary Death,2008-03-08,2008,0,0,0,0.438129
109463,The Colour Out of Space,2010-10-30,2010,0,0,0,1.206502
109466,Urban Menace,1999-09-07,1999,0,0,0,0.57406
109472,The Girl,2001-06-06,2001,0,0,0,0.001653
109475,Ironclads,1991-03-11,1991,0,0,0,0.430963
109477,Brutal Relax,2010-01-01,2010,0,0,0,0.941319
109478,Power 98,1996-05-17,1996,0,0,0,0.926867
109479,Buddy Boy,1999-09-05,1999,0,0,0,0.078239
109481,Irene,1940-04-23,1940,0,0,0,0.3785
109491,Beautiful Creatures,2013-02-13,2013,60000000,60052138,52138,20.485203
109500,Dawn Rider,2012-05-29,2012,0,0,0,4.785809
109513,Hit & Run,2012-08-22,2012,2000000,14400000,12400000,7.148558
109515,Me Shivajiraje Bhosale Boltoy,2009-04-02,2009,0,0,0,0.042453
109516,Something's Gonna Live,2012-06-12,2012,0,0,0,0.087297
109520,After Porn Ends,2012-05-21,2012,400000,0,-400000,4.611972
109535,Purgatory,1998-03-23,1998,0,0,0,0.438004
109539,The Sun Shines Bright,1953-05-02,1953,0,0,0,0.638294
109554,Suicide Manual,2003-10-06,2003,0,0,0,0.11709
109560,New York Cop,1993-08-14,1993,0,0,0,0.004537
109565,Catacombs,1988-05-14,1988,0,0,0,0.175573
109572,Lupin the Third: Episode 0: First Contact,2002-07-26,2002,0,0,0,0.482398
109581,Mission to Lars,2015-09-25,2015,0,0,0,0.869956
109584,Broken,2012-08-22,2012,0,0,0,7.305256
109587,The Red Colored Grey Truck,2004-08-11,2004,0,0,0,1.419874
109600,Shakespeare Wallah,1965-12-01,1965,0,0,0,0.04224
109610,Blindside,1987-09-01,1987,0,0,0,0.000844
109614,Losing Chase,1996-08-18,1996,0,0,0,0.901452
109632,Carmen,1915-10-31,1915,23430,0,-23430,0.224472
109636,Once Upon a Spy,1980-09-19,1980,0,0,0,0.587299
109667,David and Lisa,1962-12-26,1962,185000,0,-185000,1.776281
109669,The Tenth Man,1988-12-04,1988,0,0,0,2.11126
109671,Maskeli Be≈üler ƒ∞ntikam Pe≈üinde,2005-10-28,2005,0,0,0,0.39084
109689,I Want You,2012-06-22,2012,0,0,0,7.78818
109690,En fuera de juego,2012-06-01,2012,0,0,0,0.563904
109695,Cocaine Unwrapped,2012-12-03,2012,0,0,0,0.123077
109711,I Am the Law,1938-08-25,1938,0,0,0,0.783289
109716,A Dispatch from Reuter's,1940-10-19,1940,0,0,0,0.682534
109729,The Canyons,2013-07-29,2013,250000,56825,-193175,4.281631
109752,Chasing Leprechauns,2013-01-01,2013,0,0,0,0.211904
109774,We'll Live Till Monday,1968-07-02,1968,0,0,0,0.345099
109797,Nancy Drew,2002-12-15,2002,0,0,0,0.373368
109809,Crime and Punishment,2002-06-01,2002,0,0,0,0.533618
109835,Vazhakku Enn 18/9,2012-05-04,2012,0,0,0,0.627889
109841,Supernatural,1933-05-12,1933,0,0,0,1.023885
109843,Ill Manors,2012-06-06,2012,170000,0,-170000,5.256712
109861,The Novelist,2008-09-27,2008,1531604,0,-1531604,0.040018
109881,Love Letters,1945-10-26,1945,0,0,0,0.963997
109886,Man's Castle,1933-11-20,1933,0,0,0,0.165581
109887,My Foolish Heart,1950-01-21,1950,0,0,0,0.065284
109891,Our Modern Maidens,1929-09-08,1929,0,0,0,0.378651
109894,Hide Away,2012-05-25,2012,0,30655,30655,1.195181
109907,Hate Story,2012-04-20,2012,0,0,0,0.679086
109912,The Little Kidnappers,1990-08-17,1990,0,0,0,0.199886
109913,California Conquest,1952-07-04,1952,0,0,0,0.001859
109933,My Gal Sal,1942-04-30,1942,0,0,0,0.137966
109962,Rich and Famous,1981-09-23,1981,0,0,0,10.396878
109962,Rich and Famous,1981-09-23,1981,0,0,0,12.180836
109970,Three Comrades,1938-06-03,1938,0,0,0,0.982457
109979,18 Years Later,2010-07-04,2010,0,0,0,0.500427
109991,Quiet Flows the Don,1957-01-05,1957,0,0,0,1.233161
110001,Escape from Segovia,1981-11-07,1981,0,0,0,0.075432
110029,Oh Olsun,1973-01-01,1973,0,0,0,0.408567
110040,Salako,1974-12-12,1974,0,0,0,0.828423
110073,Rabbit,2005-01-01,2005,0,0,0,0.551855
110112,Nitro Circus: The Movie,2012-08-08,2012,0,3903479,3903479,4.40284
110115,My Ain Folk,1973-12-01,1973,0,0,0,0.541872
110122,Astronaut: The Last Push,2012-06-01,2012,0,0,0,2.295459
110123,Incredible Rocky Mountain Race,1977-01-01,1977,0,0,0,8e-06
110130,Hologram Man,1995-06-27,1995,0,0,0,1.53921
110131,The Man of Gold,1962-12-13,1962,0,0,0,0.128402
110139,Westbound,1959-04-25,1959,0,0,0,1.361559
110146,The Sapphires,2012-08-08,2012,0,0,0,4.920986
110147,The 10th Kingdom,2000-02-25,2000,0,0,0,3.738876
110148,Jesse Stone: Benefit of the Doubt,2012-05-19,2012,0,0,0,1.870355
110160,Laurence Anyways,2012-05-18,2012,9500000,12250,-9487750,8.59498
110204,The Killing Game,2011-10-30,2011,0,0,0,1.647867
110227,The Borrowers,1973-12-14,1973,0,0,0,0.311734
110253,La Boh√®me,1926-03-13,1926,0,0,0,0.349298
110260,Samson and the Slave Queen,1963-12-13,1963,0,0,0,0.687351
110261,The Seven Magnificent Gladiators,1983-07-31,1983,0,0,0,0.60295
110272,Cheerful Weather for the Wedding,2012-12-07,2012,0,0,0,7.987933
110282,A Way of Life,2004-11-12,2004,0,0,0,0.109945
110283,Minbo: the Gentle Art of Japanese Extortion,1992-05-16,1992,0,0,0,0.001586
110299,Angel Baby,1961-05-14,1961,0,0,0,0.689068
110323,Th√©r√®se,2012-05-27,2012,0,0,0,1.813362
110336,Blood of Dracula,1957-11-01,1957,0,0,0,0.307271
110351,Th√©r√®se: The Story of Saint Th√©r√®se of Lisieux,2004-10-03,2004,0,0,0,0.282495
110354,Side by Side,2012-08-19,2012,0,0,0,6.337857
110372,Descendents,2008-04-07,2008,0,0,0,0.453818
110381,Today,2013-01-09,2013,0,0,0,0.998359
110390,A Pigeon Sat on a Branch Reflecting on Existence,2014-10-24,2014,0,0,0,6.572818
110391,Rhino Season,2012-09-11,2012,0,0,0,2.794066
110392,A Liar's Autobiography: The Untrue Story of Monty Python's Graham Chapman,2012-09-08,2012,0,0,0,2.600112
110393,White Elephant,2012-05-16,2012,0,0,0,0.160574
110395,Freddie as F.R.O.7.,1992-08-14,1992,0,1119368,1119368,1.857632
110398,No,2012-08-07,2012,0,2341226,2341226,5.97966
110402,Hard to Be a God,2013-02-27,2013,7000000,1310673,-5689327,5.921772
110410,Drug War,2012-11-15,2012,0,0,0,4.330183
110412,Symptoms,1974-05-10,1974,0,0,0,0.638675
110415,Snowpiercer,2013-08-01,2013,39200000,86758912,47558912,14.131906
110416,Song of the Sea,2014-09-06,2014,0,857522,857522,6.967358
110419,"Unman, Wittering and Zigo",1971-07-11,1971,0,0,0,0.708736
110420,Wolf Children,2012-07-21,2012,0,0,0,10.249498
110428,Camille Claudel 1915,2013-03-13,2013,3512454,115860,-3396594,0.134014
110428,Camille Claudel 1915,2013-03-13,2013,3512454,115860,-3396594,0.110065
110433,Mrs. Santa Claus,1996-12-08,1996,0,0,0,0.020006
110447,Dormant Beauty,2012-09-01,2012,5700000,0,-5700000,3.616134
110457,Windbag the Sailor,1936-12-01,1936,0,0,0,0.52411
110465,Kim,1950-12-07,1950,0,0,0,1.048075
110468,Boys Will Be Boys,1935-07-01,1935,0,0,0,0.453894
110479,Smashing Time,1967-12-20,1967,0,0,0,0.325212
110486,Perfect Harmony,1991-03-31,1991,0,0,0,0.118558
110490,Rags,2012-05-28,2012,0,0,0,4.340559
110491,The Manzanar Fishing Club,2012-03-30,2012,0,0,0,0.009509
110501,Seven and a Half,2006-06-21,2006,0,0,0,0.334867
110502,The Private War of Major Benson,1955-08-02,1955,0,0,0,0.014734
110513,Girls Town,1996-08-21,1996,0,0,0,0.635669
110525,Four Sons,1940-06-14,1940,0,0,0,0.011337
110538,It Takes Two,1988-07-13,1988,0,0,0,0.00243
110540,The Age of Innocence,1934-09-14,1934,0,0,0,0.006418
110548,Deadly Surveillance,1991-09-06,1991,0,0,0,8e-06
110549,Hannibal Buress: Animal Furnace,2012-05-20,2012,0,0,0,1.373604
110552,The Protector 2,2013-10-23,2013,0,3302463,3302463,13.517632
110553,Austin High,2011-10-22,2011,0,0,0,0.394536
110555,Street Days,2010-01-20,2010,0,0,0,0.422693
110568,Island of Love,1963-06-12,1963,0,0,0,0.122088
110573,The Woman Who Dared,1944-02-03,1944,0,0,0,0.574287
110588,Gingerdead Man 3: Saturday Night Cleaver,2011-09-13,2011,0,0,0,0.520487
110598,Moment by Moment,1978-12-22,1978,0,0,0,0.292719
110603,The Three Musketeers,1939-02-17,1939,0,0,0,0.131404
110608,The Enemy,2011-03-22,2011,1200000,0,-1200000,0.980587
110624,Rescue Me,1993-12-03,1993,0,0,0,0.803745
110628,This Above All,1942-05-12,1942,0,0,0,0.677081
110643,Mass Appeal,1984-12-14,1984,0,0,0,0.582317
110650,Outer Space,1999-01-01,1999,0,0,0,0.372715
110666,Condo Painting,2000-03-17,2000,0,0,0,0.001191
110669,Wabash Avenue,1950-03-31,1950,2115000,2039000,-76000,0.109913
110671,No Down Payment,1957-10-30,1957,0,0,0,0.311254
110674,Apache Territory,1958-09-01,1958,0,0,0,0.484867
110692,No More Excuses,1968-08-08,1968,0,0,0,0.103159
110713,Max,1994-01-01,1994,0,0,0,0.153516
110733,By the Bluest of Seas,1936-04-20,1936,0,0,0,0.189609
110748,History of Postwar Japan as Told by a Bar Hostess,1970-01-01,1970,0,0,0,0.15638
110760,Stille Nacht I,1988-01-01,1988,0,0,0,0.000308
110761,Container,2006-03-10,2006,0,0,0,0.712831
110777,The Store,1983-01-01,1983,0,0,0,1e-06
110779,Urban Warriors,1987-12-30,1987,0,0,0,0.001666
110790,"Murder, He Says",1945-01-01,1945,0,0,0,0.641567
110823,A Fine Pair,1968-09-27,1968,0,0,0,0.060415
110830,American Kickboxer,1991-07-24,1991,0,0,0,0.360854
110838,The Garden,1990-09-06,1990,0,0,0,1.177019
110887,A Girl in Every Port,1928-02-26,1928,0,0,0,0.827134
110898,Apricot,2009-12-09,2009,0,0,0,0.957378
110899,Zigeunerweisen,1980-04-01,1980,0,0,0,0.57604
110901,Heat-Haze Theatre,1981-08-21,1981,0,0,0,1.900438
110903,Yumeji,1991-05-31,1991,0,0,0,0.482865
110909,Things I Never Told You,1996-10-11,1996,0,0,0,0.485874
110919,Circles,2013-01-17,2013,2050000,0,-2050000,1.64587
110924,The Little Apartment,1959-06-15,1959,0,0,0,0.373243
110958,Unlawful Killing,2011-05-18,2011,0,0,0,0.31646
110965,Heat Wave,2011-05-19,2011,0,0,0,0.222298
110972,Pie in the Sky,1996-02-09,1996,0,0,0,0.699066
110980,The Mad Monster,1942-05-15,1942,0,0,0,1.084572
110989,Spooky House,2004-04-24,2004,0,0,0,0.982993
110992,Summer of '62,2007-08-08,2007,0,0,0,0.364339
111014,Dead Silent,1999-01-01,1999,0,0,0,0.259613
111017,Return to Peyton Place,1961-05-05,1961,0,0,0,0.611692
111022,Fame High,2012-04-21,2012,0,0,0,0.31724
111024,Romanoff and Juliet,1961-06-08,1961,0,0,0,1.229984
111031,Say One for Me,1959-06-19,1959,0,0,0,0.235525
111037,The Second Time Around,1961-12-22,1961,0,0,0,0.038223
111042,The Shocking Miss Pilgrim,1947-01-04,1947,0,0,0,0.090449
111043,Springfield Rifle,1952-10-25,1952,0,0,0,0.887304
111083,The Body,2012-10-04,2012,0,0,0,5.513308
111098,Solemn Promise,2009-10-21,2009,0,0,0,0.223105
111100,Boy Meets Girl,1938-08-27,1938,0,0,0,0.693366
111103,Photographic Memory,2011-09-04,2011,0,0,0,0.116553
111109,Century of Birthing,2011-11-17,2011,0,0,0,0.178241
111114,Shock Head Soul,2011-09-03,2011,0,0,0,0.007336
111118,The Big Fix,2011-05-15,2011,0,0,0,0.439796
111149,Rafferty and the Gold Dust Twins,1975-02-02,1975,0,0,0,0.101713
111170,Rubberneck,2013-02-22,2013,0,0,0,0.731581
111172,Fairhaven,2012-06-17,2012,0,0,0,1.283474
111173,Time Zero: The Last Year of Polaroid Film,2012-04-28,2012,0,0,0,0.0998
111174,Knuckleball!,2012-09-18,2012,0,0,0,0.569051
111188,Extraordinary Stories,2008-05-01,2008,0,0,0,0.274637
111190,Adore,2013-04-03,2013,16000000,318982,-15681018,12.260159
111237,White Tiger,2012-05-03,2012,11000000,7200000,-3800000,9.56013
111239,Edge,2010-10-23,2010,0,0,0,0.005954
111248,The Belovs,1993-02-01,1993,0,0,0,0.450888
111250,Bobcat Goldthwait: You Don't Look the Same Either,2012-04-03,2012,0,0,0,0.372547
111261,Rom√°ntico,2005-01-01,2005,0,0,0,0.213028
111302,The Blackbird,1926-01-11,1926,0,0,0,0.982552
111304,Black Sun,1964-04-18,1964,0,0,0,0.115232
111305,Tell It to the Marines,1926-12-23,1926,0,0,0,0.482676
111307,Union Depot,1932-01-30,1932,0,0,0,0.363776
111310,Operator 13,1934-06-08,1934,0,0,0,0.384003
111312,Sequoia,1935-01-16,1935,0,0,0,0.079905
111315,Merrily We Live,1938-03-04,1938,0,0,0,0.385545
111317,Zenobia,1939-04-21,1939,0,0,0,0.397468
111326,"Joshua Tree, 1951: A Portrait of James Dean",2012-05-23,2012,0,0,0,0.121222
111332,Avatar: Creating the World of Pandora,2010-02-07,2010,0,0,0,1.660009
111344,Evergreen,1934-04-01,1934,0,0,0,0.22538
111359,Secret People,1952-01-01,1952,0,0,0,1.256135
111367,For Ever Mozart,1996-11-27,1996,0,0,0,0.413422
111390,Stars in My Crown,1950-05-11,1950,0,0,0,1.095242
111396,Adrift,2009-11-13,2009,0,0,0,0.157877
111397,A Wife Confesses,1961-10-29,1961,0,0,0,0.268985
111398,Yearning,1964-01-15,1964,0,0,0,1.627702
111421,Wyoming Renegades,1954-03-27,1954,0,0,0,0.283009
111440,The Pact,2012-05-25,2012,0,0,0,10.403371
111443,The End,2012-11-23,2012,0,0,0,2.367002
111457,Ella Cinders,1926-06-06,1926,0,0,0,0.391616
111459,California,1947-02-21,1947,0,0,0,0.928348
111460,"Elmer, The Great",1933-04-29,1933,0,0,0,0.792763
111469,Girlfriends,1978-08-01,1978,0,0,0,0.851935
111470,Billy the Kid,1941-05-30,1941,0,0,0,0.628428
111473,The Invisible Woman,2013-12-25,2013,0,1234254,1234254,4.183558
111477,The Helen Morgan Story,1957-10-05,1957,0,0,0,0.572061
111479,CBGB,2013-10-11,2013,5000000,40400,-4959600,3.711772
111480,OSS 117: Mission for a Killer,1965-07-02,1965,0,0,0,0.169425
111481,Family tree,2010-02-16,2010,0,0,0,0.109066
111561,The 30 Foot Bride of Candy Rock,1959-08-06,1959,0,0,0,0.423534
111570,It's in the Bag!,1945-04-21,1945,0,0,0,0.595323
111582,She Loves Me Not,1934-08-31,1934,0,0,0,0.002562
111605,True Love,1989-09-15,1989,0,0,0,1.082105
111607,What Price Glory,1926-11-23,1926,0,0,0,0.285788
111623,The Richest Girl in the World,1934-09-21,1934,0,0,0,0.482489
111625,Small Town Girl,1953-04-10,1953,0,0,0,0.409247
111642,St. Martin's Lane,1938-10-18,1938,0,0,0,2.115376
111650,It Happened in Europe,1948-11-19,1948,0,0,0,0.19593
111662,Chemerical,2009-11-04,2009,0,0,0,0.11179
111667,Night Across the Street,2012-07-11,2012,0,0,0,0.277824
111678,"Rally 'Round the Flag, Boys!",1958-12-23,1958,0,0,0,0.668831
111697,The Masked Thief,1975-12-03,1975,0,0,0,0.043125
111708,The Tobacconist of Vallecas,1987-04-09,1987,0,312010,312010,0.782345
111718,The Sun's Burial,1960-08-09,1960,0,0,0,0.733474
111732,The Jackpot,1950-11-01,1950,0,0,0,0.730181
111744,Joe and Max,2002-03-03,2002,8000000,0,-8000000,1.669115
111747,Just Pals,1920-10-21,1920,0,0,0,0.126531
111750,The Real Glory,1939-09-29,1939,0,0,0,1.087102
111752,Man in the Middle,1963-10-01,1963,0,0,0,0.446482
111759,Don Q Son of Zorro,1925-06-15,1925,0,0,0,0.264033
111771,The Four Year Plan,2011-11-16,2011,0,0,0,0.079713
111794,20 Dates,1998-01-01,1998,0,0,0,0.759793
111815,Mr & Mrs Bridge,1990-11-23,1990,0,0,0,1.035174
111836,Gabbar Singh,2012-05-11,2012,7000000,16000000,9000000,0.795228
111839,Hemingway & Gellhorn,2012-08-27,2012,19500000,0,-19500000,8.19882
111854,Chicks With Sticks,2005-10-25,2005,0,0,0,0.373488
111883,Mac,1992-09-17,1992,0,0,0,0.810792
111910,Stage Struck,1958-04-22,1958,0,0,0,0.973752
111913,A2,2001-01-01,2001,0,0,0,0.102332
111949,"Wild Horse, Wild Ride",2012-08-24,2012,0,0,0,0.356391
111960,Miranda,1948-04-06,1948,784170,834332,50162,0.578456
111969,Stuck in Love,2012-09-09,2012,0,81071,81071,6.715938
111974,Cycling Chronicles: Landscapes the Boy Saw,2004-10-31,2004,0,0,0,0.095752
111975,A Very Special Favor,1965-08-14,1965,0,0,0,0.604021
111981,"Rabbit, Run",1970-10-01,1970,0,0,0,0.023569
111988,Alexander the Great,1980-04-16,1980,0,0,0,0.71334
112033,Alles stroomt,2009-10-08,2009,0,0,0,0.466287
112044,Atlantis,2008-09-19,2008,0,0,0,0.004706
112049,Mad About Men,1954-11-16,1954,0,0,0,0.181151
112054,Beyond Justice,1992-12-02,1992,0,0,0,0.237159
112058,The Happy Hooker Goes To Washington,1977-07-15,1977,0,0,0,0.12857
112072,The magnetic man,2009-10-16,2009,262000,0,-262000,0.121601
112083,Bright Lights,1935-07-27,1935,0,0,0,0.447889
112087,The Wild Party,1975-03-01,1975,0,0,0,0.163675
112090,Branded,2012-09-06,2012,0,0,0,11.297363
112092,Sheitan Warrior,2006-04-19,2006,0,0,0,0.438674
112119,Ghosts with Shit Jobs,2012-05-07,2012,0,0,0,0.176894
112130,For the Love of Money,2012-06-08,2012,0,0,0,0.983569
112136,Buzzkill,2012-01-20,2012,1000000,0,-1000000,0.73094
112141,Menno's Mind,1997-12-13,1997,0,0,0,0.192356
112160,Sexual Chronicles of a French Family,2012-05-09,2012,0,0,0,9.47693
112161,6 Month Rule,2012-06-01,2012,0,0,0,0.125429
112162,TimeScapes,2012-06-01,2012,350000,0,-350000,1.066979
112198,What's in a Name,2012-04-25,2012,0,0,0,7.038718
112200,Thanks for Sharing,2012-09-07,2012,0,1065881,1065881,11.26248
112205,The Family,2013-09-13,2013,30000000,36894225,6894225,8.047735
112234,Women in Revolt,1971-01-01,1971,0,0,0,0.028118
112244,She Was Like a Wild Chrysanthemum,1955-11-29,1955,0,0,0,0.366779
112283,You Are My Sunshine,2005-09-23,2005,0,0,0,1.034456
112284,The Gorgeous Hussy,1936-08-28,1936,1119000,2019000,900000,0.948775
112287,Axed,2012-02-27,2012,0,0,0,0.904319
112293,Park Road - the Movie,2012-02-02,2012,0,0,0,0.498383
112304,Soldiers of Fortune,2012-06-07,2012,8000000,0,-8000000,3.777176
112336,Hitchcock,2012-11-22,2012,0,23570541,23570541,10.841495
112346,Loverboy,2003-04-12,2003,0,0,0,0.110988
112355,Night Hair Child,1972-10-14,1972,0,0,0,0.447702
112383,Lampaansy√∂j√§t,1972-11-17,1972,0,0,0,0.023982
112422,Net Worth,1995-01-01,1995,0,0,0,0.80354
112454,Clown,2014-11-13,2014,0,0,0,6.428814
112456,Hardflip,2012-06-01,2012,1000000,0,-1000000,0.236664
112460,London Voodoo,2004-02-02,2004,0,0,0,0.456527
112481,Rattlers,1976-04-23,1976,0,0,0,0.000578
112485,Hoodoo Ann,1916-03-26,1916,0,0,0,0.189059
112501,Sazen Tange and the Pot Worth a Million Ryo,1935-06-15,1935,0,0,0,0.363569
112503,Django Shoots First,1966-10-28,1966,0,0,0,0.20678
112525,Spellcaster,1992-01-01,1992,0,0,0,0.663414
112531,My Name Is Ki,2011-09-30,2011,0,0,0,0.690042
112558,The Young Stranger,1957-02-01,1957,0,0,0,0.460636
112570,Wanted,1967-03-22,1967,0,0,0,0.925274
112575,Adam and Eve,1995-12-22,1995,0,0,0,0.151042
112582,Fraternity Demon,1992-01-01,1992,0,0,0,0.002317
112601,Halleluja for Django,1967-10-28,1967,0,0,0,0.133246
112618,The Bride Walks Out,1936-07-10,1936,0,0,0,0.26938
112631,Daniel & Ana,2009-05-18,2009,0,0,0,1.39526
112633,Place de la R√©publique,1974-04-30,1974,0,0,0,0.237242
112648,Stranded,2002-01-20,2002,0,0,0,1.182768
112649,Too Many Ways to Be No. 1,1997-03-14,1997,0,0,0,0.869453
112655,Idol of the Crowds,1937-09-30,1937,0,0,0,0.315637
112672,Ambush at Cimarron Pass,1958-03-01,1958,0,0,0,0.275856
112674,The Cowboy and the Lady,1938-11-17,1938,0,0,0,0.11803
112675,The Immortals,1974-12-23,1974,0,0,0,0.104758
112678,Waco: A New Revelation,1999-10-07,1999,0,0,0,0.058409
112687,Doomwatch,1972-03-01,1972,0,0,0,0.842879
112698,The Goddess,1934-01-01,1934,0,0,0,1.280814
112699,Street Angel,1937-01-01,1937,0,0,0,0.073475
112705,The Luck of the Irish,1948-09-15,1948,0,0,0,0.498079
112708,Cage II: The Arena of Death,1994-12-14,1994,0,0,0,1.155263
112722,Louis Theroux: Behind Bars,2008-08-08,2008,0,0,0,1.109867
112731,Outlaw Blues,1977-07-15,1977,1900000,0,-1900000,0.000157
112735,The Skinny,2012-02-10,2012,0,0,0,0.150813
112739,In God We Tru$t,1980-09-26,1980,0,0,0,0.622255
112767,Shadow Run,1998-01-01,1998,0,0,0,0.481484
112823,Num√©ro Deux,1975-09-24,1975,0,0,0,0.415934
112878,The Opponent,2001-08-01,2001,0,0,0,0.157463
112882,Tokyo Chorus,1931-08-15,1931,0,0,0,0.844253
112885,The Bride Wore Red,1937-10-15,1937,0,0,0,0.752617
112912,Why We Fight: The Battle of Russia,1943-01-01,1943,0,0,0,0.315327
112931,La Soif du Monde,2012-03-20,2012,0,0,0,0.162772
112942,Life Is to Whistle,1998-12-05,1998,0,0,0,0.051087
112947,984: Prisoner of the Future,1982-08-22,1982,0,0,0,0.002647
112949,Safe Haven,2013-02-07,2013,28000000,97594140,69594140,7.598422
112961,Nola,2003-01-01,2003,0,10550,10550,0.349913
112963,Vacation!,2010-06-20,2010,0,0,0,0.057746
112969,Slaughter of the Innocents,1993-01-01,1993,0,0,0,0.644934
112973,A Pig's Tale,1996-06-07,1996,0,0,0,0.538673
112991,The Sleepy Time Gal,2001-01-24,2001,0,0,0,0.001893
112999,The Hero,1966-05-06,1966,0,0,0,0.517052
113012,Distant Thunder,1973-01-01,1973,0,0,0,0.029361
113038,Zero Bridge,2011-02-16,2011,0,0,0,0.042815
113040,Alien Origin,2012-06-12,2012,0,0,0,1.795246
113082,Berserk: The Golden Age Arc 1 - The Egg of the King,2012-02-03,2012,0,0,0,10.862777
113091,Lust for Love,2014-02-07,2014,0,0,0,7.000038
113096,The Brandon Teena Story,1998-09-23,1998,0,0,0,0.107046
113097,"Just, Melvin: Just Evil",2000-01-01,2000,0,0,0,0.208349
113105,The War of the Robots,1978-01-01,1978,0,0,0,0.41033
113119,Fugitive Alien,1987-01-01,1987,0,0,0,0.137068
113137,The Book of Stars,1999-06-06,1999,0,0,0,0.470596
113148,Prince Avalanche,2013-02-13,2013,725000,0,-725000,6.57698
113154,Invaders from Space,1965-01-01,1965,0,0,0,0.004585
113158,Rocket Attack U.S.A.,1961-01-01,1961,0,0,0,0.400135
113175,Robin of Locksley,1996-02-26,1996,0,0,0,1.076503
113178,A Wake in Providence,1999-01-01,1999,0,402805,402805,0.002817
113190,Beyond Gay: The Politics of Pride,2010-03-26,2010,0,0,0,0.25268
113194,A Trip to Mars,1910-02-18,1910,0,0,0,0.418844
113209,TekWar: TekLords,1994-02-20,1994,0,0,0,0.112734
113210,TekWar: TekJustice,1994-05-14,1994,0,0,0,0.324203
113213,Auggie Rose,2000-05-14,2000,0,0,0,1.091859
113214,"Oh, Susanna",1936-08-19,1936,0,0,0,0.145666
113215,TekWar: TekLab,1994-02-27,1994,0,0,0,0.444773
113217,Out of Sync,2000-07-12,2000,0,0,0,0.301324
113219,TekWar,1994-01-23,1994,0,0,0,0.660737
113237,Lost Boundaries,1949-07-02,1949,0,0,0,0.108984
113255,Huie's Sermon,1983-07-07,1983,58000,0,-58000,0.049479
113258,Le jeu de la mort,2010-03-12,2010,0,0,0,0.322974
113262,Guys and Dolls,2007-01-17,2007,0,0,0,0.078703
113271,Thrill Ride: The Science of Fun,1997-07-11,1997,0,0,0,0.076926
113273,On the Ropes,1999-01-01,1999,0,0,0,0.140027
113279,Regret to Inform,1999-01-01,1999,0,0,0,0.169989
113284,"The Farm: Angola, USA",1998-01-17,1998,0,0,0,0.190257
113286,The Dancemaker,1998-12-01,1998,0,0,0,0.042361
113290,The Long Way Home,1997-09-19,1997,0,0,0,0.426526
113294,Fast Girls,2012-06-15,2012,0,0,0,2.795534
113300,A Blank on the Map,1971-12-29,1971,0,0,0,1e-06
113321,Jasminum,2006-06-29,2006,0,0,0,0.053496
113329,Artificial Paradises,2012-05-04,2012,0,0,0,2.245738
113332,The Shortest Day,1963-02-14,1963,0,0,0,0.225624
113347,A Drummer's Dream,2010-01-01,2010,0,0,0,0.09111
113362,Hitler's Children,2011-11-21,2011,0,0,0,0.335585
113364,Stealing a Nation,2004-01-01,2004,0,0,0,0.07933
113369,The Pinochet Case,2001-10-10,2001,0,0,0,0.10064
113374,Kissinger,2011-01-01,2011,0,0,0,0.117369
113377,Freedom Riders,2010-01-01,2010,0,0,0,0.041185
113388,As One,2012-05-03,2012,0,0,0,1.425764
113391,Private Practices: The Story of a Sex Surrogate,1986-09-26,1986,0,0,0,0.023358
113432,Wrestling,2007-02-10,2007,0,0,0,0.424623
113456,Adelheid,1970-04-06,1970,0,0,0,0.74998
113458,Mother Joan of the Angels,1961-02-09,1961,0,0,0,1.413071
113479,Every Man for Himself,1980-09-08,1980,0,0,0,1.828887
113520,The Hart of London,1970-11-30,1970,0,0,0,0.012515
113523,Doomsday Machine,1972-01-01,1972,0,0,0,0.7172
113525,Embryo,1976-05-21,1976,0,0,0,3.949663
113582,The Spy in the Green Hat,1967-02-03,1967,0,0,0,1.42191
113594,A Turtle‚Äôs Tale 2: Sammy‚Äôs Escape From Paradise,2012-08-15,2012,0,0,0,5.107345
113629,Wind from the East,1970-08-19,1970,0,0,0,1.797627
113638,Eskimo,1933-11-14,1933,0,0,0,0.43699
113649,Be with Me,2010-06-10,2010,0,0,0,0.219285
113653,Prison,1949-03-19,1949,0,0,0,0.605028
113655,Ingenious,2009-02-01,2009,0,0,0,1.313416
113660,Rumble,2002-05-31,2002,0,0,0,0.139006
113670,To Fetch a Bike,1968-01-01,1968,0,0,0,0.135181
113693,Adventures in the Sin Bin,2012-06-08,2012,0,0,0,0.70529
113700,Lady of Vengeance,1957-08-01,1957,0,0,0,0.49055
113737,My Own Country,1998-01-01,1998,0,0,0,0.05598
113739,Ring of Terror,1962-02-01,1962,0,0,0,0.450432
113743,Jupiter's Darling,1955-02-18,1955,0,0,0,0.852036
113752,USS Seaviper,2012-05-28,2012,3000000,0,-3000000,1.029707
113757,Up in Arms,1944-02-17,1944,2000000,0,-2000000,0.369775
113777,Harper Valley P.T.A.,1978-07-02,1978,0,0,0,0.870303
113782,One Night at Dinner,1969-04-13,1969,0,0,0,0.487775
113784,The Last Polka,1985-04-15,1985,0,0,0,0.008326
113788,Hangman's House,1928-05-13,1928,0,0,0,0.179627
113823,Three Guys Named Mike,1951-03-01,1951,0,0,0,0.589707
113833,The Normal Heart,2014-05-25,2014,0,0,0,12.661286
113841,Welcome Stranger,1947-06-13,1947,0,0,0,0.405181
113843,Woman's World,1954-09-30,1954,0,0,0,0.61847
113882,Islander,2006-01-01,2006,0,0,0,0.038903
113885,The Tempest,1998-12-13,1998,0,0,0,0.249567
113916,The General Died at Dawn,1936-09-02,1936,0,0,0,0.910323
113921,Dallas,1950-12-30,1950,0,0,0,1.104845
113936,The Roof,1956-09-29,1956,0,0,0,0.543164
113947,The Sessions,2012-05-02,2012,1000000,9138338,8138338,5.760319
113958,Love Thy Neighbor,2006-02-26,2006,0,0,0,0.257066
114003,Jersey Shore Shark Attack,2012-06-09,2012,0,0,0,1.041684
114006,Oriental Elegy,1996-01-01,1996,0,0,0,0.08101
114018,The Daughter of Dawn,1920-10-01,1920,0,0,0,0.515775
114030,All About Our House,2001-06-09,2001,0,0,0,0.198484
114033,...And the Pursuit of Happiness,1986-01-01,1986,0,0,0,0.139649
114044,Interkosmos,2006-01-06,2006,9500,0,-9500,0.074151
114046,The Three Stooges in Orbit,1962-07-04,1962,450000,0,-450000,0.445183
114047,13 Curses,2002-10-12,2002,0,0,0,0.546139
114051,Candy Razors,1980-10-06,1980,0,680224,680224,1.099467
114060,Me and the Colonel,1958-10-01,1958,0,0,0,0.764929
114065,Down & Out With The Dolls,2003-03-20,2003,0,0,0,0.002404
114081,The Blue Veil,1951-10-26,1951,0,3550000,3550000,0.349985
114083,Trial,1955-10-07,1955,0,0,0,0.336615
114089,Bye-Bye,1995-08-30,1995,0,0,0,0.109406
114096,Bloodbrothers,1978-09-28,1978,0,0,0,0.748113
114104,The Bobo,1967-09-28,1967,0,0,0,0.607573
114108,Cinderella,1899-10-01,1899,0,0,0,1.301063
114116,Law and Order,1969-03-02,1969,0,0,0,0.174131
114145,Tunneling the English Channel,1907-06-30,1907,0,0,0,0.178476
114146,The Conquest of the Pole,1912-01-01,1912,0,0,0,0.462066
114150,Pitch Perfect,2012-09-28,2012,17000000,115350426,98350426,11.03595
114155,Effie Gray,2014-03-08,2014,0,0,0,6.808109
114162,Sacred Flesh,2000-01-01,2000,1850000,0,-1850000,0.464966
114172,Naked Harbour,2012-06-08,2012,0,0,0,0.740245
114184,Seven Days Somewhere Else,1969-08-29,1969,0,0,0,0.001707
114189,Remembrance,2011-11-24,2011,0,0,0,1.097188
114221,Strange Girls,2007-11-02,2007,0,0,0,0.056136
114242,Faust,1960-09-30,1960,0,0,0,0.764101
114246,Fantasma,2006-03-23,2006,0,0,0,0.499772
114251,Suspect,1960-01-01,1960,0,0,0,0.559919
114255,Tunnel Vision,1976-03-12,1976,250,0,-250,0.140948
114284,Praying with Anger,1992-01-01,1992,0,0,0,0.35467
114285,Everybody Has a Plan,2012-08-30,2012,0,0,0,0.877481
114286,Memories of My Melancholy Whores,2011-10-13,2011,0,0,0,1.467361
114299,Sex and Consequences,2006-01-01,2006,0,0,0,2.950323
114302,The Man Who Played God,1932-02-19,1932,0,0,0,0.729945
114324,Merry-Go-Round,1923-07-01,1923,0,0,0,0.695572
114333,The Hunt,1966-11-07,1966,0,0,0,0.298873
114348,Pilgrimage,1933-07-12,1933,0,0,0,0.178164
114354,The River and Death,1955-06-30,1955,0,0,0,0.483034
114370,Fist of the North Star: Legend of Yuria,2007-02-23,2007,0,0,0,1.357836
114371,Fist of the North Star: Legend of Toki,2008-03-26,2008,0,0,0,1.385707
114372,Fist of the North Star: Legend of Raoh - Chapter of Fierce Fight,2007-04-28,2007,0,0,0,2.451587
114377,The Ventriloquist,2012-06-02,2012,0,0,0,0.452604
114384,Adjustment and Work,1986-06-02,1986,0,0,0,0.000809
114390,Hospital,1970-02-01,1970,0,0,0,0.451368
114394,The Lonely Lady,1983-10-02,1983,0,1,1,0.495813
114395,Juvenile Court,1973-06-04,1973,0,0,0,0.007685
114403,Model,1980-06-02,1980,0,0,0,0.079516
114405,Multi-Handicapped,1986-06-02,1986,0,0,0,4.3e-05
114412,Public Housing,1997-06-02,1997,0,0,0,0.321714
114423,Canal Zone,1977-06-13,1977,0,0,0,0.03078
114426,Deaf,1986-06-09,1986,0,0,0,0.005625
114438,Russendisko,2012-03-28,2012,0,0,0,1.355625
114444,My Childhood,1972-06-05,1972,0,0,0,0.063647
114464,Design of Death,2012-04-28,2012,0,0,0,1.190345
114471,The Secret Land,1948-10-22,1948,0,0,0,0.446018
114478,Starship Troopers: Invasion,2012-07-21,2012,0,0,0,13.357011
114490,Raw Deal: A Question Of Consent,2001-01-20,2001,0,0,0,0.018283
114499,The Vanishing Prairie,1954-08-17,1954,0,0,0,0.170691
114503,White Wilderness,1958-08-12,1958,0,0,0,0.044624
114514,Who Are the DeBolts? And Where Did They Get Nineteen Kids?,1977-12-01,1977,0,0,0,7e-06
114516,Genocide,1982-03-14,1982,0,0,0,0.25
114521,Artie Shaw: Time Is All You've Got,1986-01-01,1986,0,0,0,0.00012
114524,Common Threads: Stories from the Quilt,1989-12-01,1989,0,0,0,0.544277
114562,Ballplayer,2012-07-13,2012,0,44689,44689,1.347578
114564,Shikshanachya Aaicha Gho,2010-01-15,2010,380000,520000,140000,0.043519
114570,The Hunters,1977-10-19,1977,0,0,0,0.362132
114574,Bikini Spring Break,2012-06-26,2012,500000,500000,0,1.946823
114575,Big Easy Express,2012-03-17,2012,0,0,0,0.558026
114577,C'mon Man,2012-06-26,2012,0,0,0,0.402752
114594,Monk Dawson,1998-07-31,1998,0,0,0,0.301581
114606,Cockneys vs Zombies,2012-08-31,2012,0,0,0,11.20619
114609,Death Rage,1976-10-22,1976,0,0,0,0.098059
114618,The Wreck of the Mary Deare,1959-11-06,1959,0,0,0,0.478596
114626,El compadre Mendoza,1934-04-05,1934,0,0,0,0.430045
114638,True Confession,1937-12-24,1937,0,0,0,0.143494
114645,Days of 36,1972-09-30,1972,0,0,0,0.023867
114661,Rules of Dating,2005-06-10,2005,0,0,0,0.711354
114674,Can It Be Love,1992-08-19,1992,0,0,0,0.054862
114718,Kauwboy,2012-04-18,2012,0,0,0,1.884039
114719,Friends & Lovers,1999-04-16,1999,0,94633,94633,1.53188
114726,Out on a Limb,1992-09-04,1992,11000000,1659542,-9340458,1.305774
114750,Dear White People,2014-10-17,2014,1000000,0,-1000000,5.546847
114761,The Beach Boys: An American Family,2000-02-27,2000,0,0,0,0.002363
114776,Changing Habits,1997-05-20,1997,1200000,0,-1200000,0.621816
114779,It's a Disaster,2013-04-12,2013,0,0,0,3.54286
114790,Under the Bridges,1946-08-31,1946,0,0,0,0.441521
114796,Tin Man,2007-04-17,2007,0,0,0,6.362129
114838,Brother Rat,1938-10-29,1938,0,0,0,0.174691
114872,Invitation,1952-01-29,1952,0,0,0,0.00414
114875,The Dark at the Top of the Stairs,1960-09-28,1960,0,0,0,0.254794
114887,The Dream Team,2012-06-13,2012,0,0,0,0.671027
114888,Love Before Breakfast,1936-03-09,1936,0,0,0,0.944682
114903,Aqu√≠ Entre Nos,2012-03-30,2012,1,2755584,2755583,0.230075
114922,Scrambled Beer,2007-03-10,2007,250,0,-250,0.003795
114931,Sonja,2006-11-23,2006,0,0,0,0.07937
114953,Lolly-Madonna XXX,1973-02-21,1973,0,0,0,1.108379
114955,Let It Shine,2012-06-15,2012,0,0,0,5.020619
114958,Storage 24,2012-06-29,2012,0,0,0,3.673183
114962,Modest Reception,2012-02-13,2012,0,0,0,0.442906
114975,Wichita,1955-07-03,1955,0,0,0,0.4542
114982,Goodbye to Language,2014-08-15,2014,0,0,0,2.662659
114994,Planet of Snail,2011-03-20,2011,0,0,0,0.540795
115023,Measuring the World,2012-10-24,2012,0,0,0,5.047333
115042,Exterminators of the Year 3000,1983-08-13,1983,0,606694,606694,0.676383
115046,Black & White & Sex,2012-01-27,2012,0,0,0,1.2644
115054,The Space Children,1958-06-01,1958,0,0,0,0.547347
115064,Supermen of Malegaon,2009-06-16,2009,0,0,0,0.025697
115084,Piranhaconda,2012-06-16,2012,1000000,0,-1000000,6.607263
115108,The Virgin's Bed,1969-01-01,1969,0,0,0,0.149125
115109,The Rains Came,1939-09-15,1939,0,0,0,0.87141
115111,"Goodbye, My Fancy",1951-05-19,1951,0,0,0,0.124344
115124,Awara Paagal Deewana,2002-06-21,2002,0,0,0,1.447152
115132,Grass: A Nation's Battle for Life,1925-03-20,1925,0,0,0,0.19921
115150,Images of the World and the Inscription of War,1989-02-21,1989,0,0,0,0.453223
115153,Kismat,2004-02-20,2004,0,0,0,0.978406
115161,Fish Heads,1980-01-01,1980,0,0,0,0.00335
115162,Chair de poule,1963-11-13,1963,0,0,0,1.358261
115173,M√≠a,2011-01-01,2011,0,0,0,0.162432
115187,Pasolini prossimo nostro,2006-11-24,2006,0,0,0,0.166183
115189,Louis Theroux: Twilight of the Porn Stars,2012-06-10,2012,0,0,0,0.3172
115199,The History of Future Folk,2012-06-15,2012,0,0,0,1.807096
115210,Stitches,2012-05-19,2012,100000,95000,-5000,8.328705
115214,My Father And The Man In Black,2013-09-06,2013,0,0,0,0.098512
115223,Pok√©mon the Movie Black: Victini and Reshiram,2011-07-16,2011,0,0,0,2.004607
115232,The Purple Ball,1987-01-01,1987,0,0,0,0.240743
115239,Wojaczek,1999-11-05,1999,0,0,0,0.054685
115241,Stevie,2008-01-01,2008,0,0,0,0.186992
115260,Uptown,2009-08-19,2009,0,0,0,0.340143
115276,Pusher,2012-10-12,2012,0,0,0,6.532164
115283,A.C.O.D.,2013-10-03,2013,0,175705,175705,5.748809
115290,Blue Lagoon: The Awakening,2012-06-16,2012,0,0,0,10.751964
115301,Enamorada,1946-12-25,1946,0,0,0,0.348704
115306,Ricky Rapper,2008-02-14,2008,0,0,0,0.093497
115332,Cross Creek,1983-09-21,1983,0,0,0,1.97664
115348,Paranoia,2013-08-14,2013,35000000,13785015,-21214985,7.249581
115353,One Damned Day at Dawn... Django Meets Sartana!,1970-06-13,1970,0,0,0,1.082224
115373,Gunshy,1998-03-06,1998,0,0,0,0.99069
115383,Wolf Summer,2003-02-28,2003,0,0,0,1.505651
115384,Bulldog Drummond's Peril,1938-03-18,1938,0,0,0,0.202059
115386,Rooftops,1989-03-17,1989,0,0,0,0.001393
115400,The Woodmans,2011-01-19,2011,0,0,0,0.070181
115425,The Buccaneer,1938-02-04,1938,0,0,0,0.201046
115427,Macbeth,1982-01-01,1982,0,0,0,0.017296
115442,The Wall,2012-02-12,2012,0,0,0,3.00007
115451,Spirit Stalkers,2012-06-16,2012,10000,0,-10000,0.078828
115463,Shocking Asia,1976-11-11,1976,20000,0,-20000,0.026034
115520,Lili's Apron,2004-01-24,2004,0,0,0,0.002505
115531,The Power and the Glory,1961-10-29,1961,0,0,0,0.162939
115547,The Rise & Fall of a White Collar Hooligan,2012-05-07,2012,1000000,0,-1000000,3.721769
115549,Blue Denim,1959-07-30,1959,0,0,0,0.040037
115553,The First Movie,2009-12-14,2009,0,0,0,0.156488
115565,Equinox,1992-09-18,1992,0,0,0,6.001067
115572,Zero Focus,1961-03-19,1961,0,0,0,0.150857
115596,Ornamental Hairpin,1941-08-26,1941,0,0,0,0.212205
115616,Hawks,1988-08-05,1988,0,0,0,1.060228
115626,Stuck in the Suburbs,2004-07-16,2004,0,0,0,6.508145
115656,Ricky Rapper and the Bicycle Thief,2010-02-11,2010,1700000,0,-1700000,0.348962
115665,Extasis,1996-02-16,1996,0,0,0,0.668037
115706,Hold That Line,1952-03-23,1952,0,0,0,0.002085
115711,The Naked Eye,1998-02-20,1998,0,0,0,0.792064
115712,Either Way,2011-09-02,2011,0,0,0,0.668137
115738,Million Dollar Crocodile,2012-06-08,2012,4700000,0,-4700000,1.105591
115782,Jobs,2013-08-16,2013,12000000,35931410,23931410,14.294019
115788,Love Hotel,1985-08-03,1985,0,0,0,0.599997
115810,Calle 54,2000-10-06,2000,0,0,0,0.50905
115821,The Artist and the Model,2012-09-28,2012,0,0,0,0.544088
115834,Ten Tall Men,1951-10-26,1951,0,0,0,1.189812
115871,Match,2012-05-01,2012,8000000,0,-8000000,0.637438
115872,The Chambermaid on the Titanic,1997-10-10,1997,0,0,0,0.406397
115873,The Angrez,2006-06-02,2006,50000,300000,250000,0.34064
115877,Fantas√≠a... 3,1966-01-01,1966,0,0,0,0.101585
115893,"The Life and Death of 9413, a Hollywood Extra",1928-06-16,1928,0,97,97,0.209191
115894,The deputy,1978-10-20,1978,0,631083,631083,0.414173
115903,Colegas,1982-10-25,1982,0,646714,646714,1.269717
115905,Kaalo,2010-12-17,2010,0,0,0,0.077685
115909,Turn of the Screw,1985-10-10,1985,0,0,0,0.149945
115929,Cool Kids Don't Cry,2012-02-15,2012,0,0,0,2.242185
115972,Sword of Sherwood Forest,1960-12-26,1960,0,0,0,1.678191
116008,Chicago Cab,1997-01-01,1997,0,0,0,0.713223
116014,Enemies: A Love Story,1989-12-13,1989,0,7754571,7754571,4.164446
116019,Taistelu N√§silinnasta 1918,2012-03-23,2012,0,0,0,0.337731
116059,Laffghanistan: Comedy Down Range,,,120000,0,-120000,0.0375
116094,Charlotte Sometimes,2002-03-11,2002,0,0,0,0.193088
116146,"Iracema, Uma Transa Amaz√¥nica",1976-01-01,1976,0,0,0,0.002001
116149,Paddington,2014-11-27,2014,55000000,259207227,204207227,15.686837
116155,Alibi Ike,1935-06-15,1935,0,0,0,0.668997
116160,Jalopy,1953-02-15,1953,0,0,0,0.523744
116167,56 Up,2012-05-14,2012,0,0,0,0.513828
116185,Billa II,2012-07-13,2012,0,0,0,2.174859
116190,Paris Playboys,1954-03-07,1954,0,0,0,0.022909
116194,Proteus,1995-01-01,1995,0,0,0,0.278796
116227,Howling,2012-02-16,2012,0,0,0,1.79924
116231,Another Woman's Life,2012-02-14,2012,0,0,0,1.520283
116232,You're Only Young Once,1937-12-10,1937,0,0,0,0.14977
116236,Crazy Desire,1962-07-31,1962,0,0,0,0.407932
116248,Vampire,2011-10-09,2011,0,0,0,4.579356
116303,Rent-a-Cat,2012-05-12,2012,0,0,0,1.691096
116306,Exit Elena,2012-06-24,2012,0,0,0,0.223271
116312,The National Shotgun,1978-09-14,1978,0,1622164,1622164,0.619347
116318,A Journey Through Fairyland,1985-01-01,1985,0,0,0,0.161979
116323,Unbowed,2012-01-18,2012,0,0,0,1.499266
116327,How to Make a Monster,1958-07-01,1958,0,0,0,0.525931
116333,Bravo Two Zero,1999-10-07,1999,0,0,0,5.523356
116336,Island of Lost Women,1959-05-01,1959,0,0,0,0.209147
116340,Dead Man's Burden,2012-06-15,2012,0,0,0,0.845067
116345,Pascali's Island,1988-07-22,1988,0,0,0,0.948693
116350,The Captive,1988-01-01,1988,0,0,0,0.177454
116351,The Snails,1966-05-31,1966,0,0,0,0.945548
116352,Monkey's Teeth,1960-01-01,1960,0,0,0,0.219564
116356,The Sexual Life of the Belgians,1994-01-28,1994,0,0,0,0.297781
116377,An Open Heart,2012-08-08,2012,0,0,0,0.504427
116379,When He Didn't Come Home,1998-05-19,1998,0,0,0,0.919199
116385,Let No Man Write My Epitaph,1960-11-10,1960,0,0,0,0.468404
116432,A Limousine the Colour of Midsummer's Eve,1981-07-12,1981,0,0,0,0.001586
116437,Kolka Cool,2011-12-16,2011,0,0,0,0.114604
116439,Foxtrot,1976-03-01,1976,0,0,0,0.461692
116440,Maggie Simpson in The Longest Daycare,2012-07-12,2012,0,0,0,4.160631
116445,Wonder Women,1973-04-25,1973,110000,0,-110000,1.82926
116463,Arachnoquake,2012-06-23,2012,0,0,0,8.26942
116466,The Flat,2011-07-11,2011,0,0,0,1.117776
116488,All About My Wife,2012-05-17,2012,0,0,0,0.98012
116494,Clearcut,1991-09-10,1991,0,0,0,0.211595
116495,Val Lewton: The Man in the Shadows,2007-09-02,2007,0,0,0,0.722011
116500,Incendiary Blonde,1945-08-31,1945,0,0,0,0.00349
116514,The Forest,2011-04-14,2011,2,0,-2,0.629428
116521,Sex Appeal,1986-05-01,1986,0,0,0,0.055846
116537,On Thin Ice,2009-09-23,2009,0,0,0,0.166984
116544,Helen the Baby Fox,2006-03-18,2006,0,0,0,0.003562
116554,Stalag Luft,1993-10-27,1993,0,0,0,0.180615
116569,Vinyl,2000-08-01,2000,0,0,0,0.606523
116609,The Rival,2006-10-09,2006,0,0,0,0.052938
116613,The Sweeney,2012-09-11,2012,3730500,6294161,2563661,5.311336
116614,The Sex of Angels,1968-02-24,1968,0,0,0,0.097818
116639,The Naughty Flirt,1931-01-11,1931,0,0,0,0.024511
116649,What Is This Film Called Love?,2012-06-26,2012,0,0,0,0.009414
116690,The Ballad of Narayama,1958-06-01,1958,0,0,0,0.969254
116698,That Championship Season,1982-12-09,1982,0,0,0,0.653601
116711,Epic,2013-05-15,2013,100000000,268426634,168426634,11.913405
116712,Flesh and Fantasy,1943-10-29,1943,0,0,0,1.059418
116714,La mies es mucha,1948-01-01,1948,0,0,0,0.10985
116723,Comes a Bright Day,2012-02-12,2012,0,0,0,4.947552
116733,The Hunchedback Horse,1947-01-10,1947,0,0,0,0.177625
116741,The Internship,2013-06-07,2013,58000000,44000000,-14000000,0.393865
116745,The Secret Life of Walter Mitty,2013-12-18,2013,90000000,188133322,98133322,8.684892
116746,Parisian Love,1925-08-01,1925,0,0,0,0.001396
116751,The Little Thief,1999-09-12,1999,0,0,0,0.162221
116753,Shwaas,2004-12-10,2004,0,0,0,0.356645
116760,Sextette,1978-03-03,1978,0,0,0,0.156508
116762,Sallah,1964-01-01,1964,0,0,0,0.728502
116764,Dealing: Or the Berkeley-to-Boston Forty-Brick Lost-Bag Blues,1972-02-25,1972,0,0,0,0.079541
116776,Dragon Ball: Mystical Adventure,1988-07-09,1988,0,0,0,1.60215
116780,Lizzie,1957-04-04,1957,0,0,0,0.733408
116789,Falling For You,1995-02-21,1995,0,0,0,0.01165
116800,Filming Othello,1978-07-10,1978,0,0,0,0.383277
116811,Berberian Sound Studio,2012-08-30,2012,0,0,0,5.532455
116844,Drunks,1997-03-14,1997,0,0,0,0.587824
116853,The Bling Ring,2011-09-26,2011,0,0,0,1.044582
116857,Death's Marathon,1913-01-01,1913,0,0,0,0.212974
116894,Blind Terror,2001-04-23,2001,0,0,0,0.011006
116904,Bar Girls,1994-09-15,1994,0,0,0,0.39401
116973,Four Men and a Prayer,1938-04-29,1938,0,0,0,0.383715
116977,Foodfight!,2012-06-15,2012,65000000,73706,-64926294,6.693589
116979,Chained,2012-10-02,2012,0,0,0,4.607816
116983,The Black Waters of Echo's Pond,2009-01-01,2009,0,0,0,0.845713
116988,Cadena perpetua,1979-08-09,1979,0,0,0,1.087147
116991,The Monastery of Sendomir,1920-01-01,1920,0,0,0,0.113587
116997,Ghost of Love,1981-04-03,1981,0,0,0,0.534422
117001,Seas Beneath,1931-01-30,1931,0,0,0,0.081761
117004,Night Court,1932-06-04,1932,0,0,0,0.144281
117007,Deadline,2004-10-05,2004,0,0,0,0.039145
117023,Sharkman,2001-01-01,2001,0,0,0,0.104482
117024,The Whispering Chorus,1918-03-28,1918,0,0,0,0.148361
117026,Daughter of Dr. Jekyll,1957-06-28,1957,0,0,0,0.144075
117034,Tattooed Tears,1979-01-09,1979,0,0,0,0.151034
117036,Synthetic Pleasures,1995-09-13,1995,0,0,0,0.001177
117038,Love and Diane,2002-10-08,2002,0,0,0,0.037647
117042,The Devil's Trap,1962-01-01,1962,0,0,0,0.179835
117044,The World Moves On,1934-06-27,1934,0,0,0,0.090754
117046,The White Dove,1960-11-04,1960,0,0,0,0.179263
117058,Desamuduru,2007-01-12,2007,0,0,0,0.588809
117098,Cloudburst,2011-09-23,2011,0,0,0,1.609941
117099,Bardaasht,2004-04-23,2004,0,0,0,0.146308
117102,The Perfect Human Diet,2012-05-22,2012,500000,0,-500000,0.806212
117120,The Facility,2012-06-23,2012,0,0,0,3.504587
117129,The Family Game,1983-05-04,1983,0,0,0,1.475108
117142,EK Chotti Si Love Story,2002-09-06,2002,0,0,0,0.072957
117164,Guardian Angel,1994-11-22,1994,0,0,0,0.595949
117168,The Year That Trembled,2002-03-22,2002,0,0,0,0.003772
117179,Just a Little Harmless Sex,1999-06-11,1999,0,0,0,0.348671
117209,Whisper of Sin,2007-03-02,2007,0,0,0,0.169469
117211,Brown of Harvard,1926-05-02,1926,0,0,0,0.363406
117212,A Fugitive from the Past,1965-01-15,1965,0,0,0,0.880475
117232,Lady Blue Shanghai,2010-05-16,2010,0,0,0,0.824515
117251,White House Down,2013-06-27,2013,150000000,205366737,55366737,9.920223
117258,Look What's Happened to Rosemary's Baby,1976-10-29,1976,0,0,0,1.250603
117259,Soft Fruit,1999-10-28,1999,0,0,0,0.086721
117262,Sunset Strip,2000-08-18,2000,0,0,0,1.172956
117263,Olympus Has Fallen,2013-03-20,2013,70000000,161025640,91025640,10.978188
117266,Craigslist Joe,2012-08-02,2012,0,0,0,1.947322
117269,Lambada,1990-03-19,1990,0,0,0,0.802118
117316,Strangers,2007-06-06,2007,0,0,0,0.316056
117319,Vishwaroopam,2013-01-25,2013,17000000,51000000,34000000,1.542355
117337,Kajraare,2010-10-15,2010,0,0,0,0.024825
117340,Hello Lonesome,2010-06-01,2010,0,0,0,0.118601
117341,Madhoshi,2004-09-24,2004,0,0,0,0.100055
117343,The Garden of Earthly Delights,2004-01-01,2004,0,0,0,0.251538
117345,Mast,1999-10-15,1999,0,0,0,0.49691
117375,One Mile Away,2013-03-29,2013,0,0,0,0.065374
117377,Flicker,2012-09-20,2012,0,0,0,0.498719
117401,She Cried No,1996-09-23,1996,0,0,0,0.447583
117404,ABC Africa,2001-10-24,2001,0,0,0,0.24961
117406,Porto of My Childhood,2001-09-19,2001,0,0,0,0.150687
117407,They Call It Myanmar: Lifting the Curtain,2012-09-21,2012,0,0,0,0.18592
117408,The Age of the Medici,1972-12-26,1972,0,0,0,0.040738
117412,Passing Fancy,1933-09-07,1933,0,0,0,0.636021
117422,Make Way For A Lady,1936-11-13,1936,0,0,0,0.100856
117424,Maidstone,1970-01-01,1970,0,0,0,0.087941
117426,Beyond the Law,1968-01-01,1968,0,0,0,0.34866
117428,Wild 90,1968-01-01,1968,0,0,0,0.059149
117435,The Trail of '98,1928-03-20,1928,0,0,0,0.059836
117452,Tony 10,2012-02-14,2012,0,0,0,0.412313
117457,Salon Mexico,1949-02-25,1949,0,0,0,1.009443
117464,Wer's glaubt wird selig,2012-08-16,2012,0,0,0,0.591097
117467,Mostly Sunny,2012-09-06,2012,0,0,0,0.828915
117472,Dragnet Girl,1933-04-27,1933,0,0,0,0.164041
117478,Two Cents Worth of Hope,1952-04-10,1952,0,0,0,0.433915
117479,Class Relations,1984-02-21,1984,0,0,0,0.011656
117483,Young Girls of Wilko,1979-09-04,1979,0,0,0,1.181015
117493,Blow for Blow,1972-06-01,1972,0,0,0,0.397546
117499,Asphalt Lambs,1968-12-20,1968,0,0,0,0.036471
117500,Pastoral Symphony,1946-09-26,1946,0,0,0,0.206154
117506,Motorway,2012-06-21,2012,0,0,0,1.525108
117509,Wimps,1986-01-01,1986,0,0,0,0.039274
117510,Preppies,1984-04-01,1984,0,0,0,0.001013
117512,Goin' All the Way!,1982-11-11,1982,0,0,0,0.000844
117514,Beach Balls,1988-05-01,1988,0,0,0,0.79402
117520,Etoiles: Dancers of the Paris Opera Ballet,2001-03-14,2001,0,0,0,0.001662
117530,Hong Kong Confidential,2010-09-16,2010,0,0,0,0.859549
117531,The Great Gabbo,1929-09-12,1929,0,0,0,0.290042
117534,E A√≠... Comeu?,2012-06-22,2012,0,0,0,0.842744
117550,"Helga, She Wolf of Spilberg",1977-10-20,1977,0,0,0,0.34502
117553,Calendar Girl,1993-09-03,1993,13000000,2570145,-10429855,1.316741
117565,Water and Power,1989-10-01,1989,0,0,0,0.664124
117567,The Road to Fort Alamo,1964-10-24,1964,0,0,0,0.746855
117592,The Seahorse,1934-01-01,1934,0,0,0,0.459031
117618,The Guest House,2012-06-18,2012,250000,0,-250000,0.989626
117629,Yossi,2012-05-16,2012,500000,116207,-383793,1.162001
117678,Dans la peau d'une grande,2011-10-27,2011,0,0,0,0.682721
117680,Home of the Brave,1986-04-27,1986,0,0,0,0.022845
117691,Gangs of Wasseypur,2012-06-22,2012,1400000,4100000,2700000,9.777219
117700,Hannah's Law,2012-06-09,2012,5000000,0,-5000000,1.270417
117730,Under The Domim Tree,1994-01-01,1994,0,0,0,0.71066
117751,Ustad Hotel,2012-06-29,2012,0,0,0,1.923616
117767,Eroica,1958-01-04,1958,0,0,0,0.071783
117773,Frozen Assets,1992-10-23,1992,0,0,0,1.335691
117781,Black Tights,1962-02-20,1962,0,0,0,0.836137
117790,Northern Light,2006-04-20,2006,0,0,0,0.038876
117800,A Wanderer's Notebook,1962-09-29,1962,0,0,0,0.013818
117856,Bigfoot,2012-06-30,2012,0,0,0,1.516298
117863,The Overcoat,1959-02-02,1959,0,0,0,0.057513
117869,El malvado Carabel,1956-10-15,1956,0,0,0,0.002559
117878,Kiss at Pine Lake,2012-01-01,2012,0,0,0,0.985717
117890,Confessions of a Police Captain,1971-03-26,1971,0,0,0,1.253364
117904,I've Been Waiting for You,1998-03-22,1998,0,0,0,1.274883
117905,Do You Wanna Know a Secret?,2001-03-04,2001,0,0,0,0.15554
117913,The Testimony,1946-02-15,1946,0,0,0,0.076894
117923,Assassin's Bullet,2012-08-01,2012,5000000,0,-5000000,2.269177
117924,Somewhere Between,2012-08-24,2012,0,0,0,0.762853
117942,Girls Gone Dead,2012-03-28,2012,500000,0,-500000,2.181036
117959,A Bell for Adano,1945-06-21,1945,0,0,0,0.411053
117963,The Harmony Game,2011-02-11,2011,0,0,0,0.100029
117969,House of Women,1962-04-11,1962,0,0,0,0.001884
117974,Sightseers,2012-11-30,2012,0,61782,61782,9.921876
117978,In Their Skin,2012-11-09,2012,4000000,0,-4000000,3.156772
117992,Advance To The Rear,1964-06-10,1964,0,0,0,0.619177
117999,Last of the Mobile Hot Shots,1970-01-02,1970,0,0,0,0.313156
118009,Victims of Sin,1951-02-02,1951,0,0,0,0.253987
118011,Another Dawn,1943-11-18,1943,0,0,0,0.293173
118013,Endeavour,,,0,0,0,1.233673
118014,The Seashell and the Clergyman,1928-02-09,1928,0,0,0,0.557243
118015,The Saddest Boy in the World,2006-04-28,2006,0,0,0,0.232856
118017,Welcome to Hard Times,1967-04-30,1967,0,0,0,0.74257
118026,Coicent,2011-02-25,2011,0,0,0,0.391854
118051,Cocktail,2012-07-13,2012,6400000,18800000,12400000,7.950488
118052,Rat,2001-04-01,2001,0,0,0,0.934445
118059,An American Romance,1944-04-16,1944,3,0,-3,0.541358
118075,Going All the Way,1997-01-19,1997,0,86175,86175,5.655387
118083,Promises in the Dark,1979-11-02,1979,0,0,0,0.684806
118098,Madame Sousatzka,1988-10-14,1988,0,0,0,0.553293
118116,Welcome to Farewell-Gutmann,2008-07-04,2008,0,0,0,0.018925
118121,Butley,1974-01-21,1974,0,0,0,0.266127
118131,Where East is East,1929-05-04,1929,0,0,0,0.207515
118134,The Widow From Chicago,1930-11-23,1930,0,0,0,0.833388
118139,The Hatchet Man,1932-02-06,1932,0,0,0,0.308959
118144,My Son,2007-05-01,2007,0,2403749,2403749,0.153181
118145,"differently, Molussia",2012-02-16,2012,0,0,0,0.062621
118150,The Blonde from Peking,1967-08-25,1967,0,0,0,0.987756
118153,The Sword and the Dragon,1956-09-16,1956,0,0,0,0.542191
118154,Quiet Flows The Don,2006-11-07,2006,2000000,0,-2000000,2.376189
118155,Star Force: Fugitive Alien II,1987-01-01,1987,0,0,0,0.003977
118180,Repatriation,2004-04-24,2004,0,0,0,0.048098
118195,Grandma,1979-05-10,1979,0,0,0,0.000603
118204,The Student,2011-09-01,2011,0,0,0,0.713885
118236,The Great Manhunt,1950-09-11,1950,0,0,0,0.089335
118245,Beauty and the Boss,1932-04-09,1932,0,0,0,0.075281
118251,First Flight,2006-03-12,2006,0,0,0,0.939069
118257,Room 666,1982-06-01,1982,0,0,0,0.442746
118283,The Girl He Left Behind,1956-10-26,1956,0,0,0,0.63149
118289,Diana,2013-09-19,2013,15000000,21766271,6766271,5.348746
118293,The Suicide Shop,2012-09-26,2012,0,0,0,5.496384
118309,John Adams,2008-03-16,2008,0,0,0,2.794764
118337,Zeta One,1969-12-01,1969,0,0,0,1.171242
118340,Guardians of the Galaxy,2014-07-30,2014,170000000,773328629,603328629,53.291601
118379,Viva Erotica,1996-11-28,1996,0,0,0,1.373953
118381,Anna Magdalena,1998-05-28,1998,0,0,0,0.702358
118390,Venus in Furs,1969-11-25,1969,0,0,0,0.034614
118397,Identical,2011-12-01,2011,2000000,0,-2000000,0.160282
118406,Naruto Shippuden the Movie: Road to Ninja,2012-07-28,2012,0,17322136,17322136,5.525454
118408,The Life of Guskou Budori,2012-07-07,2012,0,2,2,0.394173
118412,Berserk: The Golden Age Arc 2 - The Battle for Doldrey,2012-06-23,2012,0,0,0,5.777354
118424,The Iceman Tapes: Conversations with a Killer,1992-06-16,1992,0,0,0,0.071884
118427,Mommy,1995-11-28,1995,0,0,0,0.002962
118430,The Forbidden Dance,1990-03-16,1990,0,0,0,1.332871
118439,The Gambler Returns: The Luck Of The Draw,1991-11-03,1991,0,0,0,0.377806
118443,Nothing Too Good for a Cowboy,1998-01-04,1998,0,0,0,0.009019
118444,Onionhead,1958-10-25,1958,0,0,0,0.087466
118446,The Last Outpost,1951-04-04,1951,0,0,0,0.275972
118451,Eungyo,2012-04-25,2012,0,0,0,1.087573
118452,"First Love, Last Rites",1998-08-07,1998,300000,40542,-259458,0.546143
118490,Jedda,1955-05-05,1955,0,0,0,0.271236
118497,Carriage to Vienna,1966-11-11,1966,0,0,0,0.397247
118513,A Place in the Sun,2012-08-29,2012,3000000,0,-3000000,1.142933
118517,Valley of the Kings,1954-07-23,1954,0,0,0,0.243251
118533,The Sergeant,1968-12-25,1968,0,0,0,0.121512
118534,A Scandal in Paris,1946-07-19,1946,0,0,0,2.285098
118536,The Private Affairs of Bel Ami,1947-04-25,1947,0,0,0,0.397268
118549,The Wild Party,1956-12-21,1956,0,0,0,0.073212
118553,Every Little Thing,1997-03-05,1997,0,0,0,0.038727
118557,Palms,1994-02-01,1994,0,0,0,0.39262
118575,Ginza Cosmetics,1951-04-14,1951,0,0,0,0.444682
118576,The Devil's Needle,1916-08-12,1916,0,0,0,0.037056
118580,Children of Eve,1915-11-10,1915,0,0,0,0.001679
118612,After,2012-08-27,2012,0,0,0,4.982627
118617,Divorce Iranian Style,1998-08-01,1998,0,0,0,0.155233
118624,Doomsday Book,2012-04-11,2012,0,0,0,2.374122
118628,English Vinglish,2012-09-14,2012,2840000,11620000,8780000,3.611437
118632,Ghatak: Lethal,1996-11-08,1996,0,0,0,1.052675
118635,Elegy of a Voyage,2001-06-01,2001,0,0,0,0.22814
118636,Zombies of the Stratosphere,1952-07-16,1952,0,0,0,0.100693
118640,Love and Other Troubles,2012-01-01,2012,0,0,0,1.145354
118658,10 Minutes,2002-01-01,2002,0,0,0,0.28371
118677,Why Stop Now?,2012-08-17,2012,0,0,0,3.291884
118683,Maximum Conviction,2012-10-25,2012,0,0,0,3.375841
118690,Keith Lemon: The Film,2012-08-24,2012,0,0,0,0.941501
118716,The Day Mars Invaded Earth,1963-02-14,1963,0,0,0,0.469209
118727,The Life & Adventures of Santa Claus,2000-10-30,2000,0,0,0,0.635649
118737,Interview with a Hitman,2012-07-20,2012,0,0,0,10.04115
118751,Flower and Snake 5: Rope Magic,1987-12-05,1987,0,0,0,1.245621
118758,Atolladero,1997-01-01,1997,0,0,0,0.072521
118760,Forty Deuce,1982-10-01,1982,0,0,0,0.14622
118761,The Soul of Bread,2012-02-03,2012,0,0,0,0.529863
118762,Our Brief Eternity,2009-10-20,2009,0,0,0,0.004708
118769,You've Been Trumped,2012-07-06,2012,0,0,0,0.991571
118778,Sweet Evil,2010-05-12,2010,0,0,0,0.405841
118792,There Will Come Soft Rains,1984-01-01,1984,0,0,0,0.071585
118794,The Cow,1990-12-31,1990,0,0,0,0.020853
118802,Il... Belpaese,1977-01-01,1977,0,0,0,0.007963
118809,Heart,1992-01-01,1992,0,0,0,0.175741
118872,The Subject Was Roses,1968-10-13,1968,0,0,0,0.407508
118876,How to Kill a Judge,1975-02-05,1975,0,0,0,0.561785
118887,Sunburn,1979-08-10,1979,0,0,0,1.432915
118889,Kentucky,1938-12-30,1938,0,0,0,0.146222
118900,"In the Meantime, Darling",1944-09-22,1944,0,0,0,0.491271
118910,The Court-Martial of Billy Mitchell,1955-12-31,1955,0,0,0,0.288597
118911,Hurry Sundown,1967-02-09,1967,0,0,0,1.185971
118915,Such Good Friends,1971-12-16,1971,0,0,0,0.607919
118931,After School Midnighters,2012-08-25,2012,0,0,0,0.456974
118936,Stand-In,1937-10-29,1937,0,0,0,0.57266
118943,Those Awful Hats,1909-01-25,1909,0,0,0,0.680925
118946,Those Who Kill - Shadow of the Past,2012-03-15,2012,0,0,0,0.84368
118948,Adventures of Kitty O'Day,1945-01-19,1945,0,0,0,0.178753
118953,The Mystery of the 13th Guest,1943-11-05,1943,0,0,0,0.306761
118955,The Chapman Report,1962-10-05,1962,0,0,0,0.568081
118957,Bait,2012-09-05,2012,30000000,0,-30000000,6.498141
118984,33 Postcards,2011-06-09,2011,0,0,0,1.720802
118991,Keys to Tulsa,1997-04-11,1997,0,57252,57252,1.323422
118998,Ada,1961-08-25,1961,0,0,0,0.350902
119001,The Big Circus,1959-07-05,1959,0,0,0,0.617565
119010,"Sasquatch, the Legend of Bigfoot",1976-02-13,1976,0,0,0,4.2e-05
119094,Lucky Jordan,1942-11-16,1942,0,0,0,0.529771
119172,The Last Days of the World,2011-07-04,2011,0,0,0,0.417121
119183,Ulysses,1967-03-14,1967,0,0,0,1.378727
119193,What the Day Owes the Night,2012-09-12,2012,17,0,-17,3.553601
119197,Let Go,2011-10-25,2011,0,0,0,0.56888
119213,Cold Around the Heart,1997-11-07,1997,0,0,0,0.905505
119255,"Gangsters, Guns and Zombies",2012-06-30,2012,0,0,0,0.270539
119256,Dolls,2007-04-05,2007,0,0,0,0.14527
119273,Girlfriend Boyfriend,2012-08-03,2012,0,0,0,1.078883
119278,Smiley,2012-10-12,2012,0,0,0,4.871071
119283,Parker,2013-01-23,2013,35000000,46216641,11216641,13.963892
119288,Three Stars,2012-07-13,2012,0,0,0,0.122212
119321,Big Top Scooby-Doo!,2012-10-22,2012,0,0,0,2.880905
119324,Prime Suspect,1991-04-07,1991,0,0,0,2.104104
119353,The Terror Within II,1991-01-18,1991,0,0,0,0.745915
119360,Me and You,2012-09-18,2012,0,0,0,4.425191
119364,The Take,1974-05-01,1974,0,0,0,0.645963
119372,Jane Eyre,1983-10-09,1983,0,0,0,1.653906
119374,The Forest,2002-11-01,2002,0,0,0,1.20019
119409,La M√°quina de Bailar,2006-09-22,2006,0,0,0,0.204481
119425,Shit Year,2010-05-15,2010,200000,0,-200000,0.069073
119430,Owned & Operated,2012-07-02,2012,500,0,-500,0.249644
119431,Halo 4: Forward Unto Dawn,2012-10-05,2012,12500000,0,-12500000,7.429822
119433,Todd Barry: Super Crazy,2012-07-24,2012,0,0,0,0.168343
119450,Dawn of the Planet of the Apes,2014-06-26,2014,170000000,710644566,540644566,75.385211
119457,General Education,2012-08-24,2012,0,0,0,1.047595
119478,Devil Seed,2012-05-16,2012,0,0,0,2.615004
119482,Poppies Are Also Flowers,1966-10-16,1966,0,0,0,0.579757
119540,Toy Soldiers,1984-11-01,1984,0,0,0,0.263525
119552,Gas Pump Girls,1979-12-01,1979,0,0,0,1.296647
119564,Million Dollar Legs,1932-07-08,1932,0,0,0,0.617058
119569,Marvel One-Shot: Item 47,2012-09-13,2012,0,0,0,5.569008
119575,The Mind of Mr. Soames,1970-07-01,1970,0,0,0,0.504241
119586,Vampire Hookers,1978-07-01,1978,0,0,0,0.593445
119592,Nightmare Weekend,1986-01-01,1986,0,0,0,0.054964
119593,A Fever In The Blood,1961-01-28,1961,0,0,0,1.210849
119616,Black Butterfly,2006-11-01,2006,0,0,0,0.353809
119617,How to Beat the High Co$t of Living,1980-07-11,1980,0,0,0,0.775043
119623,Swann in Love,1984-02-23,1984,0,0,0,1.862417
119634,Two Little Boys,2012-09-20,2012,0,0,0,1.170867
119637,He Who Must Die,1957-05-03,1957,0,0,0,0.765704
119639,Mother Knows Best,1997-04-13,1997,0,0,0,0.449218
119675,Behind the Candelabra,2013-05-26,2013,23000000,15600000,-7400000,7.339451
119685,Mass Effect: Paragon Lost,2012-12-28,2012,0,0,0,2.796819
119687,Woman in a Dressing Gown,1957-09-12,1957,0,0,0,0.78738
119694,The Sunshine Boys,1996-02-15,1996,0,0,0,0.474328
119698,The Dinosaur Project,2012-08-09,2012,0,0,0,11.736223
119700,Among Us,2011-11-10,2011,0,0,0,0.274527
119738,Thunderstruck,2012-08-24,2012,0,0,0,7.239241
119764,A Song to Remember,1945-01-19,1945,0,0,0,0.794961
119769,The Serpent's Way,1986-12-25,1986,0,0,0,0.422714
119801,Made In Paris,1966-02-09,1966,0,0,0,1.297068
119816,Kiss and Run,2002-10-25,2002,0,0,0,0.291233
119819,The Call of the Wild,1935-08-09,1935,0,0,0,1.061454
119820,The Unfish,1997-01-01,1997,0,0,0,0.678833
119826,The Unspeakable Act,2012-04-19,2012,0,0,0,1.875791
119838,Julius Caesar,1979-02-11,1979,0,0,0,4.1e-05
119840,King Lear,1982-09-19,1982,0,0,0,0.041115
119844,Macbeth,1983-11-05,1983,0,0,0,0.328289
119855,The Dream of a Ridiculous Man,1992-11-01,1992,0,0,0,1.266314
119884,Arnold,1973-11-16,1973,0,0,0,1.818481
119892,The Monkey King,2014-01-09,2014,82000000,0,-82000000,6.793767
119893,An American Girl: McKenna Shoots for the Stars,2012-07-14,2012,0,0,0,2.112566
119905,Birdsong,2008-12-19,2008,0,0,0,0.185391
119907,Household Saints,1993-09-15,1993,0,0,0,0.055173
119914,Titus Andronicus,1985-04-25,1985,0,0,0,0.234944
119916,The Tempest,1980-02-27,1980,0,0,0,1.8e-05
119916,The Tempest,1980-02-27,1980,0,0,0,1.8e-05
119926,Bridge to the Sun,1961-10-17,1961,0,0,0,0.219545
119928,Othello,1981-10-04,1981,0,0,0,0.653579
119933,The Merchant of Venice,1980-12-17,1980,0,0,0,0.00926
119944,Emperor of Shaolin Kung Fu,1980-04-12,1980,0,0,0,1e-06
119965,In the Midst of Life,1963-10-08,1963,0,0,0,0.071579
119984,Faust et M√©phistoph√©l√®s,1903-01-01,1903,0,0,0,0.118942
120055,Trading Christmas,2011-11-26,2011,0,0,0,0.591333
120077,Running Free,1999-11-11,1999,0,0,0,0.482448
120109,Too Many Husbands,1940-04-03,1940,0,0,0,0.539853
120115,The Origin of Stitch,2005-08-30,2005,0,0,0,0.203822
120121,La vida alrededor,1959-10-08,1959,0,0,0,0.206335
120122,Vesna Goes Fast,1996-09-04,1996,0,0,0,0.38412
120129,No One Writes to the Colonel,1999-06-04,1999,0,0,0,0.582199
120143,The Four,2012-07-12,2012,0,0,0,6.653942
120149,Spirit,2012-06-14,2012,598500,0,-598500,0.499216
120172,Another World,2014-09-14,2014,1000000,0,-1000000,2.226657
120194,Childish Games,2012-03-09,2012,0,0,0,1.885325
120212,Blade on the Feather,1980-10-19,1980,0,0,0,0.441143
120249,‚ÄòRameau‚Äôs Nephew‚Äô by Diderot (Thanx to Dennis Young) by Wilma Schoen,1974-11-05,1974,0,0,0,0.070473
120259,About Mrs. Leslie,1954-08-03,1954,0,0,0,0.457418
120268,Johanna d'Arc of Mongolia,1989-02-01,1989,0,0,0,0.031153
120271,Wagner's Dream,2012-06-20,2012,0,0,0,0.240834
120280,Pekka ja P√§tk√§ puistot√§tein√§,1955-03-04,1955,0,0,0,0.10156
120292,Not Suitable For Children,2012-07-12,2012,0,0,0,6.431209
120303,The Vampire,1957-10-04,1957,0,0,0,0.510668
120328,Out Cold,1989-03-03,1989,0,0,0,0.844348
120357,Craig's Wife,1936-09-25,1936,0,0,0,0.38784
120360,An Injury to One,2002-09-09,2002,0,0,0,0.04201
120370,Three Inches,2011-12-29,2011,0,0,0,0.475674
120386,The Stud,1978-08-17,1978,0,0,0,0.857558
120393,To Get to Heaven First You Have to Die,2006-10-04,2006,0,0,0,0.166991
120399,The King Is Dead!,2012-07-12,2012,0,0,0,0.845582
120457,Drifters,2011-09-09,2011,0,0,0,3.493423
120467,The Grand Budapest Hotel,2014-02-26,2014,30000000,174600318,144600318,14.442048
120475,Dragon Ball: Episode of Bardock,2011-12-17,2011,0,0,0,3.2213
120478,The Haunting of Whaley House,2012-07-31,2012,115000,0,-115000,1.235331
120481,Come to the Stable,1949-01-01,1949,0,0,0,0.107344
120497,The Bride Comes Home,1935-12-25,1935,0,0,0,0.29523
120509,"Blackbeard, the Pirate",1952-12-24,1952,0,0,0,1.369747
120515,Book of Love,2004-01-18,2004,0,0,0,1.015492
120518,See You in the Morning,1989-04-14,1989,0,0,0,1.096075
120520,Somebody Killed Her Husband,1978-09-29,1978,0,0,0,0.372751
120522,Middle of the Night,1959-06-17,1959,0,0,0,4.743709
120528,Moving Midway,2007-04-14,2007,0,0,0,0.148499
120529,Chelsea on the Rocks,2008-05-23,2008,0,0,0,1.233761
120539,Hedda Gabler,1962-12-28,1962,0,0,0,0.389782
120555,Very Important Person,1961-04-24,1961,0,0,0,0.424395
120581,Convict's Code,1939-01-18,1939,0,0,0,0.063206
120587,How to Meet Girls from a Distance,2012-07-19,2012,80000,0,-80000,0.151112
120588,Something to Shout About,1943-02-25,1943,0,0,0,0.048972
120589,Alice Cooper: Welcome to my Nightmare,1975-11-28,1975,0,0,0,0.621114
120605,The Punisher: Dirty Laundry,2012-07-16,2012,0,0,0,11.309444
120615,Arena,1953-06-24,1953,0,0,0,0.94491
120637,Queen of Hearts,1989-10-01,1989,0,0,0,0.693409
120653,"X, Y and Zee",1972-01-21,1972,0,0,0,0.443894
120657,The Stranger's Return,1933-07-28,1933,0,0,0,0.001747
120664,Civilization,1916-06-02,1916,0,0,0,0.202129
120672,Peter Pan,1924-12-29,1924,0,0,0,0.271782
120673,Wild Oranges,1924-01-20,1924,0,0,0,0.135713
120676,The Circle,1925-09-22,1925,0,0,0,0.132439
120683,Me & Isaac Newton,2000-11-10,2000,0,0,0,0.00323
120694,Festival in Cannes,2001-11-03,2001,0,299171,299171,0.295987
120713,Wu Dang,2012-07-17,2012,0,0,0,1.937135
120729,An Englishman Abroad,1983-11-29,1983,0,0,0,0.348445
120747,The Adventures of Mark Twain,1944-05-03,1944,0,0,0,0.673755
120771,Bloody Bloody Bible Camp,2012-05-25,2012,0,0,0,0.912915
120785,Easy Living,1949-10-08,1949,0,0,0,0.823662
120802,Noobz,2013-01-25,2013,340000,0,-340000,1.090644
120828,The Great K&A Train Robbery,1926-10-17,1926,0,0,0,0.171735
120831,Love,1927-11-28,1927,0,0,0,0.664602
120833,Applause,1930-01-04,1930,0,0,0,0.798123
120835,The Devil to Pay!,1930-12-20,1930,0,0,0,0.560279
120837,Three Faces East,1930-08-26,1930,0,0,0,0.598618
120843,Girls About Town,1931-11-07,1931,0,0,0,0.624638
120850,Line of Sight,2012-07-01,2012,100000,0,-100000,0.953628
120852,Lesson of the Evil,2012-11-10,2012,0,0,0,3.451787
120854,Lizzie,2013-07-18,2013,0,0,0,1.97366
120862,The Animal Kingdom,1932-12-28,1932,0,0,0,0.98147
120872,The Girl and the Fox,2011-04-09,2011,0,0,0,0.160435
120885,Judge Hardy and Son,1939-12-22,1939,0,0,0,0.121944
120892,"Ah, Wilderness!",1935-12-06,1935,0,0,0,0.746099
120922,Torno a vivere da solo,2008-12-05,2008,0,0,0,0.560502
120932,Desperate Search,1952-11-19,1952,0,0,0,0.965531
120942,Teri Meri Kahaani,2012-06-21,2012,0,0,0,1.480336
120972,Everybody's Woman,1934-01-01,1934,0,0,0,0.119875
120977,The Dark Angel,1935-09-08,1935,0,0,0,0.11704
120990,Jim Norton: Please Be Offended,2012-06-30,2012,0,0,0,0.191276
120995,Tevye,1939-12-21,1939,0,0,0,0.075978
121001,The Biscuit Eater,1940-05-24,1940,0,0,0,0.001856
121003,The Girl from Missouri,1934-08-03,1934,0,0,0,0.729896
121006,Riffraff,1936-01-03,1936,0,0,0,0.762881
121015,Steel,1979-10-21,1979,0,0,0,2.340879
121020,Illicit,1931-02-14,1931,0,0,0,0.910714
121036,The Best Of Times,2002-09-20,2002,0,0,0,0.302673
121043,Angel In My Pocket,1969-04-02,1969,0,0,0,0.05684
121052,The Birthday Party,1968-12-09,1968,0,0,0,0.660685
121074,Any Number Can Play,1949-07-15,1949,0,0,0,0.92241
121088,Efectos secundarios,2006-09-01,2006,0,0,0,0.602894
121091,Fever,1999-05-16,1999,6,0,-6,0.646853
121111,The Telephone Book,1971-10-03,1971,0,0,0,1.173717
121113,Toomorrow,1970-08-27,1970,0,0,0,1.418274
121135,Jonestown: Paradise Lost,2007-01-15,2007,0,0,0,0.824387
121147,Freeloaders,2012-12-18,2012,3000000,0,-3000000,4.513823
121154,Tumbledown,1988-05-29,1988,0,0,0,0.7355
121170,Simply Raw,2009-02-01,2009,0,0,0,0.764904
121173,Voracious,2012-09-05,2012,11178,34659,23481,0.079287
121197,Never Fear,1949-12-29,1949,0,0,0,0.612655
121206,Villegas,2012-11-07,2012,0,0,0,0.088779
121210,Our Children,2012-08-19,2012,0,0,0,2.249619
121230,The Virginian,1946-05-05,1946,0,0,0,1.018083
121232,Dust,2008-12-03,2008,0,0,0,0.07692
121234,But Not For Me,1959-08-19,1959,0,0,0,0.600459
121238,If I Had a Million,1932-12-02,1932,0,0,0,0.709137
121245,"Bumblefuck, USA",2011-06-17,2011,0,0,0,0.042353
121250,Home Before Dark,1958-11-16,1958,1390000,0,-1390000,1.858785
121317,Family Secrets,2001-01-26,2001,0,0,0,0.393661
121329,Two Sons of Ringo,1967-05-18,1967,0,0,0,0.157428
121342,Giovannona Long-Thigh,1973-04-12,1973,0,0,0,1.992836
121351,Aces and Eights,1936-06-06,1936,0,0,0,0.051886
121354,The Great Man,1956-12-01,1956,0,0,0,0.076706
121357,Golden Earrings,1947-08-27,1947,0,0,0,0.949155
121369,Summer of the Seventeenth Doll,1959-12-01,1959,0,0,0,0.387082
121379,Lady Windermere's Fan,1925-12-26,1925,320000,0,-320000,0.49755
121401,Eye of the Cat,1969-06-18,1969,0,0,0,0.107612
121446,Birders: The Central Park Effect,2012-07-16,2012,0,0,0,0.166566
121455,Bad Luck,1960-04-04,1960,0,0,0,0.409878
121462,My Mother and Her Guest,1961-08-26,1961,0,0,0,0.076567
121464,Vanina Vanini,1961-10-12,1961,0,0,0,0.910147
121471,Shouting Fire: Stories from the Edge of Free Speech,2009-01-20,2009,0,0,0,0.004713
121491,Deranged,2012-07-05,2012,0,0,0,2.350386
121493,A Summer in La Goulette,1996-12-25,1996,0,0,0,0.263439
121498,Creep Van,2012-03-09,2012,0,0,0,0.761698
121510,Il tifoso l'arbitro e il calciatore,1982-08-01,1982,0,0,0,0.717013
121513,The Immortal Bachelor,1975-02-19,1975,0,0,0,0.387427
121516,"Heads I Win, Tails You Lose",1982-01-01,1982,0,0,0,0.447565
121530,Boys,1977-02-26,1977,0,0,0,1.022163
121539,Torn Apart,2006-09-13,2006,0,0,0,4.737858
121550,Flashback,1969-10-01,1969,0,0,0,0.110314
121555,Stephen Tobolowsky's Birthday Party,2006-05-30,2006,0,0,0,0.218159
121565,Errors of the Human Body,2012-09-23,2012,1500000,0,-1500000,2.285454
121572,Toad Road,2013-10-25,2013,0,0,0,0.608397
121573,My Amityville Horror,2013-03-14,2013,0,0,0,2.093526
121598,Midnight's Children,2012-10-26,2012,0,884100,884100,8.00411
121602,Dangerous Liaisons,2012-09-27,2012,31000000,0,-31000000,1.921426
121604,The Wee Man,2013-01-18,2013,0,0,0,2.858494
121606,Resolution,2012-04-20,2012,0,0,0,5.825388
121611,The Biggest Bundle of Them All,1968-01-17,1968,0,0,0,0.526755
121620,The Touch of Her Flesh,1967-04-19,1967,0,0,0,0.371249
121636,The Rat Race,1960-07-10,1960,0,0,0,0.430616
121640,Zaytoun,2012-10-14,2012,8000000,42330,-7957670,3.549738
121642,Twice Born,2012-09-13,2012,13000000,18295,-12981705,5.849716
121652,Cheap Smokes,2000-01-05,2000,0,0,0,1.054305
121655,London,1994-06-03,1994,0,0,0,0.112903
121662,One Hundred Mornings,2009-07-11,2009,0,0,0,0.372911
121667,Venus and Serena,2012-10-06,2012,0,0,0,0.192593
121674,Great Expectations,2012-11-30,2012,0,258656,258656,6.812108
121676,Inescapable,2012-09-14,2012,0,0,0,5.949456
121677,The Reluctant Fundamentalist,2013-03-17,2013,0,519535,519535,6.231928
121688,Wild Field,2008-09-05,2008,0,0,0,0.224777
121691,Hellbound?,2012-09-21,2012,0,0,0,0.088803
121695,Bitter Sweet,1940-11-08,1940,0,0,0,0.827543
121703,Cattle Queen of Montana,1954-11-18,1954,0,0,0,0.313233
121707,Montana,1950-01-28,1950,0,0,0,0.579823
121725,Life Back Then,2011-11-19,2011,0,0,0,0.418925
121727,The Call of the Wild,1976-05-22,1976,0,0,0,0.160044
121734,"Tad, the Lost Explorer",2012-08-31,2012,10500000,23000000,12500000,11.003515
121738,Kestrel's Eye,1998-12-25,1998,0,0,0,0.001722
121740,Details,2003-10-10,2003,0,0,0,0.373635
121749,Is It Easy to Be Young?,1986-06-06,1986,0,0,0,0.126123
121754,Misa mi,2003-12-19,2003,0,0,0,2.458467
121789,At Any Price,2012-08-30,2012,0,0,0,4.278909
121791,The Attack,2012-09-01,2012,0,0,0,2.0275
121793,Capital,2012-11-14,2012,0,0,0,4.194984
121822,The Time Being,2012-09-11,2012,0,0,0,0.976716
121823,Tai Chi Zero,2012-09-27,2012,0,0,0,10.066776
121824,Stand Up Guys,2013-01-31,2013,0,0,0,5.75637
121826,Quartet,2012-09-08,2012,11000000,59520298,48520298,6.93228
121828,Outrage Beyond,2012-09-03,2012,0,0,0,3.433531
121830,Mr. Pip,2012-09-08,2012,0,0,0,6.434329
121831,"Love, Marilyn",2012-09-12,2012,0,0,0,4.836391
121835,Lore,2012-08-02,2012,0,0,0,6.468915
121842,Echoes From a Sombre Empire,1990-11-28,1990,0,0,0,0.731278
121848,Isle of Fury,1936-10-10,1936,0,0,0,0.470464
121856,Assassin's Creed,2016-12-21,2016,125000000,240697856,115697856,27.54107
121869,Eisenstein in Guanajuato,2015-02-11,2015,0,0,0,11.461055
121872,Ginger & Rosa,2012-09-07,2012,0,1005700,1005700,10.463908
121873,Hannah Arendt,2012-09-11,2012,0,717205,717205,5.329701
121875,In the House,2012-09-26,2012,0,11879046,11879046,9.617662
121879,A Late Quartet,2012-11-02,2012,0,1562546,1562546,11.03656
121888,Bloody Psycho,1989-01-01,1989,0,0,0,0.008903
121890,An Enemy of the People,1978-03-17,1978,0,0,0,0.815273
121895,Daddy Nostalgia,1990-09-05,1990,0,0,0,1.419683
121903,Tender Is the Night,1962-01-19,1962,0,0,0,0.235787
121923,Brother John,1971-08-15,1971,0,0,0,0.9413
121927,Get Mean,1976-05-01,1976,0,0,0,0.091615
121929,Thursday Till Sunday,2012-01-28,2012,0,0,0,0.187853
121936,Happiness Never Comes Alone,2012-06-27,2012,15000000,0,-15000000,4.143244
121940,Knockout,2000-02-04,2000,0,0,0,0.31301
121942,Barrier,1966-11-18,1966,0,0,0,0.393275
121945,CHiPs '99,1998-01-01,1998,0,0,0,1.090234
121959,The Deerslayer,1957-09-10,1957,0,0,0,0.87572
121975,Carnegie Hall,1947-02-28,1947,0,0,0,0.564402
121983,Free Angela and All Political Prisoners,2012-09-09,2012,0,0,0,1.683584
121986,Frances Ha,2013-05-17,2013,0,4069826,4069826,8.471415
121992,Michael Shayne: Private Detective,1940-12-19,1940,0,0,0,0.773808
121998,It Was the Son,2012-09-01,2012,2100000,0,-2100000,0.94537
122019,Macario,1960-05-09,1960,0,0,0,0.837614
122023,Casanova,2005-03-13,2005,0,0,0,1.45169
122036,The Imperceptable Transmutations,1904-01-01,1904,0,0,0,0.071782
122044,Offender,2012-08-08,2012,2000000,0,-2000000,1.462095
122047,Ladies of Leisure,1930-04-05,1930,0,0,0,0.500752
122052,Creature from the Hillbilly Lagoon,2005-01-01,2005,11000,0,-11000,0.00978
122080,Thy Womb,2012-12-24,2012,0,306,306,0.223633
122081,Spring Breakers,2013-01-24,2013,5000000,31724284,26724284,14.830235
122083,Superstar,2012-08-27,2012,0,0,0,1.817498
122088,Fill the Void,2012-07-01,2012,0,1775316,1775316,1.647014
122089,Something in the Air,2012-09-02,2012,0,85154,85154,2.491193
122126,The Concubine,2012-06-06,2012,0,0,0,3.056241
122134,Baby's Meal,1895-12-27,1895,0,0,0,1.402404
122160,More Dead Than Alive,1969-01-15,1969,0,0,0,1.216183
122163,Jill Rips,2000-01-28,2000,2000000,0,-2000000,1.089141
122188,Sada,1998-04-11,1998,0,0,0,0.668735
122190,Endurance,1999-05-14,1999,0,0,0,0.052279
122192,The Lookout,2012-09-05,2012,0,0,0,4.604124
122198,Lines of Wellington,2012-10-13,2012,0,0,0,0.956205
122221,The Limping Man,1953-12-11,1953,0,0,0,0.64058
122229,Angel's Leap,1971-09-21,1971,0,0,0,0.313393
122252,The Naked Street,1955-08-01,1955,0,0,0,0.788539
122268,Entertaining Mr. Sloane,1970-04-08,1970,0,0,0,1.088397
122270,The Niklashausen Journey,1970-10-26,1970,0,0,0,0.085174
122271,Bleak Moments,1971-01-01,1971,0,0,0,0.601614
122289,Lilian's Story,1996-05-09,1996,0,0,0,0.964894
122291,The Homecoming,1973-10-29,1973,0,0,0,0.950147
122293,The Philadelphia Experiment,2012-07-27,2012,0,0,0,3.765759
122320,Winston Churchill: Walking with Destiny,2010-08-20,2010,0,0,0,0.383057
122325,The Rich Are Always with Us,1932-05-21,1932,0,0,0,0.154659
122326,100 Ghost Street: The Return of Richard Speck,2012-07-24,2012,150,0,-150,0.942505
122331,When a Man Loves,1927-08-21,1927,0,0,0,0.566853
122336,The Woodsman and the Rain,2011-10-23,2011,0,0,0,1.537497
122341,Pine Flat,2006-01-01,2006,0,0,0,0.053465
122348,Lunch Break,2008-11-21,2008,0,0,0,0.084113
122356,Goshogaoka,1998-03-28,1998,0,0,0,0.00349
122368,The Boy Who Walked Backwards,1995-02-05,1995,0,0,0,0.149035
122369,13 Eerie,2013-04-02,2013,0,0,0,8.507128
122372,The Ghostmaker,2011-08-01,2011,0,0,0,1.85213
122408,Buttcrack,1998-12-08,1998,0,0,0,0.314551
122435,S.O.S. Iceberg,1933-08-30,1933,0,0,0,0.404707
122466,Sick Boy,2011-12-21,2011,50000,0,-50000,1.486743
122479,The Private Life of a Cat,1944-12-31,1944,0,0,0,0.352419
122487,The Stationmaster's Wife,1977-07-31,1977,0,0,0,0.686652
122492,The Punk Syndrome,2012-05-04,2012,0,0,0,0.332434
122515,The Great Bank Hoax,1978-11-01,1978,0,0,0,0.818005
122525,Fair of the Dove,1935-12-23,1935,0,0,0,0.06371
122544,The Perfect House,2012-07-17,2012,0,0,0,0.773253
122597,Ping Pong,2012-07-06,2012,0,0,0,0.112029
122619,La Rabbia Di Pasolini,2008-09-05,2008,0,0,0,0.481496
122662,,,,0,0,0,0.0
122671,Who Saw Him Die?,1968-03-18,1968,0,0,0,0.312707
122677,Blood of Ghastly Horror,1972-01-21,1972,0,0,0,0.006668
122698,All the Way Home,1963-10-17,1963,0,0,0,1.406094
122709,Zoo in Budapest,1933-04-28,1933,0,0,0,0.216209
122767,Ground Zero,1987-10-01,1987,0,0,0,0.511308
122787,Kill and Pray,1967-03-10,1967,0,0,0,1.385216
122794,The Karamazov Brothers,2008-04-24,2008,0,0,0,0.607299
122796,Bad Karma,2012-09-12,2012,0,0,0,1.616385
122800,Freelancers,2012-08-10,2012,11000000,0,-11000000,5.973229
122804,Greystone Park,2012-09-06,2012,2000000,0,-2000000,3.431935
122843,The Wedding Video,2012-08-17,2012,0,0,0,1.217544
122857,Universal Soldier: Day of Reckoning,2012-10-04,2012,11500000,1402307,-10097693,12.887287
122884,Of Human Hearts,1938-02-11,1938,0,0,0,0.404973
122894,Journey to the Center of the Earth,1989-07-14,1989,0,0,0,0.196544
122895,The Old Temple,1984-10-15,1984,0,0,0,0.129807
122906,About Time,2013-08-16,2013,12000000,87100449,75100449,11.213913
122917,The Hobbit: The Battle of the Five Armies,2014-12-10,2014,250000000,956019788,706019788,31.718977
122924,One in the Chamber,2012-08-21,2012,6000000,0,-6000000,8.04066
122928,The Letter,2012-09-06,2012,10000000,0,-10000000,1.268026
122930,Breathless,2012-01-04,2012,5000000,0,-5000000,4.983025
122959,Ballroom Dancer,2011-11-20,2011,0,0,0,0.150742
122982,The Secretary,1995-04-12,1995,0,0,0,0.081332
123005,"Allez, Eddy!",2012-03-28,2012,0,0,0,0.114241
123025,"Batman: The Dark Knight Returns, Part 1",2012-09-06,2012,3500000,0,-3500000,12.107182
123047,Turtle Diary,1985-09-10,1985,0,0,0,0.794209
123049,Twice in a Lifetime,1985-10-23,1985,0,0,0,0.86176
123056,Desert Bloom,1986-01-22,1986,0,0,0,1.229428
123074,The Target Shoots First,2000-03-09,2000,0,0,0,0.128629
123075,The Bad Seed,1985-02-07,1985,0,0,0,0.733472
123092,"Eadweard Muybridge, Zoopraxographer",1974-01-01,1974,0,0,0,0.100607
123103,Aftershock,2012-09-12,2012,2000000,58510,-1941490,8.367858
123105,The Bay,2012-09-13,2012,0,30668,30668,6.770051
123107,Hellbenders,2013-10-18,2013,0,0,0,5.28105
123109,No One Lives,2013-03-09,2013,2900000,74918,-2825082,7.202832
123182,Coastlines,2002-01-15,2002,0,0,0,1.084028
123224,Felipe Esparza: They're Not Gonna Laugh At You,2012-01-01,2012,0,0,0,0.012939
123229,Porn in the Hood,2012-07-11,2012,0,103504,103504,9.754955
123235,Paris-Manhattan,2012-07-16,2012,0,0,0,4.200272
123261,90 Minutes,2012-09-21,2012,0,0,0,1.188532
123277,Hellhounds on My Trail: The Afterlife of Robert Johnson,2000-02-28,2000,0,0,0,0.008917
123279,Kathy Griffin: Pants Off,2011-09-20,2011,0,0,0,0.027572
123283,Marilyn in Manhattan,1998-09-05,1998,0,0,0,0.384717
123295,My Reputation,1946-01-26,1946,0,0,0,0.264751
123320,Canned Dreams,2012-01-25,2012,0,0,0,0.043575
123334,TV Junkie,2006-08-03,2006,0,0,0,1.139701
123337,Sight,2012-07-27,2012,0,0,0,1.242355
123354,The Spanish Gardener,1956-12-25,1956,0,0,0,0.694873
123359,Here Comes the Devil,2012-09-11,2012,0,4534,4534,2.540221
123360,From the Journals of Jean Seberg,1995-09-08,1995,0,0,0,0.276401
123362,Painless,2012-10-09,2012,0,0,0,7.609036
123366,The Fifth Season,2012-09-03,2012,0,0,0,0.338773
123375,A Special Day,2012-10-04,2012,0,0,0,1.197777
123377,Pieta,2012-09-05,2012,103000,3623330,3520330,5.194433
123389,Mr. Hush,2010-08-01,2010,200,0,-200,1.553125
123398,Who Killed Vincent Chin?,1987-03-11,1987,0,0,0,0.016318
123406,Fallen,2005-07-05,2005,0,0,0,0.044896
123431,Reincarnated,2012-11-11,2012,0,0,0,4.529236
123432,The Lady Says No,1952-01-06,1952,0,0,0,0.364137
123452,White Banners,1938-06-23,1938,0,0,0,0.176742
123505,A Modern Affair,1996-09-06,1996,0,0,0,0.173207
123553,The Mortal Instruments: City of Bones,2013-08-21,2013,60000000,90565421,30565421,14.336187
123561,A Message from Akira Kurosawa: For Beautiful Movies,2000-04-01,2000,0,0,0,0.002224
123581,McConkey,2013-09-30,2013,0,0,0,0.132019
123592,Korkusuz Korkak,1979-01-01,1979,0,0,0,0.216024
123601,Sosyete ≈ûaban,1985-01-01,1985,0,0,0,0.986037
123611,Tokat√ßƒ±,1983-01-01,1983,0,0,0,0.567282
123620,Spike of Bensonhurst,1988-11-11,1988,0,0,0,0.037969
123623,A Summer Story,1988-08-11,1988,0,0,0,1.123477
123628,We Think the World of You,1988-12-22,1988,0,0,0,0.950193
123634,Poolside,2012-01-01,2012,400,0,-400,0.088651
123648,The Land,1969-01-01,1969,0,0,0,0.290017
123665,Dragon Seed,1944-07-20,1944,0,0,0,0.602598
123678,The Act of Killing,2012-08-31,2012,1000000,444575,-555425,6.373118
123680,What Darwin Didn't Know,2009-11-29,2009,0,0,0,0.005883
123690,The Afternoon of a Torturer,2001-09-07,2001,0,0,0,0.871263
123691,Dream Deceivers: The Story Behind James Vance vs. Judas Priest,1992-08-06,1992,0,0,0,0.061678
123707,Next Stop Paradise,1998-09-09,1998,0,0,0,0.237125
123712,"Why Are the Bells Ringing, Mitica?",1981-09-26,1981,0,0,0,0.273568
123723,Gigi,1949-10-05,1949,0,0,0,0.43086
123728,The Empty Mirror,1996-04-09,1996,0,0,0,0.041825
123730,Dog Tags,1987-12-11,1987,0,0,0,0.001133
123742,Junkopia,1981-01-01,1981,0,0,0,0.012313
123757,All the Vermeers in New York,1990-09-11,1990,0,0,0,4e-06
123763,"I, the Worst of All",1990-08-09,1990,0,0,0,0.202495
123770,The Last of the Finest,1990-03-09,1990,0,0,0,6.313545
123772,Mister Johnson,1990-09-08,1990,0,0,0,5.309937
123777,Sink or Swim,1990-09-30,1990,0,0,0,0.070603
123778,Strangers in Good Company,1990-10-01,1990,0,0,0,0.000578
123782,Sure Fire,1990-09-09,1990,0,0,0,3.8e-05
123787,Weed,1972-04-01,1972,0,0,0,1.5e-05
123833,Possible Loves,2001-01-22,2001,0,0,0,0.388631
123846,Prime Mover,2009-02-08,2009,5000000,0,-5000000,0.344015
123858,Scab,2005-10-21,2005,0,0,0,0.039266
123867,Panda! Go Panda!: Rainy Day Circus,1973-03-16,1973,0,0,0,0.879285
123868,Destination Gobi,1953-03-20,1953,0,0,0,0.200945
123879,Say Uncle,2005-07-10,2005,650000,0,-650000,1.287796
123897,Cave In!,1983-06-19,1983,0,0,0,0.304105
123938,Thousand Pieces of Gold,1991-04-26,1991,0,0,0,0.099294
123949,Kokoko,2012-06-14,2012,0,0,0,0.697572
123961,Which Way to the Front?,1970-09-03,1970,0,0,0,1.105048
123964,Miss Blue Jeans,2012-08-03,2012,1970000,0,-1970000,0.491187
123969,The Backwater Gospel,2011-01-01,2011,0,0,0,0.29283
123979,To Die By Your Side,2011-05-14,2011,0,0,0,0.618948
124013,A Crime,1993-08-04,1993,0,0,0,0.334297
124019,A Well Spent Life,1971-01-01,1971,0,0,0,0.050521
124026,The Fiend of Dope Island,1961-01-01,1961,0,0,0,0.001966
124029,A Million to Juan,1994-05-15,1994,0,1221832,1221832,0.535028
124042,Buried Secrets,1996-11-04,1996,0,0,0,0.256955
124054,Shark Week,2012-08-04,2012,0,0,0,1.218973
124057,Kids of the Round Table,1997-07-08,1997,0,0,0,0.307075
124058,A Gathering of Eagles,1963-06-21,1963,0,0,0,0.674983
124067,The Central Park Five,2012-05-24,2012,0,273747,273747,2.24163
124069,Far Out Isn't Far Enough: The Tomi Ungerer Story,2012-10-15,2012,0,0,0,0.137666
124071,How to Make Money Selling Drugs,2012-09-07,2012,0,0,0,2.977883
124073,Iceberg Slim: Portrait of a Pimp,2012-09-08,2012,0,0,0,1.036773
124074,Mea Maxima Culpa: Silence in the House of God,2012-11-16,2012,0,0,0,1.442038
124075,More Than Honey,2012-08-10,2012,0,0,0,3.289057
124080,Shepard & Dark,2012-09-11,2012,0,0,0,0.228558
124083,Guelwaar,1993-07-28,1993,0,0,0,0.043092
124085,Hyenas,1992-09-18,1992,0,0,0,0.013026
124088,Just Another Girl on the I.R.T.,1993-01-01,1993,0,0,0,0.088937
124091,The Legend of Kaspar Hauser,2012-01-30,2012,0,0,0,1.031736
124096,"Olivier, Olivier",1992-10-28,1992,0,0,0,0.86917
124097,Eddie's Million Dollar Cook Off,2003-07-18,2003,0,0,0,1.079055
124101,Rock Hudson's Home Movies,1992-09-12,1992,0,0,0,0.000809
124108,Gotta Kick It Up,2002-07-26,2002,0,0,0,0.609379
124111,Jett Jackson: The Movie,2001-06-08,2001,0,0,0,1.244915
124115,Four Wives,1939-12-25,1939,0,0,0,0.174601
124122,Little Mother,1973-01-05,1973,0,0,0,0.134084
124124,Grave Secrets,1989-07-14,1989,0,0,0,0.612948
124134,"Up, Up, and Away",2000-01-22,2000,0,0,0,3.112302
124157,The Thieves,2012-07-25,2012,0,83519699,83519699,3.863016
124167,Alphabet City,1984-03-04,1984,0,0,0,1.35099
124198,Monobloc,2006-10-19,2006,0,0,0,0.444774
124202,I Carabbinieri,1981-04-24,1981,0,0,0,0.088992
124207,The Devil and Holy Water,1983-09-01,1983,0,0,0,0.049057
124210,First Family,1980-12-25,1980,0,0,0,0.981525
124217,The Ice Dragon,2012-02-24,2012,0,0,0,0.607721
124227,Attack on the Iron Coast,1968-06-05,1968,0,0,0,0.984142
124250,The Cavern,1964-06-26,1964,0,0,0,0.195455
124277,The Maker,2011-06-01,2011,0,0,0,1.675201
124294,R2B: Return to Base,2012-08-14,2012,10000000,0,-10000000,2.634185
124295,Anna,1994-02-16,1994,0,0,0,0.464036
124298,Kitchen Party,1997-09-08,1997,0,0,0,0.29947
124304,I Don't Want to Talk About It,1993-05-20,1993,0,0,0,1.213481
124306,My Life and Times With Antonin Artaud,1993-01-01,1993,0,0,0,0.000308
124315,Sopyonje,1993-04-10,1993,0,0,0,1.493787
124393,The Other Hell,1981-01-22,1981,0,0,0,0.694984
124409,Expect No Mercy,1995-02-28,1995,0,0,0,1.071934
124414,Pictures of the Old World,1972-01-01,1972,0,0,0,0.008267
124423,The Living Skeleton,1968-11-09,1968,0,0,0,0.809741
124429,Badman's Country,1958-08-02,1958,0,0,0,0.036546
124459,The Incredible Burt Wonderstone,2013-03-14,2013,30000000,27437881,-2562119,9.385769
124460,Country Life,1994-10-27,1994,0,0,0,0.487357
124461,A Glimpse Inside the Mind of Charles Swan III,2012-11-15,2012,0,0,0,3.042514
124470,Exists,2014-03-17,2014,0,0,0,5.364259
124471,Painted Skin: The Resurrection,2012-06-28,2012,0,0,0,3.652211
124472,A Great Day in Harlem,1994-09-27,1994,0,0,0,0.076352
124475,La s√©paration,1994-11-09,1994,0,0,0,0.533479
124480,Father,2010-11-12,2010,0,0,0,0.765538
124484,The Mystery of Rampo,1994-06-25,1994,0,0,0,0.577259
124501,In the Dark Half,2012-08-10,2012,482910,0,-482910,0.613206
124504,What Am I Doing in the Middle of the Revolution?,1972-12-18,1972,0,0,0,0.622694
124505,Afro Tanaka,2012-02-18,2012,0,0,0,0.784833
124517,Emotion,1966-01-01,1966,0,0,0,0.300704
124521,Dead on Course,1952-04-01,1952,0,0,0,0.732315
124523,Joni,1979-06-01,1979,0,0,0,0.002717
124524,When the Bough Breaks,1994-05-07,1994,0,0,0,1.86888
124527,Face the Music,1954-01-29,1954,0,0,0,0.165241
124581,Outside the Law,2002-06-25,2002,0,0,0,0.308842
124582,"I Lived, But...",1983-10-29,1983,0,0,0,0.373501
124597,Genocide,1968-11-09,1968,0,0,0,0.313494
124606,Bang,1995-09-09,1995,0,0,0,0.679528
124611,Time to Love,1965-10-09,1965,0,0,0,0.546324
124613,Brothers in Trouble,1995-08-23,1995,0,0,0,0.594716
124614,The Convent,1995-09-06,1995,0,0,0,1.606957
124619,Lotto Land,1995-06-01,1995,0,0,0,0.042365
124623,I Know That Voice,2013-11-06,2013,0,0,0,6.715162
124625,My Mother's Courage,1995-09-12,1995,0,0,0,0.622885
124626,Nico Icon,1995-02-18,1995,0,0,0,0.133893
124630,Film Is a Girl & a Gun,2009-12-04,2009,0,0,0,0.361771
124632,Small Wonders,1995-01-01,1995,0,0,0,0.00264
124633,Someone Else's America,1995-09-09,1995,0,0,0,0.099602
124636,Sonic Outlaws,1995-08-01,1995,0,0,0,0.001838
124639,Target,1995-08-01,1995,0,0,0,0.001205
124642,To Have (Or Not),1995-12-27,1995,0,0,0,0.014329
124645,Two Deaths,1995-09-10,1995,0,0,0,0.145092
124676,The Bloody Child,1996-10-26,1996,0,0,0,0.001287
124680,Broken English,1996-09-09,1996,0,0,0,0.369118
124762,Inori,2012-08-04,2012,0,0,0,0.119277
124821,Eden,1996-01-01,1996,0,0,0,0.555276
124829,The Line King: The Al Hirschfeld Story,1996-09-27,1996,0,0,0,0.001663
124834,Mondo,1995-06-01,1995,0,0,0,0.311968
124837,A Perfect Candidate,1996-06-19,1996,0,0,0,0.112669
124839,Predictions of Fire,1996-10-02,1996,0,0,0,0.038007
124843,Ripe,1996-09-10,1996,0,0,0,0.773608
124847,Stella Does Tricks,1997-11-06,1997,0,0,0,0.81627
124851,Sweet Nothing,1995-06-08,1995,0,0,0,0.234665
124853,Ten Benny,1995-04-09,1995,0,0,0,0.064219
124857,Trojan Eddie,1996-09-09,1996,0,0,0,0.330621
124902,A Dangerous Man: Lawrence After Arabia,1992-04-18,1992,0,0,0,0.488758
124905,Godzilla,2014-05-14,2014,160000000,529076069,369076069,14.019239
124963,Monsignor,1982-10-22,1982,0,0,0,0.744858
124972,Generation Um...,2012-07-11,2012,0,0,0,3.137385
124979,Juha,1937-01-24,1937,0,0,0,0.149603
124980,Land of Dreams,1988-02-08,1988,0,0,0,0.50104
124993,Hindle Wakes,1927-09-12,1927,0,0,0,0.101284
124994,Flame of My Love,1949-02-13,1949,0,0,0,0.238122
124998,Method to the Madness of Jerry Lewis,2011-12-17,2011,0,0,0,1.513452
125021,The Designated Mourner,1997-05-23,1997,0,0,0,0.152272
125025,East Side Story,1997-06-25,1997,0,0,0,0.037099
125034,Out Of The Clear Blue Sky,2012-08-17,2012,0,0,0,0.298574
125039,Genealogies of a Crime,1997-05-04,1997,0,0,0,0.690026
125052,Hurricane Streets,1997-01-21,1997,0,0,0,0.629699
125063,The Glitterball,1977-01-01,1977,0,0,0,0.165267
125077,Munchie Strikes Back,1994-08-01,1994,0,0,0,0.778371
125087,Reggie's Prayer,1996-08-01,1996,0,0,0,0.008917
125093,Too Much Sleep,1997-03-07,1997,0,0,0,0.001177
125099,Unmade Beds,1997-09-10,1997,0,0,0,0.037594
125103,Who the Hell Is Juliette?,1997-09-05,1997,0,0,0,0.100488
125109,Dragonworld,1994-08-01,1994,0,0,0,0.311555
125114,George's Island,1989-08-15,1989,0,0,0,0.002801
125123,Among Giants,1998-06-24,1998,0,0,0,0.381749
125124,The Best Man,1997-10-28,1997,0,0,0,0.114411
125136,The Cherry Orchard: Blossoming,2008-11-08,2008,0,0,0,0.159569
125140,The Truth of Lie,2011-10-27,2011,0,0,0,0.420241
125141,Hell Behind the Bars,1984-01-26,1984,0,0,0,0.003013
125148,Young Policemen in Love,1995-11-01,1995,0,0,0,0.006898
125150,Galician Caress (of Clay),1995-01-01,1995,0,0,0,0.4161
125154,Fire in Castilla (Tactilvision from the Moor of the Fright),1961-04-30,1961,0,0,0,0.337238
125161,Milky Way,2007-08-07,2007,0,0,0,0.074209
125164,Rafa,2012-05-10,2012,0,0,0,0.390674
125217,A Sun-Tribe Myth from the Bakumatsu Era,1957-07-14,1957,0,0,0,1.218546
125229,Samurai Vendetta,1959-11-22,1959,0,0,0,0.11533
125232,The Ball at the Anjo House,1947-09-27,1947,0,0,0,0.324349
125233,An Unexpected Love,2003-03-24,2003,0,0,0,0.578154
125249,The Bat Man,1943-07-16,1943,0,0,0,0.979481
125257,Muddy River,1981-01-30,1981,0,0,0,0.000308
125263,Broken Vessels,1998-04-18,1998,0,0,0,0.117541
125264,Carmen Comes Home,1951-03-21,1951,0,0,0,0.476264
125271,"Tora-san, Our Lovable Tramp",1969-08-27,1969,0,0,0,0.116077
125276,Secret Chronicle: She Beast Market,1974-09-11,1974,0,0,0,1.783356
125300,Hi-Life,1998-11-27,1998,0,0,0,0.602657
125302,Puck Hogs,2009-06-02,2009,0,0,0,0.221525
125305,Landscape Suicide,1987-08-01,1987,0,0,0,0.015894
125313,The Outskirts,1998-10-04,1998,0,0,0,0.183471
125316,Praise,1998-09-11,1998,0,0,0,0.109206
125317,The Quarry,1998-09-09,1998,0,0,0,0.203067
125336,The Story of Film: An Odyssey,2011-09-03,2011,0,0,0,1.50251
125337,The Last Seduction II,1999-06-08,1999,0,0,0,0.714564
125344,Independence,2010-04-21,2010,0,0,0,0.192231
125360,Julie Johnson,2001-01-01,2001,0,0,0,0.324143
125374,Minamata: The Victims and Their World,1971-03-12,1971,0,0,0,0.035301
125395,Partners in Crime,2012-08-20,2012,0,0,0,1.472975
125409,Kiss and Tell,1996-11-09,1996,0,0,0,1.971676
125413,Fear Strikes Out,1957-03-20,1957,0,0,0,0.647084
125414,The Final Member,2012-05-01,2012,0,0,0,0.516928
125458,"North and South, Book II",1986-05-04,1986,0,0,0,1.080461
125464,A Cosmic Christmas,1977-12-04,1977,0,0,0,0.005351
125472,In God We Teach,2011-11-01,2011,500000,0,-500000,0.044173
125490,Antiviral,2012-09-19,2012,2400000,0,-2400000,10.540581
125495,Le Mataf,1973-06-14,1973,0,0,0,0.087258
125498,Kids World,2001-12-07,2001,0,0,0,0.683109
125504,A Christmas Story 2,2012-09-06,2012,0,0,0,1.526826
125506,Getting to Know You,1999-01-22,1999,0,0,0,0.330882
125509,Wrong Turn 5: Bloodlines,2012-10-23,2012,0,0,0,10.556938
125510,Slayers Great,1997-08-02,1997,0,0,0,0.232553
125512,Dinosaurs!  A Fun-Filled Trip Back In Time,1987-01-01,1987,0,0,0,0.004948
125513,Slayers Premium,2001-12-22,2001,0,0,0,0.143157
125520,Miss Julie,1999-09-12,1999,0,0,0,0.994953
125521,Slayers Return,1996-08-03,1996,0,0,0,1.268018
125527,The Other,1999-05-26,1999,0,0,0,0.160019
125531,Pripyat,1999-09-11,1999,0,0,0,0.03668
125537,Smiling Fish & Goat On Fire,1999-09-16,1999,0,0,0,0.071495
125541,Chouga,2007-09-18,2007,0,0,0,0.039349
125548,The 24 Hour Woman,1999-01-29,1999,0,0,0,1.403627
125550,Two Women,1999-01-01,1999,0,0,0,0.051111
125553,Wadd: The Life & Times of John C. Holmes,1999-09-09,1999,0,0,0,0.294074
125558,Among Friends,2012-07-08,2012,0,0,0,3.825472
125578,Twenty Million Sweethearts,1934-05-26,1934,0,0,0,0.480081
125582,Down in the Delta,1998-12-25,1998,0,0,0,0.670559
125587,Nothing Personal,1996-10-18,1996,0,0,0,0.064512
125607,Spare Bed-Room,1969-01-01,1969,0,0,0,0.113474
125619,The forbidden education,2012-08-13,2012,0,0,0,0.872312
125623,The Other Son,2012-04-02,2012,0,0,0,2.611671
125666,Killer Shark,1950-03-19,1950,0,0,0,0.331561
125673,The Battle at Elderbush Gulch,1913-01-01,1913,0,0,0,0.196528
125680,The Almost Man,2012-09-14,2012,0,0,0,0.116897
125695,BookWars,2000-03-11,2000,0,0,0,0.001293
125696,The Cashier Wants to Go to the Seaside,2001-11-13,2001,0,0,0,0.109486
125700,Faat Kin√©,2001-02-11,2001,0,0,0,0.08158
125705,Hamlet,2000-12-10,2000,0,0,0,0.584251
125707,Innocence,2000-09-08,2000,0,0,0,0.453886
125709,Joe Gould's Secret,2000-01-21,2000,0,0,0,1.063547
125717,Time of Favor,2000-11-30,2000,0,0,0,0.167601
125727,Uttara,2000-08-30,2000,0,0,0,0.001196
125736,The Crowd Roars,1932-04-16,1932,0,0,0,0.809034
125742,The 10th District Court: Moments of Trial,2004-06-02,2004,0,0,0,0.636021
125749,The Gaucho,1927-11-21,1927,0,0,0,0.602791
125759,A Soldier's Sweetheart,1998-06-09,1998,0,0,0,0.053375
125762,Shattered Image,1998-12-04,1998,0,0,0,0.050217
125764,In The Winter Dark,1998-09-10,1998,0,0,0,0.058586
125769,Angel,1982-09-18,1982,0,0,0,0.23401
125795,Bread and Milk,2001-03-31,2001,0,0,0,0.218845
125806,Dischord,2001-08-01,2001,0,0,0,0.113078
125835,Julayi,2012-08-09,2012,0,0,0,0.943387
125842,Shot in the Heart,2001-10-13,2001,0,0,0,0.498746
125858,Tokyo.sora,2002-10-26,2002,0,0,0,0.869632
125873,Bulldog Drummond in Africa,1938-08-05,1938,0,0,0,1.033969
125874,Love & Savagery,2009-08-06,2009,0,0,0,0.53548
125882,The Ox,1991-11-22,1991,0,0,0,0.666862
125889,Stars and the Water Carriers,1974-08-14,1974,0,0,0,0.002785
125891,Intermezzo,1936-11-16,1936,0,0,0,0.745522
125911,EM,2008-06-05,2008,0,0,0,0.439646
125926,√Öke and His World,1984-10-26,1984,0,0,0,0.331461
125943,Flower & Garnet,2002-08-26,2002,0,0,0,0.017604
125945,Kedma,2002-05-05,2002,0,0,0,0.193054
125946,The Last Letter,2002-05-21,2002,0,0,0,0.002358
125948,Red Bear,2002-05-23,2002,0,0,0,1.071851
125949,My Girlfriend's Wedding,1969-01-01,1969,0,0,0,0.052391
125952,Seaside,2002-05-01,2002,0,0,0,0.69918
125953,Sister Helen,2002-03-04,2002,0,0,0,0.102117
125958,The Blood Oranges,1998-10-01,1998,0,0,0,0.325084
125990,The Hunt for the Unicorn Killer,1999-05-09,1999,0,0,0,1.018226
126004,Five,2003-12-01,2003,0,0,0,0.053844
126015,America before Columbus,2009-11-22,2009,0,0,0,0.04366
126016,Johnny Cash at Folsom Prison,2008-10-18,2008,717000,0,-717000,0.007134
126031,A Woman Called Golda,1982-04-26,1982,0,0,0,0.660673
126043,Cartola - M√∫sica Para os Olhos,2007-04-06,2007,0,0,0,0.00353
126056,The Naughty Room,2012-01-01,2012,0,0,0,0.01153
126076,The Pilot's Wife,2005-08-17,2005,0,0,0,0.883403
126083,If You Could Only Cook,1935-12-30,1935,0,0,0,0.430813
126090,Fuse,2003-08-15,2003,0,0,0,1.557965
126104,The Magic Gloves,2003-09-08,2003,0,0,0,0.128019
126108,Playing 'In the Company of Men',2003-05-15,2003,0,0,0,0.354604
126117,"This So-Called Disaster: Sam Shepard Directs ""The Late Henry Moss""",2003-01-01,2003,0,0,0,0.053866
126122,The Mind Reader,1933-04-01,1933,0,0,0,0.273441
126127,Rafter Romance,1933-09-01,1933,0,0,0,0.275198
126132,The Act of Seeing with One's Own Eyes,1971-01-01,1971,0,0,0,0.497952
126136,Our Daily Bread,1934-10-02,1934,0,0,0,0.493431
126140,Digital Dharma,,,0,0,0,0.000199
126141,The Case of the Grinning Cat,2004-12-05,2004,0,0,0,0.157945
126143,Of Two Minds,2012-11-01,2012,0,0,0,0.390121
126148,Lightning in a Bottle,2004-02-12,2004,0,0,0,0.161543
126152,With Friends Like These...,1998-09-10,1998,0,0,0,0.056395
126172,Leprechaun: Origins,2014-08-22,2014,0,0,0,4.438003
126186,Shanghai Calling,2012-05-03,2012,0,0,0,0.907309
126204,Black Ice,1994-01-01,1994,0,0,0,0.235578
126208,Stellar,1993-01-01,1993,0,0,0,0.51002
126219,A Hen in the Wind,1948-09-17,1948,0,0,0,0.262956
126227,Desolation Canyon,2006-01-06,2006,0,0,0,0.570874
126234,Pirated Copy,2004-10-21,2004,0,0,0,0.151529
126238,Ten Skies,2004-11-21,2004,0,0,0,0.10836
126250,Love Is All You Need,2012-09-04,2012,5500000,10016934,4516934,4.711231
126265,Not Wanted,1949-06-24,1949,0,0,0,0.164728
126277,American Mary,2012-05-31,2012,0,0,0,9.912269
126278,Vampir-Cuadecuc,1971-05-17,1971,0,0,0,0.343475
126300,Kilometre Zero,2005-05-12,2005,0,0,0,0.245309
126306,Sugar,2013-04-06,2013,0,0,0,0.579485
126313,Quixote,1965-01-01,1965,0,0,0,0.001188
126314,Final Cut: Ladies and Gentlemen,2012-02-04,2012,0,0,0,1.125148
126315,After Lucia,2012-10-03,2012,0,0,0,2.511322
126318,Miss Lovely,2012-05-24,2012,0,0,0,0.26877
126319,Ernest & Celestine,2012-12-12,2012,12516654,8109160,-4407494,7.225779
126321,Three Worlds,2012-12-05,2012,0,0,0,0.554759
126323,Mine Games,2012-12-01,2012,1500000,0,-1500000,5.590491
126331,The Invisible Ones,2012-11-28,2012,0,0,0,0.878522
126337,Unconditional,2012-09-21,2012,2000000,0,-2000000,7.536984
126376,Casa de Lava,1995-02-10,1995,0,0,0,1.430895
126402,Milestones,1975-10-08,1975,0,0,0,0.008903
126413,Sandow,1896-12-30,1896,0,0,0,0.237073
126415,Pride and Vengeance,1967-12-22,1967,0,0,0,0.956631
126418,Should Ladies Behave,1933-12-01,1933,0,0,0,0.001988
126420,On Top of the Whale,1982-02-04,1982,0,0,0,0.152792
126421,Seven Dollars on the Red,1966-03-16,1966,0,0,0,1.800826
126423,A Poem is a Naked Person,1974-01-01,1974,0,0,0,0.075725
126432,Scattered Clouds,1967-11-18,1967,0,0,0,0.725312
126442,Alter Egos,2012-07-20,2012,0,0,0,1.125844
126464,Victim,2011-10-02,2011,0,0,0,0.471157
126509,2016: Obama's America,2012-07-13,2012,2500000,33400000,30900000,1.221216
126516,Every-Night Dreams,1933-06-08,1933,0,0,0,0.342271
126517,Street Without End,1934-04-26,1934,0,0,0,0.62533
126523,Taming of the Fire,1972-04-12,1972,0,0,0,0.10575
126550,Raw Edge,1956-03-24,1956,0,0,0,0.526828
126555,Princess Goldilocks,1973-01-28,1973,0,0,0,0.000844
126560,Bride of the Earth,1968-04-01,1968,0,0,0,0.074161
126563,The American Dreamer,1971-04-01,1971,0,0,0,0.726015
126596,The Mudlark,1950-11-28,1950,0,0,0,0.942526
126597,Down to the Cellar,1983-10-31,1983,0,0,0,0.020031
126610,RR,2007-11-02,2007,0,0,0,0.330803
126644,By the Law,1926-01-01,1926,0,0,0,0.375273
126676,Les toits de Paris,2007-08-10,2007,0,0,0,0.112386
126692,Prelude: Dog Star Man,1962-08-02,1962,0,0,0,0.863439
126706,The Legend of Lizzie Borden,1975-02-10,1975,0,0,0,0.593118
126712,Superman,1948-07-15,1948,0,0,0,0.971064
126729,Slingshot Hip Hop,2008-01-18,2008,0,0,0,0.07436
126732,Snow,2008-05-20,2008,0,0,0,0.463261
126748,The Baby Dance,1998-08-23,1998,0,0,0,0.1034
126749,Travelling Salesman,2012-06-16,2012,12000,0,-12000,0.80519
126754,The Forgotten One,1989-09-27,1989,0,0,0,0.19402
126757,100 Bloody Acres,2012-08-04,2012,0,0,0,3.693288
126759,Address Unknown,1944-06-01,1944,0,0,0,0.398218
126760,Cancel My Reservation,1972-09-21,1972,0,0,0,0.372144
126777,If I Were King,1938-09-28,1938,0,0,0,0.142013
126781,The Last Angry Man,1959-10-22,1959,0,0,0,0.099822
126783,The Spanish Earth,1937-07-10,1937,0,0,0,0.171714
126797,Mental,2012-10-04,2012,0,0,0,2.643849
126816,I Can Make You Love Me,1993-02-09,1993,0,0,0,0.147578
126820,Baseball,1994-09-18,1994,0,0,0,0.145073
126832,Stan,2006-06-06,2006,0,0,0,0.398725
126841,Jack Brown: Genius,1994-07-11,1994,0,0,0,0.465965
126846,The Adventures of Sherlock Holmes and Doctor Watson: King of Blackmailers,1980-01-01,1980,0,0,0,0.572904
126862,Dead Europe,2012-06-14,2012,0,0,0,1.312599
126863,"Tom, Tom, the Piper's Son",1969-01-01,1969,0,0,0,0.100414
126879,Atomic Age,2012-11-27,2012,0,0,0,2.225938
126881,The Trio,1998-01-29,1998,0,0,0,0.180645
126883,The Wild Ones,2012-10-04,2012,0,0,0,0.053178
126889,Alien: Covenant,2017-05-09,2017,97000000,232380243,135380243,72.884078
126919,The Scapegoat,1959-08-06,1959,0,0,0,0.759452
126922,Lawyer Man,1933-01-07,1933,0,0,0,0.072534
126925,Gretchen the Greenhorn,1916-09-03,1916,0,0,0,0.153125
126927,The Devil's Widow,1970-12-01,1970,0,0,0,0.912847
126929,Roman Polanski: Odd Man Out,2012-09-09,2012,0,0,0,0.325527
126934,A Ring of Endless Light,2002-07-04,2002,0,0,0,0.770331
126947,Fraternity Row,1977-06-03,1977,0,0,0,0.59935
126958,The Tournament,1929-02-18,1929,0,0,0,0.099994
126963,Dragon Ball Z: Battle of Gods,2013-03-30,2013,0,50353002,50353002,10.834344
126969,Man of the Story,1996-09-06,1996,0,0,0,0.071578
126996,Marcello Mastroianni: I Remember,1997-08-29,1997,0,0,0,0.614407
127016,Dead in the Water,2002-02-12,2002,0,0,0,0.994133
127017,The Inside of the White Slave Traffic,1913-01-01,1913,0,0,0,0.003312
127021,Dibu 2: La venganza de Nasty,1998-07-02,1998,0,0,0,0.006369
127040,Pick a Star,1937-03-21,1937,0,0,0,0.506223
127083,It Rains in My Village,1968-01-01,1968,0,0,0,0.607027
127091,"Shoot First, Die Later",1974-07-12,1974,0,0,0,1.061447
127092,Nick the Sting,1976-09-14,1976,0,0,0,0.164336
127094,Apparitions,1903-10-16,1903,0,0,0,0.353632
127097,The Enchanted Well,1903-01-01,1903,0,0,0,0.336612
127098,Extraordinary Illusions,1903-01-01,1903,0,0,0,0.141611
127105,The Lonely Villa,1909-06-10,1909,0,0,0,0.517049
127142,The City Tramp,1966-01-01,1966,0,0,0,0.248846
127144,"Don't Hug Me, I'm Scared",2011-07-25,2011,0,0,0,1.260183
127146,Dr. Monica,1934-06-23,1934,0,0,0,0.365896
127148,Dog Star Man: Part II,1963-01-09,1963,0,0,0,0.666932
127150,How to Eat Your Watermelon in White Company (and Enjoy It),2005-01-01,2005,0,0,0,0.050135
127186,The Rebel Set,1959-06-28,1959,0,0,0,0.638911
127224,Sioux Ghost Dance,1894-09-23,1894,0,0,0,0.154522
127236,Me Too,2012-09-07,2012,0,0,0,1.375641
127257,Every Stewardess Goes to Heaven,2002-03-21,2002,0,0,0,0.166116
127259,New Year Sacrifice,1956-01-01,1956,0,0,0,0.054114
127286,Women Talking Dirty,2001-12-07,2001,0,0,0,1.304572
127304,Dibu 3,2002-01-01,2002,0,0,0,0.004612
127320,Dog Star Man: Part III,1964-02-05,1964,0,0,0,0.54554
127323,Dog Star Man: Part IV,1964-09-17,1964,0,0,0,0.53857
127326,The Hands,2006-08-10,2006,0,0,0,0.110295
127329,Naked Soldier,2012-08-15,2012,0,0,0,1.170411
127363,Everyday,2012-11-15,2012,0,0,0,0.722789
127367,When Day Breaks,2012-08-17,2012,0,0,0,0.338076
127369,The End of Time,2012-08-03,2012,0,0,0,0.303772
127370,Song for Marion,2012-09-15,2012,0,1697294,1697294,4.11326
127372,Emperor,2012-09-14,2012,0,3346265,3346265,6.159679
127373,What Maisie Knew,2013-05-02,2013,6000000,1066471,-4933529,8.535611
127374,Arthur Newman,2012-09-07,2012,0,0,0,4.469269
127375,America's Most Haunted Inns,,,20,0,-20,0.0
127380,Finding Dory,2016-06-16,2016,200000000,1028570889,828570889,14.477677
127391,The Merry Skeleton,1898-01-01,1898,0,0,0,0.805851
127413,Somewhere Tonight,2011-07-08,2011,0,0,0,0.187489
127424,Nazareno Cruz and the Wolf,1975-06-05,1975,0,0,0,0.184094
127445,Rain,2008-03-28,2008,0,0,0,0.119031
127451,"High Tech, Low Life",2012-04-19,2012,0,0,0,0.102274
127468,The Amateur,1999-04-22,1999,0,0,0,0.00561
127471,"Pizza, Beer, and Cigarettes",1998-01-15,1998,0,0,0,0.186823
127475,The Revengers,1972-06-21,1972,0,0,0,2.252723
127493,Stolen,2012-05-17,2012,35000000,2106557,-32893443,7.759429
127495,Graceland,2012-04-20,2012,0,0,0,0.907504
127497,Backwards,2012-09-21,2012,0,0,0,1.100896
127501,Barfi,2012-09-14,2012,4437508,2804874,-1632634,3.779077
127505,Head Games,2012-09-21,2012,0,14056,14056,0.182227
127509,Bad 25,2012-11-22,2012,0,0,0,0.929422
127517,Disconnect,2012-09-11,2012,10000000,3428048,-6571952,12.18812
127521,6 Bullets,2012-09-11,2012,10000000,0,-10000000,7.293335
127531,Deewaar: Let's Bring Our Heroes Home,2004-06-25,2004,0,0,0,0.003405
127533,Rurouni Kenshin,2012-08-25,2012,0,61700000,61700000,7.916658
127540,The Iran Job,2012-09-28,2012,0,0,0,0.287511
127544,009 Re: Cyborg,2012-10-27,2012,0,0,0,1.607827
127546,Driving Me Crazy,1988-09-10,1988,0,0,0,0.00273
127560,The Railway Man,2013-12-26,2013,18000000,22309223,4309223,6.099421
127564,The Last Hunt,1956-04-30,1956,0,0,0,1.02282
127585,X-Men: Days of Future Past,2014-05-15,2014,250000000,747862775,497862775,26.058586
127594,CLONED: The Recreator Chronicles,2012-02-16,2012,0,0,0,2.475546
127602,Happy Go Lovely,1951-03-06,1951,0,0,0,0.074823
127608,The Adventures of Sherlock Holmes and Doctor Watson: The Treasures of Agra,1983-06-25,1983,0,0,0,0.360604
127614,Almost 18,2012-03-09,2012,0,0,0,0.845036
127642,Feng Shui,2004-09-18,2004,0,0,0,0.814716
127651,The Seasoning House,2012-08-21,2012,0,0,0,4.565307
127668,The Father of a Soldier,1964-01-01,1964,0,0,0,0.983858
127687,Tapestries of Hope,2010-09-28,2010,0,0,0,0.006246
127688,Expresso Bongo,1959-12-01,1959,0,0,0,0.117056
127700,The Newest Pledge,2012-08-28,2012,0,0,0,0.010466
127702,La Se√±al,2007-09-13,2007,0,0,0,0.575554
127728,8:46,2011-09-11,2011,0,0,0,0.714819
127756,Hitman's Run,1999-01-01,1999,0,0,0,0.115801
127760,Uno contro l'altro praticamente amici,1980-12-01,1980,0,0,0,0.514834
127762,Baignade en Mer,1895-12-28,1895,0,0,0,0.429666
127770,Apostle Peter and the Last Supper,2012-02-20,2012,750000,0,-750000,0.843333
127776,Because They're Young,1960-04-01,1960,0,0,0,0.091664
127798,Chad Hanna,1940-12-25,1940,0,0,0,0.842653
127803,3 Times a Charm,2011-01-01,2011,0,0,0,0.791178
127808,All The Fine Young Cannibals,1960-09-15,1960,0,0,0,0.315493
127812,Ars√®ne Lupin Returns,1938-02-25,1938,0,0,0,0.412253
127817,Blinkity Blank,1955-01-01,1955,0,0,0,0.245883
127818,Eyes of the Mothman,2011-02-22,2011,0,0,0,0.153558
127846,A Hijacking,2012-02-26,2012,0,0,0,5.945296
127847,7 Boxes,2012-08-10,2012,0,0,0,3.703585
127849,Double Tap,2000-05-27,2000,0,0,0,0.724986
127853,Artifact,2012-09-14,2012,0,0,0,6.637049
127856,Augustine,2012-11-07,2012,0,0,0,1.435618
127862,Blackbird,2012-09-09,2012,0,0,0,1.019956
127864,Blancanieves,2012-09-21,2012,0,279735,279735,4.048978
127866,Boy Eating the Bird's Food,2012-09-27,2012,0,0,0,0.440456
127867,The Brass Teapot,2012-09-08,2012,0,0,0,10.642891
127872,Call Girl,2012-11-09,2012,6075000,0,-6075000,3.908079
127878,Casting By,2012-09-09,2012,0,0,0,2.156181
127880,Clandestine Childhood,2011-09-20,2011,0,0,0,1.01965
127884,Come Out and Play,2012-09-13,2012,0,0,0,8.568944
127894,Do Not Disturb,2012-10-03,2012,5000000,0,-5000000,1.714187
127901,Eat Sleep Die,2012-10-05,2012,0,0,0,0.962442
127905,First Comes Love,2013-05-13,2013,500000,0,-500000,0.11618
127913,The Deep,2012-09-07,2012,3000000,0,-3000000,2.469216
127916,The Fitzgerald Family Christmas,2012-09-09,2012,0,0,0,1.226389
127918,The Gatekeepers,2012-07-09,2012,0,0,0,3.271813
127929,Death By China,2012-08-17,2012,0,0,0,0.128842
127962,Leviathan,2012-08-09,2012,0,0,0,1.564398
127973,Six of a Kind,1934-02-09,1934,0,0,0,0.52878
127987,The Delightful Forest,1972-09-20,1972,0,0,0,0.523078
128006,Speedway,1929-10-07,1929,0,0,0,0.001363
128042,The Scenic Route,1978-04-15,1978,0,0,0,0.803265
128043,The Outsider,1981-01-01,1981,0,0,0,0.633021
128044,Hotel Magnezit,1978-01-01,1978,0,0,0,0.02158
128048,Sea Devils,1953-05-23,1953,0,0,0,0.511522
128061,The Deflowering of Eva van End,2012-09-09,2012,0,0,0,0.163281
128062,They All Lie,2009-03-28,2009,0,0,0,0.0953
128070,Gone Fishing,2012-12-26,2012,0,0,0,0.843072
128073,Greetings from Tim Buckley,2012-09-09,2012,0,0,0,0.0658
128081,I Declare War,2013-05-10,2013,0,0,0,1.706329
128089,Imagine,2012-04-12,2012,0,0,0,2.110715
128104,Inch'Allah,2012-09-08,2012,0,0,0,4.982867
128110,Jump,2012-06-08,2012,0,0,0,0.342685
128111,Juvenile Offender,2012-09-11,2012,0,0,0,0.477533
128113,Key of Life,2012-09-16,2012,0,0,0,1.859543
128120,The Last Time I Saw Macao,2012-08-06,2012,0,0,0,0.368635
128121,The Last White Knight,2012-09-11,2012,0,0,0,0.173305
128124,The Lesser Blessed,2012-09-09,2012,0,0,0,0.518664
128129,London: The Modern Babylon,2012-08-03,2012,0,0,0,1.018079
128133,Museum Hours,2012-08-08,2012,0,0,0,2.225564
128135,Mushrooming,2012-09-21,2012,0,0,0,0.132186
128136,My Awkward Sexual Adventure,2012-09-11,2012,0,45250,45250,3.751532
128140,No Place on Earth,2012-09-10,2012,0,0,0,0.973327
128142,"Nono, the Zigzag Kid",2012-10-03,2012,0,0,0,0.988802
128149,Once Upon a Time Veronica,2012-09-09,2012,0,0,0,1.01536
128151,Our Little Differences,2012-07-02,2012,0,0,0,0.02667
128152,Dracula's Widow,1988-07-02,1988,0,0,0,0.345821
128154,Out in the Dark,2012-09-09,2012,0,0,0,1.804663
128158,The Patience Stone,2012-09-08,2012,0,148671,148671,4.713745
128169,Sideways,2009-10-31,2009,0,0,0,0.056422
128174,Blood Thirst,1971-05-14,1971,0,0,0,0.081694
128177,Elisa Before the End of the World,1997-06-22,1997,0,0,0,0.619812
128190,The Pervert's Guide to Ideology,2012-09-07,2012,0,0,0,1.556451
128201,Revolution,2013-04-12,2013,0,0,0,0.737019
128203,Road North,2012-08-24,2012,0,0,0,0.636526
128206,Shahid,2013-10-18,2013,0,0,0,0.706928
128207,Ship of Theseus,2012-09-06,2012,0,0,0,0.837582
128209,The Towrope,2012-05-19,2012,0,0,0,0.205314
128215,Still Mine,2012-09-10,2012,0,0,0,8.549448
128216,Stories We Tell,2012-10-12,2012,0,0,0,13.922815
128229,Long Pants,1927-03-26,1927,0,0,0,0.099877
128230,Three Sisters,2012-11-21,2012,0,0,0,0.160322
128237,Viola,2012-09-09,2012,0,0,0,0.469914
128241,The Rise,2012-09-09,2012,0,0,0,2.05703
128246,A Werewolf Boy,2012-10-31,2012,0,0,0,3.783265
128248,What Richard Did,2012-09-09,2012,0,0,0,3.507571
128250,When I Saw You,2014-06-06,2014,0,0,0,0.125675
128264,Zombie Reanimation,2009-11-30,2009,0,0,0,0.058367
128266,The Day Lincoln Was Shot,1998-04-12,1998,0,0,0,0.888438
128268,Veruschka: A Life for the Camera,2005-09-30,2005,0,0,0,0.056298
128270,Not Fade Away,2012-12-21,2012,20000000,610792,-19389208,2.688548
128276,May I Kill U?,2013-01-11,2013,0,0,0,0.393771
128280,Blood Money,2012-08-28,2012,2300000,0,-2300000,1.054783
128284,Rain,1929-12-14,1929,0,0,0,0.726791
128298,Chicago,1927-12-23,1927,0,0,0,0.206599
128311,Under the Bed,2012-07-19,2012,0,0,0,6.670898
128353,Hole in the Forehead,1968-05-25,1968,0,0,0,1.760392
128364,Where the Lilies Bloom,1974-04-10,1974,0,0,0,0.015817
128368,"Douro, Faina Fluvial",1931-09-21,1931,0,0,0,0.164387
128395,Emita√Ø,1971-07-20,1971,0,0,0,0.083761
128396,The Diary of Anne Frank,1995-08-19,1995,0,0,0,0.66202
128410,No One Will Play with Me,1976-01-01,1976,0,0,0,0.568394
128412,Falling Leaves,1966-01-01,1966,0,0,0,0.318093
128414,Friend,1988-05-01,1988,0,0,0,0.47039
128437,Bullet for a Badman,1964-09-01,1964,0,0,0,1.623217
128442,The Bread and Alley,1970-01-01,1970,0,0,0,0.003822
128508,Pretty Butterflies,2012-09-06,2012,0,0,0,0.716787
128555,The Rebel,1980-01-01,1980,0,0,0,0.000561
128557,Hunted City,1979-09-27,1979,0,0,0,0.2725
128563,The Iron Commissioner,1978-01-01,1978,0,0,0,4.4e-05
128564,Attack of the 50 Foot Cheerleader,2012-01-01,2012,1000000,0,-1000000,1.862464
128571,Cure for Pain: The Mark Sandman Story,2011-04-29,2011,0,0,0,0.184134
128588,Covert Action,1978-03-03,1978,0,0,0,0.046375
128598,Left for Dead,2007-03-04,2007,0,0,0,0.552064
128606,The Gun That Won the West,1955-09-01,1955,0,0,0,0.008037
128612,Invader,1997-06-02,1997,0,0,0,0.517048
128614,"Like Father, Like Son",1965-08-01,1965,0,0,0,0.002932
128625,Rudyland,2001-08-10,2001,0,0,0,0.10101
128634,Prototype,1992-12-23,1992,0,0,0,0.214778
128637,American Roulette,1988-01-01,1988,0,0,0,0.318935
128639,Kounterfeit,1996-11-15,1996,0,0,0,1.313652
128644,Marked for Murder,1993-01-17,1993,0,0,0,0.154434
128657,Saint Tropez - Saint Tropez,1992-01-01,1992,0,0,0,1.114225
128669,Rhythm on the River,1940-08-28,1940,0,0,0,0.846166
128671,The New York Hat,1912-12-05,1912,0,0,0,0.271328
128679,Begone Dull Care,1949-01-01,1949,0,0,0,1.217187
128682,A Movie,1958-04-07,1958,0,0,0,0.406711
128714,Tess of the D'Urbervilles,1998-03-08,1998,0,0,0,0.767216
128722,Priest of Darkness,1936-04-30,1936,0,0,0,0.284043
128728,The Friend,2008-01-17,2008,0,0,0,0.07897
128733,Hollywood,1980-02-09,1980,0,0,0,0.055713
128748,Curse of the Blair Witch,1999-07-11,1999,0,0,0,1.549716
128766,The Fruit Hunters,2012-11-23,2012,0,0,0,0.567235
128767,God Loves Caviar,2012-10-11,2012,0,0,0,1.731652
128779,Le Joli Mai,1963-06-01,1963,0,0,0,0.224428
128780,The Christmas That Almost Wasn't,1966-11-23,1966,0,0,0,0.269781
128795,Fatal Bond,1991-10-28,1991,0,0,0,1.523312
128797,Killers Are Challenged,1966-02-24,1966,0,0,0,0.148554
128831,Letter from Siberia,1957-05-16,1957,0,0,0,0.471276
128841,The Thompsons,2012-08-21,2012,3000000,0,-3000000,3.13727
128842,Lethal Hostage,2012-08-16,2012,0,0,0,0.382116
128846,Not Reconciled,1965-07-04,1965,0,0,0,0.151806
128847,Lesson Plan,2010-10-09,2010,0,0,0,0.006045
128848,A Time For Dying,1969-12-31,1969,0,0,0,0.10095
128854,Hills of Home,1948-11-25,1948,0,0,0,0.166229
128856,Traffic Affairs,2004-02-06,2004,0,0,0,0.173446
128857,Apollo 13: To the Edge and Back,1994-01-01,1994,0,0,0,0.002384
128862,The Bogus Witch Project,2000-08-19,2000,0,0,0,0.317253
128866,Arachnia,2003-08-05,2003,0,0,0,0.643247
128873,India: Matri Bhumi,1959-06-27,1959,0,0,0,0.078006
128876,Tower Block,2012-09-19,2012,0,0,0,3.611777
128891,Winstanley,1976-01-01,1976,0,0,0,0.002317
128892,9 Dalmuir West,1962-12-07,1962,0,0,0,0.001178
128899,Bardelys the Magnificent,1926-09-30,1926,0,0,0,0.978542
128900,Hip hip hurra!,1987-09-04,1987,0,0,0,0.607737
128917,Voodoo Dawn,1991-01-24,1991,0,0,0,0.73673
128939,The Seine Meets Paris,1957-11-20,1957,0,0,0,0.34842
128946,Lille Fridolf Och Jag,1956-10-29,1956,0,0,0,0.113747
128960,The Substitute,1961-12-31,1961,0,0,0,0.794976
128979,Treasure Island,1999-01-01,1999,0,0,0,1.240835
128990,Cooking up dreams,2009-10-01,2009,0,0,0,0.095652
129006,A Thousand Men and a Baby,1997-12-07,1997,0,0,0,0.132938
129009,Love Is a Ball,1963-04-24,1963,0,0,0,0.875177
129062,Bullets Don't Argue,1964-08-21,1964,0,0,0,0.450778
129067,Hunger,1974-10-01,1974,0,0,0,0.001655
129089,Flash Gordon: Trip to Mars,1938-03-21,1938,0,0,0,0.933309
129112,Wadjda,2012-08-31,2012,0,1347747,1347747,5.451273
129115,Lions,2012-09-03,2012,0,0,0,0.409409
129119,Araf/Somewhere in Between,2012-09-21,2012,0,0,0,1.541676
129129,Light Is Calling,2004-01-16,2004,0,0,0,0.476742
129139,The To Do List,2013-07-24,2013,1500000,3566225,2066225,7.081404
129175,Films of Fury: The Kung Fu Movie Movie,2011-01-01,2011,0,0,0,0.220443
129229,A Plasticine Crow,1981-12-31,1981,0,0,0,0.513269
129237,Tada's Do-It-All House,2011-04-22,2011,0,0,0,0.448199
129251,The Incident,1990-03-04,1990,0,0,0,0.561054
129269,Into the Universe with Stephen Hawking,2010-04-24,2010,0,0,0,1.998564
129277,Two-Legged Horse,2008-01-01,2008,0,0,0,0.251794
129303,Pas de Deux,1968-01-01,1968,0,0,0,0.69501
129311,A Gun For Jennifer,1997-07-01,1997,500000,0,-500000,0.151099
129332,Party Camp,1987-06-19,1987,0,0,0,0.066034
129359,Lille Fridolf Blir Morfar,1957-09-02,1957,0,0,0,0.348329
129360,"Usain Bolt, La L√©gende",2012-07-27,2012,0,0,0,0.431827
129363,En rach√¢chant,1982-01-01,1982,0,0,0,0.002317
129383,Something Like It,1981-09-12,1981,0,0,0,0.093022
129400,Elvis & Madona,2011-09-23,2011,0,0,0,0.055434
129405,World War II: When Lions Roared,1994-04-18,1994,0,0,0,0.591221
129415,Katt Williams: Kattpacalypse,2012-08-25,2012,0,0,0,0.721129
129417,The Childhood of Maxim Gorky,1938-09-27,1938,0,0,0,0.981955
129418,Bigfoot: The Lost Coast Tapes,2012-09-03,2012,0,0,0,1.091795
129427,Rabbit √† la Berlin,2009-04-29,2009,0,0,0,0.608911
129432,Queen of Montreuil,2012-08-31,2012,0,0,0,0.415904
129455,Fatherland,1986-09-02,1986,0,0,0,1.124466
129467,Release the Prisoners to Spring,1975-12-06,1975,0,0,0,1.463872
129507,Joker,2012-08-31,2012,0,0,0,0.966606
129517,Yuma,2012-08-03,2012,0,0,0,0.898925
129518,Island Guests,2005-10-04,2005,0,0,0,0.043189
129530,Brutal,2012-08-21,2012,0,0,0,0.57077
129533,Barbie: The Princess & The Popstar,2012-09-13,2012,0,0,0,6.135769
129535,Play Girl,1941-03-07,1941,0,0,0,0.162319
129542,Salmonberries,1991-10-31,1991,0,0,0,0.25793
129552,"Helsinki, Forever",2008-01-01,2008,0,0,0,0.054379
129553,Song Without End,1960-08-11,1960,0,0,0,0.679183
129564,Property Is No Longer a Theft,1973-10-03,1973,0,0,0,1.306139
129577,A Few Dollars for Django,1966-09-09,1966,0,0,0,0.682952
129579,Arizona Colt Returns,1970-08-14,1970,0,0,0,0.078435
129609,Chronicle of My Mother,2011-08-27,2011,0,0,0,1.063269
129627,Gunman Called Nebraska,1966-03-18,1966,0,0,0,0.657032
129628,Stars & Bars,1988-03-18,1988,0,0,0,0.40317
129670,Nebraska,2013-09-21,2013,12000000,17654912,5654912,11.160699
129682,Blind,1987-12-02,1987,0,0,0,0.00273
129689,"I Are You, You Am Me",1982-04-17,1982,0,0,0,1e-06
129728,Palme,2012-09-14,2012,0,0,0,0.802144
129734,Paradise: Faith,2012-08-29,2012,0,6508,6508,2.387892
129745,We Were Here: Part 2,2012-04-21,2012,0,0,0,1.547683
129798,The Crying Dead,2011-10-31,2011,0,0,0,0.544923
129806,The Rumyantsev Case,1955-06-06,1955,0,0,0,0.093682
129820,Silence and Cry,1968-06-12,1968,0,0,0,0.476432
129830,Aniskin and Fantomas,1974-05-08,1974,0,0,0,0.349144
129847,Deep West,1971-04-08,1971,0,0,0,0.04557
129850,The Bullet Vanishes,2012-08-14,2012,12000000,117629,-11882371,1.675406
129851,A Bullet for a Stranger,1971-09-23,1971,0,0,0,0.953466
129854,"Trust Us, This Is All Made Up",2009-03-13,2009,0,0,0,0.00525
129865,Demolition of a Wall,1896-03-06,1896,0,0,0,1.187422
129882,Phantom Love,2007-01-01,2007,0,0,0,0.582257
129933,Paraguayan Hammock,2006-11-02,2006,0,0,0,0.22129
129942,The Experience,1973-01-01,1973,0,0,0,0.068859
129943,Breaktime,1972-01-01,1972,0,0,0,0.002841
129945,The Chorus,1982-01-01,1982,0,0,0,0.110037
129966,David et Madame Hansen,2012-08-29,2012,8806000,0,-8806000,1.125103
129974,Buckskin Frontier,1943-05-14,1943,0,0,0,0.298715
130002,Mark Twain,2002-01-14,2002,0,0,0,1.249999
130015,Le Papillon Fantastique,1909-01-01,1909,0,0,0,0.776598
130055,Looking for Hortense,2012-09-05,2012,0,0,0,0.742452
130062,The Three Must-Get-Theres,1922-08-22,1922,0,0,0,0.071781
130064,Flesh and Blood,1922-08-22,1922,0,0,0,0.024602
130090,The Girl from Jones Beach,1949-07-16,1949,0,0,0,0.084012
130098,Treachery Rides the Range,1936-05-02,1936,0,0,0,0.021875
130100,The Brass Legend,1956-12-01,1956,0,0,0,0.341996
130134,Lafayette Escadrille,1958-03-01,1958,0,0,0,0.523153
130150,Labor Day,2013-12-27,2013,18000000,20275812,2275812,6.108646
130233,Fly Away,2012-07-12,2012,0,0,0,0.269108
130241,Morning for the Osone Family,1946-02-21,1946,0,0,0,0.211239
130243,Wives Under Suspicion,1938-06-03,1938,0,0,0,1.128746
130267,Seal Team Six: The Raid on Osama Bin Laden,2012-11-04,2012,0,0,0,5.074995
130269,Cien ni√±os esperando un tren,1988-01-01,1988,0,0,0,0.020031
130272,"Mother Dao, the Turtlelike",1995-04-06,1995,0,0,0,0.255441
130275,Miss Lulu Bett,1921-11-01,1921,0,0,0,0.039127
130278,Struck,2008-12-30,2008,0,0,0,0.060014
130296,Sinful Davey,1969-02-10,1969,0,0,0,0.706824
130300,Back to You and Me,2005-07-23,2005,0,0,0,0.356377
130322,Kill Them All and Come Back Alone,1968-12-31,1968,0,0,0,0.268979
130358,Liz & Dick,2012-11-25,2012,0,0,0,1.267272
130374,Guest Wife,1945-07-27,1945,0,0,0,1.63944
130398,Broadway Serenade,1939-04-07,1939,0,0,0,0.672662
130401,Tiara Tahiti,1962-07-01,1962,0,0,0,0.21761
130402,Last Night At The Alamo,1984-07-01,1984,0,0,0,0.007685
130424,The Story of Three Loves,1953-03-26,1953,0,0,0,0.511389
130436,Rebirth Of A Nation,2008-11-04,2008,0,0,0,0.056
130445,Consuming Spirits,2012-01-01,2012,0,0,0,0.061697
130450,The Lonedale Operator,1911-03-23,1911,0,0,0,0.256769
130452,Gold Diggers in Paris,1938-06-11,1938,0,0,0,0.715602
130457,Life Goes On,1969-12-22,1969,0,0,0,0.5783
130458,The Sugar Curtain,2005-09-21,2005,0,0,0,0.040229
130474,Young Cassidy,1965-02-25,1965,0,0,0,0.682079
130492,Uno bianca,2001-02-05,2001,0,0,0,0.877629
130507,Four Mothers,1941-01-04,1941,0,0,0,0.123392
130515,The Girls in the Band,2013-05-10,2013,0,0,0,0.092233
130544,Palermo or Wolfsburg,1980-02-01,1980,0,0,0,0.060535
130593,Good Vibrations,2012-05-31,2012,0,0,0,2.390972
130612,Harry Dean Stanton: Partly Fiction,2012-09-05,2012,0,0,0,3.636845
130623,N√∂madak Tx,2006-01-01,2006,0,0,0,0.003637
130624,The Girl from the Marsh Croft,1935-09-10,1935,0,0,0,0.036702
130627,Get Out,2010-02-01,2010,0,0,0,0.147059
130633,I Accuse,1938-01-23,1938,0,0,0,0.228809
130638,Hitler - Never Heard of Him,1963-07-25,1963,0,0,0,0.113331
130639,Extreme Private Eros: Love Song 1974,1974-01-01,1974,0,0,0,0.662784
130650,No Exit,1954-12-22,1954,0,0,0,0.100017
130677,King Kelly,2012-11-11,2012,0,0,0,1.629079
130694,Life Is No Piece of Cake,2012-11-21,2012,0,0,0,0.44263
130717,Broadway,1929-05-27,1929,1000000,0,-1000000,0.031343
130719,The Mystery of Oberwald,1981-09-03,1981,0,0,0,0.267863
130736,3 Zimmer/K√ºche/Bad,2012-10-03,2012,0,0,0,1.87683
130739,A Coffee in Berlin,2012-07-03,2012,300000,2750275,2450275,7.90622
130745,16 Acres,2012-09-23,2012,0,0,0,0.277305
130747,The Guardians,2012-09-18,2012,0,0,0,2.73072
130750,The World Before Her,2012-03-11,2012,0,0,0,1.749649
130754,Souls of Zen: Ancestors and Agency in Contemporary Japanese Temple Buddhism,2012-06-01,2012,100000,0,-100000,0.043532
130798,Forget me not,2013-01-31,2013,0,0,0,0.592828
130802,A Night In the Woods,2012-09-07,2012,0,0,0,0.191765
130804,Sofia's Last Ambulance,2012-05-23,2012,0,0,0,0.149432
130805,Expecting a Miracle,2009-01-10,2009,0,0,0,0.106603
130813,So Long Letty,1929-10-16,1929,0,0,0,0.119262
130816,Abraham Lincoln,1930-11-08,1930,0,0,0,1.14295
130824,As I Was Moving Ahead Occasionally I Saw Brief Glimpses of Beauty,2000-07-19,2000,0,0,0,0.7984
130881,Red Ensign,1934-06-17,1934,0,0,0,0.019338
130882,The Phantom Light,1935-08-05,1935,0,0,0,0.113557
130885,Take Me to Town,1953-06-19,1953,0,0,0,0.051803
130900,Nancy Goes to Rio,1950-03-10,1950,0,0,0,0.135257
130917,Tribute,1980-12-14,1980,0,0,0,0.695113
130925,Partysaurus Rex,2012-09-14,2012,0,0,0,6.066171
130948,7 Hours of Violence,1973-11-15,1973,0,0,0,0.292065
130957,The Sons of Great Bear,1966-02-18,1966,0,0,0,0.359292
130973,Wasted Youth,2011-03-17,2011,0,0,0,0.149792
130980,Holiday For Lovers,1959-07-24,1959,0,0,0,0.003233
130993,Future My Love,2012-06-21,2012,0,0,0,0.150219
131027,Csontvary,1980-10-02,1980,0,0,0,0.143876
131039,Sea Wolf,2009-12-24,2009,19000000,0,-19000000,1.151371
131045,Nine Days of One Year,1961-12-25,1961,0,0,0,0.184325
131074,Hunted,1952-03-17,1952,0,0,0,0.420001
131098,Pinocchio,1976-03-27,1976,0,0,0,0.059308
131116,Saviour Square,2006-09-07,2006,0,0,0,0.719288
131172,Nasty Habits,1977-03-18,1977,0,0,0,0.411814
131194,Eagle's Wing,1979-11-23,1979,0,0,0,0.526379
131220,Jason Becker: Not Dead Yet,2012-03-03,2012,0,0,0,0.404706
131232,Two Friends,2002-03-20,2002,0,0,0,0.003949
131313,Jane Eyre,1971-06-04,1971,0,0,0,0.475569
131334,The Mask,1988-05-10,1988,0,0,0,0.00022
131343,Frost,2012-09-07,2012,1500000,0,-1500000,0.313424
131351,Afterburn,1992-05-30,1992,0,0,0,1.282798
131360,Upstream,1927-01-30,1927,0,0,0,0.129893
131366,Backstairs,1921-12-11,1921,0,0,0,0.41673
131398,Fun Without Limits,1998-01-01,1998,0,0,0,0.036471
131433,Freedom,2006-11-24,2006,0,0,0,0.154679
131434,Un vampiro para dos,1965-01-01,1965,0,0,0,0.060528
131455,The Struggle,1931-12-10,1931,0,0,0,0.174509
131457,Green Light,1937-02-20,1937,0,0,0,0.433975
131475,Cold Blooded,2012-07-31,2012,0,0,0,1.686185
131476,Sweet Bunch,1983-10-19,1983,0,0,0,0.788768
131478,Doomed Love,1979-11-25,1979,0,0,0,0.013577
131503,Stars Above,2012-08-15,2012,0,0,0,0.854413
131504,Meet Me in Las Vegas,1956-03-09,1956,0,0,0,0.123823
131507,Scandali nudi,1968-12-22,1968,0,0,0,0.300359
131585,Mother's Heart,1969-01-29,1969,0,0,0,0.621144
131631,The Hunger Games: Mockingjay - Part 1,2014-11-18,2014,125000000,752100229,627100229,147.098006
131634,The Hunger Games: Mockingjay - Part 2,2015-11-18,2015,160000000,653428261,493428261,26.628178
131653,Euridice BA 2037,1975-09-29,1975,0,0,0,0.268068
131671,Elia Kazan: A Director's Journey,1995-08-14,1995,0,0,0,0.115658
131673,It's in the Blood,2012-05-31,2012,0,0,0,2.271475
131689,The Wicked,2013-03-20,2013,800000,0,-800000,2.135239
131729,The Con,1998-03-04,1998,0,0,0,1.235102
131732,You're Telling Me!,1934-03-18,1934,0,0,0,0.085537
131737,St George's Day,2012-09-07,2012,0,0,0,3.817408
131739,"Isoroku Yamamoto, the Commander-in-Chief of the Combined Fleet",2011-12-23,2011,0,0,0,1.301226
131764,Frenchman's Creek,1944-09-20,1944,0,0,0,0.476878
131770,"Arise, My Love",1940-11-08,1940,0,0,0,1.240754
131781,"Rich, Young and Pretty",1951-07-09,1951,0,0,0,0.707895
131792,At Sea,2007-09-07,2007,0,0,0,0.228707
131799,Can Heironymus Merkin Ever Forget Mercy Humppe and Find True Happiness?,1969-03-19,1969,0,0,0,0.378399
131805,"Sexo, Amor e Trai√ß√£o",2004-01-02,2004,0,0,0,0.305481
131815,The Sea Serpent,1984-12-31,1984,0,0,0,0.094983
131822,Kuningas Litmanen,2012-09-28,2012,431274,0,-431274,0.103806
131830,"Rag. Arturo De Fanti, bancario precario",1980-03-14,1980,0,0,0,0.600785
131836,The Long Absence,1961-05-17,1961,0,0,0,0.767638
131837,The Reluctant Saint,1962-12-03,1962,0,0,0,0.413202
131861,An American Dream,1966-08-31,1966,0,0,0,0.147798
131880,Stonewall Uprising,2010-06-16,2010,0,0,0,0.640779
131887,Entity,2012-10-24,2012,0,0,0,1.342691
131897,I Made a Splash,1980-10-30,1980,0,0,0,0.444508
131898,This Earth Is Mine,1959-06-26,1959,0,0,0,0.228273
131903,Face The Music,1993-01-01,1993,0,0,0,0.165855
131907,God is on Air,2002-01-01,2002,0,0,0,0.167703
131914,The Uninvited,1996-10-29,1996,0,0,0,0.351875
131916,Scary or Die,2012-09-09,2012,0,0,0,1.669797
131932,FBI: Frikis buscan incordiar,2004-06-04,2004,0,928391,928391,0.044048
131934,Prime Suspect: Scent of Darkness,1995-05-15,1995,0,0,0,1.091116
131940,Josh,2000-06-09,2000,6900000,15000000,8100000,4.0315
131944,Daughters Courageous,1939-07-22,1939,0,0,0,0.587828
131957,Nina Takes a Lover,1995-03-03,1995,0,0,0,0.769522
131958,Where Is Enohp Located?,1987-06-06,1987,0,0,0,0.011064
131966,Strike Force,1975-04-12,1975,0,0,0,1.085518
131997,The Thrushes Are Still Singing,1979-10-10,1979,0,0,0,0.071371
132030,The Green Elephant,1999-01-01,1999,0,0,0,0.668157
132038,Boogie-Doodle,1940-01-01,1940,0,0,0,0.321059
132064,Vile,2011-08-25,2011,0,0,0,5.003941
132122,Chains,1949-10-29,1949,0,0,0,0.497498
132128,Voices of the Andes,2009-01-01,2009,0,0,0,0.006588
132133,Man on the Tracks,1957-01-17,1957,0,0,0,0.31388
132137,Werewolf: The Beast Among Us,2012-10-09,2012,5000000,0,-5000000,9.476537
132141,The Noose,1958-01-19,1958,0,0,0,0.386626
132144,The Battle of Chile - Part I,1975-03-18,1975,0,0,0,0.057128
132148,The Battle of Chile - Part II,1976-03-13,1976,0,0,0,0.004351
132150,The Battle of Chile - Part III,1979-03-15,1979,0,0,0,0.112442
132166,The Little Theatre of Jean Renoir,1970-12-15,1970,0,0,0,0.002538
132185,Two Days In April,2007-04-09,2007,0,0,0,0.076161
132227,La pr√≥xima estaci√≥n,2008-09-08,2008,0,0,0,0.095319
132232,Mama,2013-01-17,2013,15000000,146497771,131497771,16.018525
132236,Four Assassins,2013-05-14,2013,0,0,0,1.247085
132263,The Ghost Goes West,1935-12-17,1935,0,0,0,0.636497
132298,Dibu: La Pel√≠cula,1997-07-10,1997,3000000,0,-3000000,0.344495
132316,Jab Tak Hai Jaan,2012-11-13,2012,0,0,0,4.856861
132320,The Mural of Siqueiros,2011-08-19,2011,0,0,0,0.529543
132328,It's Good to Be Alive,1974-02-22,1974,0,0,0,0.06433
132332,Manon,1949-03-09,1949,0,0,0,0.825978
132342,The Liberator,2013-09-09,2013,50000000,0,-50000000,5.600208
132344,Before Midnight,2013-04-05,2013,3000000,11176469,8176469,11.30324
132363,The Butler,2013-08-16,2013,25000000,115922175,90922175,11.061894
132379,The '?' Motorist,1906-10-01,1906,0,0,0,0.398256
132392,A Diary for Timothy,1945-12-31,1945,0,0,0,0.177418
132397,After Death,1915-01-01,1915,0,0,0,0.539444
132422,Stealing Time,2001-06-17,2001,0,0,0,1.342198
132426,Capturing Mary,2007-11-12,2007,0,0,0,1.06885
132506,I Met Him in Paris,1937-05-28,1937,0,0,0,0.730017
132518,Yes or No 2,2012-08-16,2012,0,0,0,0.96295
132540,The Taiwan Oyster,2012-03-10,2012,0,0,0,0.362432
132542,The Return of Bruno,1987-02-17,1987,0,0,0,0.863611
132551,Cannibal Vegetarian,2012-03-01,2012,0,0,0,0.193391
132561,Mixed Kebab,2012-02-29,2012,0,0,0,1.482072
132597,Ramona,1936-09-25,1936,0,0,0,0.339674
132601,The Reef 2: High Tide,2012-10-30,2012,0,0,0,1.675072
132608,Kings & Rats,2012-02-17,2012,0,0,0,0.41158
132641,Wife,1953-04-29,1953,0,0,0,0.619388
132641,Wife,1953-04-29,1953,0,0,0,0.096079
132654,Les Miserables,1952-08-14,1952,0,0,0,0.278476
132705,Morgana,2012-08-03,2012,0,1612100,1612100,0.368092
132709,Rebirth,2011-08-31,2011,0,0,0,0.37198
132712,Party Crashers,2012-11-30,2012,0,0,0,2.052774
132714,Gulliver Mickey,1934-05-19,1934,0,0,0,1.521059
132725,The Hi-Line,2000-05-05,2000,0,0,0,0.211159
132744,One 2 Ka 4,2001-03-29,2001,0,0,0,1.838534
132759,Soulless,2012-10-04,2012,2800000,13218980,10418980,1.823774
132765,Stone & Ed,2008-01-08,2008,560,0,-560,0.038832
132812,Cowboy del Amor,2005-03-12,2005,0,0,0,0.052706
132859,"Come On, Rangers",1938-11-21,1938,0,0,0,0.002879
132873,Die Mondverschw√∂rung,2011-04-21,2011,0,0,0,0.767484
132883,Wonder Bar,1934-03-31,1934,0,0,0,0.153016
132887,First Cousin Once Removed,2012-10-09,2012,0,0,0,0.158211
132894,Aladdin and the Death Lamp,2012-09-15,2012,0,0,0,0.635069
132912,The Price of Sex,2011-04-09,2011,0,0,0,0.129413
132923,"Guns, Girls and Gambling",2011-11-14,2011,0,0,0,14.950975
132928,No Time for Comedy,1940-09-14,1940,0,0,0,0.749298
132936,Wheelmen,2005-06-03,2005,0,0,0,1.747824
132939,Arizona Raiders,1965-08-01,1965,0,0,0,0.392813
132957,Don't Click,2012-05-30,2012,0,0,0,2.325504
132961,The Caine Mutiny Court-Martial,1988-05-08,1988,0,0,0,0.575483
133008,Twenty Days Without War,1977-05-01,1977,0,0,0,0.845133
133018,A Streetcar Named Desire,1984-03-04,1984,0,0,0,1.1622
133021,A Streetcar Named Desire,1995-10-24,1995,0,0,0,1.355359
133063,The Haunted Castle,1896-12-24,1896,0,0,0,1.53747
133082,The Dead Man and Being Happy,2012-09-23,2012,0,0,0,0.268524
133088,Everything Will Be All Right,1995-06-06,1995,0,0,0,1.129118
133108,Money Matters,2011-11-15,2011,0,0,0,0.148981
133115,Maze,2000-10-10,2000,0,0,0,0.52991
133119,Torch Song,1953-10-01,1953,0,0,0,0.574971
133121,Resident Evil: Damnation,2012-09-25,2012,0,0,0,16.532373
133123,The Last Days of Pompeii,1913-08-13,1913,0,0,0,0.223436
133131,"Why, Charlie Brown, Why?",1990-03-16,1990,0,0,0,0.136961
133137,Dead Creatures,2001-09-25,2001,0,0,0,0.002709
133148,Hustling,1975-02-22,1975,0,0,0,0.61473
133160,Postcard,2010-10-27,2010,0,0,0,0.807369
133183,The Child,2012-09-18,2012,5000000,0,-5000000,1.719131
133200,Masquerade,2012-09-12,2012,0,0,0,3.291016
133213,The Dinosaur and the Missing Link: A Prehistoric Tragedy,1915-01-01,1915,5000,0,-5000,0.176389
133241,Mariachi Gringo,2012-10-03,2012,0,0,0,0.694159
133255,Harlem Rides the Range,1939-02-01,1939,0,0,0,0.001373
133328,The Deadly Trackers,1973-12-21,1973,0,0,0,0.187358
133339,The Surgeon,1995-01-13,1995,10000000,0,-10000000,1.141545
133365,The Diary of Anne Frank,2009-01-09,2009,0,0,0,2.92322
133369,The Conspiracy,2012-08-23,2012,0,0,0,4.531007
133373,Identification Marks: None,1965-11-18,1965,0,0,0,1.082036
133382,Lackawanna Blues,2005-02-12,2005,0,0,0,1.515541
133396,Forgotten,2012-12-20,2012,0,0,0,1.257014
133411,I Belong,2012-09-14,2012,0,0,0,0.1188
133441,The Summit,2012-10-12,2012,0,0,0,6.312295
133446,Imaginary Friend,2012-06-02,2012,0,0,0,7.412679
133448,Macbeth,2010-10-06,2010,0,0,0,1.159167
133458,The Hypnotist,2012-09-28,2012,0,0,0,9.090998
133459,The Anderssons in Greece: All Inclusive,2012-12-21,2012,0,0,0,4.172291
133463,Redd Inc.,2012-11-03,2012,500000,1000000,500000,5.411012
133469,The Dream Team,2012-09-24,2012,0,0,0,5.159723
133485,Jaur√®s,2012-02-11,2012,0,0,0,0.083554
133491,The Delay,2012-06-01,2012,0,0,0,0.294455
133521,Shameless,2012-07-20,2012,0,0,0,0.771924
133523,"See You in Hell, My Darling",1999-01-01,1999,0,0,0,0.160269
133557,The Girl,2012-10-22,2012,0,0,0,8.45535
133558,Saints and Soldiers: Airborne Creed,2012-08-17,2012,0,0,0,5.112102
133560,Youth in Fury,1960-08-30,1960,0,0,0,0.078327
133563,Killers on Parade,1961-02-19,1961,0,0,0,0.385757
133569,Rat Fever,2012-06-22,2012,0,0,0,0.01
133575,The Velocity of Gary,1999-07-16,1999,4000000,0,-4000000,1.074248
133601,The Neighbors,2012-08-22,2012,0,0,0,1.399664
133603,The Traffickers,2012-08-28,2012,0,0,0,1.264345
133643,Karin Daughter of Ingmar,1920-02-02,1920,0,0,0,0.148494
133684,The Russian Game,2007-10-04,2007,0,0,0,1.22821
133694,Promised Land,2012-09-23,2012,15000000,8138788,-6861212,7.06378
133698,Fly Me to the Moon,2012-10-29,2012,0,0,0,7.881755
133701,Tears of Steel,2012-09-25,2012,0,0,0,3.611436
133704,"George Lopez: It's Not Me, It's You",2012-07-24,2012,0,0,0,0.810568
133715,All the Young Men,1960-08-26,1960,0,0,0,1.25789
133716,Valley of Head Hunters,1953-07-29,1953,0,0,0,0.005018
133736,Electoral Dysfunction,2012-11-20,2012,0,0,0,0.01367
133738,186 Dollars to Freedom,2012-09-21,2012,0,0,0,1.639233
133741,Radio Unnameable,2012-09-19,2012,0,0,0,0.396338
133750,Er√©ndira,1983-05-01,1983,0,0,0,1.197094
133764,Vanishing Waves,2012-06-29,2012,0,0,0,1.894596
133781,Happy New Year,1987-08-07,1987,0,41232,41232,0.941321
133783,Marie Kroyer,2012-09-26,2012,0,0,0,0.805203
133786,Where the Trail Ends,2012-09-19,2012,0,0,0,0.558363
133788,Il rosso e il blu,2012-01-01,2012,0,0,0,1.572491
133790,Clear History,2013-08-10,2013,0,0,0,7.864289
133792,The Joker Is Wild,1957-09-26,1957,0,0,0,1.323445
133805,Carrie,2013-10-16,2013,30000000,82394288,52394288,18.399055
133823,Call Me Kuchu,2012-02-11,2012,0,0,0,0.878152
133827,Backfire,1964-09-04,1964,0,0,0,0.436941
133831,Endangered Species,2003-11-13,2003,0,0,0,1.286525
133879,Johan Falk: Spelets regler,2012-09-25,2012,0,0,0,0.929547
133919,Scenes from a Marriage,1973-04-11,1973,150000,0,-150000,2.845693
133931,Zambezia,2012-06-05,2012,20000000,0,-20000000,8.825276
133941,Double Face,1969-07-04,1969,0,0,0,1.009951
133953,Snow Shark: Ancient Snow Beast,2011-10-12,2011,0,0,0,0.23136
133964,Pluto,2012-10-05,2012,0,0,0,0.838756
133977,Liar Game: Reborn,2012-03-03,2012,0,0,0,0.605467
134012,The Zero Years,2005-11-25,2005,0,0,0,0.283025
134018,House of the Sleeping Beauties,2006-11-02,2006,1900000,0,-1900000,0.814379
134053,Animation Runner Kuromi 2,2004-01-28,2004,0,0,0,0.05318
134096,Two Plus Two,2012-08-16,2012,0,0,0,2.128852
134126,A Company Man,2012-10-11,2012,3500000,7339398,3839398,6.261686
134132,Excuse Me for Living,2012-10-12,2012,0,0,0,0.889662
134144,The Italian,1915-01-01,1915,0,0,0,0.113836
134153,Pretty Smart,1987-03-13,1987,0,0,0,0.008471
134155,King Lear,1916-12-17,1916,0,0,0,0.072373
134158,The Punk Rock Movie,1978-06-09,1978,0,0,0,0.499105
134168,Trio,1950-10-10,1950,0,0,0,0.367819
134201,Out of Time,1988-07-17,1988,0,0,0,0.021309
134209,A Wedding Suit,1976-01-01,1976,0,0,0,0.107106
134215,Heroine,2012-09-21,2012,0,0,0,1.015355
134223,The Man Called Noon,1973-08-29,1973,0,0,0,1.927397
134238,Song of the Saddle,1936-02-28,1936,0,0,0,0.005411
134255,The American Scream,2012-10-28,2012,0,0,0,1.129757
134308,The Bermuda Triangle,1996-01-01,1996,0,0,0,0.842615
134350,Why Don't You Play in Hell?,2013-09-14,2013,0,0,0,4.631176
134355,The Happy Road,1957-06-20,1957,500000,0,-500000,0.544916
134360,Mickey's Orphans,1931-12-09,1931,0,0,0,0.832055
134362,The Beast,2010-01-01,2010,0,0,0,0.049089
134366,Grave Encounters 2,2012-10-12,2012,0,0,0,9.021941
134368,One Tough Cop,1998-10-09,1998,0,0,0,1.082
134371,Atlas Shrugged Part II,2012-10-12,2012,0,0,0,2.833747
134372,Marriage Material,2012-01-12,2012,0,0,0,0.365149
134374,Pain & Gain,2013-04-18,2013,25000000,86175291,61175291,9.218002
134375,Home Alone: The Holiday Heist,2012-11-25,2012,0,0,0,4.792279
134390,The Finest Hour,1992-05-29,1992,0,0,0,0.580891
134394,Barricade,2012-09-25,2012,0,0,0,2.178305
134397,Below the Belt,1980-12-01,1980,0,0,0,0.227045
134409,Decoding Deepak,2012-03-11,2012,0,0,0,0.581747
134411,Snitch,2013-02-21,2013,35000000,42930462,7930462,13.542675
134415,Vampire Dog,2012-09-25,2012,0,0,0,1.689975
134427,Downstairs,1932-08-06,1932,0,0,0,0.784385
134435,Quantrill's Raiders,1958-04-27,1958,0,0,0,0.120173
134446,Chachi 420,1997-12-19,1997,0,0,0,0.777867
134458,Executive Target,1997-07-11,1997,0,0,0,1.086438
134463,"The Tree, the Mayor and the Mediatheque",1993-02-10,1993,0,0,0,0.036572
134472,Another Harvest Moon,2010-10-06,2010,0,0,0,0.132857
134474,Godfather,1991-03-03,1991,18000,700000,682000,0.646227
134475,The Red Mill,1927-01-29,1927,0,0,0,0.635909
134477,Sandesham,1991-02-04,1991,0,0,0,1.13233
134480,The Great Garrick,1937-10-30,1937,0,0,0,0.88523
134481,Frozen Planet,2011-10-26,2011,0,0,0,3.80163
134569,The House,2011-03-17,2011,0,0,0,0.27606
134597,The Collection,2012-09-21,2012,0,6842058,6842058,8.031713
134602,Half the Sky: Turning Oppression Into Opportunity for Women Worldwide,2012-10-03,2012,0,0,0,0.481845
134608,The Castilian,1963-04-13,1963,0,0,0,0.089389
134632,Monster High: Ghouls Rule,2012-10-09,2012,0,0,0,5.298815
134656,I Love Sarah Jane,2008-01-01,2008,0,0,0,1.226463
134662,Ape,2012-08-08,2012,0,0,0,0.563097
134673,Renoir,2012-10-08,2012,0,2293798,2293798,5.337351
134679,Meet Him And Die,1976-10-08,1976,0,0,0,0.031907
134680,Billy Gardell: Halftime,2011-02-05,2011,0,60,60,0.007877
134688,D.L. Hughley: Reset,2012-07-14,2012,0,0,0,0.046078
134693,Heathens and Thieves,2012-08-01,2012,0,0,0,0.98003
134705,Amazon,1990-12-14,1990,0,0,0,0.365646
134732,Daddy-O,1958-03-01,1958,0,0,0,0.076198
134733,The Dead Season,1968-12-20,1968,0,0,0,0.473351
134738,Roseland,1977-10-02,1977,0,0,0,0.120345
134743,Who Am I This Time?,1982-02-02,1982,0,0,0,0.98175
134746,Scam,1993-05-22,1993,0,0,0,0.121051
134750,Humorous Phases of Funny Faces,1906-04-05,1906,0,0,0,0.664213
134756,Killjoy Goes To Hell,2012-10-09,2012,0,0,0,0.63753
134777,The Lost Room,2006-12-09,2006,0,0,0,5.655194
134782,The Italian Key,2011-05-14,2011,1800000,0,-1800000,0.05983
134806,Riders of the Purple Sage,1996-01-21,1996,0,0,0,0.332653
134812,Wither,2013-05-09,2013,0,0,0,1.419673
134841,Makdee,2002-11-22,2002,0,0,0,0.312925
134881,More of Me,2007-06-17,2007,0,0,0,0.317873
134890,Evil Behind You,2006-10-31,2006,200000,0,-200000,0.005605
134901,Life After Tomorrow,2006-12-24,2006,0,0,0,0.00353
134908,Horses of God,2013-02-13,2013,0,0,0,0.765503
134990,Touch of the Light,2012-09-21,2012,0,0,0,1.674653
135047,Hotel Noir,2012-10-09,2012,0,0,0,5.600473
135097,The Cinema Snob Movie,2012-09-27,2012,0,0,0,0.045236
135161,You Are God,2012-05-07,2012,1951964,0,-1951964,0.331599
135195,P,2005-01-01,2005,0,0,0,1.063804
135198,12 Storeys,1997-06-12,1997,0,0,0,0.158851
135199,Ek Hasina Thi,2004-01-16,2004,0,0,0,0.47165
135200,Ex-Girlfriends,2012-11-28,2012,0,0,0,0.340973
135204,Frank & Wendy,2004-01-01,2004,0,0,0,0.038697
135210,Junk,2006-03-26,2006,3000000,0,-3000000,0.811005
135214,The Last Sentence,2012-12-07,2012,0,0,0,1.092682
135225,Purge,2012-09-07,2012,3100000,0,-3100000,6.082938
135260,Top Sensation,1969-03-29,1969,0,0,0,0.10465
135275,Wild and Woolly,1917-06-24,1917,0,0,0,0.109246
135281,Camille Rewinds,2012-09-12,2012,0,0,0,3.444467
135286,Watch Your Left,1936-08-20,1936,0,0,0,0.518977
135307,Derrick contre Superman,1992-12-23,1992,0,0,0,0.877244
135309,Lake Placid: The Final Chapter,2012-09-29,2012,0,0,0,8.860585
135312,Glorious Technicolor,1998-01-01,1998,0,0,0,0.918802
135313,Welcome to Sherwood! The Story of 'The Adventures of Robin Hood',2003-01-01,2003,0,0,0,0.079302
135317,Speed - In Search of Lost Time,2012-09-28,2012,0,0,0,0.198423
135335,A Mother Should Be Loved,1934-05-11,1934,0,0,0,0.095234
135337,The Girls,1968-09-16,1968,0,0,0,0.261022
135362,The chosen,2006-06-02,2006,1000000,0,-1000000,0.32369
135368,The Barrens,2012-09-28,2012,0,0,0,3.678189
135385,Django Kills Softly,1967-04-29,1967,0,0,0,0.447296
135390,The Softening of the Egg,1975-03-17,1975,0,0,0,0.661863
135397,Jurassic World,2015-06-09,2015,150000000,1513528810,1363528810,32.790475
135418,Dim Sum: A Little Bit of Heart,1985-08-09,1985,0,0,0,0.272989
135465,Carl Panzram: The Spirit of Hatred and Vengeance,2012-05-28,2012,0,0,0,0.451389
135473,The Ballad of the Sad Cafe,1991-03-28,1991,0,184890,184890,0.877573
135482,Fever Lake,1996-01-01,1996,0,0,0,0.293346
135510,Deadly Chase,1978-12-08,1978,0,0,0,0.002047
135536,Chi lavora √® perduto,1963-12-05,1963,0,0,0,0.423327
135545,A Conversation with Gregory Peck,1999-01-01,1999,0,0,0,0.448833
135547,The Marshal of Finland,2012-09-28,2012,0,0,0,0.080044
135561,Mud Zombies,2008-07-28,2008,0,0,0,0.61256
135579,Dead Before Dawn 3D,2012-10-10,2012,0,0,0,2.642791
135598,Bread of Happiness,2012-01-28,2012,0,0,0,0.589618
135647,The Details,2012-11-02,2012,0,0,0,5.143891
135652,Christmas in Compton,2012-11-09,2012,0,0,0,0.925835
135659,Johan Falk: De 107 patrioterna,2012-10-09,2012,0,0,0,2.679436
135670,Amber Alert,2012-11-02,2012,0,0,0,1.424857
135678,Leave,2011-05-03,2011,0,0,0,1.778183
135679,"Andrew Jenks, Room 335",2008-01-15,2008,0,0,0,0.096034
135686,The Headhunter's Sister,1997-01-01,1997,0,0,0,0.003221
135695,Steel,2012-11-14,2012,0,0,0,0.259315
135696,El asombroso mundo de Borjamari y Pocholo,2004-12-03,2004,0,3367646,3367646,0.793589
135697,K.O. Miguel,1957-01-01,1957,0,0,0,0.014984
135708,Nature Calls,2012-11-09,2012,0,0,0,1.442686
135713,Beware of Christians,2011-01-14,2011,0,0,0,0.009971
135714,Redemption: For Robbing the Dead,2011-10-16,2011,0,0,0,0.085592
135718,OMG: Oh My God!,2012-09-28,2012,0,0,0,2.960593
135787,The Silver Screen: Color Me Lavender,1997-11-01,1997,0,0,0,0.075111
135799,The Samurai That Night,2012-11-17,2012,0,0,0,0.407424
135800,No Logo: Taking Aim at the Brand Bullies,2003-07-01,2003,0,0,0,0.0066
135812,Dracula 3D,2012-11-09,2012,0,0,0,4.038628
135832,Moon Man,2012-12-19,2012,12000,0,-12000,1.211827
135855,Dirty Pictures,2000-05-27,2000,0,0,0,0.542681
135858,Dungeons & Dragons: The Book of Vile Darkness,2012-08-08,2012,12000000,0,-12000000,4.422468
135890,Storyville,1992-08-26,1992,0,0,0,0.810096
135921,Everything or Nothing,2012-10-05,2012,0,0,0,1.99456
135938,Daddy,1995-12-14,1995,0,0,0,0.209106
135990,Shell,2012-11-26,2012,0,0,0,2.013046
136058,Seeing Red: Stories of American Communists,1983-10-04,1983,0,0,0,0.070603
136070,Vengeance Can Wait,2010-10-09,2010,0,0,0,1.045343
136071,Johan Falk: Alla r√•ns moder,2012-10-24,2012,0,0,0,0.5288
136074,Little Monsters,2012-01-02,2012,0,0,0,0.36305
136080,Escape,2012-09-28,2012,0,0,0,2.060217
136087,The Giant King,2012-10-04,2012,0,0,0,1.804347
136106,Honor Among Lovers,1931-03-21,1931,0,0,0,0.010595
136109,Consolation Marriage,1931-11-21,1931,0,0,0,0.462741
136134,Resurrection Man,1998-02-13,1998,0,0,0,0.543985
136141,The Steel Road,1929-10-15,1929,0,0,0,0.151206
136146,Inside,2002-06-01,2002,0,0,0,0.960057
136190,In the Shadow,2012-09-13,2012,0,0,0,0.99391
136215,Barbie and the Rockers: Out Of This World,1987-01-01,1987,0,0,0,0.44533
136238,Sista dansen,1993-12-25,1993,0,0,0,0.682046
136254,Les Patterson Saves the World,1987-04-09,1987,0,0,0,0.108088
136278,Blood,2012-10-09,2012,0,0,0,2.933201
136294,The Perfect Date,2010-05-05,2010,0,0,0,2.933283
136296,B.B. King: The Life of Riley,2012-10-15,2012,0,0,0,2.147188
136311,American Strays,1996-09-12,1996,0,1910,1910,0.51063
136336,The Long Dark Hall,1951-02-06,1951,0,0,0,0.106919
136339,The Policeman of the 16th Precinct,2008-11-27,2008,0,0,0,0.705268
136345,Ballerina,2006-08-31,2006,0,0,0,0.428373
136366,Fugu & Tako,2012-09-21,2012,0,0,0,0.125697
136368,Echo Planet,2012-08-01,2012,0,0,0,2.059664
136386,The Knot,2012-10-05,2012,0,0,0,1.005983
136400,2 Guns,2013-08-02,2013,61000000,131940411,70940411,13.336512
136403,Populaire,2012-11-27,2012,0,0,0,8.804555
136418,Hummingbird,2013-05-07,2013,20000000,8352885,-11647115,8.801032
136437,Beyond the Walls,2012-12-05,2012,0,0,0,1.247098
136459,Victor and the Secret of Crocodile Mansion,2012-03-22,2012,0,0,0,0.638952
136466,Sparrows Dance,2013-08-23,2013,175000,0,-175000,0.742942
136476,State of Emergency,2011-01-01,2011,1300000,0,-1300000,1.334551
136525,Divorce,1945-08-18,1945,0,0,0,0.471484
136553,The Rumble in the Air: Conditioned Auditorium,2012-10-06,2012,0,0,0,0.172538
136558,Kingdom Come,2011-01-01,2011,0,0,0,0.986251
136572,Hotel Meina,2007-10-07,2007,0,0,0,0.157899
136576,Counselor at Crime,1973-08-30,1973,0,0,0,0.591107
136582,Aliyah,2012-09-19,2012,0,0,0,1.019312
136585,Return to Nuke 'Em High Volume 1,2013-05-16,2013,0,0,0,1.526871
136616,The Pursuit of Unhappiness,2012-11-29,2012,0,0,0,0.53039
136619,Pinocchio,2012-10-05,2012,0,0,0,0.272995
136627,Devdas,1955-01-01,1955,0,0,0,0.295098
136663,Beyond the Walls,1984-09-27,1984,0,0,0,0.005984
136698,Underground: The Julian Assange Story,2012-10-07,2012,0,0,0,2.125772
136716,Hollywood on Trial,1976-11-01,1976,0,0,0,0.0375
136727,Of Snails and Men,2012-09-14,2012,0,0,0,0.811537
136735,The Snitch Cartel,2012-11-11,2012,0,0,0,0.978084
136741,Myn Bala: Warriors of the Steppe,2012-04-25,2012,10,0,-10,2.267594
136742,Gulf Stream Under the Iceberg,2012-06-26,2012,0,0,0,1.756488
136743,The Third Half,2012-09-27,2012,0,0,0,2.227426
136752,"Rock, Paper, Scissors",2012-06-22,2012,0,0,0,0.191452
136762,So Is This,1983-12-31,1983,0,0,0,0.00273
136786,Liv & Ingmar,2012-09-28,2012,0,0,0,0.462133
136793,Dino Time,2012-12-07,2012,0,0,0,8.011533
136795,The Heat,2013-06-27,2013,43000000,158674180,115674180,12.706403
136797,Need for Speed,2014-03-13,2014,66000000,203277636,137277636,18.271383
136799,Trolls,2016-10-13,2016,125000000,346864462,221864462,16.83711
136801,Back from Hell,2012-10-16,2012,0,0,0,0.441613
136835,No Good Deed,2014-09-10,2014,13200000,53830415,40630415,24.644321
136842,Amarilly of Clothes-Line Alley,1918-03-10,1918,0,0,0,0.539374
136850,Breaking the Girls,2013-07-26,2013,0,0,0,2.142248
136867,Oliver Twist,1999-11-28,1999,0,0,0,1.306213
136884,Dark Blood,2012-09-27,2012,0,0,0,0.667463
136902,Death of a Man in the Balkans,2012-11-15,2012,0,0,0,0.329195
136911,The Factory,2012-10-19,2012,25000000,0,-25000000,7.913726
136921,Pixels,2010-04-01,2010,0,0,0,1.190657
136928,First Winter,2012-10-11,2012,0,0,0,0.129207
136966,Barbed Wire,1952-07-25,1952,0,0,0,0.004733
137002,The Capsule,2012-08-03,2012,0,0,0,0.597526
137008,small roads,2011-09-03,2011,0,0,0,0.047721
137014,How They Get There,1997-01-01,1997,0,0,0,0.730682
137037,The Death of Maria Malibran,1972-03-02,1972,0,0,0,0.217022
137072,The Comedian,2013-05-31,2013,0,0,0,0.366565
137079,The Winter of Discontent,2013-08-23,2013,0,0,0,0.542998
137093,Last Vegas,2013-10-31,2013,28000000,134402450,106402450,9.157369
137094,Jack Ryan: Shadow Recruit,2014-01-15,2014,60000000,50549107,-9450893,11.234862
137106,The Lego Movie,2014-02-06,2014,60000000,469160692,409160692,16.418133
137113,Edge of Tomorrow,2014-05-27,2014,178000000,370541256,192541256,31.982986
137116,Smurfs: The Lost Village,2017-03-23,2017,60000000,197183546,137183546,16.972835
137144,Jeff Dunham: Minding the Monsters,2012-10-07,2012,0,0,0,0.749133
137145,247¬∞F,2011-09-01,2011,650000,0,-650000,7.427206
137174,Marfa Girl,2012-11-20,2012,2000000,0,-2000000,0.942041
137180,Aiyyaa,2012-10-12,2012,0,0,0,0.795674
137182,The Broken Circle Breakdown,2012-10-09,2012,0,5475058,5475058,12.507625
137193,The Day of the Crows,2012-10-23,2012,0,0,0,2.18722
137200,Back To The Sea,2012-01-27,2012,0,0,0,1.082675
137217,Donovan's Echo,2011-09-17,2011,0,0,0,1.459705
137221,The Day That Lasted 21 Years,2012-09-30,2012,0,0,0,0.053959
137222,Doppelg√§nger Paul,2012-09-12,2012,0,0,0,0.019704
137236,Backstage,2000-09-08,2000,0,0,0,0.363422
137269,Cousin Jules,1972-05-01,1972,0,0,0,0.451329
137285,Crossfire Hurricane,2012-10-18,2012,0,0,0,1.434624
137308,Sancharram,2004-10-01,2004,0,0,0,0.67977
137310,Wild Hearts,2006-07-08,2006,0,0,0,1.058512
137312,Red Flag,2012-07-15,2012,0,0,0,0.375329
137315,Every Blessed Day,2012-10-10,2012,0,0,0,3.211308
137321,Winter's Tale,2014-02-13,2014,60000000,30800231,-29199769,7.363527
137333,Uncanny,2015-01-31,2015,0,0,0,6.515574
137347,Closer to the Moon,2013-11-29,2013,9000000,0,-9000000,1.375615
137357,Hungry Hill,1947-01-07,1947,0,0,0,1.199812
137366,Led Zeppelin - Celebration Day,2012-10-17,2012,0,0,0,5.431571
137370,Pauline d√©tective,2012-10-01,2012,0,0,0,1.534833
137381,People of a Feather,2012-04-20,2012,0,0,0,0.085595
137400,Black & White: The Dawn of Assault,2012-01-13,2012,12000000,0,-12000000,1.091711
137409,Cold War,2012-11-08,2012,0,0,0,7.762757
137429,Babbitt,1934-12-08,1934,0,0,0,0.56427
137474,An Affair of the Heart,2012-04-14,2012,0,0,0,0.016164
137475,Golden Christmas 2,2011-11-15,2011,0,0,0,0.750256
137484,New Year,2011-03-13,2011,0,0,0,0.044016
137491,Snow in August,2001-08-12,2001,0,0,0,1.028803
137499,Foreverland,2012-06-15,2012,0,0,0,0.497507
137504,"Older Brother, Younger Sister",1953-08-19,1953,0,0,0,0.458318
137528,You Can't Kill Stephen King,2012-04-14,2012,0,0,0,1.062964
137533,Revenge of the Stepford Wives,1980-10-12,1980,0,0,0,0.956557
137563,A Band Called Death,2013-06-27,2013,0,125,125,2.690008
137566,Between Us,2012-09-13,2012,0,0,0,1.282586
137587,Reilly: Ace of Spies,1983-09-05,1983,0,0,0,0.034712
137599,Action,1980-01-04,1980,121,0,-121,1.12006
137614,The Forest,2012-12-14,2012,0,0,0,0.497835
137619,Umbracle,1972-01-01,1972,0,0,0,0.519795
137625,Nocturne 29,1968-01-01,1968,0,0,0,0.155855
137646,The Education of Mohammad Hussein,2012-05-14,2012,0,0,0,0.046141
137651,Kings Point,2012-01-01,2012,0,0,0,0.04353
137654,Open Heart,2013-01-15,2013,0,0,0,0.177433
137669,To Boldly Flee,2012-10-20,2012,0,0,0,0.709969
137683,The Kitchen,2012-08-13,2012,0,0,0,4.424429
137698,The Dance of Reality,2013-05-18,2013,3000000,0,-3000000,4.047325
137700,Women's Day,2012-05-08,2012,0,0,0,0.195583
137726,The Departure,1967-03-06,1967,0,0,0,0.4796
137746,The Recovered,2008-01-01,2008,0,0,0,0.010592
137748,The Confession,2001-01-01,2001,0,0,0,0.807227
137757,The Merry Frolics of Satan,1906-01-01,1906,0,0,0,0.285283
137769,The Magic Crystal,2011-11-18,2011,5000000,0,-5000000,0.241162
137776,A Mother's Nightmare,2012-09-29,2012,0,0,0,1.555534
137801,Nobody Knows Sex,2006-03-15,2006,0,0,0,0.152426
137826,The Remarkable Mr. Pennypacker,1959-02-20,1959,0,0,0,0.564334
137853,Journey to Planet X,2012-04-20,2012,0,0,0,0.209749
137859,The Unvanquished,1964-09-25,1964,0,0,0,0.515185
137876,The Reckoning,2014-08-06,2014,0,0,0,6.489398
137955,Crowsnest,2012-01-01,2012,1200000,0,-1200000,0.475386
137960,The Discoverers,2014-05-16,2014,0,0,0,1.392765
137968,Drift,2013-07-23,2013,11000000,0,-11000000,4.121722
137984,The Collection,1976-01-01,1976,0,0,0,0.48398
138014,Fish out of Water,2009-07-18,2009,0,0,0,0.040003
138022,Blood in the Face,1991-02-27,1991,0,0,0,0.035265
138030,The Coward,1965-05-07,1965,0,0,0,1.258328
138038,Girl vs. Monster,2012-10-12,2012,0,0,0,6.670101
138061,American Juggalo,2011-09-25,2011,0,0,0,0.078128
138093,Revue,2008-06-15,2008,0,0,0,0.110644
138103,The Expendables 3,2014-08-04,2014,90000000,206172544,116172544,14.753545
138115,Johan Falk: Organizatsija Karayan,2012-11-06,2012,0,0,0,1.578264
138118,Johan Falk: Barninfiltrat√∂ren,2012-11-21,2012,0,0,0,1.425992
138122,Student of the Year,2012-10-19,2012,0,0,0,3.550969
138167,One Love,2011-11-09,2011,0,0,0,0.403726
138191,36,2012-01-17,2012,0,0,0,0.219855
138202,Future Weather,2012-04-29,2012,0,0,0,1.128018
138217,Koch,2013-02-01,2013,0,0,0,0.048664
138222,Best Man Down,2012-10-20,2012,1500000,1938,-1498062,5.875708
138273,La Vacanza,1971-09-04,1971,0,0,0,4.158529
138308,The Hard Man,1957-12-01,1957,0,0,0,0.255555
138341,Big City Blues,1932-09-18,1932,0,0,0,0.441939
138357,The Prodigal,1955-05-06,1955,0,0,0,0.661561
138372,Bad Kids Go To Hell,2012-12-07,2012,0,0,0,3.140175
138376,A Dark Truth,2012-11-29,2012,0,5750,5750,8.73819
138394,Monty Python - Almost the Truth (The Lawyer's Cut),2009-10-04,2009,0,0,0,0.35625
138449,Ora o mai pi√π,2003-01-01,2003,0,0,0,0.073046
138450,True Skin,2012-10-10,2012,0,0,0,0.424518
138486,Arrow In The Dust,1954-04-25,1954,0,0,0,0.458093
138496,Crawlspace,2012-05-01,2012,0,0,0,4.606329
138502,Offline,2012-11-14,2012,0,0,0,1.270481
138513,In His Father's Shoes,1997-06-05,1997,0,0,0,0.48118
138522,Few of Us,1996-09-18,1996,0,0,0,0.537009
138535,11 x 14,1977-04-16,1977,0,0,0,0.050215
138543,A Lot Like You,2012-03-28,2012,0,0,0,0.01039
138544,American Horror House,2012-10-13,2012,0,0,0,0.589213
138550,The Star Making Machine,2012-08-30,2012,0,0,0,0.344831
138574,Beyond the Hill,2012-12-14,2012,0,0,0,1.502637
138611,Le peuple invisible,2007-01-01,2007,0,0,0,0.010318
138665,Perfect Number,2012-10-18,2012,0,0,0,1.040434
138667,Cameraman Ganga Tho Rambabu,2012-10-17,2012,0,0,0,0.27824
138686,The Marathon,2012-10-18,2012,0,0,0,1.891895
138697,Don Jon,2013-07-26,2013,6000000,0,-6000000,10.948605
138699,The Little Hut,1957-05-03,1957,0,0,0,0.883862
138705,Vares: Gambling Chip,2012-03-16,2012,0,0,0,0.592993
138719,Super Demetrios,2011-11-05,2011,0,0,0,1.362725
138724,A Man with Warranty,2012-09-27,2012,0,0,0,1.59049
138730,The House of Ghosts,1908-01-01,1908,0,0,0,0.550504
138735,Little Thirteen,2012-07-04,2012,600000,0,-600000,2.12364
138752,Return to Reason,1923-09-06,1923,0,0,0,0.484709
138754,Good Luck. And Take Care of Each Other,2012-10-19,2012,914,0,-914,0.115801
138767,Room 514,2012-10-12,2012,0,0,0,0.095633
138827,Penance,2012-01-07,2012,0,0,0,0.533016
138832,We're the Millers,2013-08-07,2013,37000000,269994119,232994119,18.474368
138843,The Conjuring,2013-07-18,2013,13000000,318000141,305000141,14.90169
138853,Ghost,2010-11-13,2010,0,9833553,9833553,0.215013
138906,Le Grand Amour,1969-03-21,1969,0,0,0,0.302462
138907,Sassy Pants,2012-10-26,2012,0,0,0,1.83717
138941,Found,2012-03-30,2012,8000,0,-8000,1.747257
138943,Daddy's Little Girl,2012-01-01,2012,0,0,0,1.566681
138977,Hello Herman,2012-06-05,2012,1500000,0,-1500000,1.469955
138990,Twilight of Honor,1963-11-13,1963,0,0,0,0.025166
139038,A Haunted House,2013-01-11,2013,2500000,60141683,57641683,6.531373
139058,I'll Never Forget What's'isname,1967-12-18,1967,0,0,0,0.29714
139075,Dance Me to My Song,1998-10-20,1998,0,0,0,0.307336
139156,Stars 80,2012-10-24,2012,0,0,0,2.370243
139159,Coming Home,2012-04-04,2012,0,0,0,0.70833
139169,Farewell,1981-10-07,1981,0,0,0,0.317334
139170,The Long Day's Dying,1968-05-28,1968,0,0,0,0.291201
139176,Camille,1921-09-26,1921,0,0,0,0.214792
139195,The Office Party,1972-10-04,1972,0,0,0,0.648098
139212,Recipes For Disaster,2008-09-19,2008,0,0,0,0.164427
139215,Garrison Keillor: The Man on the Radio in the Red Shoes,2009-07-01,2009,0,0,0,0.059671
139230,The Return of the War Room,2008-10-13,2008,0,0,0,0.006999
139238,The Lily of Belgium,1915-10-10,1915,0,0,0,0.112814
139244,The Tale of Sweeney Todd,1998-04-19,1998,0,0,0,0.471
139251,I Married Who?,2012-10-20,2012,0,0,0,1.931262
139270,Little Black Spiders,2012-09-19,2012,0,0,0,0.744542
139272,A Long Story,2012-10-12,2012,0,0,0,0.946781
139276,Un mundo cuadrado,2012-10-19,2012,0,0,0,0.495184
139300,Ticket to Vegas,2013-01-24,2013,0,6134438,6134438,1.125635
139302,The Bitter Buddha,2012-06-15,2012,250000,0,-250000,0.849106
139325,Made in Mexico,2012-09-21,2012,2000000,0,-2000000,0.447095
139329,Back to 1942,2012-11-01,2012,0,311,311,1.678013
139334,The Huns,1960-10-05,1960,0,0,0,0.338321
139349,The Premonition,1976-05-19,1976,0,0,0,0.717077
139357,Pizza,2012-10-19,2012,240000,2800000,2560000,0.602301
139367,The Mark,2012-01-01,2012,0,0,0,0.542939
139374,Bullit & Ripper,2012-12-02,2012,9000000,0,-9000000,2.754608
139380,Nativity 2: Danger in the Manger!,2012-11-21,2012,0,0,0,0.619534
139383,Betrayal,1983-02-19,1983,0,0,0,0.798206
139405,Across the Sea of Time,1995-10-20,1995,0,0,0,0.114469
139406,Radio Free Albemuth,2010-01-01,2010,3600000,0,-3600000,1.91768
139408,The Stars Fell on Henrietta,1995-09-15,1995,0,0,0,0.913522
139433,No One Dies in Lily Dale,2011-01-01,2011,0,0,0,0.04249
139434,You Don't Like the Truth: 4 Days Inside Guantanamo,2010-01-01,2010,0,0,0,0.198734
139445,N√¥,1998-05-26,1998,0,0,0,0.187537
139455,Silent Night,2012-11-30,2012,0,14567,14567,7.601525
139459,Contest,2013-12-31,2013,0,0,0,0.763024
139463,The Scapegoat,2012-09-09,2012,0,0,0,7.618217
139467,Camouflage,1977-01-28,1977,0,0,0,0.152146
139504,The Commander and the Stork,2012-10-18,2012,0,0,0,1.270181
139519,Magic Magic,2013-07-26,2013,0,0,0,7.201765
139521,Matru Ki Bijlee Ka Mandola,2013-01-11,2013,838403,0,-838403,1.638668
139559,Till Night Do Us Part,2012-10-11,2012,0,0,0,0.376914
139563,La poliziotta,1974-11-15,1974,0,0,0,0.050698
139567,Fire with Fire,2012-08-31,2012,20000000,4636169,-15363831,10.999209
139571,Refuge,2012-10-11,2012,0,0,0,1.023793
139572,Rising from Ashes,2013-08-02,2013,0,0,0,0.082464
139575,Bitch Hug,2012-10-19,2012,0,0,0,0.273637
139579,Little Tragedies,1980-06-30,1980,0,0,0,1.086068
139582,Chakravyuh,2012-10-24,2012,0,0,0,0.156595
139589,An Interesting Story,1904-10-01,1904,0,0,0,0.189855
139609,Les quatre v√©rit√©s,1962-12-21,1962,0,0,0,0.305309
139635,El hijo del cura,1982-09-17,1982,0,0,0,0.281148
139637,No Man's Land,1978-01-01,1978,0,0,0,0.818181
139646,Animals,2012-10-26,2012,0,0,0,0.77732
139651,Haute Cuisine,2012-09-17,2012,0,11384015,11384015,4.64874
139659,Puppet Master X: Axis Rising,2012-09-15,2012,0,0,0,0.724869
139662,Maattrraan,2012-10-11,2012,11340000,0,-11340000,0.59039
139692,Coquille,1999-03-27,1999,0,0,0,0.090233
139712,Marx Reloaded,2011-01-01,2011,0,0,0,0.622591
139715,Detention of the Dead,2012-04-27,2012,500000,0,-500000,2.524224
139718,The Phynx,1970-03-06,1970,0,0,0,0.596273
139725,Twice Upon a Time,2012-06-13,2012,0,0,0,1.392492
139777,World Without End,2012-01-01,2012,0,0,0,2.196372
139799,The Glass Slipper,1955-01-01,1955,0,0,0,2.443375
139808,A Gun in Each Hand,2012-12-05,2012,0,0,0,1.814897
139820,Goltzius and the Pelican Company,2012-09-30,2012,0,0,0,1.149191
139826,In Pursuit of Honor,1995-03-18,1995,0,0,0,0.828105
139846,Soundtrack for a Revolution,2009-01-01,2009,0,0,0,0.056028
139848,On Modern Servitude,2009-01-01,2009,0,0,0,0.151526
139851,And Now My Love,1974-05-15,1974,0,0,0,0.147314
139854,Anita O'Day: The Life of a Jazz Singer,2007-04-30,2007,200000,0,-200000,0.003741
139856,New Jerusalem,2011-11-06,2011,0,0,0,0.062282
139862,Rommel,2012-06-06,2012,0,0,0,2.223235
139863,Bertsolari,2011-10-13,2011,0,0,0,0.201862
139909,Aurinkotuuli,,,0,0,0,0.000127
139922,She's Working Her Way Through College,1952-07-12,1952,0,0,0,0.114492
139929,Deal,2012-09-28,2012,0,0,0,0.276021
139930,How Do You Write a Joe Schermann Song,2012-07-13,2012,0,0,0,0.013899
139933,Kiss of the Damned,2012-11-07,2012,0,14752,14752,11.397245
139945,The Dark Glow of the Mountain,1985-03-09,1985,62500,0,-62500,0.798546
139948,Burn,2012-11-01,2012,225000,111300,-113700,0.466236
139997,And While We Were Here,2013-09-13,2013,0,0,0,1.797315
139998,Supporting Characters,2012-01-23,2012,0,0,0,1.304887
140003,Ballad of the Little Soldier,1984-11-05,1984,0,0,0,0.480589
140007,After the Reconciliation,2000-12-27,2000,0,0,0,0.209425
140008,The Leather Boys,1964-03-08,1964,0,0,0,0.351614
140032,The Fountain of Youth,1958-09-16,1958,0,0,0,0.054186
140036,Olympian Holiday,1976-12-17,1976,0,0,0,0.00363
140054,We Were Here: Part 1,2012-03-17,2012,0,0,0,0.843229
140071,Seize the Day,1986-09-09,1986,0,0,0,1.916869
140101,Love Torn in a Dream,2000-08-28,2000,0,0,0,0.663575
140149,Season's Greetings,1996-10-31,1996,0,0,0,0.822097
140161,V: The Final Battle,1984-05-06,1984,0,0,0,3.126689
140172,Cool Air,2006-11-03,2006,1,0,-1,0.509406
140174,Rise of the Zombies,2012-10-27,2012,0,0,0,1.792726
140207,Tinker Tailor Soldier Spy,1979-09-10,1979,0,0,0,1.564586
140208,Bad Boy Street,2012-10-22,2012,0,0,0,1.49467
140212,Confession of Murder,2012-11-08,2012,0,0,0,3.056171
140222,Love and Honor,2013-03-22,2013,0,0,0,6.617821
140229,The Girl and Death,2012-11-15,2012,0,0,0,0.505235
140231,Elaan,2005-01-14,2005,0,0,0,1.598655
140276,The Road to Glory,1936-09-04,1936,0,0,0,0.107913
140278,Dogville Confessions,2004-06-27,2004,0,0,0,0.375271
140281,She Wouldn't Say Yes,1945-11-29,1945,0,0,0,0.446719
140300,Kung Fu Panda 3,2016-01-23,2016,145000000,521170825,376170825,14.696548
140380,26 Years,2012-11-29,2012,4330000,0,-4330000,1.1939
140383,Keep an Eye on Amelia,1949-12-16,1949,0,0,0,0.251702
140413,All Night Long,1981-03-06,1981,0,10000000,10000000,0.708186
140418,Bulldog Drummond at Bay,1937-05-01,1937,0,0,0,0.371059
140420,Paperman,2012-11-02,2012,0,0,0,7.198633
140423,I Love You Rosa,1972-02-12,1972,0,0,0,0.295582
140441,Sadako 3D,2012-05-12,2012,0,0,0,9.039479
140443,The Girl,2012-01-15,2012,0,0,0,2.006277
140447,Una noche,2012-02-15,2012,0,0,0,1.73454
140448,Downeast,2012-06-15,2012,0,0,0,0.00891
140456,For No Good Reason,2012-10-12,2012,0,0,0,2.229266
140465,Prohibition,2011-10-02,2011,0,0,0,1.433433
140470,Bulldog Drummond's Bride,1939-07-12,1939,0,0,0,0.412039
140472,Bulldog Drummond's Revenge,1937-12-16,1937,0,0,0,0.354936
140481,"Park Avenue: Money, Power & The American Dream",2012-01-01,2012,0,0,0,0.883435
140485,Saƒü Salim,2012-05-18,2012,0,0,0,0.289716
140489,The Mother Of Invention,2010-06-25,2010,60000,0,-60000,0.367293
140491,Alienate,2016-02-22,2016,0,0,0,3.21853
140509,"The Foreign Duck, the Native Duck and God in a Coin Locker",2007-06-23,2007,0,0,0,1.017725
140511,King of the Jungle,2000-10-12,2000,0,27,27,0.938234
140513,Bakeneko: A Vengeful Spirit,1968-07-12,1968,0,0,0,0.062612
140519,Mascara,1999-05-07,1999,0,0,0,0.970449
140527,Glitterbug,1994-03-05,1994,0,0,0,0.686753
140530,White Rose Campus: Then... Everybody Gets Raped,1982-06-25,1982,0,0,0,2.656714
140541,Blood Sisters of Lesbian Sin,1997-01-01,1997,0,0,0,0.053233
140554,Fraktus,2012-11-06,2012,0,0,0,1.651528
140595,Elaine Stritch: At Liberty,2002-01-01,2002,300000,0,-300000,0.089067
140605,Certain Fury,1985-03-01,1985,0,0,0,0.606516
140607,Star Wars: The Force Awakens,2015-12-15,2015,245000000,2068223624,1823223624,31.626013
140632,Hot Summer Week,1972-06-21,1972,0,0,0,0.12986
140648,City on Fire,1979-07-11,1979,0,0,0,1.015142
140652,My Super Psycho Sweet 16: Part 3,2012-03-13,2012,0,0,0,0.922344
140668,Somewhere in Palilula,2012-04-20,2012,0,0,0,0.04619
140697,Elevator,2008-04-04,2008,260,0,-260,0.042904
140708,So It Goes,2012-03-09,2012,0,0,0,0.00831
140733,The Gnome,2005-03-17,2005,0,0,0,0.314552
140750,ThanksKilling 3,2012-11-13,2012,100000,0,-100000,0.337176
140781,Daylight,2011-07-17,2011,0,0,0,0.062936
140783,A Mother's Courage,2009-01-01,2009,0,0,0,0.04013
140814,Elliot Loves,2012-05-04,2012,0,0,0,0.338447
140818,Ragnarok,2013-11-11,2013,6500000,3721345,-2778655,11.365247
140823,Saving Mr. Banks,2013-11-16,2013,35000000,112544580,77544580,15.130888
140825,The Deadly Trap,1971-06-09,1971,0,0,0,0.382406
140846,Company,2011-06-15,2011,0,0,0,1.496974
140849,The Rawhide Years,1955-11-28,1955,0,0,0,1.127041
140870,Minuscule: Valley of the Lost Ants,2013-11-17,2013,19700000,30000000,10300000,6.583428
140873,That Guy... Who Was in That Thing,2012-01-01,2012,0,0,0,1.276872
140883,Prahaar: The Final Attack,1991-01-01,1991,0,0,0,0.908234
140887,The Three Musketeers,1933-04-07,1933,0,0,0,0.694665
140894,Tricked,2012-09-25,2012,0,0,0,1.784351
140897,Outside Ozona,1998-12-18,1998,0,0,0,1.28977
140934,The Preacher's Daughter,2012-08-31,2012,0,0,0,0.11207
140966,Pirates of the 20th Century,1980-07-14,1980,0,0,0,1.50219
140979,Electronic Labyrinth THX 1138 4EB,1967-03-14,1967,0,0,0,0.727025
140995,The Sisters,1938-10-14,1938,0,0,0,0.646946
141003,The Thin Blue Lie,2000-08-13,2000,0,0,0,0.0826
141010,And the Crows Will Dig Your Grave,1971-08-11,1971,0,0,0,6.2e-05
141015,Combustion,2013-04-26,2013,0,0,0,0.133451
141043,A Long Way Down,2014-03-20,2014,0,7176347,7176347,10.46897
141052,Justice League,2017-11-15,2017,0,0,0,25.944629
141055,Bikini Summer II,1992-01-01,1992,0,0,0,0.014867
141058,A Viking Saga: The Darkest Day,2013-06-10,2013,0,0,0,0.06417
141063,Skeleton Key 2: 667 Neighbor of the Beast,2008-09-02,2008,5000,0,-5000,0.299214
141102,The Swan Princess Christmas,2012-11-05,2012,40000000,0,-40000000,1.647024
141131,The Magnificent Ruffians,1979-09-20,1979,0,0,0,0.948253
141138,The Kung Fu Instructor,1979-06-16,1979,0,0,0,0.244392
141145,Kid,2013-01-16,2013,0,0,0,0.376076
141152,Everybody's Got Somebody... Not Me,2012-11-02,2012,0,0,0,0.490462
141210,The Sleepover,2013-10-12,2013,0,0,0,0.135596
141241,15,2005-10-21,2005,0,28,28,0.03856
141262,Season For Assassins,1975-12-27,1975,0,0,0,0.034706
141267,Johan Falk: Kodnamn Lisa,2013-03-15,2013,0,0,0,1.107204
141319,Spanish Judges,2000-10-16,2000,3500000,0,-3500000,1.000373
141418,The Letter Writer,2011-11-15,2011,0,0,0,0.584922
141419,Arnulf Rainer,1960-12-31,1960,0,0,0,0.693517
141423,The Legend of Mor'du,2012-01-01,2012,0,0,0,3.785848
141461,The Sword Stained with Royal Blood,1981-03-06,1981,0,0,0,0.063059
141476,When Santa Fell to Earth,2011-11-23,2011,0,0,0,1.297422
141489,Hamlet from the Lunt-Fontanne Theatre,1964-09-23,1964,0,0,0,0.512134
141520,Rita's Last Fairy Tale,2012-11-01,2012,200000,486937,286937,0.560685
141581,Nous York,2012-11-06,2012,5,0,-5,3.061288
141603,Hooligan,1998-09-04,1998,0,0,0,0.200777
141613,Jeet,1996-08-23,1996,0,0,0,0.660941
141614,"Niko 2 - Little Brother, Big Trouble",2012-10-12,2012,0,17000000,17000000,3.232942
141635,All the Light in the Sky,2012-11-03,2012,0,0,0,0.335212
141640,David Copperfield,2001-12-25,2001,0,0,0,1.020542
141643,Ten Violent Women,1982-03-01,1982,0,0,0,0.00335
141679,Spike Island,2012-10-11,2012,0,0,0,6.556092
141714,Wild China,2008-01-01,2008,0,0,0,0.674662
141733,Cottage Country,2013-03-13,2013,0,0,0,5.743909
141754,Chainsaw Maid,2007-12-08,2007,0,0,0,0.355582
141757,The Phantom,1984-07-05,1984,0,0,0,0.011938
141760,Numbered,2012-10-14,2012,0,0,0,0.037338
141803,Moshe Kasher: Live in Oakland,2012-10-26,2012,0,0,0,0.121612
141810,Gli equilibristi,2012-01-01,2012,0,0,0,0.409337
141819,Unforgiven,2013-09-13,2013,0,0,0,2.443676
141868,Fatty and Mabel Adrift,1916-01-09,1916,0,0,0,0.314735
141884,A BIG Love Story,2012-04-29,2012,0,0,0,0.281145
141901,Evim Sensin,2012-11-02,2012,0,0,0,1.947948
141950,Calm at Sea,2012-03-21,2012,0,0,0,1.485498
141955,A Flea In Her Ear,1968-11-27,1968,0,0,0,0.816407
141971,Blackout,2008-12-26,2008,0,0,0,0.411949
141971,Blackout,2008-12-26,2008,0,0,0,0.411949
141971,Blackout,2008-12-26,2008,0,0,0,0.411949
141976,Mistletoe Over Manhattan,2011-11-06,2011,0,0,0,0.637774
141978,They Rode West,1954-12-04,1954,0,0,0,0.423377
142012,Gang in Blue,1996-09-08,1996,0,0,0,0.652515
142023,Lovers of the Caf√© Flore,2006-01-26,2006,0,0,0,1.374382
142026,The Dancing Pig,1907-08-10,1907,0,0,0,0.697911
142051,Jazz,2001-01-09,2001,0,0,0,1.507756
142052,Irene in Time,2009-06-19,2009,2000000,0,-2000000,0.519131
142061,"Batman: The Dark Knight Returns, Part 2",2013-01-18,2013,3500000,0,-3500000,12.576611
142064,"It's A Bird, It's A Plane, It's Superman!",1975-02-21,1975,0,0,0,0.100013
142084,Hiroshima,2009-09-15,2009,0,0,0,0.045762
142085,Lost Persons Area,2009-05-16,2009,0,0,0,0.020105
142093,Lover,2005-12-08,2005,0,0,0,1.135639
142106,Petunia,2013-06-28,2013,0,0,0,1.846272
142115,Five Dances,2013-06-19,2013,0,0,0,1.8256
142118,The Storage,2011-12-30,2011,0,0,0,0.469543
142119,Food Stamped,2010-10-09,2010,0,0,0,0.142575
142132,Sugar Town,1999-09-17,1999,0,0,0,0.20833
142145,Cold River,1982-03-01,1982,0,0,0,0.007203
142150,Kidnapped,1995-11-05,1995,0,0,0,0.309018
142159,Across to Singapore,1928-04-07,1928,290000,596000,306000,0.140491
142161,9.79*,2012-10-09,2012,0,0,0,0.154128
142168,Searching for Debra Winger,2002-07-13,2002,0,0,0,0.439424
142208,Buffalo Girls,2012-11-14,2012,0,0,0,0.122409
142216,Quarterback Princess,1983-12-03,1983,0,0,0,0.479034
142254,Jeanne Eagels,1957-08-02,1957,0,0,0,0.026219
142293,Bending Colours,2012-01-01,2012,0,0,0,0.19551
142308,Santa Paws 2: The Santa Pups,2012-11-20,2012,0,0,0,2.583829
142320,Viva l'Italia,2012-10-25,2012,0,0,0,3.164861
142358,A Night Full of Rain,1978-01-17,1978,0,0,0,0.659604
142373,Joan the Maid 1: The Battles,1994-02-09,1994,0,0,0,1.153977
142374,Joan the Maid 2: The Prisons,1994-02-09,1994,0,0,0,1.006711
142375,The Koumiko Mystery,1965-10-09,1965,0,0,0,0.292845
142391,95ers: Time Runners,2013-02-14,2013,750,0,-750,1.489131
142402,Sam Steele and the Junior Detective Agency,2011-01-04,2011,0,0,0,0.483398
142406,Saturday October 5th,1969-10-10,1969,0,0,0,0.038719
142408,Laissons Lucie faire !,2000-12-27,2000,0,0,0,0.875408
142412,Kaun?,1999-02-26,1999,0,0,0,0.701988
142478,The Making of 'The Bridge on the River Kwai',2000-01-01,2000,0,0,0,0.483056
142487,The Precocious and Brief Life of Sabina Rivas,2012-11-09,2012,4620000,2395000,-2225000,0.546165
142499,The Harmonium in My Memory,1999-03-27,1999,0,0,0,1.893759
142507,Exit,2011-01-01,2011,0,0,0,0.667502
142528,Des fleurs pour Algernon,2006-11-14,2006,0,0,0,1.091052
142533,Dangerously Excited,2011-02-01,2011,0,0,0,0.739523
142563,Fresh Guacamole,2012-03-02,2012,0,0,0,4.406065
142573,Are All Men Pedophiles?,2012-02-29,2012,0,0,0,0.862061
142585,That Certain Summer,1972-11-01,1972,0,0,0,0.372215
142611,"Houston, We Have a Problem!",2016-05-05,2016,0,0,0,0.902847
142631,Love Ke Liye Kuch Bhi Karega,2001-06-21,2001,0,0,0,0.623882
142635,Love at the Thanksgiving Day Parade,2012-11-04,2012,0,0,0,1.425795
142650,Finding Joy,2013-06-07,2013,0,0,0,0.748977
142656,Fountainhead,1956-02-26,1956,0,0,0,0.145941
142712,8:28 AM,2010-09-17,2010,0,0,0,0.430238
142724,Walker,2012-09-08,2012,0,0,0,0.515289
142746,Take Care of the Women!,1981-10-01,1981,0,0,0,0.37965
142757,Valentin and Valentina,1985-12-12,1985,0,0,0,1.54159
142758,Deadly Renovations,2010-01-09,2010,0,0,0,0.045141
142770,True Friends,1954-04-20,1954,0,0,0,0.892569
142797,Height,1957-04-27,1957,0,0,0,0.172227
142798,"Blue Mountains, or Unbelievable Story",1984-12-03,1984,0,0,0,0.074998
142802,–ì–æ–Ω–≥–æ—Ñ–µ—Ä,1992-01-01,1992,0,0,0,0.000844
142808,Dauria,1972-05-08,1972,0,0,0,0.238063
142830,Hell's Bells,1988-01-01,1988,0,0,0,3e-06
142876,Cheers For Miss Bishop,1941-02-21,1941,0,0,0,0.442155
142881,Kommunist,1958-02-03,1958,0,0,0,0.386603
142897,Mantle,2005-07-13,2005,0,0,0,0.141464
142914,In Search of Blind Joe Death: The Saga of John Fahey,2013-08-16,2013,0,0,0,0.047059
142916,The Great Flood,2012-11-17,2012,0,0,0,0.523999
142918,Woman of Tokyo,1933-02-09,1933,0,0,0,0.320118
142946,Why Me?,1990-04-20,1990,0,0,0,1.347788
142966,"Dave Attell: Hey, Your Mouth's Not Pregnant!",2006-04-20,2006,0,0,0,0.506726
142971,Grace Kelly,1983-02-21,1983,0,0,0,0.992274
142973,Dating Games People Play,2008-02-12,2008,0,0,0,0.003545
142979,The Joy of Living,1961-05-11,1961,0,0,0,0.62512
142982,La corruzione,1963-11-22,1963,0,0,0,0.837243
142984,Scott Joplin,1977-12-30,1977,0,0,0,0.326103
142989,A Get2Gether,2005-09-28,2005,0,0,0,0.057863
143005,–õ—å–≤–∏–Ω–∞—è –¥–æ–ª—è,2001-01-01,2001,0,0,0,0.802866
143049,Adult World,2013-04-18,2013,0,0,0,4.944783
143068,The Postmaster,1972-08-25,1972,0,0,0,0.002001
143073,The Cook,1965-06-06,1965,0,0,0,0.348516
143092,Don't Give Up the Ship,1959-07-03,1959,0,0,0,1.087132
143098,Fire-Eater,1998-10-29,1998,0,0,0,0.235882
143117,"A Black Rose Is an Emblem of Sorrow, a Red Rose an Emblem of Love",1989-02-03,1989,0,0,0,0.630944
143142,Axe Giant - The Wrath of Paul Bunyan,2013-04-25,2013,0,0,0,1.043862
143144,Justice Is Mind,2013-08-18,2013,25000,0,-25000,0.098412
143146,Ritual,2013-12-31,2013,0,0,0,0.819156
143169,Envelope,2012-05-28,2012,0,0,0,0.414002
143223,Fatty Drives the Bus,1999-03-14,1999,0,0,0,0.140298
143240,Nigdy w ≈ºyciu!,2004-02-13,2004,0,0,0,0.89031
143247,Lucy,2003-05-04,2003,0,0,0,0.981883
143277,The Hoodlum,1919-08-31,1919,0,0,0,0.65658
143295,What About Dick?,2012-11-13,2012,0,0,0,0.912708
143299,The Joyriders,1999-04-18,1999,0,0,0,0.505964
143322,Word Is Out,1977-01-31,1977,0,0,0,0.000308
143335,The Gathering Storm,1974-11-29,1974,0,0,0,0.017521
143336,"The Chicken, the Fish and the King Crab",2008-02-15,2008,0,0,0,0.464685
143344,El truco del manco,2008-11-07,2008,0,404075,404075,0.191219
143355,The Battle of Sutjeska,1973-07-31,1973,0,0,0,1.00075
143380,Genius,1991-06-06,1991,0,0,0,0.202703
143431,Louis Theroux's African Hunting Holiday,2008-02-10,2008,0,0,0,1.15378
143437,1 P.M.,1972-02-10,1972,0,0,0,0.633395
143451,Arcana,1972-04-06,1972,0,0,0,0.652815
143453,Thrust in Me,1985-09-11,1985,0,0,0,0.001393
143516,Winterhawk,1975-11-05,1975,0,0,0,1.20983
143525,I'm Afraid,1982-03-26,1982,0,0,0,0.000132
143534,The White Shadow,1924-05-05,1924,0,0,0,0.143297
143546,The Chiefs,2004-10-07,2004,0,0,0,0.002803
143547,Silent Tongue,1993-01-28,1993,0,0,0,1.238099
143563,Jesus Christ Superstar - Live Arena Tour,2012-11-19,2012,0,0,0,1.170973
143567,Just Like Brothers,2012-11-21,2012,0,0,0,3.130494
143602,Reboot,2012-12-12,2012,0,0,0,0.42947
143634,The Electric Hotel,1908-10-31,1908,0,0,0,0.560372
143747,"$1,000 on the Black",1966-12-18,1966,0,0,0,0.634857
143750,The Farmer's Wife,2012-06-20,2012,0,0,0,0.211754
143754,Taste of Killing,1966-08-06,1966,0,0,0,0.132494
143769,Pennies from Heaven,1978-03-07,1978,0,0,0,0.24976
143777,The Killings at Outpost Zeta,1980-02-25,1980,0,0,0,0.000603
143795,War and Peace,2002-04-14,2002,0,0,0,0.003492
143796,As Long as You've Got Your Health,1966-02-25,1966,0,0,0,0.436688
143800,Aftermath,2012-11-09,2012,0,0,0,1.380446
143801,The Sick Kitten,1903-12-31,1903,0,0,0,0.659695
143838,The Mouthpiece,1932-05-07,1932,0,0,0,0.721911
143839,Nothing But the Best,1964-03-10,1964,0,0,0,0.726984
143841,"One Potato, Two Potato",1964-01-01,1964,0,0,0,0.15139
143876,Very Russian Detective,2008-11-20,2008,0,0,0,0.704722
143881,Suhaag,1994-10-20,1994,0,0,0,0.110964
143883,Den radio,2001-03-24,2001,0,0,0,0.671422
143887,Uncle Vanya,1970-12-29,1970,0,0,0,0.277136
143928,Hellgate,2011-11-05,2011,5000000,0,-5000000,1.206717
143936,Payment in Blood,1967-04-14,1967,0,0,0,0.054198
143946,I Will Buy You,1956-11-21,1956,0,0,0,0.346396
143959,Ricky Rapper and Cool Wendy,2012-02-20,2012,0,0,0,0.009599
143966,Perfect Child,2007-08-06,2007,0,0,0,0.030184
143973,Last Run,2001-07-01,2001,0,0,0,1.686472
143980,Brave Revolutionary,1994-07-22,1994,0,0,0,0.318826
143983,"Me, a Groupie",1970-11-26,1970,0,0,0,1.059342
144008,Miles Electric - A Different Kind Of Blue,2004-11-23,2004,0,0,0,0.105778
144089,"The Actress, the Dollars and the Transylvanians",1978-12-22,1978,0,0,0,0.25
144092,Chris Hardwick: Mandroid,2012-11-10,2012,0,0,0,0.258357
144097,All I Want for Christmas,2007-12-01,2007,0,0,0,0.37286
144105,Frankie Boyle - Live - The Last Days of Sodom,2012-11-18,2012,0,0,0,0.383382
144111,Nana,1934-02-01,1934,0,0,0,0.293293
144114,The Dust Bowl,2012-11-17,2012,0,0,0,0.434151
144121,Best of the Badmen,1951-08-09,1951,0,0,0,0.981432
144139,"What Happened on Twenty-Third Street, New York City",1901-07-31,1901,0,0,0,0.916587
144156,Dream Work,2001-03-17,2001,0,0,0,0.352785
144183,Heavy Weather,1995-12-24,1995,0,0,0,0.080985
144204,Thanatomorphose,2012-10-04,2012,0,0,0,1.658699
144206,Whistle and I'll Come to You,2010-12-24,2010,0,0,0,0.255256
144229,Power Play,1978-11-01,1978,0,0,0,0.947815
144231,Always,1985-10-04,1985,0,0,0,0.358193
144271,Joe + Belle,2011-06-01,2011,28000,0,-28000,0.382886
144288,Berserk: The Golden Age Arc 3 - The Advent,2013-02-01,2013,0,0,0,8.141653
144326,Satan Never Sleeps,1962-03-23,1962,0,0,0,0.670369
144331,Dream Team 1935,2012-11-16,2012,2620000,0,-2620000,0.175073
144336,Sabotage,2014-03-28,2014,35000000,17508518,-17491482,6.966505
144340,Admission,2013-03-21,2013,13000000,18000000,5000000,10.098539
144341,"Stranger, Say Your Prayers!",1968-05-16,1968,0,0,0,0.119682
144344,"A Man, a Horse, a Gun",1967-08-17,1967,0,0,0,0.001312
144351,Ghost Fever,1987-03-27,1987,0,0,0,0.220231
144390,The Startup Kids,2012-12-01,2012,0,0,0,0.706199
144393,Annie Oakley,1894-11-01,1894,0,0,0,0.404741
144410,Annabelle Serpentine Dance,1895-04-01,1895,0,0,0,1.58434
144421,Wintergartenprogramm,1895-11-01,1895,0,0,0,0.744847
144430,Ded Moroz i seriy volk,1978-01-01,1978,0,0,0,0.070817
144436,Jack and the Beanstalk,1902-06-20,1902,0,0,0,0.205349
144444,New York Subway,1905-06-05,1905,0,0,0,0.211362
144454,Moscow Clad in Snow,1909-04-09,1909,0,0,0,0.271515
144464,Electrocuting an Elephant,1903-01-12,1903,0,0,0,0.246446
144465,The Match King,1932-07-12,1932,0,0,0,1.221611
144471,"Cole Younger, Gunfighter",1958-03-30,1958,0,0,0,0.489777
144475,The Case of the Howling Dog,1934-09-22,1934,0,0,0,0.582068
144481,41,2012-06-12,2012,0,0,0,0.414219
144498,To Find a Man,1972-01-31,1972,0,0,0,0.174742
144541,"Cze≈õƒá, Tereska",2001-09-28,2001,0,0,0,0.254635
144560,"Right On, Man!",1980-02-29,1980,0,0,0,0.244506
144570,Forest of the Gods,2005-09-23,2005,2177870,0,-2177870,0.19364
144580,Double Bang,2001-08-17,2001,0,0,0,1.270385
144595,Family Way,2012-11-21,2012,0,0,0,1.513933
144610,City Cops,1989-11-18,1989,0,0,0,0.085889
144611,Kino Eye,1924-10-31,1924,0,0,0,0.150588
144613,Beau Brummel,1924-03-30,1924,0,0,0,0.172143
144651,Ghosts Before Breakfast,1928-07-14,1928,0,0,0,0.586297
144676,Scorpio One,1998-01-01,1998,0,0,0,0.478101
144680,Pretty Sweet,2012-11-16,2012,0,0,0,1.330991
144686,The Lift,1972-11-01,1972,0,0,0,0.00469
144712,Cancel Christmas,2011-12-24,2011,0,0,0,0.697003
144724,"Vodka, Mr. Palmu",1969-03-07,1969,0,0,0,0.452939
144726,Holy Year,1976-04-23,1976,0,0,0,1.237192
144728,"The Stars Will Tell, Inspector Palmu",1962-04-21,1962,0,0,0,0.403282
144784,Bed of Roses,1933-06-29,1933,0,0,0,0.030188
144785,Matchmaker Santa,2012-11-21,2012,0,0,0,0.880944
144789,I'm So Excited!,2013-03-08,2013,5000000,11724119,6724119,6.757549
144792,Liliom,1930-10-05,1930,0,0,0,0.504987
144804,Living,2012-08-30,2012,0,0,0,1.69925
144852,Dig That Uranium,1955-12-25,1955,0,0,0,0.08675
144886,Schwechater,1958-12-31,1958,0,0,0,0.917896
144910,Suppose They Gave a War and Nobody Came?,1970-09-11,1970,0,0,0,0.88344
144939,The Harvest of Sorrow,1998-01-01,1998,0,0,0,0.001177
144942,Top Gear: The Worst Car In the History of the World,2012-11-19,2012,0,0,0,1.274759
144953,Where's Marlowe?,1998-01-01,1998,0,0,0,1.193384
144982,The Big Squeeze,1996-09-06,1996,0,0,0,0.404501
145002,A Gun for One Hundred Graves,1968-08-24,1968,0,0,0,0.727126
145051,The Kinematograph,2009-01-01,2009,0,0,0,0.355141
145059,There's Only One Sun,2007-01-01,2007,0,0,0,1.388705
145066,Waterland,1992-08-21,1992,0,0,0,0.857374
145075,Homework,1989-01-01,1989,0,0,0,0.052377
145081,The Killing Machine,1995-01-11,1995,0,0,0,0.200659
145132,A Heartland Christmas,2010-12-10,2010,0,0,0,1.163721
145135,Dark Skies,2013-02-21,2013,3500000,25174316,21674316,26.972326
145147,The Second Circle,1990-09-11,1990,0,0,0,0.052573
145154,Ballou,2008-09-11,2008,0,0,0,0.006986
145162,The Walking Stick,1970-06-05,1970,0,0,0,0.584448
145186,12 Wishes of Christmas,2011-11-27,2011,0,0,0,1.676886
145191,I Always Wanted to Be a Saint,2003-05-16,2003,0,0,0,0.004918
145194,Such Is Life,1996-10-24,1996,0,0,0,0.075245
145197,Upstream Color,2013-04-05,2013,100000,444098,344098,8.003815
145203,BMF: The Rise and Fall of a Hip-Hop Drug Empire,2012-12-11,2012,0,0,0,0.203213
145217,Cream Lemon,2004-09-25,2004,0,0,0,0.005819
145220,Muppets Most Wanted,2014-03-20,2014,50000000,80383290,30383290,7.244956
145221,Monsters: Dark Continent,2014-10-09,2014,0,0,0,12.648061
145244,Seven Times Seven,1968-04-25,1968,0,0,0,1.133019
145247,The 100 Year-Old Man Who Climbed Out the Window and Disappeared,2013-12-25,2013,9250000,0,-9250000,5.434306
145259,Home Sweet Home,2001-03-09,2001,0,0,0,0.388954
145312,Dear Santa,2011-08-11,2011,0,0,0,4.740309
145316,Air Mater,2011-08-04,2011,0,0,0,8.844424
145337,Rock the Boat,1944-12-31,1944,0,0,0,0.107923
145373,If You Want to Live... Shoot!,1968-01-07,1968,0,0,0,0.006364
145379,No Graves on Boot Hill,1968-11-23,1968,0,0,0,0.006528
145385,Last Hippie Standing,2002-03-31,2002,0,0,0,0.078608
145474,The Invisible Men,2012-01-01,2012,0,0,0,0.187797
145481,Don Quijote cabalga de nuevo,1973-03-09,1973,0,0,0,0.872694
145504,The Secret Nation,1989-01-01,1989,0,0,0,0.075867
145547,Mad Ship,2012-12-07,2012,0,0,0,0.475534
145593,Kyle Kinane: Whiskey Icarus,2012-11-24,2012,0,0,0,0.160248
145594,Descongelate!,2003-09-12,2003,0,0,0,0.007517
145668,Butcher Boys,2013-09-06,2013,0,0,0,1.65166
145677,Savage Three,1975-09-20,1975,0,0,0,0.68637
145689,Atlantic Records: The House That Ahmet Built,2007-05-02,2007,0,0,0,0.167895
145691,Gun Glory,1957-07-19,1957,0,0,0,1.978554
145711,Naughty or Nice,2012-12-24,2012,0,0,0,1.493696
145760,Last Year's Snow Was Falling,1983-01-01,1983,0,0,0,0.659367
145762,Now!,1965-06-23,1965,0,0,0,0.305169
145813,Bunker Hill Bunny,1950-09-23,1950,0,0,0,1.123773
145840,Hitched for the Holidays,2012-11-25,2012,0,0,0,1.602238
145872,Scattered Cloud,2011-09-06,2011,0,0,0,0.081611
145874,St. Nick,2009-03-15,2009,0,0,0,0.118621
145878,The First Texan,1956-06-29,1956,0,0,0,0.512685
145899,"Gas, Inspector Palmu!",1961-08-30,1961,0,0,0,0.41551
145902,Trench Road,2004-11-26,2004,0,0,0,0.044653
145909,Promise,2005-09-15,2005,0,0,0,0.368474
145912,Tup-akka-lakko,1980-11-26,1980,0,0,0,0.000603
145925,Mille bolle blu,1993-01-01,1993,0,0,0,0.03537
145926,B.U.S.T.E.D,1999-03-20,1999,0,0,0,0.407118
145959,Obsessed,1992-09-26,1992,0,0,0,0.249696
145963,The Bulleteers,1942-03-26,1942,0,0,0,0.402295
145977,Terror on the Midway,1942-08-30,1942,0,0,0,0.084453
145995,Blonde Fever,1944-12-05,1944,0,0,0,0.039819
146015,The Double,2014-04-04,2014,0,200406,200406,7.597475
146030,Summer,1976-06-10,1976,0,0,0,0.00022
146045,Autumn,1990-12-20,1990,0,0,0,0.236258
146047,Emmanuelle 5,1987-01-07,1987,0,0,0,1.366642
146072,The Underground World,1943-06-18,1943,0,0,0,0.111147
146075,Rio 100 Degrees F.,1955-08-24,1955,0,0,0,0.192623
146079,Django and Sartana Are Coming... It's the End,1970-11-14,1970,0,0,0,0.210307
146121,The Baby Maker,1970-10-01,1970,0,0,0,0.020072
146132,The Couples,1970-12-23,1970,0,0,0,0.088596
146184,Bye Bye Blue Bird,1999-07-30,1999,0,0,0,0.383597
146198,Triple 9,2016-02-19,2016,20000000,12639297,-7360703,12.892504
146203,The Last Exorcism Part II,2013-02-28,2013,5000000,15179302,10179302,5.874458
146216,RED 2,2013-07-18,2013,84000000,0,-84000000,11.04233
146223,Closed Circuit,2013-08-28,2013,0,5750401,5750401,12.797172
146227,Getaway,2013-08-29,2013,18000000,10501938,-7498062,13.224288
146229,Kristy,2014-08-07,2014,6900000,0,-6900000,9.159818
146231,Hybrid,2000-11-24,2000,0,0,0,0.001178
146233,Prisoners,2013-09-18,2013,46000000,122126687,76126687,11.96262
146238,Runner Runner,2013-09-24,2013,30000000,62616646,32616646,8.864607
146239,Delivery Man,2013-10-10,2013,26000000,51164106,25164106,13.548808
146243,Haunt,2014-02-19,2014,0,0,0,10.964552
146269,The Young Unknowns,2000-03-12,2000,0,0,0,0.001677
146270,Vaastav: The Reality,1999-10-07,1999,0,0,0,0.334261
146301,Paranormal Activity: The Ghost Dimension,2015-10-21,2015,10000000,78096553,68096553,9.185701
146304,The Best Man Holiday,2013-11-15,2013,17000000,71625195,54625195,6.102021
146313,The Cottage,2012-12-10,2012,0,0,0,1.475684
146315,Last Will,2011-03-22,2011,0,0,0,1.017397
146322,Running,1979-10-30,1979,0,0,0,0.985056
146341,Bird of Prey,1995-09-12,1995,0,0,0,0.564117
146364,Cosimo and Nicole,2012-11-29,2012,0,0,0,0.536977
146371,"Don't Cry, Mommy",2012-11-22,2012,0,0,0,1.309583
146373,Some Girl,1998-04-19,1998,0,0,0,1.019347
146375,On the Other Side of the Tracks,2012-12-15,2012,0,25109572,25109572,5.160049
146380,The Legend of Bloody Jack,2007-02-27,2007,0,0,0,0.712345
146381,Justin and the Knights of Valour,2013-08-09,2013,22000000,0,-22000000,6.574051
146404,The Best of Men,2012-08-16,2012,0,0,0,4.345109
146405,A Season for Miracles,1999-12-12,1999,0,0,0,1.599337
146414,The Diaries of a School Principal,1975-10-20,1975,0,0,0,0.001425
146416,A Long and Happy Life,1966-01-01,1966,0,0,0,0.535738
146428,You and Me,1971-10-25,1971,0,0,0,0.112462
146449,Loose Ankles,1930-02-02,1930,0,0,0,0.385938
146473,Precautions Against Fanatics,1969-03-28,1969,0,0,0,0.567644
146490,Ray Harryhausen: Special Effects Titan,2011-11-27,2011,0,0,0,1.743602
146521,Beginning of an Unknown Era,1967-12-31,1967,0,0,0,0.396568
146563,Under Ten Flags,1960-09-15,1960,0,0,0,0.860168
146578,The Package,2013-02-09,2013,0,1469,1469,2.469772
146596,Gelosia,1953-01-01,1953,0,0,0,0.297798
146599,Once Upon a Time... When We Were Colored,1996-01-26,1996,0,0,0,0.252287
146631,U.F.O.,2012-12-14,2012,2500000,0,-2500000,8.695473
146679,Backyard Dogs,2001-11-20,2001,0,0,0,0.9854
146712,A Fairly Odd Christmas,2012-11-23,2012,0,0,0,1.484618
146724,Love 911,2012-12-19,2012,0,0,0,2.024775
146730,Alice's Wonderland,1923-01-01,1923,0,0,0,1.138122
146778,The Men Next Door,2012-12-11,2012,0,0,0,1.040376
146783,The Bandit,1946-10-05,1946,0,0,0,0.369582
146787,Overrun!,1970-01-03,1970,0,0,0,0.000603
146837,Jim Jefferies: Fully Functional,2012-10-30,2012,0,0,0,1.50968
146893,Death of a Shadow,2012-06-04,2012,0,0,0,0.84046
146904,"Rio, Zona Norte",1957-08-26,1957,0,0,0,0.072383
146905,Golden Mouth,1963-05-03,1963,0,0,0,0.103347
146916,Bus Riley's Back In Town,1965-03-24,1965,0,0,0,0.566716
146919,Bullets For O'Hara,1941-07-19,1941,0,0,0,0.214007
146926,Heatseeker,1995-06-27,1995,0,0,0,1.037592
146933,The Wannabes,2003-09-25,2003,0,0,0,0.252708
146946,Yellow Rock,2011-11-01,2011,0,0,0,1.231331
146949,Marine Battleground,1963-04-11,1963,0,0,0,0.301689
146955,Border Run,2012-10-12,2012,5000000,0,-5000000,1.964489
146970,In the West There Was a Man Named Invincible,1973-05-03,1973,0,0,0,0.519918
147050,Lambchops,1929-10-31,1929,0,0,0,0.073418
147055,Barnum!,1986-01-01,1986,0,0,0,1e-06
147105,The Enchanted World of Danny Kaye: The Emperor's New Clothes,1972-02-21,1972,0,0,0,1e-06
147106,Oklahoma Crude,1973-07-03,1973,0,0,0,0.684588
147129,Maria Bamford: The Special Special Special!,2012-11-28,2012,0,0,0,0.402536
147132,A Bride for Christmas,2012-12-01,2012,0,0,0,2.097031
147164,Assassin of the Tsar,1991-01-01,1991,0,0,0,0.539697
147169,Under the Lighthouse Dancing,1997-10-15,1997,0,0,0,0.002801
147264,The Outsider,2005-12-04,2005,0,0,0,1.206658
147276,Jay and Silent Bob Go Down Under,2012-11-30,2012,0,0,0,0.914668
147287,The Little Chaos,1966-12-02,1966,0,0,0,0.367256
147307,Multiple SIDosis,1970-12-31,1970,0,0,0,0.049417
147360,Marianne of My Youth,1955-03-18,1955,0,0,0,0.235313
147367,Slightly Single in L.A.,2013-09-03,2013,0,0,0,1.792983
147371,"War and Peace, Part I: Andrei Bolkonsky",1965-07-01,1965,0,0,0,0.725004
147397,Mr. Edison at Work in His Chemical Laboratory,1897-05-31,1897,0,0,0,0.217122
147405,Dabangg 2,2012-12-21,2012,13650000,0,-13650000,4.704351
147415,Wasteland,1960-11-09,1960,0,0,0,0.001685
147441,Exodus: Gods and Kings,2014-12-03,2014,140000000,268031828,128031828,16.320249
147496,Amber City,1999-01-01,1999,0,0,0,0.001177
147533,The Russian Novel,2013-09-19,2013,0,0,0,0.049885
147538,It's Such a Beautiful Day,2012-10-05,2012,0,0,0,3.974088
147575,The Four Who Came to Kill Sartana,1969-11-09,1969,0,0,0,0.012279
147590,100 Ways to Murder Your Wife,1986-09-24,1986,0,0,0,0.093311
147618,Stage Struck,1925-11-16,1925,0,0,0,0.113306
147621,The Mysterious X,1914-03-23,1914,0,0,0,0.433975
147622,Ingeborg Holm,1913-10-27,1913,0,0,0,0.177574
147643,A Dangerous Summer,1982-10-22,1982,0,0,0,0.451139
147683,"The Prophet, the Gold, and the Transylvanians",1978-02-12,1978,0,0,0,0.259357
147692,"The Oil, the Baby and the Transylvanians",1981-01-12,1981,0,0,0,0.035727
147698,Crulic - The Path to Beyond,2011-10-21,2011,292,0,-292,1.179559
147722,This Is My Affair,1937-05-28,1937,0,0,0,0.986769
147726,A Message to Garcia,1936-04-10,1936,0,0,0,0.009507
147729,Animals Are Beautiful People,1974-11-14,1974,0,0,0,1.582132
147746,The Magic Lantern,1903-01-01,1903,0,0,0,0.87176
147747,Wetherby,1985-06-19,1985,0,0,0,5.162757
147764,The Man Who Shook the Hand of Vicente Fernandez,2012-04-27,2012,0,0,0,0.859109
147767,Khiladi 786,2012-12-07,2012,0,126,126,0.704637
147773,The Way Way Back,2013-06-06,2013,4600000,23198652,18598652,10.342737
147778,Showrunners: The Art of Running a TV Show,2014-10-17,2014,0,0,0,2.792369
147810,Let's Dance,1950-11-29,1950,0,0,0,0.164342
147815,Kadal,2013-02-01,2013,7500000,0,-7500000,0.63504
147829,Stand Up and Fight,1939-01-06,1939,0,0,0,0.85217
147841,El Medico: The Cubaton Story,2012-01-27,2012,0,0,0,0.321069
147843,If Winter Comes,1947-12-31,1947,0,0,0,0.975622
147846,The Letter,1929-03-17,1929,0,0,0,0.070496
147868,The Worst Christmas of My Life,2012-12-22,2012,6843500,10703234,3859734,3.800073
147870,Wolf! Wolf!,1944-06-22,1944,0,0,0,0.076969
147871,Bugs Bunny and the Three Bears,1944-02-26,1944,0,0,0,0.770627
147876,The Bowery,1933-10-07,1933,421496,0,-421496,0.220136
147882,At Sword's Point,1952-04-22,1952,0,0,0,1.266891
147886,The Great Sinner,1949-06-29,1949,0,0,0,0.656505
147903,Santa Fe,1951-04-01,1951,0,0,0,0.884982
147923,(A)Sexual,2011-01-01,2011,0,0,0,0.312914
147939,Teenage Mutant Ninja Turtles: We Wish You a Turtle Christmas,1994-10-01,1994,0,0,0,0.001715
148021,Toward the Unknown,1956-09-27,1956,0,0,0,1.116528
148031,Freedom Road,1979-10-29,1979,0,0,0,0.356672
148033,Dottie Gets Spanked,1993-09-17,1993,0,0,0,0.585939
148034,The Elusive Summer of '68,1984-01-30,1984,0,0,0,0.879728
148039,Christmas Time In South Park,2000-10-09,2000,0,0,0,1.125323
148044,Romance in a Minor Key,1943-06-25,1943,0,0,0,0.266021
148077,The Matriarch,2007-09-14,2007,1400000,435000,-965000,0.271386
148175,Young Again,1986-05-11,1986,0,0,0,1.215696
148176,A Chairy Tale,1957-12-31,1957,0,0,0,0.699012
148184,Who Killed Chea Vichea?,2010-01-01,2010,350000,0,-350000,0.005882
148243,Bluebeard,1936-12-31,1936,0,0,0,0.126284
148265,Eega,2012-06-06,2012,5990000,19450000,13460000,8.615159
148284,Enthiran,2010-10-01,2010,26400000,62000000,35600000,4.330396
148314,Pekko ja Unissak√§velij√§,1997-09-26,1997,0,0,0,0.071764
148318,What Remains of Us,2004-04-27,2004,0,0,0,0.005825
148326,Captain January,1924-07-06,1924,0,0,0,0.373378
148327,Novena,2005-08-26,2005,0,0,0,0.37221
148331,Solovey-Razboynik,2012-11-22,2012,0,5,5,0.816981
148347,The Jungle,2012-11-29,2012,0,0,0,0.920854
148353,Work in Progress,2001-10-19,2001,0,0,0,0.65959
148356,Don't Give Up the Sheep,1953-01-03,1953,0,0,0,0.838008
148357,Where Are My Children?,1916-04-16,1916,0,0,0,0.616015
148371,A Story Written with Water,1965-11-23,1965,0,0,0,0.370132
148380,Curry and Pepper,1990-05-23,1990,0,0,0,1.596286
148408,The Crush,1967-02-16,1967,0,0,0,0.03688
148410,The Case of the Velvet Claws,1936-08-15,1936,0,0,0,0.335497
148411,Chermeni,1970-01-01,1970,0,0,0,0.25
148430,Dzhamilya,1969-10-13,1969,0,0,0,0.152109
148431,"Ringo, It's Massacre Time",1970-08-02,1970,0,0,0,0.127557
148432,Pekka ja P√§tk√§ salapoliiseina,1957-12-08,1957,0,0,0,0.001655
148434,The Stranger That Kneels Beside the Shadow of a Corpse,1970-11-27,1970,0,0,0,0.148033
148435,Pekka ja P√§tk√§ Suezilla,1958-12-08,1958,0,0,0,0.062996
148451,Committed,1991-04-18,1991,0,0,0,0.001133
148478,Freakin' Beautiful World,1997-04-11,1997,0,0,0,0.380149
148479,I Hired Two Contract Cleaners,1997-11-24,1997,0,0,0,0.116532
148482,The Saimaa Gesture,1981-09-11,1981,0,0,0,0.015306
148503,Local Color,1977-04-19,1977,0,0,0,0.070684
148511,The 'Teddy' Bears,1907-03-02,1907,0,0,0,0.421469
148536,My Apprenticeship,1939-09-12,1939,0,0,0,0.277691
148558,Betty Boop's Museum,1932-12-16,1932,0,0,0,0.160229
148597,King of the Children,1987-01-01,1987,0,0,0,0.047883
148615,The Ordeal of Patty Hearst,1979-03-04,1979,0,0,0,0.034716
148617,The Case of the Lucky Legs,1935-10-05,1935,0,0,0,0.099705
148622,Forgotten Tune for the Flute,1987-10-23,1987,0,0,0,0.215456
148636,The Hunchback,1997-03-16,1997,0,0,0,1.745185
148652,The Eleventh Victim,2012-11-03,2012,0,0,0,1.452426
148675,Suez,1938-10-28,1938,0,0,0,0.01209
148697,Avanak Apdi,1978-01-01,1978,0,0,0,0.39052
148753,Funeral March,2001-09-25,2001,0,0,0,0.001303
148757,The House of Smiles,1991-03-01,1991,0,0,0,0.386369
148766,Forever Female,1954-01-13,1954,0,0,0,0.824347
148777,In Vogue: The Editor's Eye,2012-12-06,2012,0,0,0,1.096709
148778,MC5: Kick Out the Jams,1999-09-07,1999,0,0,0,0.001648
148782,I Am Twenty,1965-01-01,1965,0,0,0,0.35936
148784,Hound-Dog Man,1959-11-11,1959,0,0,0,0.11282
148807,"Lost, Lost, Lost",1976-09-14,1976,0,0,0,0.128261
148811,Reminiscences of a Journey to Lithuania,1972-10-04,1972,0,0,0,0.249544
148820,Land of Milk and Honey,1971-02-09,1971,0,0,0,0.081011
148833,Last Resort,1986-03-31,1986,0,0,0,0.696667
148853,Legacy,2006-09-20,2006,0,0,0,1.383278
148857,Close,2004-06-27,2004,850000,0,-850000,0.881873
148864,Omert√†,2012-07-11,2012,0,0,0,0.154221
149023,Christmas Oranges,2012-08-12,2012,0,0,0,1.355787
149026,T.R. Baskin,1971-10-20,1971,0,0,0,0.813278
149043,St. Giuseppe Moscati: Doctor to the Poor,2007-09-26,2007,0,0,0,1.02825
149085,Tai Chi Hero,2012-10-25,2012,40000000,0,-40000000,3.164718
149087,Turning Tide,2013-11-05,2013,0,0,0,3.766291
149094,Story of Night,1979-11-30,1979,0,0,0,0.000578
149101,King of Katoren,2012-12-05,2012,0,0,0,0.36934
149114,Seven Angry Men,1955-03-27,1955,0,0,0,0.483473
149117,Lavatory Lovestory,2008-01-01,2008,0,0,0,0.66476
149145,Les Hautes Solitudes,1974-12-15,1974,0,0,0,0.378577
149149,Berta's Motives,1984-09-01,1984,0,0,0,0.113436
149150,Melody for a Street Organ,2009-06-21,2009,0,0,0,0.392921
149154,A Place in the World,2001-06-12,2001,0,0,0,0.225757
149155,"Harvest: 3,000 Years",1976-04-06,1976,0,0,0,0.000844
149170,A Nest of Gentry,1969-01-01,1969,0,0,0,0.759401
149172,Let Fury Have the Hour,2012-12-14,2012,0,0,0,0.009412
149180,Taste of Vengeance,1969-09-22,1969,0,0,0,0.055504
149190,Tormento,1950-02-11,1950,0,0,0,0.60492
149206,Holiday Spin,2012-11-19,2012,0,0,0,0.739783
149213,Murder in a Small Town,1999-01-10,1999,0,0,0,0.76814
149218,Come Dance with Me,2012-12-08,2012,0,0,0,0.395019
149232,The Pardon,2013-03-22,2013,5000000,0,-5000000,1.242132
149235,Help for the Holidays,2012-12-09,2012,0,0,0,0.962581
149255,You Don't Know Bo,2012-12-08,2012,0,0,0,0.505879
149320,King: A Filmed Record... Montgomery to Memphis,1970-03-24,1970,0,0,0,0.810554
149326,Ape and Super-Ape,1972-01-01,1972,0,0,0,0.12112
149336,The Challenge... A Tribute to Modern Art,1974-12-05,1974,0,0,0,0.0
149347,People of the Wind,1976-01-01,1976,0,0,0,0.009057
149362,The War at Home,1979-01-01,1979,0,0,0,0.040128
149445,Harry and Walter Go To New York,1976-06-17,1976,0,0,0,1.345474
149455,A Spring for the Thirsty,1965-01-01,1965,0,0,0,0.141187
149459,Going Down in Morocco,1989-04-11,1989,0,0,0,0.562708
149465,"War and Peace, Part II: Natasha Rostova",1966-07-23,1966,0,0,0,1.074692
149467,"War and Peace, Part III: The Year 1812",1967-07-21,1967,0,0,0,0.411942
149468,"War and Peace, Part IV: Pierre Bezukhov",1967-11-04,1967,0,0,0,0.523083
149469,Carne de gallina,2001-10-26,2001,0,0,0,0.071765
149474,Galgameth,1997-08-05,1997,0,0,0,0.156223
149507,The Report,1977-01-01,1977,0,0,0,0.311501
149509,Horns,2013-09-06,2013,0,0,0,8.363417
149511,The Ashes,1965-09-25,1965,0,0,0,0.277185
149515,The Vanishing American,1925-10-15,1925,0,0,0,0.256579
149586,The Conscientious Objector,2004-03-01,2004,0,0,0,0.200159
149600,Eye of the Hurricane,2012-03-10,2012,0,0,0,0.471855
149645,Smiley's People,1982-09-20,1982,0,0,0,1.809791
149657,Dad,2010-10-25,2010,0,0,0,0.171465
149687,The Perils of Pauline,1947-07-04,1947,0,0,0,0.88763
149690,The Deserter,1970-12-04,1970,0,0,0,0.625736
149691,Kill Django...Kill First,1971-02-05,1971,0,0,0,0.8625
149708,Anticipation of the Night,1958-12-31,1958,0,0,0,0.339923
149712,In Memory of the Day Passed By,1990-01-01,1990,0,0,0,0.149527
149722,The 12 Disasters of Christmas,2012-12-02,2012,0,0,0,1.144133
149723,The Letters,2006-11-03,2006,0,0,0,0.442975
149725,Wild Women,1970-10-20,1970,0,0,0,0.334052
149727,The Plea,1968-09-05,1968,0,0,0,0.27382
149763,Men Do what Men Can,2012-10-10,2012,0,0,0,2.370516
149786,Christmas with Holly,2012-12-09,2012,0,0,0,1.893719
149793,The Lone Wolf Spy Hunt,1939-01-27,1939,0,0,0,0.3154
149832,The Princess and the Pea,1976-11-01,1976,0,0,0,0.003108
149851,Enid Is Sleeping,1991-05-17,1991,0,0,0,1.304582
149854,Gloriously Wasted,2012-12-28,2012,0,0,0,0.632621
149856,Baby on Board,1992-12-28,1992,0,0,0,0.353766
149862,"Concepci√≥n Arenal, la visitadora de c√°rceles",2012-01-01,2012,0,0,0,0.033792
149868,Hush,2012-07-13,2012,0,0,0,0.339234
149870,The Wind Rises,2013-07-20,2013,30000000,117932401,87932401,9.310866
149871,The Tale of the Princess Kaguya,2013-11-23,2013,49300000,24186232,-25113768,7.566053
149883,Eugene Mirman: An Evening of Comedy in a Fake Underground Laboratory,2012-12-21,2012,0,0,0,0.07299
149893,Two Lives,2012-10-19,2012,0,0,0,2.793306
149895,The Red Ball Express,1952-05-24,1952,0,0,0,0.142929
149910,Super Buddies,2013-08-07,2013,0,0,0,3.306917
149911,Titanic at 100: Mystery Solved,2012-04-15,2012,0,0,0,0.046732
149926,Champions,1984-04-20,1984,0,0,0,0.982587
149940,Double Tide,2009-10-21,2009,0,0,0,0.060493
149946,Two in One,2007-11-27,2007,0,0,0,0.038832
149955,Three Godfathers,1936-03-06,1936,0,0,0,0.370093
149957,Jungle Man-Eaters,1954-06-01,1954,0,0,0,0.444053
149961,The Sentimental Swordsman,1977-10-14,1977,0,0,0,0.527499
150004,Taken,2002-12-02,2002,0,0,0,10.62823
150010,Soldier Ivan Brovkin,1955-09-08,1955,0,0,0,1.201447
150025,Django's Cut Price Corpses,1971-05-03,1971,0,0,0,0.373369
150029,"Durango Is Coming, Pay or Die",1971-03-05,1971,0,0,0,0.20165
150041,Brasserie Romance,2012-12-18,2012,0,0,0,0.207227
150043,Something For Everyone,1970-07-22,1970,0,0,0,1.171828
150049,The New Watchdogs,2012-01-10,2012,0,0,0,0.868468
150054,Light of My Eyes,2010-05-10,2010,0,0,0,0.737414
150056,Jesus liebt mich,2012-12-20,2012,0,0,0,1.413023
150065,Yelling To The Sky,2012-12-14,2012,0,0,0,1.371273
150084,Mr. Blue Sky: The Story of Jeff Lynne & ELO,2012-10-05,2012,0,0,0,0.391014
150093,Just Like a Woman,2012-12-14,2012,0,0,0,1.551414
150108,Travel Beyond the Three Seas,1957-01-01,1957,0,0,0,0.60467
150117,I Give It a Year,2013-02-08,2013,0,28234657,28234657,11.783332
150124,"Blood, Sweat + Vinyl: DIY in the 21st Century",2011-10-08,2011,0,0,0,0.007059
150140,Promise,1986-12-21,1986,0,0,0,0.009707
150161,Southwest,2011-10-13,2011,0,0,0,0.506379
150191,I Am the Law,1977-09-23,1977,0,0,0,0.883343
150201,You Are Not Alone,2016-06-23,2016,0,0,0,0.793136
150202,The Haunting in Connecticut 2: Ghosts of Georgia,2013-02-01,2013,0,0,0,8.61296
150208,Vares: Tango of Darkness,2012-10-05,2012,0,0,0,0.588539
150211,The Frozen,2012-10-10,2012,0,0,0,0.553158
150213,Pok√©mon the Movie: Kyurem vs. the Sword of Justice,2012-07-13,2012,0,44057737,44057737,2.162495
150218,Hercules Against the Barbarians,1964-04-16,1964,0,0,0,0.094595
150223,The Wishing Tree,1977-08-23,1977,0,0,0,0.137028
150224,Savage Guns,1971-11-25,1971,0,0,0,0.546304
150226,Ballad of Django,1971-04-17,1971,0,0,0,0.365117
150229,Tomorrow You're Gone,2012-10-31,2012,0,0,0,3.219988
150230,Kill 'em All,2012-12-11,2012,0,0,0,3.227488
150247,Zebra in the Kitchen,1965-06-01,1965,0,0,0,0.132194
150249,Forsaking All Others,1934-12-23,1934,0,0,0,0.622574
150273,The Return,1980-03-31,1980,0,0,0,0.602143
150329,The Dukes of Hazzard: Reunion!,1997-04-25,1997,0,0,0,1.065471
150338,Pendulum,1969-02-17,1969,0,0,0,0.088856
150396,The Red Spectre,1907-01-01,1907,0,0,0,0.209485
150473,Bad Hair Friday,2012-02-15,2012,0,0,0,0.578396
150523,The Mahabharata,1989-09-28,1989,334077,0,-334077,0.838039
150540,Inside Out,2015-06-09,2015,175000000,857611174,682611174,23.985587
150578,Light Keeps Me Company,2000-08-26,2000,0,0,0,0.120735
150605,The Wedding March,1965-04-25,1965,0,0,0,0.42292
150657,Merry In-Laws,2012-12-08,2012,0,0,0,0.517327
150658,Goodbye & Amen,1978-02-08,1978,0,0,0,0.596517
150677,His Name was King,1971-05-18,1971,0,0,0,0.429005
150689,Cinderella,2015-03-12,2015,95000000,543514353,448514353,19.801128
150704,Four Gunmen of the Holy Trinity,1971-05-29,1971,0,0,0,0.012894
150708,Terrible Day of the Big Gundown,1971-06-26,1971,0,0,0,0.000946
150712,They Gave Him a Gun,1937-05-07,1937,0,0,0,0.116263
150736,Recto / verso,,,0,0,0,0.0
150747,Dead Man Talking,2012-10-03,2012,0,0,0,1.397497
150778,So Proudly We Hail,1943-09-08,1943,0,0,0,0.773279
150823,The Shooter,1997-10-23,1997,0,0,0,0.112249
150838,H√¥tel des Invalides,1952-12-31,1952,0,0,0,0.149604
150839,Commando Leopard,1985-10-24,1985,0,0,0,1.026428
150871,"10,000 Black Men Named George",2002-02-24,2002,0,0,0,0.002359
150897,Paradise: Hope,2013-02-08,2013,0,6701,6701,2.340258
150912,Goliath and the Sins of Babylon,1963-12-03,1963,0,0,0,0.068376
150922,Samay: When Time Strikes,2003-01-01,2003,0,0,0,0.039916
150938,All Passion Spent,1986-12-09,1986,0,0,0,0.489913
150958,Ostia,1970-03-11,1970,0,0,0,0.382045
151043,A Man Called Adam,1966-03-16,1966,0,0,0,0.5904
151044,McCullin,2012-04-26,2012,0,0,0,0.869409
151062,Mad at the Moon,1992-09-16,1992,0,0,0,1.225055
151068,The New Babylon,1929-01-01,1929,0,0,0,0.074347
151069,Whiskey School,2005-09-11,2005,0,0,0,0.011073
151085,Hypocrites,1915-01-20,1915,0,0,0,0.32164
151086,The Ocean Waif,1916-11-02,1916,0,0,0,0.036471
151123,The Village,2010-02-01,2010,0,0,0,0.012918
151136,Pizzas,2012-11-11,2012,0,0,0,0.013233
151138,The Visit,1964-01-01,1964,0,0,0,2.429589
151141,Malibu Hot Summer,1981-01-01,1981,0,0,0,0.222023
151168,Disneyland Dream,1956-07-31,1956,0,0,0,0.242068
151227,Mother,1991-11-27,1991,0,0,0,0.510917
151232,Mother,1992-01-14,1992,0,0,0,0.838046
151250,Ronin-gai,1990-08-18,1990,0,0,0,0.448565
151310,Ambush,1950-01-13,1950,0,0,0,0.688155
151368,Open Windows,2014-07-04,2014,0,0,0,12.294525
151370,Crash Course,1988-01-18,1988,0,0,0,0.710193
151423,Let's Go And Kill Sartana,1971-09-06,1971,0,0,0,0.000553
151431,A Kid for Two Farthings,1956-01-20,1956,0,0,0,0.701604
151436,Wholly Communion,1965-12-31,1965,0,0,0,0.151089
151489,Hedd Wyn,1992-01-01,1992,0,0,0,0.270432
151506,She Fought Alone,1995-11-06,1995,0,0,0,0.622808
151509,Trapped in the Closet: Chapters 23-33,2012-11-23,2012,750000,0,-750000,0.433321
151535,Scooby-Doo! Mask of the Blue Falcon,2012-12-15,2012,0,0,0,2.245536
151590,Susan Lenox (Her Fall and Rise),1931-10-10,1931,0,0,0,0.506049
151652,The Old Man,2012-01-01,2012,0,0,0,0.37955
151679,End of the Road,1970-02-10,1970,0,0,0,0.983284
151687,Charlie Muffin,1979-12-11,1979,0,0,0,0.587672
151693,Morgan,2012-01-07,2012,0,0,0,1.740147
151727,Trembling Before G-d,2001-12-06,2001,0,0,0,0.329301
151730,Eat,1963-12-31,1963,0,0,0,0.151119
151731,The Negro Soldier,1944-04-10,1944,0,0,0,0.520835
151732,Alleluja & Sartana Are Sons... Sons of God,1972-12-22,1972,0,0,0,0.007875
151743,Lost in Thailand,2012-12-12,2012,2200000,208000000,205800000,1.789133
151826,The Man Who Laughs,2012-12-26,2012,0,0,0,2.779704
151831,The Delicious Little Devil,1919-05-01,1919,0,0,0,0.079384
151848,The Garden of Allah,1936-10-14,1936,2200000,0,-2200000,0.472865
151870,Minecraft: The Story of Mojang,2012-12-23,2012,0,0,0,0.813402
151911,Blockade,1938-06-17,1938,0,0,0,0.69411
151923,Gross Misconduct,1993-07-29,1993,0,0,0,1.335058
151933,Dead in Tombstone,2013-10-01,2013,5200000,0,-5200000,6.065874
151937,Return to Mayberry,1986-04-13,1986,0,0,0,0.011917
151960,Planes,2013-08-09,2013,50000000,219788712,169788712,11.604181
152023,The Rising Place,2001-02-01,2001,0,0,0,0.586722
152042,Puella Magi Madoka Magica the Movie Part I: Beginnings,2012-10-05,2012,0,0,0,2.645355
152044,Puella Magi Madoka Magica the Movie Part II: Eternal,2012-10-13,2012,0,0,0,2.796424
152100,I 2 soliti idioti,2012-12-20,2012,0,0,0,2.137039
152113,Planet Ocean,2012-06-18,2012,0,0,0,2.37287
152130,Playdate,2012-01-01,2012,0,0,0,1.312744
152155,And Here's What's Happening to Me,2012-12-09,2012,0,14353,14353,0.181963
152206,National Lampoon's Favorite Deadly Sins,1995-11-12,1995,0,0,0,0.616497
152218,The Barbershop,1894-01-01,1894,0,0,0,0.247013
152259,Phantom,2013-01-03,2013,10000000,1034589,-8965411,6.651567
152266,Submarine Command,1952-01-18,1952,0,0,0,0.515822
152273,The Sarnos: A Life in Dirty Movies,2013-03-27,2013,0,0,0,0.321083
152388,Vendetta for the Saint,1969-01-05,1969,0,0,0,0.089608
152393,The Fiction Makers,1968-12-08,1968,0,0,0,0.418858
152426,The Langoliers,1995-05-14,1995,0,0,0,12.215925
152532,Dallas Buyers Club,2013-09-07,2013,5000000,55198285,50198285,14.785719
152539,L'All√©e du Roi,1995-01-01,1995,0,0,0,0.980696
152570,Fast Life,1932-12-16,1932,0,0,0,0.05971
152584,Blue Is the Warmest Color,2013-10-09,2013,4300000,10165694,5865694,4.938148
152599,The Immigrant,2013-07-03,2013,16000000,5867686,-10132314,6.985915
152601,Her,2013-12-18,2013,23000000,47351251,24351251,13.829515
152603,Only Lovers Left Alive,2013-12-12,2013,7000000,0,-7000000,13.594992
152611,7:35 in the Morning,2003-01-01,2003,0,0,0,0.47098
152618,Galaxy Hunter,2004-04-01,2004,0,0,0,0.473647
152625,Akkare Akkare Akkare,1990-01-01,1990,0,0,0,0.112792
152635,The Assassination,1972-10-11,1972,0,0,0,1.081593
152653,Clubbed to Death,1997-06-25,1997,0,0,0,0.122462
152736,Child of God,2014-04-28,2014,0,0,0,3.314702
152737,August: Osage County,2013-12-26,2013,25000000,74188937,49188937,6.954296
152742,The Best Offer,2013-01-01,2013,13500000,19255873,5755873,8.995603
152745,As I Lay Dying,2013-10-09,2013,0,0,0,4.864228
152747,All Is Lost,2013-10-18,2013,9000000,6108720,-2891280,12.74965
152748,Ain't Them Bodies Saints,2013-07-03,2013,0,1031243,1031243,5.086013
152756,Paradise,2013-10-18,2013,0,0,0,4.328691
152760,The Monuments Men,2014-01-24,2014,70000000,154984035,84984035,11.132411
152780,The Past,2013-05-17,2013,11000000,10631747,-368253,9.166555
152787,Deaf Smith & Johnny Ears,1973-03-29,1973,0,0,0,0.910314
152790,The Angriest Man in Brooklyn,2014-05-23,2014,0,0,0,9.911949
152792,Devil's Knot,2013-05-09,2013,15000000,0,-15000000,5.988507
152795,The Congress,2013-05-16,2013,0,455815,455815,8.534039
152795,The Congress,2013-05-16,2013,0,455815,455815,8.534039
152797,Le bel indiff√©rent,1957-12-31,1957,0,0,0,0.037919
152846,The Most Beautiful Wife,1970-03-12,1970,0,0,0,0.317226
152861,Outsider,1997-02-13,1997,0,0,0,0.100195
152912,Mr. Blot in Space,1988-12-05,1988,0,0,0,0.648241
152938,National Geographic: Hitler's Stealth Fighter,2009-01-01,2009,0,0,0,0.006884
152943,Pentimento,1979-02-01,1979,0,0,0,0.195532
152948,The New Gulliver,1935-03-25,1935,0,0,0,0.554008
152986,Gambling Lady,1934-03-31,1934,0,0,0,1.200342
152989,The Stroller Strategy,2012-11-10,2012,0,3462,3462,2.156134
152992,The Wayward Bus,1957-05-27,1957,0,0,0,0.003235
153021,Doors Open,2012-12-26,2012,0,0,0,1.161399
153035,Provincia violenta,1978-12-30,1978,0,0,0,0.059216
153041,Otaku,1994-12-01,1994,0,0,0,0.177577
153073,Escape from Mars,1999-03-25,1999,0,0,0,0.436924
153100,Portrait of a '60% Perfect Man': Billy Wilder,1982-05-21,1982,0,0,0,0.270043
153102,12 Days of Terror,2005-07-05,2005,0,0,0,1.523441
153118,The Man Without a Shadow,2004-12-31,2004,0,0,0,0.178094
153133,Undercover Bridesmaid,2012-04-15,2012,0,0,0,3.877286
153141,The Low Down,2001-01-26,2001,0,32395,32395,0.490728
153153,Pablo,2012-10-17,2012,0,0,0,1.366862
153158,Underdogs,2013-07-18,2013,22000000,24000000,2000000,14.347931
153161,Young Dr. Kildare,1938-10-14,1938,0,0,0,0.683506
153162,Calling Dr. Kildare,1939-04-28,1939,0,0,0,0.78896
153163,The Secret of Dr. Kildare,1939-11-24,1939,0,0,0,1.044495
153165,Dr. Kildare's Strange Case,1940-04-12,1940,0,0,0,0.078571
153169,Dr. Kildare's Victory,1942-02-04,1942,0,0,0,0.213993
153170,Bandh Darwaza,1990-05-07,1990,0,0,0,0.009279
153196,Rosas H√∂llenfahrt,2009-10-31,2009,0,0,0,0.048511
153228,The Moonlighter,1953-09-19,1953,0,0,0,0.986013
153266,Happy New York,1997-09-27,1997,0,0,0,0.39122
153272,Taxandria,1994-01-01,1994,0,0,0,0.628835
153397,Restless,2012-12-07,2012,0,0,0,1.512077
153410,Kiss,1963-12-31,1963,0,0,0,0.531073
153420,Love Ghost,2001-03-24,2001,0,0,0,0.582263
153423,Motel Cactus,1997-10-25,1997,0,0,0,0.146178
153444,David Golder,1931-03-06,1931,0,0,0,0.100517
153518,The Angry Birds Movie,2016-05-11,2016,73000000,349779543,276779543,11.171927
153532,Benigni,2009-01-01,2009,0,0,0,0.004707
153541,Robert Mitchum Est Mort,2011-04-13,2011,0,0,0,0.392611
153556,Reconvers√£o,2012-08-11,2012,0,0,0,0.044715
153561,La buena nueva,2008-11-14,2008,0,0,0,0.307388
153609,Hercules: Zero to Hero,1999-01-01,1999,0,0,0,0.700633
153641,The Reckoning,1970-01-01,1970,0,0,0,0.985307
153652,The Mark,1961-06-07,1961,0,0,0,0.740787
153695,Nature Unleashed: Volcano,2005-02-04,2005,0,0,0,0.88017
153717,Aschenputtel,2010-12-24,2010,0,0,0,0.781805
153737,Sincere Heart,1953-01-29,1953,0,0,0,0.478836
153738,Frankenstein's Army,2013-01-24,2013,0,0,0,5.451583
153750,The Complex,2013-05-13,2013,0,0,0,1.658179
153774,The Future,2013-09-06,2013,0,13983,13983,1.051148
153779,The Kingdom of Solomon,2010-10-06,2010,5000000,0,-5000000,1.027956
153781,Lasting,2013-01-08,2013,0,0,0,0.953437
153795,Straight A's,2013-01-16,2013,7000000,0,-7000000,3.594488
153820,The Girl from Nowhere,2013-02-06,2013,0,0,0,0.779579
153845,The Eleventh Year,1928-05-14,1928,0,0,0,0.154625
153854,It Felt Like Love,2013-01-19,2013,0,0,0,1.342329
153913,The Intern,2000-01-21,2000,0,0,0,0.4721
153936,Back to School with Franklin,2003-08-19,2003,0,0,0,0.040437
153997,The Big Land,1957-03-01,1957,0,0,0,0.164676
154019,Belarmino,1964-11-18,1964,0,0,0,0.511532
154028,Ed Wood: Look Back in Angora,1994-01-01,1994,0,0,0,0.323876
154030,The Tower,2012-12-25,2012,0,0,0,4.107272
154073,Kid Blue,1973-01-31,1973,0,0,0,2.11682
154093,Riding Shotgun,1954-04-01,1954,0,1400000,1400000,1.316519
154105,After Image,2001-01-23,2001,1400000,0,-1400000,0.272016
154115,Taxi Hunter,1993-10-14,1993,0,0,0,0.007472
154140,Men in White,1998-08-16,1998,0,0,0,0.582861
154188,Conserva Acabada,1990-09-27,1990,0,0,0,0.007795
154207,Hellboy Animated: Iron Shoes,2007-06-12,2007,0,0,0,0.836081
154211,Sogobi,2002-01-12,2002,0,0,0,0.072941
154226,Diving In,1990-09-21,1990,0,0,0,0.544547
154276,The Stone Boy,1984-04-04,1984,0,0,0,0.481371
154282,Touchy Feely,2013-01-19,2013,0,35022,35022,2.976672
154326,Hearty Paws,2006-10-25,2006,2,0,-2,0.973344
154339,Falling Cat,1894-01-01,1894,0,0,0,1.467106
154371,Manhunt in Space,1956-01-01,1956,0,0,0,0.042889
154397,The Commander,1988-04-28,1988,0,0,0,1.169267
154399,Hands Up!,1981-10-09,1981,0,0,0,0.491973
154400,The Drop,2014-09-12,2014,12600000,19054534,6454534,11.695036
154413,Orderly or Disorderly,1981-01-01,1981,0,0,0,0.088427
154430,Shadow of the Eagle,2005-09-08,2005,2075374,0,-2075374,0.102529
154441,Till Luck Do Us Part,2012-10-05,2012,0,1672940,1672940,1.991908
154442,Tree Without Leaves,1986-11-15,1986,0,0,0,1.092022
154501,Legend of the Galactic Heroes: Golden Wings,1992-12-12,1992,0,0,0,1.298538
154515,"Dance, Fools, Dance",1931-02-07,1931,0,0,0,2.03334
154537,Arcadia,2012-02-13,2012,0,0,0,4.329041
154575,Illumination,1973-09-29,1973,0,0,0,0.3339
154582,Artists Under the Big Top: Perplexed,1968-08-29,1968,0,0,0,0.425403
154622,100 Years at the Movies,1994-12-31,1994,0,0,0,0.384209
154623,Men without Wings,1946-01-01,1946,0,0,0,0.175553
154653,Kiev Frescoes,1966-05-09,1966,0,0,0,0.105727
154663,The Happy Poet,2010-09-17,2010,0,0,0,0.849542
154671,Vem √§lskar Yngve Frej?,1973-01-05,1973,0,0,0,0.000844
154718,Jail Bait,1973-01-09,1973,0,0,0,0.737529
154727,Legend of the Galactic Heroes: Overture to a New War,1993-12-18,1993,0,0,0,0.398224
154738,Legend of the Galactic Heroes: My Conquest Is the Sea of Stars,1988-02-06,1988,0,0,0,0.588754
154779,Ed Hardy: Tattoo the World,2010-10-09,2010,0,0,0,0.041734
154786,Wavemakers,2013-07-06,2013,0,0,0,0.063288
154792,Electile Dysfunction: Inside the Business of American Campaigns,,,0,0,0,0.0
154793,The Listening Project,2008-02-08,2008,0,0,0,0.048983
154795,One Nation Under God,1993-05-26,1993,0,0,0,0.247068
154821,Arguing the World,1998-01-07,1998,0,0,0,0.001188
154879,Neecha Nagar,1946-01-01,1946,0,0,0,0.456931
154922,Tri Bogatyrya na Dalnikh Beregakh,2012-12-27,2012,0,0,0,0.469112
154972,Het Bombardement,2012-12-19,2012,0,0,0,1.587427
154980,East Wind,1993-01-20,1993,0,0,0,1.642119
155011,Muzungu,1999-03-26,1999,0,0,0,0.057844
155017,Megazone 23,1985-01-01,1985,0,0,0,0.001586
155052,Whispering Pages,1994-02-11,1994,0,0,0,0.512921
155055,The Ice House,1997-04-04,1997,0,0,0,1.485183
155084,13 Sins,2014-04-18,2014,5000000,13809,-4986191,9.067788
155096,Amen,2011-12-08,2011,0,0,0,0.173348
155107,Buffalo Dance,1894-09-23,1894,0,0,0,0.205698
155128,The Body,1974-03-06,1974,0,0,0,0.880222
155130,The Forgotten Faces,1961-01-01,1961,0,0,0,0.03703
155169,Frog,1987-01-01,1987,0,0,0,0.417945
155191,A Thief Of Time,2004-01-01,2004,0,0,0,0.002785
155208,Night Unto Night,1949-06-10,1949,0,0,0,0.418513
155217,Ranma ¬Ω,2011-12-09,2011,0,0,0,0.160533
155288,Bela Kiss: Prologue,2013-01-10,2013,0,0,0,1.037843
155308,Zakhm,1998-12-14,1998,0,0,0,0.395317
155325,300 Miles to Heaven,1989-10-30,1989,0,0,0,0.709622
155336,Fuck for Forest,2012-11-23,2012,0,0,0,0.526457
155341,Ax 'Em,1992-01-29,1992,0,0,0,0.207064
155386,La Sierra,2005-01-01,2005,0,0,0,0.298019
155397,The Incredible Kung Fu Master,1979-10-23,1979,0,0,0,0.489143
155399,The Day the Earth Froze,1959-10-15,1959,0,0,0,0.947192
155426,Anio≈Ç w Krakowie,2002-09-20,2002,0,0,0,0.41747
155445,Nicht alle waren M√∂rder,2006-10-31,2006,0,0,0,0.958706
155459,The Strange Affair,1968-08-22,1968,0,0,0,0.073765
155556,Blood Brother,2013-01-20,2013,0,0,0,0.725065
155596,Tokyo Trial,1983-06-04,1983,0,0,0,0.172495
155597,All Screwed Up,1974-02-22,1974,0,0,0,0.123441
155605,Youth of the Son,1952-06-25,1952,0,0,0,0.077725
155661,Mars of Destruction,2005-07-08,2005,0,0,0,0.052812
155685,Apache Rifles,1964-11-26,1964,0,0,0,0.596775
155706,The Speak,2011-01-06,2011,0,0,0,0.707666
155714,Barbara,1997-10-02,1997,0,0,0,0.15112
155724,Escape Clause,1996-12-15,1996,0,0,0,0.702554
155751,A Family Affair,1937-03-12,1937,0,0,0,0.009057
155765,Gensomaden Saiyuki Requiem: For the One Not Chosen,2001-08-18,2001,0,0,0,0.400981
155796,Still Life,2007-07-20,2007,0,0,0,0.432542
155797,"Good Luck, Miss Wyckoff",1979-04-13,1979,0,0,0,2.052797
155852,The Moth,1980-10-10,1980,0,0,0,1e-06
155887,A Prince (almost) Charming,2013-01-07,2013,0,214000,214000,1.985348
155890,Tied,2013-01-07,2013,0,0,0,1.249059
155939,Time to Die,2007-10-19,2007,0,0,0,0.37798
155941,Blue Swallow,2005-12-29,2005,0,0,0,0.218156
155953,The Blot,1921-09-04,1921,0,0,0,0.661938
155956,Joan of Arc at the Stake,1954-12-20,1954,0,0,0,0.253016
156007,The Flying Dagger,1969-06-18,1969,0,0,0,1.512402
156015,Out 1: Spectre,1972-01-01,1972,0,0,0,0.63294
156022,The Equalizer,2014-09-24,2014,55000000,192330738,137330738,17.618057
156045,The Imp,1981-11-05,1981,0,0,0,0.696036
156063,Off the Charts: The Song-Poem Story,2003-11-13,2003,150000,0,-150000,0.002371
156068,Mark of the Witch,1970-01-01,1970,0,0,0,0.240923
156084,The Town That Was,2007-09-07,2007,0,0,0,0.154531
156135,La Sfida,1958-09-06,1958,0,0,0,0.430255
156140,To My Dear Mother on Her Birthday,1974-08-22,1974,0,0,0,0.174012
156141,Stalingrad,1989-01-01,1989,0,0,0,1.201846
156145,"Due cuori, una cappella",1975-10-02,1975,0,0,0,0.248739
156180,Amor?,2011-06-07,2011,0,0,0,0.014381
156201,Red Dust,1990-11-23,1990,0,0,0,0.615136
156220,The Staircase II: The Last Chance,2012-11-15,2012,0,0,0,0.469669
156225,¬°Cuba S√≠!,1961-12-31,1961,0,0,0,0.148344
156235,In Praise Of Older Women,1978-09-22,1978,0,0,0,2.015948
156236,Cycling with Moli√®re,2013-01-16,2013,0,10759874,10759874,3.239562
156268,InAPPropriate Comedy,2013-03-22,2013,0,228,228,3.097025
156277,Big Sur,2013-11-01,2013,0,33621,33621,2.76283
156284,Fire In The Blood,2013-09-06,2013,0,0,0,0.694639
156288,Fool N Final,2007-06-01,2007,0,0,0,0.718586
156306,A Successful Calamity,1932-09-17,1932,0,0,0,0.313017
156310,Wolfman,1979-09-20,1979,0,0,0,0.015557
156317,Alias the Doctor,1932-03-06,1932,0,0,0,0.443941
156320,Our Blushing Brides,1930-07-19,1930,0,0,0,0.412683
156326,L'op√©ra de quat'sous,1931-11-04,1931,0,0,0,0.26468
156329,The Mad Genius,1931-11-07,1931,0,0,0,0.979796
156335,The Vanishing Legion,1931-06-01,1931,0,0,0,0.819588
156339,The Wet Parade,1932-03-26,1932,0,0,0,0.62124
156356,Kiki,1931-03-14,1931,0,0,0,0.001993
156360,Millie,1931-02-08,1931,0,0,0,0.716082
156388,The Pie-Covered Wagon,1932-10-30,1932,0,0,0,0.008399
156389,Runt Page,1932-04-11,1932,0,0,0,0.14299
156415,Behind Office Doors,1931-03-15,1931,0,0,0,0.100285
156529,La cartomancienne,1932-04-17,1932,0,0,0,0.036477
156547,Mai Stati Uniti,2012-01-03,2012,0,0,0,3.972868
156566,Red Garters,1954-02-09,1954,0,1300000,1300000,0.182717
156597,Stage Fright,2014-04-03,2014,0,0,0,4.478881
156603,Let's Go Navy!,1951-07-29,1951,0,0,0,0.64078
156627,The Story of Sin,1975-06-03,1975,0,0,0,0.926499
156643,The Last Tycoon,2012-12-22,2012,0,0,0,2.091058
156700,The Kings of Summer,2013-01-19,2013,0,0,0,6.25805
156708,Afternoon Delight,2013-08-30,2013,0,0,0,4.573796
156711,Austenland,2013-08-15,2013,4900000,2159041,-2740959,8.076305
156713,C.O.G.,2013-09-20,2013,0,0,0,3.320044
156717,Death Race: Inferno,2013-01-04,2013,6500000,0,-6500000,8.531668
156896,Fit,1994-12-26,1994,0,0,0,0.100913
156908,T√§ynn√§ tarmoa,2009-03-01,2009,0,0,0,0.046516
156917,Pekka ja P√§tk√§ neekerein√§,1960-03-11,1960,0,0,0,0.001177
156937,Holy Wars,2010-01-01,2010,0,0,0,0.175871
156954,Die Reise,1986-09-25,1986,0,0,0,0.000603
156965,Concussion,2013-04-04,2013,0,0,0,9.078909
156967,The Journey,1997-01-01,1997,0,0,0,0.001362
156981,Old 37,2015-03-21,2015,0,0,0,1.023086
156988,The Return of Halleluja,1972-08-30,1972,0,0,0,0.00104
156995,"Holy God, Here Comes the Passatore!",1973-01-18,1973,0,0,0,0.054817
157005,Google and the World Brain,2013-01-18,2013,0,0,0,0.231755
157016,Our Nixon,2013-01-23,2013,0,0,0,0.420779
157033,Die Welt,2013-01-24,2013,0,0,0,0.015242
157045,Winter in the Blood,2013-06-14,2013,0,0,0,0.647629
157050,Anthony Jeselnik: Caligula,2013-01-13,2013,0,0,0,0.667595
157058,30 Nights of Paranormal Activity With the Devil Inside the Girl With the Dragon Tattoo,2013-01-14,2013,0,0,0,1.864324
157075,A Job to Kill For,2006-06-27,2006,2500000,0,-2500000,0.404769
157099,Better Living Through Chemistry,2014-03-14,2014,5000000,75143,-4924857,7.392294
157115,Jug Face,2013-08-09,2013,0,0,0,5.305049
157117,Sound City,2013-01-18,2013,0,0,0,4.290209
157123,Tell No One,2012-09-07,2012,0,0,0,2.374266
157129,Table No. 21,2013-01-03,2013,0,0,0,1.293793
157152,Moving Alan,2003-04-04,2003,0,0,0,0.252669
157153,Benjam√≠n's Wife,1991-01-02,1991,0,0,0,0.222001
157161,I Didn't Come Here to Die,2010-10-04,2010,0,0,0,0.252975
157174,Samson and the Seven Miracles of the World,1961-10-31,1961,0,0,0,0.170727
157178,GrajƒÖcy z talerza,1995-11-07,1995,0,0,0,0.104189
157239,A Fighter's Blues,2000-11-21,2000,0,0,0,0.225155
157283,Christopher Columbus,1949-10-12,1949,0,0,0,0.741268
157289,Curfew,2012-01-01,2012,0,0,0,1.470692
157293,ABCD (Any Body Can Dance),2013-02-07,2013,0,222000,222000,0.917727
157301,Adam and Dog,2013-02-01,2013,0,0,0,1.30961
157305,Head Over Heels,2012-05-24,2012,10400,0,-10400,2.566949
157320,History of Cinema in Popielawy,1998-11-01,1998,0,0,0,0.120464
157336,Interstellar,2014-11-05,2014,165000000,675120017,510120017,32.213481
157343,Hard to Handle,1933-01-28,1933,0,0,0,0.538124
157350,Divergent,2014-03-14,2014,85000000,288747895,203747895,21.572585
157351,The Truth About Emanuel,2013-04-26,2013,0,0,0,6.636313
157353,Transcendence,2014-04-16,2014,100000000,103039258,3039258,9.730176
157354,Fruitvale Station,2013-07-25,2013,0,17385830,17385830,13.305596
157360,In a World...,2013-08-09,2013,1000000,2963902,1963902,9.769134
157370,Kill Your Darlings,2013-10-04,2013,1030064,0,-1030064,7.075031
157373,Commune,2005-04-07,2005,0,0,0,0.301732
157375,The Lifeguard,2013-08-30,2013,0,0,0,5.499664
157380,May in the Summer,2013-01-17,2013,0,0,0,4.487643
157384,Mother of George,2013-01-18,2013,0,0,0,1.409684
157386,The Spectacular Now,2013-08-02,2013,2500000,6854611,4354611,8.098964
157409,Crystal Fairy & the Magical Cactus,2013-07-12,2013,0,0,0,10.82388
157414,Up There,2012-11-16,2012,0,0,0,1.14009
157420,Houston,2013-01-22,2013,0,0,0,0.99994
157422,The Wicked Within,2015-10-16,2015,0,0,0,2.278493
157424,Cabin Fever: Patient Zero,2014-02-05,2014,0,0,0,10.118928
157447,Prosecuting Casey Anthony,2013-01-19,2013,0,0,0,1.499331
157449,She Made Them Do It,2012-12-28,2012,0,0,0,2.448345
157515,Seven Journeys,1947-06-13,1947,0,0,0,0.372662
157544,The Vatican Tapes,2015-07-24,2015,13000000,1784763,-11215237,5.149301
157547,Oculus,2013-09-08,2013,5000000,44030246,39030246,8.698043
157559,Ah Nerede,1975-11-19,1975,0,0,0,0.181492
157641,Prison Images,2000-07-01,2000,0,0,0,0.054774
157655,Dangerous Child,2001-07-16,2001,0,0,0,0.632479
157674,FrackNation,2013-01-07,2013,150000,0,-150000,0.382339
157676,The Creators of the Shopping Worlds,2001-06-11,2001,0,0,0,0.072324
157683,For a Book of Dollars,1973-01-01,1973,0,0,0,3e-06
157690,On My Way,2013-05-16,2013,0,0,0,2.557344
157723,Nantucket Film Festival's Comedy Roundtable,2012-09-27,2012,0,0,0,0.776445
157724,The Crazy Bunch,1974-04-27,1974,0,0,0,0.00022
157779,Skin 'em Alive,1978-05-25,1978,0,0,0,0.094331
157787,Nom de code : Rose,2012-12-04,2012,0,0,0,0.515027
157800,Har Dil Jo Pyar Karega...,2000-07-23,2000,0,0,0,1.496361
157803,Unbreakable: The Western States 100,2012-11-22,2012,0,0,0,0.120866
157820,Mood Indigo,2013-04-24,2013,0,0,0,8.23984
157823,Night Moves,2014-04-23,2014,0,0,0,6.35282
157825,White Bird in a Blizzard,2014-08-14,2014,0,33821,33821,12.898498
157827,Louder Than Bombs,2015-05-18,2015,11000000,161789,-10838211,12.293202
157829,The Disappearance of Eleanor Rigby: Them,2014-05-14,2014,0,985007,985007,6.266831
157832,Calvary,2014-04-11,2014,0,0,0,11.033403
157834,The Zero Theorem,2014-01-02,2014,8500000,770706,-7729294,10.990614
157837,From the Sea to the Land Beyond,2012-06-12,2012,0,0,0,0.640336
157841,The Young and Prodigious T.S. Spivet,2013-10-16,2013,33000000,9494789,-23505211,6.839535
157843,Queen of the Desert,2015-09-03,2015,15000000,0,-15000000,5.01561
157845,The Rover,2014-05-18,2014,12250000,2295423,-9954577,6.561373
157847,Joe,2014-04-11,2014,4000000,2365467,-1634533,13.784411
157849,A Most Wanted Man,2014-07-25,2014,15000000,31554855,16554855,10.432407
157851,Maps to the Stars,2014-05-21,2014,0,1338365,1338365,9.431879
157856,Once Upon a Time,1922-10-02,1922,0,0,0,0.204375
157862,Growing Pains,1984-11-11,1984,0,0,0,0.853913
157898,Desirable,1934-09-08,1934,0,0,0,0.350425
157903,Straight Shooting,1917-08-27,1917,0,0,0,0.641859
157909,Show Me,2004-09-23,2004,0,0,0,0.524827
157919,Knife Fight,2013-01-25,2013,7000000,0,-7000000,0.18458
157924,Pompeii: The Mystery of the People Frozen in Time,2013-03-27,2013,0,0,0,0.130692
157964,The Confrontation,1969-02-06,1969,0,0,0,0.28772
158009,The Legend of the North Wind,1992-07-02,1992,0,0,0,0.119227
158011,The Call,2013-03-14,2013,13000000,68572378,55572378,8.611077
158013,White Fang and the Hunter,1975-12-31,1975,0,0,0,0.06978
158015,The Purge,2013-05-31,2013,3000000,89328627,86328627,23.207663
158068,Admiral Yamamoto,1968-08-13,1968,0,0,0,0.377774
158079,"$100,000 for Ringo",1965-11-18,1965,0,0,0,0.456946
158091,Metro Manila,2013-01-20,2013,0,0,0,2.853241
158113,The Case of the Stuttering Bishop,1937-06-08,1937,0,0,0,0.738739
158114,The Case of the Black Cat,1936-10-31,1936,0,0,0,0.124148
158150,How to Fall in Love,2012-07-21,2012,4000000,0,-4000000,1.252665
158182,There Will Come a Day,2013-01-21,2013,0,0,0,0.490065
158217,Kamikaze Taxi,1995-04-29,1995,0,0,0,0.005125
158219,Sex in Chains,1928-10-24,1928,0,0,0,0.146181
158231,Putzel,2012-10-10,2012,0,0,0,0.091852
158232,Greenwich Village: Music That Defined a Generation,2013-01-18,2013,0,0,0,0.116848
158238,Stolen Seas,2013-01-18,2013,0,0,0,0.49248
158262,The Angel Levine,1970-07-27,1970,0,0,0,0.002709
158273,Max and Mona,2004-09-11,2004,0,0,0,0.056414
158382,Hotel Hell Vacation,2010-02-07,2010,0,0,0,1.481633
158386,A Thousand Cuts,2012-01-21,2012,0,0,0,0.568235
158413,Journeys with George,2002-03-08,2002,0,0,0,0.202712
158426,Intersections,2013-01-29,2013,7700000,0,-7700000,4.501117
158431,Slow Burn,2000-09-12,2000,10000000,0,-10000000,1.329106
158439,Lucky Partners,1940-08-02,1940,0,0,0,0.172542
158443,Linda and Abilene,1969-09-01,1969,0,0,0,0.796449
158445,Miracle in Cell No. 7,2013-01-23,2013,0,0,0,6.757725
158455,An Afghan Love Story,2013-01-20,2013,0,0,0,0.222029
158483,Mei and the Kittenbus,2002-01-01,2002,0,0,0,2.146182
158503,Natarang,2010-01-01,2010,0,0,0,0.688708
158517,Lain ulkopuolella,,,0,0,0,0.000143
158519,1920: Evil Returns,2012-11-02,2012,0,0,0,0.931118
158589,Six Acts,2012-06-06,2012,0,0,0,0.918151
158598,"Armida, the drama of a bride",1970-02-03,1970,0,0,0,0.000209
158675,Les Mis√©rables in Concert - The 25th Anniversary,2010-10-03,2010,0,0,0,2.0026
158711,The Human Family Tree,2009-09-01,2009,0,0,0,0.155266
158739,Blue Caprice,2013-09-12,2013,0,0,0,3.897281
158741,In Celebration,1975-03-17,1975,0,0,0,0.721323
158743,Computer Chess,2013-07-17,2013,0,0,0,2.826746
158750,Moving Target,1996-11-26,1996,0,0,0,0.486184
158752,Escape from Tomorrow,2013-10-11,2013,650,0,-650,4.318643
158780,Run,2004-01-29,2004,0,0,0,0.714987
158800,A Majority of One,1961-12-27,1961,0,0,0,1.400185
158811,Wise Girl,1937-12-31,1937,0,0,0,0.367375
158828,An American Hippie in Israel,1972-01-01,1972,0,0,0,0.016023
158848,The Falls,2012-01-12,2012,0,0,0,0.495278
158852,Tomorrowland,2015-05-19,2015,190000000,209154322,19154322,22.296076
158864,American Milkshake,2013-09-06,2013,0,0,0,1.028307
158870,Newlyweeds,2013-09-18,2013,0,0,0,0.537877
158884,A Teacher,2013-09-06,2013,100000,0,-100000,2.957165
158895,This Is Martin Bonner,2013-06-28,2013,0,0,0,0.553315
158900,Faro,2013-03-15,2013,0,0,0,0.126305
158903,The Gits,2008-07-07,2008,0,0,0,0.005
158907,Breathe In,2013-01-18,2013,0,15000,15000,6.437916
158908,The Inevitable Defeat of Mister & Pete,2013-10-11,2013,0,0,0,2.476252
158914,The Look of Love,2013-04-26,2013,0,0,0,4.121282
158916,Sweetwater,2013-01-24,2013,7000000,6147,-6993853,5.799861
158920,The Souler Opposite,1998-10-04,1998,0,0,0,0.018795
158921,Reflections of a Blender,2010-08-19,2010,0,0,0,0.113624
158928,The Roman Spring of Mrs. Stone,2003-05-04,2003,110,0,-110,0.814722
158933,Charlie Victor Romeo,2014-01-29,2014,0,0,0,0.188595
158936,Interior. Leather Bar.,2013-01-18,2013,0,0,0,1.634311
158939,Something About Amelia,1984-01-09,1984,0,0,0,0.156607
158942,Silent Ones,2013-01-22,2013,0,0,0,0.091298
158947,My Dog Killer,2013-04-11,2013,0,0,0,0.363671
158951,Darkness,2013-01-27,2013,0,0,0,0.014962
158959,Feiern,2006-06-06,2006,0,0,0,0.163387
158967,House Hunting,2013-03-05,2013,0,0,0,1.806133
158968,Salt for Svanetia,1930-05-24,1930,0,0,0,0.112502
158990,Wrong Cops,2013-12-18,2013,0,0,0,3.356422
158994,After Tiller,2013-09-20,2013,0,0,0,0.355978
158997,American Promise,2013-10-18,2013,0,0,0,0.459708
158999,Blackfish,2013-06-07,2013,0,2063312,2063312,5.495138
159000,Citizen Koch,2013-01-20,2013,0,0,0,0.332065
159002,Cutie and the Boxer,2013-08-16,2013,0,0,0,1.505666
159004,Dirty Wars,2013-01-18,2013,0,0,0,6.413287
159005,Gideon's Army,2013-01-21,2013,0,0,0,0.223415
159006,God Loves Uganda,2013-10-11,2013,0,0,0,0.482547
159008,Inequality for All,2013-01-19,2013,0,0,0,2.818452
159009,Life According to Sam,2013-10-21,2013,0,0,0,0.084083
159011,Manhunt: The Inside Story of the Hunt for Bin Laden,2013-01-20,2013,0,0,0,0.527539
159012,Narco Cultura,2013-11-22,2013,0,0,0,1.551364
159014,20 Feet from Stardom,2013-06-14,2013,1000000,0,-1000000,8.283621
159015,Valentine Road,2013-01-19,2013,0,0,0,1.231287
159024,Ass Backwards,2013-01-21,2013,3000000,0,-3000000,4.190074
159032,Pussy Riot: A Punk Prayer,2013-06-10,2013,0,0,0,0.870165
159037,The Square,2013-06-07,2013,0,0,0,4.689168
159039,Dr. Ketel,2011-09-17,2011,26700,0,-26700,0.079086
159069,Vaastu Shastra,2004-10-22,2004,0,0,0,0.002574
159090,Duplicate,1998-05-08,1998,0,0,0,0.936806
159092,Hell Baby,2013-09-06,2013,2500000,0,-2500000,4.899401
159095,In Fear,2013-04-03,2013,0,0,0,3.802031
159100,Kink,2013-01-19,2013,0,0,0,2.042703
159109,The Rambler,2013-01-21,2013,0,0,0,1.515997
159117,V/H/S/2,2013-06-06,2013,0,21833,21833,10.714779
159121,Paulette,2013-01-16,2013,0,29494,29494,6.031147
159128,We Are What We Are,2013-09-27,2013,0,81381,81381,7.859837
159137,Anita,2013-03-25,2013,0,0,0,0.526905
159138,The Crash Reel,2013-06-10,2013,0,0,0,2.212038
159140,History of the Eagles,2013-01-19,2013,0,0,0,1.743032
159142,Linsanity,2013-10-04,2013,0,0,0,1.079771
159151,Muscle Shoals,2013-09-27,2013,0,0,0,2.155926
159152,Pandora's Promise,2013-06-12,2013,0,0,0,0.720583
159153,Running from Crazy,2013-01-20,2013,0,0,0,0.870447
159154,We Steal Secrets: The Story of WikiLeaks,2013-05-24,2013,0,602042,602042,8.469808
159160,When I Walk,2013-01-21,2013,0,0,0,0.266326
159166,Which Way Is The Front Line From Here? The Life and Time of Tim Hetherington,2013-01-20,2013,0,0,0,0.153191
159167,The World According to Dick Cheney,2013-01-18,2013,0,0,0,0.191474
159185,"Red Firecracker, Green Firecracker",1994-10-14,1994,0,0,0,0.078257
159186,Just Like Us,2011-10-06,2011,0,0,0,0.020315
159201,Ozzie,2006-09-20,2006,0,0,0,1.253125
159203,Tale of a Forest,2012-12-28,2012,0,0,0,0.359806
159207,Delhi Dance,2012-11-29,2012,0,30292,30292,0.241287
159211,The Haunting of Helena,2013-01-14,2013,0,0,0,2.057244
159215,The Silk Express,1933-06-01,1933,0,0,0,0.411663
159230,Code Name: Jackal,2012-11-15,2012,0,1261947,1261947,1.322781
159245,Komsomol,1933-01-02,1933,0,0,0,0.139915
159281,Two Faces of the Dollar,1967-12-28,1967,0,0,0,0.043995
159304,Runaway,2009-06-08,2009,0,0,0,0.07639
159324,Calendar Girl Murders,1984-04-07,1984,0,0,0,0.538686
159344,Gold,2013-02-09,2013,0,0,0,4.77299
159365,Benaam,1974-10-18,1974,0,0,0,1e-06
159389,TalhotBlond,2012-06-23,2012,0,0,0,2.371553
159403,Ninja 4: Siege,1964-07-10,1964,0,0,0,0.497615
159412,The Thick-Walled Room,1956-10-31,1956,0,0,0,0.129546
159414,The Inheritance,1962-02-16,1962,0,0,0,0.141417
159432,You & Me Forever,2012-09-13,2012,0,0,0,1.194239
159434,"Good Boy, Bad Boy",2007-05-10,2007,4,0,-4,0.558837
159436,Jaani Dushman: Ek Anokhi Kahani,2002-08-16,2002,0,0,0,0.270886
159447,"Mommies, Happy New Year!",2012-12-27,2012,2000000,11666088,9666088,1.456046
159464,Meth,2006-01-01,2006,0,0,0,0.004174
159469,From This Day Forward,1946-03-02,1946,0,0,0,0.444928
159474,La viaccia,1961-06-13,1961,0,0,0,0.766546
159479,"Ryaba, My Chicken",1994-10-01,1994,2700000,4635143,1935143,0.677253
159480,On the Last Verse - A Small Film About Death,1999-04-15,1999,0,0,0,0.383446
159514,Matterhorn,2013-01-24,2013,0,0,0,1.771622
159538,The Strange Case of Alice Cooper,1979-04-09,1979,0,0,0,0.417007
159550,The Last Brickmaker in America,2001-09-23,2001,8000000,0,-8000000,0.038998
159569,Home Page,1998-10-14,1998,0,0,0,0.001183
159615,The Sound and the Fury,1959-03-27,1959,0,0,0,0.597439
159622,Terms and Conditions May Apply,2013-07-12,2013,0,0,0,3.238145
159630,Holi,1985-04-08,1985,0,0,0,0.296788
159636,Raakh,1989-09-17,1989,0,0,0,0.0
159638,Ghost Team One,2013-01-20,2013,0,9195,9195,6.136155
159652,Hank and Asha,2014-04-11,2014,0,0,0,0.165259
159657,Baazi,1995-04-05,1995,0,0,0,0.419631
159666,Mela,2000-01-07,2000,0,0,0,0.441936
159667,Molly Maxwell,2013-01-06,2013,0,0,0,2.00514
159701,I Do,2013-05-31,2013,0,0,0,1.182339
159704,The Cave of the Golden Rose,1991-12-22,1991,0,0,0,1.929422
159727,Song of Freedom,1936-08-16,1936,0,0,0,0.013234
159763,A Nanny's Revenge,2012-10-20,2012,0,0,0,0.373318
159770,The Dirties,2013-10-04,2013,0,0,0,2.382853
159810,Caravaggio,2007-07-03,2007,0,0,0,0.973274
159824,Hotel Transylvania 2,2015-09-21,2015,80000000,473226958,393226958,11.760218
159849,Why We Fight: Divide and Conquer,1943-01-01,1943,0,0,0,0.473322
159849,Why We Fight: Divide and Conquer,1943-01-01,1943,0,0,0,0.473322
159862,Cute Girl,1980-01-01,1980,0,0,0,0.300742
159878,Twilight of a Woman's Soul,1913-11-26,1913,0,0,0,0.207974
159897,Man Walking Around a Corner,1887-08-18,1887,0,0,0,1.184891
159898,The Boxing Cats (Prof. Welton's),1894-07-16,1894,0,0,0,0.227559
159900,"Ella Lola, a la Trilby",1898-01-01,1898,0,0,0,0.055116
159907,"Turkish Dance, Ella Lola",1898-09-30,1898,0,0,0,0.1019
159910,Hadj Cheriff,1894-10-05,1894,0,0,0,0.076062
159932,A Single Shot,2013-02-09,2013,0,18642,18642,12.90146
159937,An Amish Murder,2013-01-06,2013,0,0,0,6.19377
159942,An Episode in the Life of an Iron Picker,2013-10-10,2013,0,0,0,0.855232
159967,The Nun,2013-02-10,2013,0,0,0,1.794501
159988,The Institute,2013-10-11,2013,0,0,0,1.272657
160008,The Revolutionary,2011-12-30,2011,0,0,0,0.060946
160019,Crash Dive,1997-03-28,1997,0,0,0,0.899066
160046,Vovka in the Kingdom of Far Far Away,1965-01-01,1965,0,0,0,1.139555
160068,Gloria,2013-02-10,2013,0,2107925,2107925,3.534494
160070,Apartment 1303 3D,2012-12-06,2012,5000000,0,-5000000,8.303374
160075,Nobody's Daughter Haewon,2013-02-28,2013,0,0,0,1.965104
160085,Schlussmacher,2013-01-10,2013,0,0,0,4.372036
160106,≈†kola princ≈Ø,2010-01-18,2010,0,0,0,0.167233
160118,Child's Pose,2013-03-08,2013,1104000,0,-1104000,3.465681
160124,A Long and Happy Life,2013-04-11,2013,0,0,0,0.627269
160128,Sawney: Flesh of Man,2012-08-22,2012,0,0,0,2.267245
160139,Night Train to Lisbon,2013-03-07,2013,7700000,0,-7700000,6.976215
160155,Life Is Ruff,2005-01-13,2005,0,0,0,1.473947
160160,Vic+Flo Saw a Bear,2013-09-04,2013,0,0,0,1.100663
160162,Blondes at Work,1938-02-05,1938,0,0,0,0.244976
160165,In the Name of...,2013-09-06,2013,0,0,0,4.891581
160171,Closed Curtain,2013-02-12,2013,0,0,0,0.53312
160194,The Skateboard Kid II,1995-01-01,1995,0,0,0,1.198688
160220,Bronies: The Extremely Unexpected Adult Fans of My Little Pony,2012-11-04,2012,348164,0,-348164,2.978835
160234,Abel's Field,2012-09-14,2012,0,0,0,0.779689
160254,There's Always A Woman,1938-04-20,1938,0,0,0,0.413343
160261,Army,1996-01-19,1996,0,0,0,0.465912
160265,Koyla,1997-04-06,1997,0,0,0,3.037553
160266,Rahtree: Flower of the Night,2003-11-13,2003,0,0,0,1.245891
160297,The Slanted Screen,2006-01-03,2006,0,0,0,0.303126
160324,"Hello, Friend",2003-02-02,2003,0,0,0,0.082861
160329,Lightheaded,2009-08-04,2009,0,0,0,0.07998
160372,The Golden Ball,1994-04-13,1994,0,0,0,0.107814
160399,Megazone 23 III,1989-01-01,1989,0,0,0,0.00363
160564,Under the Rainbow,2013-03-05,2013,0,0,0,2.751874
160588,Blue Jasmine,2013-07-25,2013,18000000,99206215,81206215,12.61244
160660,Confidential Agent,1945-11-09,1945,0,0,0,1.749168
160704,The Berlin File,2013-01-30,2013,9000000,48965210,39965210,7.453745
160706,Hava Nagila: The Movie,2012-07-19,2012,0,0,0,0.515897
160718,I Spy Returns,1994-02-03,1994,0,0,0,0.067043
160758,A Dangerous Place,2012-11-30,2012,0,0,0,0.168055
160768,Jimmy P.,2013-09-11,2013,10000000,30283,-9969717,4.50333
160783,Branded,1950-11-03,1950,0,0,0,0.547438
160788,Color of the Ocean,2012-03-22,2012,0,0,0,0.119252
160793,Jungle Goddess,1948-08-13,1948,0,0,0,0.225008
160799,The Stranger,1973-02-26,1973,0,0,0,0.435191
160821,I'm a Standard Supporter,2013-06-25,2013,0,0,0,0.168535
160833,Short Stories,2012-11-15,2012,0,0,0,2.250715
160844,Una donna per la vita,2012-09-21,2012,0,0,0,0.126154
160859,Elena,2013-04-11,2013,0,0,0,0.884128
160874,The Third Reich: The Rise & Fall,2010-12-14,2010,0,0,0,0.376485
160897,Barrio Tales,2012-01-12,2012,0,0,0,0.690089
160907,The Fall of the Essex Boys,2012-02-07,2012,0,0,0,0.778634
160960,Elevator Movie,2004-08-22,2004,25000,0,-25000,0.037726
160989,Day and Night,1997-02-12,1997,0,0,0,0.021472
161006,Praying With Lior,2008-06-17,2008,0,82,82,0.004706
161024,Lovely Loneliness,2009-03-05,2009,0,0,0,0.219318
161056,8-Ball,2013-02-22,2013,0,0,0,1.108516
161064,Filmistaan,2012-07-10,2012,0,0,0,0.234857
161070,August,1996-08-08,1996,0,0,0,0.987434
161073,Mariage √† Mendoza,2013-01-23,2013,0,0,0,1.007559
161076,Some Kind of a Nut,1969-09-14,1969,0,0,0,0.487036
161080,Secret Society,2000-10-29,2000,0,4275,4275,0.042036
161088,High School Big Shot,1959-10-16,1959,0,0,0,0.170226
161094,Hoop Reality,2007-07-01,2007,0,0,0,0.019502
161143,Madly Madagascar,2013-01-29,2013,0,0,0,11.463062
161158,"Paris, France",1994-02-04,1994,0,0,0,0.741522
161179,Shakti: The Power,2002-09-19,2002,0,0,0,0.451851
161187,Saving Lincoln,2013-02-15,2013,700000,0,-700000,0.341101
161212,Kyon Ki...,2005-11-03,2005,0,0,0,0.867723
161226,Biwi No. 1,1999-05-27,1999,0,0,0,1.133102
161227,Jaanam Samjha Karo,1999-04-01,1999,0,0,0,0.425306
161238,Judwaa,1997-02-07,1997,0,0,0,1.373163
161243,Men to Kiss,2012-02-21,2012,0,0,0,0.251257
161244,Desmundo,2002-11-08,2002,3,3,0,0.26507
161246,"Raging Sun, Raging Sky",2009-10-15,2009,1000000,0,-1000000,0.561648
161267,Somewhere Under the Broad Sky,1954-11-23,1954,0,0,0,0.151836
161273,A Time of Roses,1969-02-07,1969,0,0,0,0.274639
161277,Flight from Death: The Quest for Immortality,2003-01-01,2003,0,0,0,0.296731
161297,Ars√®ne Lupin,1932-03-05,1932,0,0,0,0.113792
161299,The Hired Gun,1975-11-13,1975,0,0,0,0.112576
161303,The Playroom,2013-02-06,2013,0,0,0,1.081515
161315,Are You Listening?,1932-03-20,1932,0,0,0,0.073727
161321,The Power of Few,2013-02-15,2013,0,0,0,3.278622
161337,Underworld: Endless War,2011-10-19,2011,0,0,0,3.301063
161359,Lyrical Nitrate,1991-02-20,1991,0,0,0,0.017788
161361,The Forbidden Quest,1993-04-08,1993,0,0,0,0.000234
161374,Tarantulas: The Deadly Cargo,1977-12-28,1977,0,0,0,0.397274
161402,Suryavanshi,1992-02-07,1992,0,0,0,0.224144
161422,The Orkly Kid,1985-10-01,1985,0,0,0,0.706615
161426,You Killed Me First,1985-01-01,1985,0,0,0,0.548423
161442,Waqt Hamara Hai,1993-06-22,1993,0,0,0,0.035294
161456,When Heroes Lie,2012-10-05,2012,0,0,0,0.227758
161460,You Can't Win 'Em All,1970-07-23,1970,0,0,0,1.103785
161463,Citizen King,2004-01-01,2004,0,0,0,0.002354
161482,The Coalition,2013-02-04,2013,0,0,0,0.744802
161491,Northwest,2013-04-17,2013,0,0,0,2.984889
161495,Roommates,1995-03-01,1995,22000000,12400000,-9600000,3.395867
161512,Mission to Moscow,1943-05-22,1943,0,0,0,0.512595
161529,Must Have Been Love,2012-10-18,2012,0,0,0,0.420708
161535,Doraemon:Ë≤ìÁãóÊôÇÁ©∫ÂÇ≥,2004-03-06,2004,0,0,0,0.002354
161545,Tutto tutto niente niente,2012-11-30,2012,5579750,8927600,3347850,2.208906
161565,The Lawyer,1970-03-10,1970,0,0,0,0.124348
161602,Calling Bulldog Drummond,1951-12-14,1951,0,0,0,0.380778
161620,Wonder Woman,1974-03-12,1974,0,0,0,0.366808
161683,Secrets In The Snow,2013-01-08,2013,100000,0,-100000,0.095549
161687,The Ballad of Ramblin' Jack,2000-01-26,2000,0,0,0,0.00259
161710,The Squaw Man,1914-02-14,1914,0,0,0,0.302413
161782,Hansel & Gretel: Warriors of Witchcraft,2013-01-22,2013,0,0,0,5.817159
161795,D√©j√† Vu,1998-04-22,1998,0,0,0,0.438882
161796,The Whispering Shadow,1933-04-17,1933,0,0,0,0.040031
161806,Ed's Next Move,1996-10-18,1996,0,0,0,0.550278
161808,Celal ile Ceren,2013-01-18,2013,0,0,0,0.630223
161816,Raghu Romeo,2003-08-14,2003,0,0,0,0.003494
161825,Best Friends,2005-11-12,2005,0,0,0,0.674257
161827,"I, a Woman",1965-09-17,1965,0,0,0,0.16036
161833,Mickey's Gala Premier,1933-07-01,1933,0,0,0,0.430328
161836,Building a Building,1933-01-07,1933,0,0,0,1.064244
161880,One Step Ahead of My Shadow,1933-02-04,1933,0,0,0,0.003646
161885,Betty Boop's Hallowe'en Party,1933-11-03,1933,0,0,0,0.151893
161898,Oil: A Symphony in Motion,1933-05-01,1933,0,0,0,0.100461
161908,Head Over Heels 2,2012-12-28,2012,0,0,0,2.36934
161915,Ice,1970-10-15,1970,0,0,0,0.111703
161967,Sittin' on a Backyard Fence,1933-12-15,1933,0,0,0,0.036471
161969,Betty Boop's Big Boss,1933-06-01,1933,0,0,0,0.55393
162006,Brave Hearts: Umizaru,2012-07-12,2012,0,0,0,1.215935
162042,Riding with Death,1976-01-01,1976,0,0,0,0.038963
162056,Il minestrone,1981-12-30,1981,0,0,0,0.652262
162059,Front Page Woman,1935-07-11,1935,0,0,0,0.698276
162117,Secrets of Life,1956-11-06,1956,0,0,0,0.072334
162139,Perri,1957-08-28,1957,0,0,0,0.617774
162145,The Liability,2012-11-24,2012,0,0,0,6.301471
162215,How I Live Now,2013-09-10,2013,0,0,0,14.21278
162234,Lola and Billy the Kid,1999-02-12,1999,0,0,0,0.835746
162282,A Perfect Family,2012-11-28,2012,0,0,0,2.59776
162284,Guilty Hands,1931-08-22,1931,0,0,0,0.304974
162320,Love Exists,1960-02-11,1960,0,0,0,0.038029
162372,Fugitives,2000-10-06,2000,0,0,0,0.127155
162374,Top Floor Left Wing,2010-11-15,2010,0,0,0,0.227788
162382,To Bed or Not to Bed,1963-12-22,1963,0,0,0,1.570917
162383,The Bridge,1999-04-06,1999,0,0,0,0.639626
162396,The Big Swap,1998-06-11,1998,0,0,0,0.38283
162406,Embracing,1992-01-01,1992,0,0,0,0.071763
162435,Sun on the Horizon,1996-01-01,1996,0,0,0,0.002321
162437,Katatsumori,1994-05-22,1994,0,0,0,0.076656
162442,See Heaven,1995-06-06,1995,0,0,0,0.056847
162451,Portrait Werner Herzog,1986-03-27,1986,0,0,0,0.716599
162453,Ka√Ørat,1992-08-01,1992,0,0,0,0.000578
162458,Mods,2002-10-25,2002,0,0,0,0.038177
162472,An√©mone,1968-02-13,1968,0,0,0,0.014274
162494,Crisis: Behind a Presidential Commitment,1963-10-21,1963,0,0,0,0.183471
162505,One Way or Another,1978-04-02,1978,0,0,0,0.073163
162510,Strange Voyage,1964-08-09,1964,0,0,0,1.120287
162512,Eveready Harton in Buried Treasure,1929-04-29,1929,0,0,0,0.199235
162532,Sarraounia,1986-07-01,1986,0,0,0,0.889029
162592,The Lumi√®re Brothers' First Films,1996-07-18,1996,0,0,0,0.036823
162611,Portrait of a Young Man in Three Movements,1931-04-15,1931,0,0,0,0.036471
162643,Snow & Ashes,2010-05-16,2010,600000,0,-600000,0.362249
162678,London After Midnight,2002-11-02,2002,0,0,0,0.248556
162686,Voyage to the Sky,1937-01-01,1937,0,0,0,0.352816
162755,Blackbird,1959-06-05,1959,0,0,0,0.156418
162818,The Women on the Roof,1989-09-15,1989,0,0,0,0.164654
162821,Nocturne Indien,1989-05-26,1989,0,0,0,0.022568
162850,The China Lake Murders,1990-01-31,1990,0,0,0,0.001632
162862,Peg o' My Heart,1933-05-26,1933,0,0,0,0.049323
162864,The 3 Rs,2011-09-21,2011,0,0,0,1.557542
162865,Why We Fight: War Comes to America,1945-06-14,1945,0,0,0,0.069688
162874,The Florodora Girl,1930-05-31,1930,0,0,0,0.489142
162877,Venus In Furs,1995-03-15,1995,0,0,0,0.585592
162880,Tell-Tale,2010-03-31,2010,0,0,0,0.681666
162899,Ten Thousand Talents,1960-12-31,1960,0,0,0,0.001247
162903,The Fifth Estate,2013-10-11,2013,28000000,8555008,-19444992,10.850442
162928,Let Us Be Gay,1930-08-08,1930,0,0,0,0.275624
162934,The Witching of Ben Wagner,1990-01-01,1990,0,0,0,0.000603
162954,Walk Cheerfully,1930-03-01,1930,0,0,0,0.141908
162987,Jaguar,1967-01-01,1967,0,0,0,0.218666
163018,"Learn How to Read and Write, Son",1981-09-30,1981,0,0,0,0.554045
163042,Orange Love,2007-05-19,2007,3000000,0,-3000000,0.166253
163053,A Morning Bath,1896-10-30,1896,0,0,0,0.26236
163068,"T,O,U,C,H,I,N,G",1969-01-01,1969,0,0,0,0.182885
163077,Days of Nietzsche in Turin,2001-05-04,2001,0,0,0,0.001194
163111,Down the Hudson,1903-03-22,1903,0,0,0,0.071759
163202,A Borrowed Life,1994-01-01,1994,0,0,0,0.061654
163250,A Night at the Movies: The Horrors of Stephen King,2011-10-03,2011,0,0,0,0.679242
163312,The Forest,2009-09-01,2009,0,0,0,0.01477
163313,Better Mus Come,2013-03-15,2013,0,0,0,0.049339
163333,Monsieur Ripois,1954-09-30,1954,0,0,0,0.083571
163343,The Tender Game,1958-01-01,1958,0,0,0,0.001262
163366,Spend It All,1971-01-01,1971,0,0,0,0.001021
163376,Luv,1967-07-26,1967,0,1000000,1000000,0.985785
163392,The War Between Men and Women,1972-06-01,1972,0,0,0,0.796097
163406,Tipping Point,2007-01-28,2007,0,0,0,0.506323
163428,Man Follows Birds,1976-12-01,1976,0,0,0,0.035351
163431,Ego,2013-01-24,2013,0,0,0,0.668532
163447,Criminally Insane 2,1987-01-01,1987,0,0,0,0.310577
163523,14 Going on 30,1988-03-06,1988,0,0,0,0.050841
163549,Sunday in the Country,1974-11-22,1974,0,0,0,0.003013
163583,River's End,2005-01-01,2005,1000000,0,-1000000,0.51525
163590,Metal Brothers,2012-12-24,2012,0,0,0,0.520486
163630,Dancers,1987-10-09,1987,0,0,0,0.330067
163631,Oliver's Story,1978-12-15,1978,0,0,0,6.823808
163659,Cochochi,2007-04-24,2007,0,0,0,0.564956
163676,A Thousand Clouds of Peace,2003-05-26,2003,0,0,0,0.160085
163706,Chronicle of a Death Foretold,1987-05-07,1987,0,0,0,1.389198
163710,Hide Your Smiling Faces,2014-03-25,2014,0,0,0,1.602963
163791,And the Wife Shall Revere Her Husband,1965-06-28,1965,0,0,0,0.304438
163795,The Guide,2011-04-27,2011,0,0,0,0.042369
163814,Nearlyweds,2013-05-02,2013,0,0,0,1.630406
163837,When Night Falls on the Reeperbahn,1967-10-12,1967,0,0,0,0.490839
163839,The Black Sheep of Whitehall,1942-02-23,1942,0,0,0,0.1531
163845,To.get.her,2011-01-21,2011,86,0,-86,0.007595
163869,Just Write,1997-03-01,1997,0,0,0,0.700719
163870,Tenchi: The Samurai Astronomer,2012-09-15,2012,0,0,0,0.093914
163875,Into the Mind,2013-09-25,2013,0,0,0,1.222176
163890,Blockade,2005-11-07,2005,0,0,0,0.480285
163907,The Villain,1979-07-26,1979,0,0,0,4.27404
163924,Invasion,1969-10-18,1969,0,0,0,0.106688
163937,Film About a Woman Who‚Ä¶,1974-12-11,1974,0,0,0,0.146891
163942,Adrienn P√°l,2011-03-17,2011,0,0,0,0.371893
163978,Soundtracker,2010-05-02,2010,0,0,0,0.006284
164013,"Dzhentlmeny, Udachi!",2012-12-26,2012,0,0,0,0.748609
164041,The Seventh Companion,1968-04-14,1968,0,0,0,0.122209
164045,They Eat Scum,1979-01-01,1979,0,0,0,0.000809
164073,Down to the Sea in Ships,1949-02-15,1949,0,0,0,0.253556
164120,Tropic√°lia,2012-09-14,2012,0,0,0,0.52459
164123,A Storm in Summer,2000-02-27,2000,0,0,0,0.906862
164134,Pad Yatra: A Green Odyssey,,,0,0,0,0.000253
164144,Red Hollywood,1995-09-01,1995,0,0,0,0.309145
164184,"Bless Me, Ultima",2013-02-22,2013,0,1553826,1553826,0.779768
164251,Serena,2014-10-12,2014,0,176391,176391,7.381098
164278,Harvey,1996-10-19,1996,0,0,0,0.143493
164286,Down and Dangerous,2014-02-14,2014,0,0,0,0.671167
164288,The Fearless Triplets,2004-09-03,2004,0,0,0,0.06669
164328,The Strange Little Cat,2013-02-11,2013,0,0,0,0.873666
164331,Spiders,2013-02-08,2013,7000000,0,-7000000,11.012438
164353,Weddings and Babies,1958-01-31,1958,0,0,0,0.102565
164366,Frits and Franky,2013-02-04,2013,0,0,0,0.482671
164372,The Snow Queen,2012-10-11,2012,7000000,12400000,5400000,6.407641
164377,Outpost: Rise of the Spetsnaz,2013-06-26,2013,0,0,0,1.832243
164379,Brooklyn Dodgers: The Ghosts of Flatbush,2007-07-11,2007,0,0,0,0.721507
164419,Maata meren alla,2009-01-23,2009,0,0,0,0.083439
164421,A Matter of Dignity,1958-04-30,1958,0,0,0,0.040883
164443,The Makeover,2013-01-26,2013,8000000,0,-8000000,5.152674
164457,Out of the Furnace,2013-12-06,2013,22000000,15400000,-6600000,6.760321
164479,To the Last Man,1933-09-15,1933,0,0,0,0.833545
164502,The Double,2012-12-25,2012,2000000,0,-2000000,1.205899
164504,Man of the Forest,1933-08-24,1933,0,0,0,0.624066
164558,One Direction: This Is Us,2013-08-28,2013,10000000,0,-10000000,5.988929
164580,The Spirit of '45,2013-03-15,2013,0,0,0,1.269054
164652,About Sarah,1998-10-04,1998,0,0,0,0.316756
164687,Dante's Inferno,1935-08-23,1935,0,0,0,0.977254
164741,Little Richard,2000-02-20,2000,0,0,0,0.151378
164753,Pumping Iron II: The Women,1985-05-03,1985,0,0,0,0.138214
164777,The Magnificient Cuckold,1964-10-19,1964,0,0,0,0.536652
164827,"What Did You Do in the War, Thanassi?",1971-09-23,1971,0,0,0,0.985905
164954,Pluto's Blue Note,1947-12-26,1947,0,0,0,1.088718
164990,The Golden Fortress,1974-12-27,1974,0,0,0,1.084644
165016,Aflatoon,1997-12-19,1997,0,0,0,0.959473
165023,Retaliation,1968-10-05,1968,0,0,0,0.163769
165027,Light Gradient,2009-06-04,2009,0,0,0,0.881727
165066,Dil Kya Kare,1999-01-01,1999,0,0,0,0.036471
165095,Wow! A Talking Fish!,1983-01-31,1983,0,0,0,0.739673
165108,The Story of O Part 2,1984-08-06,1984,0,0,0,5.436479
165159,Agenzia Riccardo Finzi... praticamente detective,1979-12-21,1979,0,0,0,0.00022
165181,Abiogenesis,2011-09-29,2011,0,0,0,0.305357
165213,New World,2013-02-21,2013,0,0,0,5.323934
165300,Hotel Berlin,1945-03-02,1945,0,0,0,0.85602
165321,Way Beyond Weight,2012-09-01,2012,0,0,0,0.341377
165344,The Sentimental Engine Slayer,2010-04-22,2010,0,0,0,0.301722
165401,Honeymoon Academy,1990-05-11,1990,0,0,0,0.140197
165402,Main Prem Ki Diwani Hoon,2003-06-26,2003,0,0,0,1.092782
165404,Humraaz,2002-07-26,2002,0,0,0,0.555975
165432,Joi Baba Felunath,1979-01-04,1979,0,0,0,2.238456
165462,Miracle in Harlem,1948-11-29,1948,0,0,0,0.086772
165463,The Priest's Children,2013-01-02,2013,0,0,0,1.706527
165477,Whole Lotta Sole,2012-04-21,2012,0,0,0,6.039675
165534,Southbounders,2005-06-22,2005,0,0,0,0.041726
165550,Provocateur,1998-05-19,1998,0,0,0,0.992281
165567,Static,2012-10-31,2012,0,0,0,6.941034
165569,Wuthering Heights,2003-09-14,2003,0,0,0,0.539564
165573,Kya Kehna,2000-05-18,2000,0,0,0,0.397078
165586,Mutantes,2009-12-21,2009,0,0,0,0.568418
165621,Herman U.S.A.,2001-01-01,2001,0,0,0,0.33738
165644,Nutcracker Fantasy,1979-03-03,1979,0,0,0,0.039518
165718,Kick-heart,2013-05-01,2013,201164,0,-201164,0.536549
165739,Pawn,2013-04-23,2013,83000000,0,-83000000,4.525671
165790,Cinema of Vengeance,1994-01-01,1994,0,0,0,1.275719
165864,Hansel and Gretel Get Baked,2013-02-19,2013,4500000,0,-4500000,6.23802
165904,Special 26,2013-02-07,2013,7100000,18000000,10900000,2.78114
165911,The Pear Tree,1998-10-18,1998,0,0,0,0.385599
166007,Love in the Rough,1930-09-05,1930,0,0,0,0.20999
166027,Fida,2004-08-20,2004,0,0,0,0.2506
166076,Superman: Unbound,2013-05-06,2013,0,2915767,2915767,7.389122
166085,Tasting Menu,2013-06-14,2013,3780000,0,-3780000,0.932583
166089,Scorpion in Love,2013-04-12,2013,0,0,0,1.405668
166161,Jacob,2011-09-30,2011,900000,0,-900000,0.834734
166178,Fighting Fish,2012-10-01,2012,0,0,0,0.468508
166204,Kanchenjungha,1962-05-11,1962,0,0,0,0.47351
166207,P√°pa Piquillo,1998-12-18,1998,0,0,0,0.383572
166221,Teresa's Tattoo,1994-03-15,1994,0,0,0,0.761102
166225,Khel,2003-11-11,2003,0,0,0,0.073323
166231,Refugee,2000-06-30,2000,0,0,0,0.492298
166253,Pyaar Tune Kya Kiya,2001-01-01,2001,0,0,0,0.136025
166255,Jungle,2000-07-14,2000,0,0,0,0.071764
166256,Main Madhuri Dixit Banna Chahti Hoon!,,,0,0,0,0.0
166258,Road,2002-09-27,2002,0,0,0,0.056473
166259,Virasat,1997-07-06,1997,0,0,0,0.154687
166260,Doli Saja Ke Rakhna,1998-11-27,1998,0,0,0,0.629541
166262,All'ultima spiaggia,2012-10-04,2012,2700000,0,-2700000,0.263761
166271,Haunter,2013-10-25,2013,0,0,0,8.753381
166375,Taqwacore: The Birth of Punk Islam,2009-11-03,2009,0,0,0,0.068498
166393,Burning an Illusion,1981-11-13,1981,0,0,0,0.000571
166424,Fantastic Four,2015-08-05,2015,120000000,167977596,47977596,17.246484
166426,Pirates of the Caribbean: Dead Men Tell No Tales,2017-05-23,2017,230000000,794191988,564191988,133.82782
166452,September Eleven 1683,2012-10-11,2012,16000000,0,-16000000,0.9208
166472,Manslaughter,1922-09-24,1922,0,0,0,1.625211
166560,Chasing Rainbows,1930-02-22,1930,0,0,0,0.460181
166607,Behold a Pale Horse,1964-08-14,1964,0,0,0,0.986266
166610,The Ducktators,1942-08-01,1942,0,0,0,0.50716
166621,Bright Lights,1930-09-20,1930,0,0,0,0.236636
166624,Treading Water,2013-09-13,2013,4700000,0,-4700000,0.830472
166627,Calloused Hands,2013-03-03,2013,0,0,0,0.011853
166643,Men Without Women,1930-02-08,1930,0,0,0,0.662595
166660,Jurassic Attack,2012-02-22,2012,0,0,0,1.290102
166666,3096 Days,2013-02-21,2013,0,0,0,7.089137
166671,The Long and Short of It,2003-01-01,2003,0,0,0,0.874789
166677,The Flight That Fought Back,2004-12-31,2004,0,0,0,0.037647
166680,Avalanche,1978-09-29,1978,6500000,0,-6500000,1.192297
166733,Tsiou,2005-10-04,2005,0,0,0,0.038016
166747,Monster High: Friday Night Frights,2013-02-01,2013,0,0,0,2.328593
166770,Sullivan's Banks,2001-02-09,2001,0,0,0,0.001749
166773,Andrew Dice Clay: Indestructible,2012-12-31,2012,0,0,0,0.011189
166798,Pathetic Fallacy,1958-05-23,1958,0,0,0,0.073521
166822,Big Ass Spider!,2013-10-17,2013,0,0,0,12.48386
166874,Coincidence,1969-10-04,1969,0,0,0,0.001202
166879,One Small Hitch,2013-02-14,2013,0,7965,7965,3.316857
166883,Le Grand Jeu,1934-05-02,1934,0,0,0,0.426592
166886,"Mother, I Love You",2013-02-11,2013,0,0,0,0.467629
166888,The Condemned of Altona,1962-10-30,1962,0,0,0,0.524034
166901,Rude,1995-09-08,1995,0,0,0,0.065827
166904,Master Minds,1949-11-27,1949,0,0,0,0.43573
167012,The Wish List,2010-08-27,2010,0,0,0,0.79427
167021,It's a Long Road,1998-02-18,1998,0,0,0,0.151805
167032,Curse of Chucky,2013-10-04,2013,5000000,0,-5000000,15.771245
167073,Brooklyn,2015-10-20,2015,11000000,62076141,51076141,7.991613
167087,Asfalto,2000-02-04,2000,0,0,0,0.550651
167101,Born Reckless,1958-11-02,1958,0,0,0,0.03734
167112,Deserter,1933-09-18,1933,0,0,0,0.115836
167153,Maladies,2013-02-09,2013,0,0,0,0.8525
167161,Playground,2009-09-04,2009,0,0,0,0.665155
167177,Hair Show,2004-10-17,2004,0,0,0,1.00728
167179,Traffic Department,2013-01-31,2013,1800000,0,-1800000,1.888935
167190,Western Spaghetti,2008-04-26,2008,0,0,0,1.39406
167198,The Midnight Game,2013-03-02,2013,0,0,0,1.64194
167221,Long Live Freedom,2013-02-13,2013,5000000,48125,-4951875,2.513078
167262,Cattle Annie and Little Britches,1981-04-24,1981,0,0,0,0.378564
167267,The Structure of Crystals,1969-10-14,1969,0,0,0,0.202959
167284,Viva Algeria,2004-01-01,2004,0,0,0,0.153287
167305,Kill for Me,2013-02-12,2013,0,0,0,3.00147
167313,Monster High: Why Do Ghouls Fall in Love?,2011-12-21,2011,0,0,0,2.363315
167330,Mord in Eberswalde,2013-01-30,2013,0,0,0,0.784362
167364,Turf,2013-02-13,2013,0,0,0,2.202562
167408,Galileo,1975-01-27,1975,0,0,0,0.926626
167410,Hibernation,2005-02-10,2005,0,0,0,0.073275
167424,The Dead and the Living,2012-09-25,2012,0,0,0,0.386129
167449,The Guillotines,2012-12-20,2012,15000000,5290,-14994710,2.080781
167494,"Reason, Debate and a Story",1974-01-01,1974,0,0,0,2.87607
167502,Is the Man Who Is Tall Happy?,2013-11-22,2013,0,0,0,1.512586
167548,The Shutka Book of Records,2005-11-03,2005,0,0,0,0.285012
167556,My Friends Need Killing,1976-12-10,1976,0,0,0,5e-05
167575,Hatchet III,2013-06-14,2013,0,0,0,4.546004
167581,Free Fall,2013-05-27,2013,0,0,0,5.98915
167583,Corleone,1978-01-02,1978,0,0,0,0.817751
167618,The Strange Case of Wilhelm Reich,2013-01-17,2013,0,0,0,0.288609
167644,Finnish Blood Swedish Heart,2012-09-23,2012,0,0,0,0.1568
167649,In the Shadow of the Sun,2012-01-01,2012,0,0,0,0.04353
167658,My Stuff,2013-01-23,2013,0,0,0,0.867073
167666,Monster High: Escape from Skull Shores,2012-02-16,2012,0,0,0,2.341218
167673,The Mooring,2013-02-01,2013,0,0,0,0.267469
167683,Reaching for the Moon,2013-02-09,2013,0,0,0,3.318055
167707,A Bee in the Rain,1972-04-13,1972,0,0,0,0.405918
167726,Love and Lemons,2013-02-20,2013,0,0,0,0.343246
167733,Vamp U,2013-02-27,2013,0,0,0,7.057051
167738,Guy,1997-12-17,1997,0,0,0,0.60839
167810,Lost River,2015-04-08,2015,2000000,45431,-1954569,6.640704
167858,The Story of the Voyages,1983-09-04,1983,0,0,0,0.586365
167874,Rolf,1984-02-23,1984,0,0,0,0.069686
167882,The Gift of Love,1978-12-08,1978,0,0,0,0.05385
167919,Confine,2012-09-29,2012,0,0,0,0.460859
167928,Frozen City,2006-11-11,2006,0,0,0,0.110396
167935,So Much Water,2013-05-10,2013,0,0,0,0.300224
167938,Istanbul,1985-01-30,1985,0,0,0,0.00586
167948,Space Milkshake,2012-10-26,2012,0,0,0,1.737986
167951,Body and Soul,1981-01-01,1981,0,0,0,0.453611
167956,Fist of Jesus,2012-06-05,2012,0,0,0,0.873612
167960,Sanitarium,2013-03-01,2013,0,0,0,10.267494
167963,Thesis on a Homicide,2013-01-17,2013,0,0,0,3.763458
167966,Voices from the List,2004-03-09,2004,0,0,0,0.154035
167983,Buddies,2012-11-07,2012,2511000,0,-2511000,0.327128
168022,Monster Pies,2013-04-10,2013,0,0,0,0.782851
168027,Freaky Deaky,2012-04-22,2012,0,0,0,7.829016
168031,Caf√© Metropole,1937-05-07,1937,0,0,0,0.228565
168051,Scatter My Ashes at Bergdorf's,2013-05-03,2013,0,0,0,0.017563
168055,Love Is in the Air,2013-04-02,2013,0,7636,7636,6.579812
168056,The Fj√§llbacka Murders: Friends for Life,2013-01-02,2013,0,0,0,0.775202
168057,The Fj√§llbacka Murders: In the Eye of the Beholder,2012-12-26,2012,0,0,0,1.322312
168079,Cold Sweat,1993-05-07,1993,0,0,0,0.634053
168098,Cell,2016-07-06,2016,0,1133031,1133031,10.752519
168112,Eskil & Trinidad,2013-03-29,2013,4200000,0,-4200000,0.058112
168114,Murder 3,2013-02-14,2013,0,0,0,0.734917
168138,The Last Days,2013-03-27,2013,0,0,0,5.961623
168164,The Expedition to the End of the World,2013-02-13,2013,0,0,0,0.143398
168171,Brass Monkey,1948-12-01,1948,0,0,0,0.1145
168179,Pastorale,1975-01-01,1975,0,0,0,0.294605
168202,"Hen, His Wife",1990-05-01,1990,0,0,0,0.003013
168210,Bag of Bones,2011-12-10,2011,15000000,0,-15000000,2.539238
168217,Lightnin',1925-08-23,1925,0,0,0,0.090534
168219,The Men Who Built America,2012-10-16,2012,0,0,0,0.548464
168228,Some Call It Loving,1973-11-16,1973,0,0,0,1.203444
168235,"I, Pet Goat II",2012-03-15,2012,0,0,0,0.122244
168245,Kai Po Che!,2013-02-13,2013,0,0,0,2.000631
168259,Furious 7,2015-04-01,2015,190000000,1506249360,1316249360,27.275687
168261,Shadow of the Holy Book,2007-11-24,2007,0,0,0,0.038829
168283,Fire on the Mountain,1996-11-29,1996,0,0,0,0.001177
168295,Legend of a Duel to the Death,1963-08-10,1963,0,0,0,0.005956
168300,Jubilation Street,1944-06-08,1944,0,0,0,0.341334
168320,The Weight of Elephants,2013-02-14,2013,0,0,0,0.189664
168361,Murder in New Hampshire: The Pamela Wojas Smart Story,1991-09-23,1991,0,0,0,0.814273
168375,Poker Alice,1987-05-21,1987,0,0,0,0.926501
168379,Blue and Not So Pink,2012-11-27,2012,0,0,0,1.298
168399,Pioneer,2013-08-30,2013,7500000,0,-7500000,2.417241
168408,Esther and the King,1960-11-18,1960,0,0,0,1.813569
168421,"Chile, the Obstinate Memory",1997-02-25,1997,0,0,0,0.210078
168426,If I Were You,2013-03-15,2013,0,0,0,2.37094
168450,Parallel Sons,1995-01-01,1995,0,0,0,0.264398
168478,Mermaid,1997-02-14,1997,0,0,0,1.015912
168485,Hit and Runway,1999-04-17,1999,0,0,0,0.413762
168496,Act of Love,1953-12-17,1953,0,0,0,1.169288
168501,Raising Waylon,2004-02-22,2004,0,0,0,0.334592
168530,Ride Along,2014-01-07,2014,25000000,153997819,128997819,9.895752
168535,The Substance of Fire,1996-09-11,1996,0,0,0,0.757322
168538,"Nana, the True Key of Pleasure",1983-06-13,1983,0,0,0,1.276602
168538,"Nana, the True Key of Pleasure",1983-06-13,1983,0,0,0,1.276602
168541,Twilight Time,1982-04-01,1982,0,0,0,0.237546
168552,Youth,2013-08-29,2013,0,0,0,0.820013
168607,Expo Magic of the White City,2005-09-16,2005,0,0,0,0.621779
168616,Tumult,2012-06-29,2012,0,0,0,0.229608
168643,XIII,2008-09-24,2008,21000000,0,-21000000,2.947094
168647,Sounder,2003-01-19,2003,0,0,0,0.641964
168672,American Hustle,2013-12-12,2013,40000000,251171807,211171807,16.478036
168676,Company of Heroes,2013-02-25,2013,0,0,0,3.924855
168693,Milk,1998-01-01,1998,0,0,0,0.43351
168705,BloodRayne,2005-10-22,2005,25000000,2405420,-22594580,6.514132
168712,Panic in the Skies,2006-10-13,2006,0,0,0,1.443855
168742,The Rocket,2013-02-10,2013,1525000,0,-1525000,1.665135
168758,LFO,2013-09-20,2013,0,0,0,0.391409
168767,alaskaLand,2013-02-08,2013,0,0,0,0.010588
168806,Waltz for Monica,2013-09-13,2013,0,0,0,1.227181
168814,Will You Still Love Me Tomorrow?,2013-04-03,2013,0,0,0,0.487394
168819,Weiser,2001-01-18,2001,0,0,0,0.433234
168864,GMO OMG,2013-09-13,2013,0,0,0,0.757848
168885,Demon Hunter,2012-03-20,2012,0,0,0,0.553724
168903,Barbie in the Pink Shoes,2013-02-14,2013,0,0,0,7.254864
168976,The Silent Touch,1992-09-30,1992,0,0,0,0.121702
168981,Beautiful Days,1955-05-25,1955,0,0,0,0.0465
168994,Army,1944-12-07,1944,0,0,0,0.434162
169009,Bridge To Terabithia,1985-02-04,1985,0,0,0,1.157092
169020,Vive la France,2013-02-19,2013,0,0,0,5.081131
169022,Just Friends?,2009-12-17,2009,0,0,0,0.239151
169066,Blindfold,1965-12-22,1965,0,0,0,0.416396
169068,Dorfman,2011-10-20,2011,0,0,0,7.325924
169069,Studio illegale,2013-02-06,2013,0,0,0,1.229133
169089,Henrietta,1983-12-15,1983,0,0,0,0.069924
169090,P√• palmblad och rosor,1976-04-03,1976,0,0,0,0.036214
169091,Zig Zag Story,1983-05-03,1983,0,0,0,0.218568
169108,Lomax the Songhunter,2004-01-01,2004,0,0,0,0.002354
169158,Standoff,1998-01-11,1998,0,0,0,1.349745
169209,Empire State,2013-09-03,2013,11000000,3639345,-7360655,9.003792
169219,The Dyatlov Pass Incident,2013-02-27,2013,0,0,0,5.771432
169250,The Rat Savior,1976-10-26,1976,0,0,0,0.853982
169298,Bullet,2014-02-25,2014,3000000,0,-3000000,3.282908
169310,Borrowed Time,2013-09-13,2013,0,0,0,1.12272
169314,Where The Dead Go to Die,2012-02-01,2012,0,0,0,0.559969
169343,The Plague,2013-02-07,2013,0,0,0,0.088729
169355,Here Is My Heart,1934-12-28,1934,0,0,0,0.18136
169357,The Bengali Night,1988-10-26,1988,0,0,0,0.413448
169364,Swayamvaram,1972-11-23,1972,39000,0,-39000,0.063531
169379,My American Cousin,1985-09-05,1985,0,0,0,0.115498
169382,Homemade Hillbilly Jam,2005-04-25,2005,0,0,0,0.112165
169448,Fifi Howls from Happiness,2013-02-11,2013,0,0,0,0.185681
169479,The Golem,1936-02-13,1936,0,0,0,0.412956
169496,Kitchen,1965-01-01,1965,0,0,0,0.03649
169541,Miracles,1986-07-11,1986,0,0,0,1.285222
169594,The Nostradamus Kid,1993-10-14,1993,0,0,0,0.508815
169607,Finding Vivian Maier,2014-03-28,2014,0,1503616,1503616,7.035082
169618,No Love for Johnnie,1961-02-14,1961,0,0,0,0.364228
169634,Unforgotten Shadows,2013-11-14,2013,1000000,0,-1000000,0.397702
169642,Zero Charisma,2013-10-11,2013,0,0,0,2.02344
169644,Stalled,2013-08-24,2013,0,0,0,1.957144
169652,Salom√©,1972-02-19,1972,0,0,0,0.033575
169656,Gorilla Bathes at Noon,1993-02-11,1993,0,0,0,0.076008
169683,See You Tomorrow,2013-04-20,2013,0,0,0,1.831639
169692,The Landlords,2012-03-13,2012,0,0,0,0.430112
169721,Trevor Noah: You Laugh But It's True,2011-10-22,2011,0,0,0,0.884769
169726,The Gypsy and the Gentleman,1958-01-15,1958,0,0,0,0.071845
169730,Amber Lake,2011-10-11,2011,0,0,0,0.132262
169747,Rated X: A Journey Through Porn,1999-09-09,1999,0,0,0,0.943789
169758,The Stranger Within,2013-05-01,2013,800000,0,-800000,3.40629
169760,Maidentrip,2014-01-17,2014,0,0,0,1.549318
169782,The Making of a Lady,2012-12-19,2012,0,0,0,0.675532
169788,Wives and Lovers,1963-08-29,1963,0,0,0,0.079382
169794,All That I Am,2013-03-10,2013,0,0,0,0.638862
169798,Licks,2013-07-27,2013,0,0,0,0.255933
169800,The Retrieval,2013-03-11,2013,0,0,0,1.597258
169813,Short Term 12,2013-08-23,2013,0,1600000,1600000,12.34835
169832,Number One with a Bullet,1987-02-27,1987,0,0,0,0.500661
169836,A Demon in My View,1991-09-23,1991,0,0,0,0.414982
169840,Good Fortune,2009-06-01,2009,0,0,0,0.004712
169842,The Squall,1929-05-09,1929,0,0,0,0.409037
169844,Malarek,1988-12-16,1988,0,0,0,0.421018
169853,12 O‚ÄôClock Boys,2013-01-31,2013,0,44,44,0.635492
169856,El vendedor de humo,2012-01-04,2012,0,0,0,0.465587
169860,Hey Bartender,2013-06-07,2013,0,0,0,0.527949
169864,The Short Game,2013-09-20,2013,0,0,0,1.537704
169865,The Frankenstein Theory,2013-03-01,2013,0,0,0,3.944932
169869,Blue,1968-05-09,1968,112,0,-112,0.917461
169877,Bovines,2012-02-22,2012,0,0,0,0.008321
169881,The Physician,2013-12-25,2013,32000000,57284237,25284237,13.332387
169883,Barnacle Bill,1941-04-07,1941,0,0,0,0.124964
169885,Flight of the Butterflies,2012-10-01,2012,0,0,0,0.121003
169917,A Walk Among the Tombstones,2014-09-18,2014,28000000,53181600,25181600,14.914924
169934,Iron Man: Rise of Technovore,2013-04-24,2013,0,0,0,10.474313
169962,Counterpoint,1967-03-03,1967,0,0,0,0.447129
170033,Parole de flic,1985-08-21,1985,0,0,0,2.242706
170039,Killing Lincoln,2013-02-16,2013,2000000,0,-2000000,6.929223
170078,Maula Jat,1979-02-10,1979,0,0,0,0.017521
170094,Liberty Kid,2007-06-17,2007,0,0,0,0.010291
170178,K-11,2013-03-15,2013,0,0,0,1.686305
170187,Spanish Fly,1998-09-10,1998,0,0,0,0.12732
170194,Riddle,2013-01-10,2013,7000000,0,-7000000,6.24665
170234,Faithless,1932-10-15,1932,0,0,0,0.027797
170261,The Legend of Sleepy Hollow,1980-10-31,1980,0,0,0,1.650688
170263,Ingmar Bergman on Life and Work,1998-01-31,1998,0,0,0,0.001636
170277,Up the Creek,1958-05-13,1958,0,0,0,0.478898
170279,Ushi Must Marry,2013-02-13,2013,0,0,0,1.294826
170292,Being in the World,2009-12-30,2009,0,0,0,0.059265
170309,Gold,1934-03-29,1934,0,0,0,0.259029
170315,The Ceremony,1963-12-18,1963,0,0,0,0.908396
170368,The Green Years,1963-11-29,1963,0,0,0,0.475908
170399,Grand Isle,1991-08-23,1991,0,0,0,0.842431
170400,Gaudi Afternoon,2001-05-01,2001,0,0,0,0.845166
170430,Man of Her Dreams,1997-11-18,1997,0,0,0,0.79822
170455,A Killer Among Us,2012-09-08,2012,0,0,0,0.626058
170477,Anna Lucasta,1958-11-01,1958,0,0,0,0.205285
170517,The Cool Ones,1967-04-11,1967,0,0,0,0.174993
170522,Asterix: The Mansions of the Gods,2014-11-26,2014,30000000,0,-30000000,8.411263
170548,Crosstrap,1962-01-01,1962,0,0,0,0.010919
170582,Great Expectations,1934-10-22,1934,0,0,0,0.203251
170603,Round Trip to Heaven,1992-09-02,1992,0,0,0,0.506262
170632,Stuck,2013-02-23,2013,0,0,0,0.160291
170657,Journey to the West: Conquering the Demons,2013-02-01,2013,0,0,0,10.506004
170677,The Maids,1975-04-21,1975,0,0,0,0.455434
170687,The Boxtrolls,2014-09-10,2014,60000000,108255770,48255770,11.563909
170689,M√∂bius,2013-02-27,2013,0,0,0,9.299699
170740,Benedict Arnold: A Question of Honor,2003-01-13,2003,0,0,0,0.944574
170750,Getting Go: The Go Doc Project,2013-03-04,2013,0,0,0,0.914399
170752,The Hot Flashes,2013-07-12,2013,4000000,0,-4000000,1.634485
170759,Kokowaah 2,2013-01-27,2013,0,0,0,5.035008
170767,Goya in Bordeaux,1999-09-04,1999,0,0,0,1.300405
170838,Mr. & Mrs. Khiladi,1997-01-01,1997,0,0,0,0.316156
170845,Karma,1986-02-23,1986,0,0,0,0.076367
170856,Deux fois,1968-02-01,1968,0,0,0,0.039134
170898,Sonja and the Bull,2012-07-20,2012,0,0,0,0.58904
170923,Quick Billy,1970-03-24,1970,0,0,0,0.13958
170934,The Piano Lesson,1995-02-05,1995,0,0,0,0.005022
170936,SOS Coast Guard,1937-08-28,1937,0,0,0,0.707991
170967,The House of Suh,2010-05-05,2010,0,0,0,0.07658
170986,Frozen,2007-07-21,2007,0,0,0,0.381779
170998,Shool,1999-11-04,1999,0,0,0,0.009089
171019,Pony Soldier,1952-04-01,1952,0,0,0,0.821121
171032,Man of the Moment,1935-09-01,1935,0,0,0,0.937035
171045,Dead End,2012-03-08,2012,0,0,0,0.387223
171061,Below Sea Level,2008-08-31,2008,0,0,0,0.375625
171075,Crooks Anonymous,1962-03-31,1962,0,0,0,0.530474
171108,Disney Sing-Along-Songs: Under the Sea,1990-08-14,1990,0,0,0,0.003244
171130,Starlift,1951-12-14,1951,0,0,0,0.529599
171160,The Butterfly's Dream,2013-02-21,2013,0,0,0,1.311104
171174,Walnut Bread,1977-06-06,1977,0,0,0,0.223684
171213,Love After Love,1992-04-15,1992,0,0,0,0.6425
171229,Second Skin,1999-12-13,1999,0,0,0,0.831471
171232,Let the Good Times Roll,1973-05-25,1973,0,0,0,0.001586
171274,Inherent Vice,2014-12-25,2014,20000000,11110975,-8889025,13.52638
171277,The House Across the Street,2015-04-10,2015,0,0,0,0.877618
171292,Desire: The Vampire,1982-11-15,1982,0,0,0,0.251427
171308,Baffled!,1973-01-29,1973,0,0,0,0.869219
171337,Siberian Education,2013-02-27,2013,0,0,0,13.631223
171346,Torchy Blane in Panama,1938-05-07,1938,0,0,0,0.642796
171357,"Jonathan Rosenbaum, Present",2013-02-27,2013,0,0,0,0.018703
171363,Pimp Bullies,2011-06-30,2011,0,0,0,1.05862
171372,Frank,2014-05-02,2014,0,645186,645186,5.847845
171424,The Green Inferno,2014-09-04,2014,5000000,6833445,1833445,9.336019
171427,Studentfesten,2013-04-19,2013,0,0,0,0.046452
171429,Black Indians: An American Story,2004-01-01,2004,0,0,0,0.093444
171432,The Man from Beyond,1922-04-01,1922,0,0,0,0.001751
171446,Weary River,1929-02-10,1929,0,0,0,1.16766
171492,Ankur,1974-07-20,1974,0,0,0,0.078659
171540,Big Bad Wolves,2013-04-21,2013,0,33232,33232,4.552786
171550,Pawn's Move,,,0,0,0,0.035301
171581,The Marine 3: Homefront,2013-03-05,2013,0,0,0,3.725381
171587,Whatcha Wearin'?,2012-12-05,2012,0,0,0,1.344487
171594,Enter Arsene Lupin,1944-11-24,1944,0,0,0,0.008978
171597,R√¢nia,2012-01-29,2012,0,0,0,0.050043
171648,It‚Äôs Only Make Believe,2013-03-22,2013,0,0,0,0.697558
171688,Aftermath,2013-11-01,2013,0,0,0,0.531022
171698,The Citizen,2012-09-19,2012,0,0,0,2.546614
171738,Only Daughter,2013-03-02,2013,0,0,0,0.010588
171755,Genius on Hold,2013-03-01,2013,0,0,0,0.15796
171759,The Lost Medallion: The Adventures of Billy Stone,2013-03-01,2013,0,0,0,2.207763
171769,Leonie,2010-11-20,2010,0,0,0,0.492103
171771,The Scar,2013-03-03,2013,0,0,0,0.025665
171776,Sparks,2013-03-01,2013,0,0,0,3.544048
171795,Birth of the Living Dead,2013-10-18,2013,0,0,0,1.452115
171826,All Against All,2013-02-28,2013,0,0,0,0.950908
171840,Kimberly,2000-11-07,2000,0,0,0,0.952744
171846,Killers,2014-02-01,2014,0,0,0,2.129976
171857,Federal Hill,1995-02-24,1995,0,0,0,0.100685
171859,Black White + Gray: A Portrait of Sam Wagstaff and Robert Mapplethorpe,2007-05-01,2007,0,0,0,0.145271
171861,The Flight That Disappeared,1961-09-01,1961,0,0,0,1.111761
171873,Unter Umst√§nden verliebt,2012-03-05,2012,0,0,0,0.022756
171885,Lost Rivers,2013-03-01,2013,0,0,0,0.021035
171902,Mythos Wald,2011-01-27,2011,0,0,0,0.646682
171908,The Perils of Pauline,1967-08-02,1967,0,0,0,0.462405
171910,I Am Divine,2013-03-09,2013,0,0,0,4.69296
171952,Teenage Bank Heist,2012-11-09,2012,0,0,0,0.416693
171961,"Luck, Trust & Ketchup: Robert Altman in Carver Country",1993-03-26,1993,0,0,0,0.035278
171964,American Vagabond,2013-02-27,2013,0,0,0,0.064238
171982,Romance,2012-10-09,2012,0,0,0,0.052377
171993,Deep Blood,1990-09-20,1990,0,0,0,0.081735
172003,Day Is Done,2011-09-23,2011,0,0,0,0.007563
172004,I Am My Films: A Portrait of Werner Herzog,1979-04-18,1979,0,0,0,0.058492
172008,Complicit,2013-02-16,2013,0,0,0,1.113566
172011,Last Words,1968-04-02,1968,0,0,0,0.792956
172014,Underground,1976-05-09,1976,0,0,0,1.8e-05
172104,Broadway Thru a Keyhole,1933-11-02,1933,0,0,0,0.299094
172120,Fagbug,2009-04-20,2009,0,0,0,0.156218
172149,Burning Secret,1988-12-23,1988,0,0,0,1.351087
172198,Magic Hunter,1994-10-23,1994,0,0,0,0.091984
172214,Jew S√ºss,1934-10-13,1934,0,0,0,0.53439
172226,In Secret,2013-09-17,2013,0,0,0,5.583563
172259,Midnight Man,1995-05-09,1995,0,0,0,0.065469
172295,People of the Mountains,1942-02-28,1942,0,0,0,0.071785
172297,The Shimmering Beast,1982-10-15,1982,0,0,0,0.000844
172340,Lovin' Molly,1974-04-14,1974,0,0,0,0.529724
172385,Rio 2,2014-03-19,2014,103000000,500188435,397188435,8.18534
172386,Return to Nim's Island,2013-03-15,2013,0,0,0,3.098933
172390,Tom Sawyer & Huckleberry Finn,2014-10-23,2014,0,0,0,0.834604
172391,Khumba,2013-07-18,2013,20000000,27187375,7187375,5.219667
172396,The Collectors,1999-08-27,1999,0,0,0,0.489766
172413,The True Meaning of Christmas Specials,2002-12-14,2002,0,0,0,0.01526
172443,His Picture in the Papers,1916-02-13,1916,0,0,0,0.036862
172445,The Matrimaniac,1916-12-16,1916,0,0,0,0.241805
172457,Afterparty,2013-09-13,2013,0,0,0,0.716834
172469,Love & Air Sex,2013-10-08,2013,0,0,0,1.610836
172474,The Juche Idea,2008-03-31,2008,0,0,0,0.189007
172475,Mrs. Pollifax: Spy,1971-05-21,1971,0,0,0,0.64703
172499,What If...,2012-11-28,2012,0,0,0,0.66779
172520,Coldwater,2013-03-10,2013,0,0,0,5.441277
172533,Drinking Buddies,2013-08-23,2013,0,343341,343341,7.745083
172535,The Trials of Oscar Wilde,1960-05-01,1960,0,0,0,2.011489
172542,Go for Sisters,2013-11-08,2013,0,0,0,1.519664
172545,Alive and Kicking,1996-11-08,1996,0,0,0,0.873828
172548,Good Night,2013-03-08,2013,0,0,0,0.759277
172577,The Take,2009-06-17,2009,0,0,0,2.76859
172631,Family Weekend,2013-03-28,2013,0,0,0,3.931936
172673,Instructions for a Light & Sound Machine,2006-01-01,2006,0,0,0,0.899832
172705,Habibie & Ainun,2012-12-19,2012,0,0,0,0.344795
172721,End of the World,2013-02-22,2013,0,0,0,1.912981
172729,An American Terror,2013-05-10,2013,200000,0,-200000,0.966123
172747,Duel of Champions,1961-10-19,1961,0,0,0,0.032796
172760,China Dolls,1992-01-01,1992,0,0,0,0.000112
172767,500 MPH Storm,2013-02-28,2013,3000000,0,-3000000,3.698229
172782,Dances with Dragon,1991-12-19,1991,0,0,0,0.714395
172785,Expecting,2013-12-06,2013,0,0,0,1.754062
172803,Hours,2013-11-29,2013,4000000,0,-4000000,10.053166
172817,Saheb Biwi Aur Gangster Returns,2013-03-08,2013,0,0,0,1.021034
172824,Loves Her Gun,2014-01-10,2014,0,0,0,1.263175
172828,Bad Milo,2013-08-28,2013,0,19613,19613,14.013119
172847,Scenic Route,2013-08-23,2013,0,0,0,5.471865
172868,Madagascar Skin,1995-01-26,1995,0,0,0,0.580724
172878,Tale in the Darkness,2009-09-10,2009,0,0,0,1.180238
172890,Metastases,2012-03-01,2012,0,0,0,0.201495
172897,Some Girl(s),2013-06-28,2013,0,0,0,4.86809
172908,Time Bomb,1953-02-05,1953,0,0,0,1.026753
172913,The Boob,1926-05-17,1926,0,0,0,0.002765
172923,Dos Cr√≠menes,1995-05-26,1995,0,0,0,0.233376
172972,Kung Fu Vs. Acrobatic,1990-07-21,1990,0,0,0,0.000578
172973,Beware of My Love,1998-05-26,1998,0,0,0,0.050356
173056,100 Yen: The Japanese Arcade Experience,2012-08-30,2012,32213,0,-32213,0.772606
173080,Graveyard Shift,1987-06-12,1987,0,0,0,0.004351
173151,El chocolate del loro,2004-10-29,2004,0,0,0,0.028043
173153,Phil Spector,2013-03-24,2013,0,0,0,4.657956
173165,The King of Arcades,2014-06-17,2014,175000,0,-175000,0.88805
173168,We Always Lie to Strangers,2013-04-04,2013,0,0,0,0.072054
173171,A Jungle Book of Regulations,1974-12-24,1974,0,0,0,0.427297
173177,Piedipiatti,1990-03-03,1990,0,0,0,1.447592
173185,It Boy,2013-03-06,2013,0,0,0,5.616687
173189,Brian Posehn: The Fartist,2013-03-01,2013,0,0,0,0.682588
173192,An Unreal Dream: The Michael Morton Story,2013-03-11,2013,0,0,0,0.454477
173205,Girl Rising,2013-03-07,2013,0,0,0,3.273977
173210,Downloaded,2013-06-20,2013,0,0,0,2.82234
173224,Along the Roadside,2013-02-28,2013,250,0,-250,0.302165
173288,Black Sheep,2006-10-25,2006,45000,0,-45000,0.880881
173294,Papadopoulos & Sons,2012-12-20,2012,0,0,0,6.60279
173299,Hail Caesar,1994-05-11,1994,0,0,0,0.910213
173300,Getting Back to Abnormal,,,0,0,0,0.000177
173301,Good Ol‚Äô Freda,2013-09-06,2013,0,135039,135039,5.618938
173327,From Bedrooms to Billions,2014-10-03,2014,0,0,0,0.702079
173340,Lovers and Lollipops,1956-04-18,1956,0,0,0,0.3714
173341,Punk in London,1977-12-02,1977,0,0,0,0.118539
173385,My Best Friend,2001-03-02,2001,0,0,0,0.705006
173421,Alter Ego,2007-05-09,2007,0,0,0,0.075118
173433,Holes in My Shoes,,,0,0,0,0.001654
173443,Rio 2096: A Story of Love and Fury,2013-03-07,2013,2000000,0,-2000000,1.320196
173455,Mistaken for Strangers,2013-09-19,2013,0,137460,137460,0.063568
173456,The Plough and the Stars,1936-12-26,1936,0,0,0,0.693777
173465,Medora,2013-11-08,2013,0,0,0,0.105679
173467,Milius,2013-03-09,2013,0,0,0,2.103548
173480,The Other Shore,2013-07-23,2013,0,0,0,0.115296
173484,Rewind This!,2013-08-27,2013,0,0,0,1.283397
173488,Spark: A Burning Man Story,2013-08-16,2013,0,0,0,0.714584
173491,TINY: A Story About Living Small,2013-03-09,2013,0,0,0,0.877716
173494,My Grandmother,1929-01-01,1929,0,0,0,0.051059
173495,Unhung Hero,2013-03-08,2013,0,0,0,1.217759
173497,We Cause Scenes,2014-01-08,2014,0,0,0,0.431841
173499,Everyone's Going to Die,2013-03-10,2013,0,0,0,0.058801
173541,How to Save a Marriage and Ruin Your Life,1968-01-17,1968,0,0,0,0.518286
173557,The Seven Year Hitch,2012-10-13,2012,0,0,0,1.598135
173577,NY77: The Coolest Year in Hell,2007-07-09,2007,0,0,0,0.48231
173580,Dynamite,1929-12-13,1929,0,0,0,0.886807
173587,Dutch Light,2003-11-06,2003,0,0,0,0.085849
173631,Bremer Freiheit,1972-12-12,1972,0,0,0,0.000308
173634,Rockin' In The Rockies,1945-04-17,1945,0,0,0,1.278285
173635,The Argyle Secrets,1948-05-07,1948,0,0,0,0.732721
173638,When the Whales Came,1989-03-28,1989,0,0,0,0.41875
173662,Stella,1950-07-20,1950,0,0,0,0.065362
173672,Hunger,2009-05-12,2009,625000,0,-625000,3.232681
173689,Lights of New York,1928-07-18,1928,75000,1200000,1125000,0.251353
173728,Sparsh,1980-01-30,1980,0,0,0,0.332161
173732,Bang Bang,1971-01-01,1971,0,0,0,0.000578
173739,Z√©zero,1974-01-01,1974,0,0,0,1e-06
173761,Curandero,2005-10-18,2005,0,0,0,1.088587
173793,White Tiger,1996-04-03,1996,0,0,0,0.986861
173796,Brave Miss World,2013-12-13,2013,0,0,0,0.023867
173805,Fortune and Men's Eyes,1971-06-15,1971,0,0,0,0.1223
173845,Dirch Passer v√¶lter byen,1954-03-22,1954,0,0,0,0.00254
173847,Amiche da morire,2013-03-07,2013,0,0,0,2.572216
173865,Esa ja Vesa ‚Äì auringonlaskun ratsastajat,1994-11-10,1994,3120375,0,-3120375,0.205786
173873,Courage for Every Day,1964-01-01,1964,0,0,0,0.502356
173874,The Many Faces of Christopher Lee,1996-01-01,1996,0,0,0,0.051939
173891,Kind Lady,1935-12-06,1935,0,0,0,0.169677
173893,"Cry, the Beloved Country",1952-04-26,1952,0,0,0,0.691117
173897,Resident Evil: The Final Chapter,2016-12-23,2016,40000000,312242626,272242626,0.75571
173908,Sunlight Jr.,2013-04-20,2013,0,0,0,9.471018
173911,Bluebird,2014-02-27,2014,0,0,0,1.072631
173912,Just a Sigh,2013-04-10,2013,0,0,0,0.7654
173914,Sƒì≈ÜotƒÅji,2013-03-07,2013,520,0,-520,0.014823
173917,Stand Clear of the Closing Doors,2014-05-24,2014,0,0,0,0.277707
173928,The Mystery of Sintra,2007-05-03,2007,0,0,0,0.8727
173938,Mighty Uke,2011-01-11,2011,0,0,0,0.011213
173962,Brothers Karamazov,1968-12-25,1968,0,0,0,0.934245
173980,The Devil's in the Details,2013-03-06,2013,0,0,0,1.590978
174000,Nightjohn,1996-06-01,1996,0,0,0,1.168698
174020,Bill Hicks: It's Just a Ride,1994-06-18,1994,0,0,0,0.734406
174122,Dallas - War of The Ewings,1998-04-23,1998,0,0,0,0.773709
174150,The Desert Song,1943-12-17,1943,0,0,0,0.794462
174162,Our Time,1974-04-10,1974,0,0,0,0.197102
174187,That Little Band Of Gold,1915-03-14,1915,0,0,0,0.076965
174188,Rapture-Palooza,2013-06-07,2013,0,0,0,9.603327
174195,Private Eyes,1953-12-06,1953,0,0,0,0.158484
174271,The Fortunes and Misfortunes of Moll Flanders,1996-10-13,1996,0,0,0,1.237982
174278,Duffy of San Quentin,1954-03-16,1954,0,0,0,0.009794
174309,Teenage,2013-04-20,2013,0,0,0,1.695982
174311,All Is Bright,2013-09-10,2013,0,0,0,2.828815
174314,Bottled Up,2013-04-19,2013,0,0,0,0.843111
174316,A Case of You,2013-11-06,2013,0,4187,4187,5.819403
174319,Elaine Stritch: Shoot Me,2013-04-09,2013,0,0,0,1.024055
174321,The English Teacher,2013-05-16,2013,0,104810,104810,9.673017
174322,Gasland Part II,2013-04-20,2013,0,0,0,0.405805
174323,G.B.F.,2013-10-20,2013,0,0,0,0.265042
174324,Gore Vidal: The United States of Amnesia,2013-08-04,2013,0,0,0,1.943032
174325,Moms Mabley: I Got Somethin' to Tell You,2013-04-22,2013,0,0,0,1.208847
174326,A Birder's Guide to Everything,2013-04-21,2013,0,0,0,2.401451
174334,The Motivation,2013-04-25,2013,0,0,0,0.920587
174337,The Pretty One,2014-02-07,2014,0,13769,13769,9.197511
174340,Richard Pryor: Omit the Logic,2015-02-03,2015,0,0,0,3.514786
174341,Some Velvet Morning,2013-12-10,2013,0,6420,6420,3.118419
174343,Trust Me,2013-04-20,2013,0,0,0,2.735064
174344,Whitewash,2013-04-19,2013,0,0,0,4.437517
174346,Alias Ruby Blade,2012-11-16,2012,0,0,0,0.009794
174348,Farah Goes Bang,2013-04-19,2013,0,0,0,0.893768
174350,The Genius of Marian,2013-04-18,2013,0,0,0,0.010588
174351,The Kill Team,2013-10-15,2013,0,0,0,0.33836
174352,Let the Fire Burn,2013-10-02,2013,0,0,0,0.666362
174354,Oxyana,2013-07-16,2013,0,0,0,0.586709
174358,Red Obsession,2013-02-13,2013,0,0,0,0.842357
174366,Bridegroom,2013-04-23,2013,0,0,0,1.642017
174369,Deep Powder,2013-04-19,2013,0,0,0,0.819614
174371,Flex Is Kings,2013-04-18,2013,0,0,0,0.528214
174372,Floating Skyscrapers,2013-04-18,2013,0,0,0,1.4739
174374,Lenny Cooke,2013-12-06,2013,0,0,0,0.469718
174378,Run & Jump,2014-01-24,2014,0,0,0,3.40872
174383,No Place to Hide,1970-12-22,1970,0,0,0,0.303624
174442,Bosko's Parlor Pranks,1934-11-24,1934,0,0,0,0.001347
174487,True Love and Chaos,1997-05-22,1997,0,0,0,1.186081
174552,A Life for a Life,1916-05-09,1916,0,0,0,0.036471
174565,Farmer Al Falfa Sees New York,1916-10-17,1916,0,0,0,0.002638
174588,The Queen of Spades,1916-04-01,1916,0,0,0,0.221127
174593,Blind Justice,1916-09-24,1916,0,0,0,0.392619
174594,Going Straight,1916-06-03,1916,0,0,0,0.315423
174598,Snow White,1916-12-24,1916,0,0,0,0.139346
174611,Bedfellows,2008-08-11,2008,0,0,0,0.601929
174615,Return to Source: The Philosophy of The Matrix,2004-12-07,2004,0,0,0,0.478635
174645,Java Heat,2013-03-06,2013,0,0,0,4.601191
174650,The Return of the Exorcist,1975-08-23,1975,0,0,0,0.485904
174671,Dark Touch,2013-09-27,2013,0,0,0,2.118377
174675,The Machine,2013-04-25,2013,0,0,0,5.871579
174678,Mr. Jones,2013-05-02,2013,0,0,0,3.145229
174682,Raze,2013-04-21,2013,0,0,0,3.217885
174688,The Trials of Muhammad Ali,2013-08-23,2013,0,0,0,1.07091
174712,Coo of The Far Seas,1993-12-19,1993,0,0,0,0.12697
174720,Maksim Perepelitsa,1955-12-12,1955,0,0,0,0.492842
174733,Metro,2013-02-21,2013,13000000,0,-13000000,3.887331
174748,Lars i porten,1984-12-30,1984,0,0,0,0.0
174751,Jane Got a Gun,2016-01-01,2016,25000000,1397284,-23602716,8.826071
174754,Specters,1987-04-24,1987,0,0,0,0.733454
174759,The Sea Bat,1930-07-05,1930,0,0,0,0.069755
174762,Passion Flower,1930-12-06,1930,0,0,0,0.292069
174769,Night Song,1947-11-10,1947,0,0,0,0.081672
174772,Europa Report,2013-06-27,2013,125687,0,-125687,6.964263
174773,Sealed Cargo,1951-05-19,1951,0,0,0,2.257847
174784,Lucky Night,1939-05-05,1939,0,0,0,0.915572
174787,Guerrilla: The Taking of Patty Hearst,2004-11-26,2004,0,0,0,0.198801
174792,The Girl Said No,1930-03-15,1930,0,0,0,0.52513
174865,Penelope,1966-11-10,1966,4000000,0,-4000000,1.381827
174895,"Be Silent, Sorrow, Be Silent",1918-05-14,1918,0,0,0,0.16121
174905,The Young Lady and the Hooligan,1918-05-01,1918,0,0,0,0.208569
174925,Old Wives for New,1918-05-18,1918,0,0,0,0.17124
174928,Carmen,1918-12-20,1918,0,0,0,0.259942
174946,The Busher,1919-05-17,1919,0,0,0,0.202719
174958,Harakiri,1919-12-18,1919,0,0,0,0.480186
174988,Folies Berg√®re de Paris,1935-02-22,1935,0,0,0,0.33188
175005,The Grim Game,1919-10-11,1919,0,0,0,0.078576
175027,Double Harness,1933-07-21,1933,0,0,0,0.561833
175035,When Ladies Meet,1933-06-23,1933,0,0,0,0.948344
175065,Fun on a Weekend,1947-05-15,1947,0,0,0,0.356403
175112,Tinker Bell and the Pirate Fairy,2014-02-13,2014,0,20300000,20300000,12.796484
175116,Out of the Blue,2013-03-14,2013,0,0,0,5.566747
175171,Swing Fever,1943-11-01,1943,0,0,0,0.003318
175226,The Symbol of the Unconquered,1920-11-28,1920,0,0,0,0.001264
175245,Ferocious,2013-03-07,2013,0,0,0,0.942526
175287,Lost and Found,1979-07-13,1979,0,0,0,0.399258
175291,Cheap Thrills,2013-03-08,2013,0,0,0,11.311004
175331,Fratricide,2005-07-31,2005,0,0,0,0.483721
175334,The Love Light,1921-01-08,1921,0,0,0,0.670888
175339,Mad Love,1921-09-09,1921,0,0,0,0.039955
175380,Twilight Zone,1993-11-02,1993,0,0,0,0.407463
175386,Cheyenne,1947-06-06,1947,0,0,0,0.382681
175427,These Birds Walk,2013-11-01,2013,0,0,0,0.593678
175457,Opus II,1921-12-31,1921,0,0,0,0.177238
175461,Lichtspiel opus I,1921-04-26,1921,0,0,0,0.212768
175503,From Morn to Midnight,1920-01-01,1920,0,0,0,0.151641
175518,Tommy Tucker's Tooth,1922-12-06,1922,0,0,0,0.363928
175528,Baggage Claim,2013-09-27,2013,8500000,22456509,13956509,5.590678
175541,Black Nativity,2013-11-27,2013,17500000,7018189,-10481811,5.346121
175553,Fultah Fisher's Boarding House,1922-04-01,1922,0,0,0,0.053067
175555,A Madea Christmas,2013-12-13,2013,0,0,0,4.470777
175574,Free Birds,2013-10-30,2013,55000000,110000000,55000000,7.713231
175587,Our Gang,1922-11-04,1922,0,0,0,0.112741
175597,Polikushka,1922-10-30,1922,0,0,0,0.005525
175606,Pasta Shells,2013-03-20,2013,0,0,0,0.194324
175681,It Started With A Kiss,1959-09-04,1959,0,0,0,0.340325
175739,The Life of Aleksis Kivi,2002-01-18,2002,0,0,0,0.152893
175774,Ruby Red,2013-03-14,2013,0,0,0,8.582533
175791,Ci vuole un gran fisico,2013-03-10,2013,0,0,0,0.684208
175822,The Phantom Fiend,1932-09-08,1932,0,0,0,0.098846
175869,The Treasure,1923-02-23,1923,0,0,0,0.314569
175910,7 Days in September,2002-09-06,2002,0,0,0,0.040398
175924,Between the Lines,1977-04-27,1977,0,0,0,0.096062
175953,Year Zero: The Silent Death of Cambodia,1979-10-30,1979,0,0,0,0.003977
175983,Finishing School,1934-05-04,1934,0,0,0,1.75581
175998,Deadly Duo,1962-02-01,1962,0,0,0,0.813288
176032,Escape from the 'Liberty' Cinema,1990-10-14,1990,0,0,0,1.288561
176037,Supermarket,2012-12-28,2012,0,0,0,0.077748
176068,+1,2013-09-20,2013,0,0,0,5.874701
176069,Foreign Letters,2012-04-22,2012,0,0,0,0.236013
176077,Enter the Dangerous Mind,2013-03-11,2013,0,0,0,1.219246
176079,The Wait,2013-01-31,2013,0,0,0,1.315002
176085,White Reindeer,2013-12-06,2013,0,0,0,0.787464
176088,The Story of Luke,2013-04-05,2013,0,0,0,2.097056
176124,Home Run,2013-04-19,2013,1200000,2861020,1661020,1.472463
176143,Behind the Rising Sun,1943-08-01,1943,0,0,0,0.700467
176167,Parsifal,1982-04-30,1982,0,0,0,0.165026
176182,The Human Scale,2013-02-20,2013,0,0,0,1.459804
176216,I Accuse!,1958-03-05,1958,0,0,0,0.922723
176238,Hawking,2013-03-11,2013,0,0,0,1.505729
176241,Prison Break: The Final Break,2009-05-26,2009,0,0,0,6.526913
176273,The Chechahcos,1924-05-14,1924,0,0,0,0.038728
176297,Dead Set,2008-10-27,2008,0,0,0,4.87963
176298,Opus III,1924-03-11,1924,0,0,0,0.256196
176321,New Year's Eve,1924-01-03,1924,0,0,0,0.036539
176339,Mary and Martha,2013-03-01,2013,0,0,0,12.015917
176389,Kean,1924-02-14,1924,0,0,0,0.19643
176403,In Bloom,2013-02-10,2013,0,0,0,0.966462
176407,Soviet Toys,1924-03-11,1924,0,0,0,0.487334
176535,All Will Be Well,2007-10-05,2007,0,0,0,0.144881
176545,Casting Couch,2013-03-11,2013,0,0,0,1.307954
176568,Sensuela,1973-05-29,1973,0,0,0,1.002187
176570,Shadow People,2013-03-17,2013,0,0,0,3.388843
176627,Mary Stevens M.D.,1933-07-22,1933,0,0,0,0.306951
176650,The Sandwich Man,1983-09-01,1983,0,0,0,0.141103
176651,Darkness and Light,1999-11-26,1999,0,0,0,0.297027
176670,Shoot-Out At Medicine Bend,1957-05-04,1957,0,0,0,0.119953
176715,Jack,2013-03-10,2013,0,0,0,0.36972
176720,Something Real and Good,2013-03-05,2013,0,0,0,0.719208
176734,A Life of Her Own,1950-09-01,1950,0,0,0,0.808676
176807,O Delfim,2002-03-13,2002,0,0,0,0.634022
176810,Air Hawks,1935-05-07,1935,0,0,0,0.460947
176841,Moonlight Murder,1936-03-27,1936,0,0,0,0.283269
176867,Heart of the North,1938-12-10,1938,0,0,0,0.007722
176896,Heavy Metal Britannia,2010-03-07,2010,0,0,0,0.576967
176915,Dead Shadows,2012-09-09,2012,0,0,0,2.158991
176983,One Piece Film Z,2012-12-15,2012,0,0,0,3.754607
177043,Flap,1970-11-13,1970,0,0,0,0.541883
177047,Decoding Annie Parker,2014-05-02,2014,2000000,48390,-1951610,3.880541
177085,Late Last Night,1999-06-20,1999,0,0,0,1.209929
177104,Napoletani a Milano,1953-09-05,1953,0,0,0,0.089436
177112,Found in Time,2012-10-05,2012,0,0,0,0.470742
177117,Mars and April,2012-10-05,2012,0,0,0,0.779743
177155,Days and Hours,2004-08-20,2004,0,0,0,1.018864
177190,It's Tough to Be Famous,1932-04-02,1932,0,0,0,0.110358
177203,The Challenger,2013-03-18,2013,0,0,0,5.236699
177216,Twist,1992-09-18,1992,0,0,0,0.00076
177221,The Battery,2012-10-13,2012,0,0,0,3.530559
177234,Spy Chasers,1955-07-31,1955,0,0,0,0.631319
177271,Lego Batman: The Movie - DC Super Heroes Unite,2013-05-20,2013,0,0,0,1.607783
177317,West Of Shanghai,1937-10-30,1937,0,0,0,0.127134
177335,Alamo Bay,1985-04-03,1985,0,0,0,5.482197
177354,Stud Life,2012-03-22,2012,0,0,0,0.212113
177358,Jolly LLB,2013-03-15,2013,0,0,0,0.839911
177436,A Man to Remember,1938-10-14,1938,0,0,0,0.002701
177440,The Golden Hawk,1952-10-08,1952,0,0,0,0.67175
177474,That Kind of Woman,1959-09-11,1959,0,0,0,0.611903
177494,Veronica Mars,2014-03-13,2014,6000000,3485127,-2514873,7.510159
177522,Lipton Cockton in the Shadows of Sodoma,1995-04-21,1995,0,0,0,0.073825
177552,A Resurrection,2013-03-21,2013,0,0,0,4.555887
177564,Destroy Yourselves,1969-05-09,1969,0,0,0,0.071856
177566,Jack the Giant Killer,2013-03-12,2013,50000,0,-50000,1.565726
177572,Big Hero 6,2014-10-24,2014,165000000,652105443,487105443,213.849907
177580,The Affairs of Dobie Gillis,1953-08-14,1953,0,0,0,0.090084
177622,I Dream Of Wires,2014-11-10,2014,0,0,0,0.786443
177677,Mission: Impossible - Rogue Nation,2015-07-23,2015,150000000,682330139,532330139,17.836882
177697,Hangtime,2009-10-14,2009,0,0,0,0.75515
177699,Alan Partridge: Alpha Papa,2013-07-24,2013,4000000,9800000,5800000,10.130541
177703,Broadway Idiot,2013-10-18,2013,0,0,0,1.729206
177714,M√°gica Aventura,1973-06-09,1973,0,0,0,1e-06
177790,The Man I Married,1940-08-09,1940,0,0,0,0.187243
177865,The Hour of the Lynx,2013-05-23,2013,3700000,0,-3700000,2.012333
177869,Survive and Advance,2013-03-17,2013,0,0,0,0.08118
177888,Teen Beach Movie,2013-07-19,2013,0,0,0,4.909843
177902,Doubting Thomas,1935-07-10,1935,0,0,0,0.047712
177945,"Like Father, Like Son",2013-09-28,2013,0,19978961,19978961,7.074042
177950,Parliament Funkadelic: One Nation Under a Groove,2005-04-05,2005,0,0,0,0.004091
177979,Peng! Du bist tot!,1987-04-15,1987,0,0,0,0.002789
178032,"L√∫cio Fl√°vio, o Passageiro da Agonia",1977-02-01,1977,0,0,0,0.154252
178103,The Rising of the Moon,1957-08-10,1957,0,0,0,0.365754
178146,The Lady Vanishes,2013-03-17,2013,0,0,0,0.963271
178189,"Inner Worlds, Outer Worlds",2012-12-19,2012,0,0,0,0.438376
178222,The Falcon,1981-01-01,1981,0,0,0,0.365618
178290,The Punk Singer,2013-11-29,2013,0,0,0,2.650803
178314,Shutter,2013-02-22,2013,0,0,0,1.530521
178337,The Ice Follies of 1939,1939-03-10,1939,0,0,0,0.110013
178341,Mandalay,1934-02-10,1934,0,0,0,0.945843
178382,Ode,1999-06-09,1999,0,0,0,0.084657
178385,Travis,2004-01-01,2004,0,0,0,0.39691
178446,Generation War,2013-03-17,2013,12000000,0,-12000000,5.127594
178447,Wide Open,1930-02-01,1930,0,0,0,0.141396
178452,Hollywood Party,1934-06-01,1934,0,0,0,0.947216
178469,Three Rooms of Melancholia,2004-12-28,2004,0,0,0,0.300164
178535,The Dupes,1973-07-01,1973,0,0,0,0.016023
178541,The Ballad of Lucy Whipple,2001-01-20,2001,0,0,0,1.338622
178543,Blind Pig Who Wants to Fly,2008-05-18,2008,0,0,0,0.040236
178569,Jail Busters,1955-09-18,1955,0,0,0,0.164536
178587,The Happy Time,1952-10-30,1952,0,0,0,0.109127
178595,"DOS ŒºŒπŒ± ŒπœÉœÑŒøœÅŒØŒ± Œ±Œ≥Œ¨œÄŒ∑œÇ, Œ±œÄ' œÑŒ∑ŒΩ Œ±ŒΩŒ¨œÄŒøŒ¥Œ∑",2011-09-01,2011,0,0,0,0.082658
178603,Detour,2013-03-29,2013,0,0,0,4.51583
178606,Buud Yam,1997-09-10,1997,0,0,0,0.109074
178607,Right Cross,1950-10-06,1950,0,0,0,0.063783
178614,Happy Anniversary and Goodbye,1974-11-19,1974,0,0,0,0.439725
178675,Venus Boyz,2002-07-04,2002,0,0,0,0.45331
178682,The Wizards Return: Alex vs. Alex,2013-03-15,2013,0,0,0,6.287572
178687,616: Paranormal Incident,2013-02-12,2013,0,0,0,1.445628
178736,Chizuko's Younger Sister,1991-05-10,1991,0,0,0,0.008701
178751,Countdown,2012-12-19,2012,0,0,0,0.987869
178755,"Arab Cortege, Geneva",1896-01-01,1896,0,0,0,0.052557
178806,21 Ways to Ruin a Marriage,2013-02-07,2013,0,0,0,0.367875
178809,The Colony,2013-04-12,2013,16000000,0,-16000000,9.726664
178862,Aroused,2013-02-20,2013,0,0,0,2.358338
178907,The Lonely Voice of Man,1987-09-05,1987,0,0,0,0.076367
178915,Welcome Mr. President!,2013-03-19,2013,0,9500000,9500000,4.709454
178917,Best Kept Secret,2013-05-04,2013,0,0,0,0.13879
178927,The Millionaire,1931-05-01,1931,0,0,0,1.170284
178946,Craig Ferguson: I'm Here to Help,2013-03-14,2013,0,0,0,0.429412
179053,App,2013-04-03,2013,2000000,0,-2000000,2.256245
179057,No Sad Songs for Me,1950-04-27,1950,0,0,0,0.418174
179066,I Live My Life,1935-10-04,1935,0,0,0,0.80842
179085,A Kiss in the Dark,1949-03-26,1949,0,0,0,0.524521
179103,On Dress Parade,1939-11-18,1939,0,0,0,0.002484
179105,Scavengers,2013-03-21,2013,0,0,0,2.355288
179109,Bastards,2013-07-06,2013,0,12247,12247,2.16237
179111,A Field in England,2013-07-05,2013,0,32846,32846,13.567726
179144,The Great Beauty,2013-05-21,2013,12400000,8371085,-4028915,8.176134
179146,The Last of the Unjust,2013-05-20,2013,0,0,0,1.188118
179150,Reality,2014-08-28,2014,0,0,0,5.905061
179154,Standing Up,2013-08-16,2013,6000000,0,-6000000,2.871891
179159,Germ,2013-03-12,2013,500000,0,-500000,0.775143
179178,Poker In Bed,1974-08-14,1974,0,0,0,0.720048
179179,American Winter,2013-03-18,2013,0,0,0,0.340861
179188,Jungle Cat,1959-12-16,1959,0,0,0,0.271123
179235,Let Me Dream Again,1900-08-01,1900,0,0,0,0.462651
179236,Grandma's Reading Glass,1900-11-01,1900,0,0,0,0.471404
179251,We Live Again,1934-11-01,1934,0,0,0,0.345705
179267,Jay And Silent Bob's Super Groovy Cartoon Movie,2013-04-20,2013,0,0,0,1.66913
179270,Tell Me and I Will Forget,2010-01-01,2010,0,0,0,0.005882
179272,El Paso,1949-03-22,1949,0,0,0,2.337457
179288,Blackbird,2007-03-12,2007,475000,0,-475000,0.485794
179302,√Ånima Buenos Aires,2012-05-02,2012,0,0,0,0.216973
179308,Die Akte Golgatha,2010-06-29,2010,0,0,0,0.056583
179340,Goddess,2013-03-12,2013,114,0,-114,1.60678
179366,The Body Farm,2011-09-12,2011,0,0,0,0.997362
179375,Red Wine,2013-03-22,2013,0,0,0,0.537292
179398,Please Kill Mr. Know It All,2013-04-14,2013,0,0,0,0.095686
179519,"Uncle Marin, the Billionaire",1979-02-05,1979,0,0,0,0.997899
179538,Witching & Bitching,2013-09-20,2013,8000000,0,-8000000,13.515614
179549,Stop Thief!,1901-01-01,1901,0,0,0,0.113326
179553,La Habanera,1937-12-18,1937,0,0,0,0.869722
179573,Fair Sex,2012-12-04,2012,0,0,0,0.712994
179603,Woman in the Dark,1934-11-08,1934,0,0,0,0.193829
179641,Chlo√©,1996-01-01,1996,0,0,0,1.93846
179668,The Brussels Business,2012-03-13,2012,0,0,0,0.159774
179690,What Men Do!,2013-02-27,2013,0,0,0,1.113619
179715,Angel's Fall,2005-02-03,2005,0,0,0,0.037666
179798,Defiance,1980-03-14,1980,0,0,0,2.068784
179799,Tattoo Nation,2013-04-04,2013,0,0,0,1.061241
179805,Lotus Eaters,2013-04-05,2013,0,0,0,0.801038
179812,Camp,2013-02-22,2013,0,0,0,0.647811
179818,Paid,1930-12-30,1930,0,0,0,0.85277
179822,MURPH: The Protector,2013-03-22,2013,0,0,0,0.893606
179826,Odd Thomas,2013-04-16,2013,27000000,0,-27000000,7.090029
179837,Manufractur,1985-01-01,1985,0,0,0,0.004137
179847,First Love,1974-07-01,1974,0,0,0,0.001021
179848,Ratchagan,1997-10-29,1997,0,0,0,0.005866
179868,The Affair,1967-05-13,1967,0,0,0,0.188931
179966,Fishing Naked,2015-05-08,2015,0,0,0,1.098982
180016,First Person Plural,2000-12-18,2000,0,0,0,0.001178
180021,Groupies,1970-11-08,1970,0,0,0,0.587786
180048,Amen,2013-03-21,2013,110000,270000,160000,1.104156
180050,Cigarettes and Coffee,2004-02-05,2004,0,0,0,0.36048
180093,Still Life,1997-05-23,1997,0,0,0,0.256207
180095,Refuge,2013-03-22,2013,100000,0,-100000,0.705263
180114,Holy Matrimony,1943-08-24,1943,0,0,0,0.613323
180132,Raiders of the Sun,1992-06-24,1992,0,0,0,0.000578
180147,We Are The Nobles,2013-03-28,2013,2000000,0,-2000000,3.938691
180152,Out on a Limb,1987-01-18,1987,0,0,0,0.600304
180162,Breaking the Rules,1992-10-09,1992,0,0,0,0.51617
180240,Normaal: Ik Kom Altied Weer Terug,,,0,0,0,0.0
180244,We Don't Care About Music Anyway,2009-09-09,2009,0,0,0,0.1654
180252,Very Ordinary Couple,2013-03-21,2013,0,0,0,1.329846
180296,They Came Together,2014-06-27,2014,0,0,0,9.139015
180299,The Raid 2,2014-03-27,2014,4500000,2627209,-1872791,8.434884
180305,Mercy,2014-10-07,2014,0,0,0,8.708018
180314,Salinger,2013-09-06,2013,0,0,0,7.486516
180318,The Chicago 8,2011-06-04,2011,0,0,0,0.974037
180363,We Sold Our Souls for Rock 'n Roll,2001-01-19,2001,0,0,0,0.002915
180371,Vai Que D√° Certo,2013-03-22,2013,1000000,0,-1000000,2.685498
180383,Deceptive Practice: The Mysteries and Mentors of Ricky Jay,2012-10-04,2012,500000,0,-500000,0.582497
180399,The Legend of Leigh Bowery,2002-04-13,2002,0,0,0,0.110649
180418,15 Years and One Day,2013-06-07,2013,0,0,0,0.785439
180420,Asphalt Playground,2012-11-16,2012,0,0,0,0.776233
180427,Frisco Kid,1935-11-29,1935,0,0,0,0.308882
180514,Bokhandlaren som slutade bada,1969-04-06,1969,0,0,0,0.807142
180555,Critique of Separation,1961-03-25,1961,0,0,0,0.213032
180576,Rich in Love,1992-10-01,1992,0,0,0,0.396507
180607,Down the Shore,2011-01-06,2011,0,0,0,1.856812
180624,Before Dawn,1933-08-04,1933,0,0,0,0.039196
180635,One Sunday Afternoon,1933-09-01,1933,0,0,0,0.316962
180644,Anina,2013-02-12,2013,0,0,0,1.634427
180651,Fists of Legend,2013-04-10,2013,0,0,0,1.948953
180679,Sexy Evil Genius,2013-04-09,2013,0,0,0,4.542951
180680,Himmatwala,2013-03-29,2013,0,0,0,0.157217
180685,Oh Willy...,2013-04-03,2013,0,0,0,0.485658
180688,Deep Dark Canyon,2013-04-23,2013,0,0,0,3.927043
180691,David Bowie & the Story of Ziggy Stardust,2012-06-22,2012,150000,0,-150000,0.817968
180695,The Roe's Room,1997-06-14,1997,0,0,0,0.313359
180705,Benji,2012-10-23,2012,0,0,0,0.131653
180717,Dead On,1994-10-01,1994,0,0,0,0.203801
180721,Blueberry Hill,1988-12-02,1988,0,0,0,0.011064
180759,Nice Guy,2012-01-06,2012,0,0,0,0.012572
180794,"Tom, Dick and Harriet",2013-03-16,2013,0,0,0,0.360812
180810,And Now a Word from Our Sponsor,2013-05-10,2013,0,0,0,1.39366
180813,One Track Heart: The Story of Krishna Das,2013-05-08,2013,0,0,0,0.004801
180819,Feudin' Fools,1952-09-21,1952,0,0,0,0.269692
180836,Miss Marple: The Moving Finger,1985-02-21,1985,0,0,0,1.388201
180850,Lucky Bastard,2014-02-14,2014,0,0,0,1.394775
180856,King's Faith,2013-04-26,2013,0,0,0,0.175771
180859,E la chiamano estate,2012-11-22,2012,0,0,0,0.381072
180863,T2 Trainspotting,2017-01-27,2017,18000000,41412709,23412709,17.645877
180879,Harry Munter,1969-12-20,1969,0,0,0,0.304433
180886,Spooky Town,1999-02-16,1999,0,0,0,1.495305
180891,Real,2013-06-01,2013,0,0,0,1.633896
180894,Ninja: Shadow of a Tear,2013-12-27,2013,0,0,0,5.632097
180900,Shield of Straw,2013-04-25,2013,0,0,0,1.787465
180929,Whiffs,1975-10-15,1975,0,0,0,0.640909
180935,Please Subscribe,2013-03-23,2013,0,0,0,0.925468
180948,Vehicle 19,2013-03-07,2013,0,0,0,10.803734
180951,Summer in February,2013-06-13,2013,0,0,0,10.47983
180954,Vessel of Wrath,1938-03-04,1938,0,0,0,0.657391
180960,Celestial Wives of the Meadow Mari,2012-11-11,2012,0,0,0,0.847522
180970,Offset,2006-07-20,2006,0,0,0,0.443846
180998,M√∫sica Campesina,2011-08-27,2011,0,0,0,0.007156
181009,Saving General Yang,2013-04-04,2013,20000000,0,-20000000,5.333347
181083,God's Gift,1982-01-01,1982,0,0,0,0.049573
181104,Sleeping on Dark Waters,2008-01-01,2008,0,0,0,0.098578
181135,Twist of Faith,2013-03-09,2013,0,0,0,0.420116
181267,Celestial Subway Lines/Salvaging Noise,2005-01-01,2005,0,0,0,0.07997
181269,Secrets of a Married Man,1984-09-24,1984,0,0,0,0.79666
181283,Child 44,2015-03-15,2015,50000000,3324330,-46675670,17.608346
181330,Kevin Hart: Let Me Explain,2013-07-03,2013,0,32230907,32230907,11.110533
181426,Chandu on the Magic Island,1935-01-01,1935,0,0,0,0.956381
181454,The Ghosts in Our Machine,2013-04-28,2013,0,0,0,0.395008
181456,Thieves After Dark,1984-02-27,1984,0,0,0,1.170842
181533,Night at the Museum: Secret of the Tomb,2014-12-17,2014,127000000,349424282,222424282,19.539436
181537,The Late George Apley,1947-03-19,1947,0,0,0,0.408394
181553,"Me, Natalie",1969-07-13,1969,0,0,0,0.68458
181564,Crossing the Last Line,1991-07-09,1991,0,0,0,0.001393
181565,Outing - Engaged by Mistake,2013-03-30,2013,0,0,0,1.26876
181574,Flash,1997-12-21,1997,0,0,0,1.197974
181628,Search for the Beast,1997-01-01,1997,0,0,0,0.001662
181649,Chu Chin Chow,1934-05-01,1934,0,0,0,0.01265
181656,Asura,2012-09-29,2012,0,0,0,2.373448
181753,Backfire,1988-06-21,1988,0,0,0,0.95393
181801,Hot Splash,1988-05-19,1988,0,0,0,0.03714
181850,The Pirates of Penzance,1980-06-01,1980,0,0,0,0.218585
181876,Blackmailed,1951-01-30,1951,0,0,0,0.567483
181886,Enemy,2013-12-31,2013,0,3396726,3396726,12.66992
181999,Butterflies Have No Memories,2009-10-18,2009,0,0,0,0.632486
182030,The Twin Swords,1965-12-22,1965,0,0,0,0.674934
182035,In Old Santa Fe,1934-11-15,1934,0,0,0,0.100442
182067,The Spy Who Loved Flowers,1966-08-12,1966,0,0,0,0.371055
182097,God's Sandbox,2002-06-06,2002,0,0,0,0.024891
182099,21-87,1963-04-24,1963,0,0,0,0.897979
182127,Ip Man: The Final Fight,2013-03-22,2013,0,37884,37884,1.54105
182129,A Midsummer Night's Dream,1968-09-30,1968,0,0,0,0.922111
182131,Little Witch Academia,2013-03-02,2013,480000,0,-480000,4.767058
182217,"The Good, the Bad, and Huckleberry Hound",1988-04-05,1988,0,0,0,0.926771
182219,Serial Teachers,2013-04-17,2013,12000000,0,-12000000,0.240446
182228,100 Degrees Below Zero,2013-03-29,2013,500000,0,-500000,1.717936
182246,11.6,2013-04-03,2013,0,0,0,2.846798
182349,Love Sick Love,2012-11-15,2012,0,0,0,0.05168
182415,"Bianca come il latte, rossa come il sangue",2013-04-02,2013,0,0,0,5.665259
182424,Rita da Cascia,2004-09-26,2004,0,0,0,0.375835
182499,The Neighbor,1993-11-03,1993,0,0,0,0.476993
182528,Crimi Clowns: De Movie,2013-04-03,2013,0,0,0,0.170043
182545,Bingo,2013-03-26,2013,0,0,0,0.184827
182548,Mary Pickford: The Muse of the Movies,2008-08-29,2008,250000,0,-250000,0.136137
182560,Dark Places,2015-03-31,2015,20000000,208588,-19791412,9.188583
182583,Hit 'n Strum,2013-04-05,2013,0,0,0,0.135284
182756,Perfect Strangers,1945-10-15,1945,0,0,0,0.045629
182768,Leda - The Fantastic Adventure of Yohko,1985-01-16,1985,0,0,0,0.545656
182799,Cement,2000-04-03,2000,0,0,0,0.841443
182827,The Great Passage,2013-04-04,2013,0,0,0,1.289687
182843,Mortacci,1989-04-25,1989,0,0,0,0.007223
182848,Welcome to Australia,1999-12-02,1999,0,0,0,0.00345
182873,Green Street Hooligans: Underground,2013-01-01,2013,0,0,0,3.368436
182899,The Voice of Bugle Ann,1936-02-15,1936,0,0,0,0.078521
182937,Continental Circus,1972-07-15,1972,0,0,0,0.00022
182950,Blonde Dynamite,1950-02-12,1950,0,0,0,0.018424
182972,Cargo,2013-04-02,2013,0,0,0,1.139989
182979,Louis Theroux: Under The Knife,2007-10-07,2007,0,0,0,0.500445
182981,Nude Area,2014-06-01,2014,0,0,0,0.420688
182991,Finisterre,2003-05-22,2003,0,0,0,0.002539
183011,Justice League: The Flashpoint Paradox,2013-07-28,2013,3500000,0,-3500000,9.527559
183015,American Kickboxer 2,1993-08-04,1993,0,0,0,0.869784
183039,Broken Blossoms,1936-05-20,1936,0,0,0,0.207803
183049,That Certain Feeling,1956-06-04,1956,0,0,0,0.447493
183073,I tromboni di Fra' Diavolo,1962-10-11,1962,0,0,0,0.251895
183088,Megaville,1990-01-22,1990,0,0,0,0.905762
183108,Ecstasy in Entropy,1999-01-01,1999,0,0,0,0.274586
183111,Whoregasm,1988-01-01,1988,0,0,0,0.007531
183113,Police State,1987-01-01,1987,0,0,0,0.002001
183119,Kiss Me Goodbye,1986-01-01,1986,0,0,0,0.000308
183127,The Wild World of Lydia Lunch,1983-01-01,1983,0,0,0,0.320139
183128,The Bogus Man,1980-01-01,1980,0,0,0,0.039802
183171,Dangerous Corner,1934-12-04,1934,0,0,0,0.471426
183176,Lord Montagu,2013-04-04,2013,0,0,0,0.048548
183190,Dr. Gillespie's New Assistant,1942-11-01,1942,0,0,0,0.639048
183218,Safe at Home!,1962-04-13,1962,0,0,0,0.352739
183247,The Inspector,1962-05-24,1962,0,0,0,0.286906
183252,Perfectly normal,1991-02-15,1991,0,0,0,0.083899
183258,All Things To All Men,2013-04-05,2013,6000000,0,-6000000,12.177435
183336,A.C.A.B. All Cats Are Brilliant,2012-03-28,2012,0,0,0,0.347087
183339,Asssscat,2007-03-24,2007,0,0,0,1.064144
183383,tzeni tzeni,1966-02-20,1966,0,0,0,0.292741
183386,Terminal USA,1993-09-17,1993,0,0,0,0.163415
183388,Mia trelli... trelli oikogeneia,1965-10-18,1965,0,0,0,0.058537
183412,Dead Souls,2012-10-11,2012,0,0,0,2.366645
183433,Forgetting the Girl,2012-10-11,2012,200,0,-200,1.13962
183635,A Man on His Knees,1979-04-13,1979,0,0,0,0.00022
183654,Garm Hava,1973-01-05,1973,0,0,0,0.670684
183662,Crush,2013-03-13,2013,0,0,0,6.642311
183672,Whole,2003-06-12,2003,0,0,0,0.041972
183825,Bad Men of Missouri,1941-07-26,1941,0,0,0,1.692907
183827,The Bad Man,1941-03-28,1941,0,0,0,0.136618
183832,Billy the Kid,1930-10-18,1930,0,0,0,0.875418
183836,The Brats,2013-04-17,2013,0,0,0,5.183112
183855,The Asphalt Kiss,1981-01-02,1981,0,0,0,0.432939
183859,Interviews with My Lai Veterans,1971-02-25,1971,0,0,0,0.041681
183871,Mumia Abu-Jamal: A Case for Reasonable Doubt?,1998-03-01,1998,0,0,0,0.00145
183889,A View from the Bridge,1962-01-19,1962,0,0,0,0.633855
183894,Emma,2009-10-11,2009,0,0,0,2.853737
183910,Adjust Your Tracking: The Untold Story of the VHS Collector,2013-04-05,2013,5000,0,-5000,0.621925
183932,Mare Nostrum,1926-02-15,1926,0,0,0,0.281912
183946,Yellow,1998-05-29,1998,0,0,0,0.006175
183955,Midnight Dancers,1994-09-09,1994,0,0,0,0.05956
183962,Safety Catch,1970-04-07,1970,0,0,0,0.411043
183964,Facciamo paradiso,1995-04-07,1995,0,0,0,0.002368
184002,Dirty Hands,1989-10-04,1989,0,0,0,0.226496
184020,It Happened in Saint-Tropez,2013-01-13,2013,0,0,0,8.834976
184061,Deliver Us from Evil,1973-09-11,1973,0,0,0,0.317373
184080,"Doin' It in the Park: Pick-Up Basketball, NYC",2012-06-17,2012,0,0,0,0.325506
184098,Think Like a Man Too,2014-06-20,2014,24000000,70181428,46181428,7.576924
184125,Assault on Wall Street,2013-06-30,2013,0,0,0,7.089715
184129,Return of the Bad Men,1948-07-17,1948,0,0,0,0.834842
184143,Rio Diablo,1993-02-28,1993,0,0,0,0.181859
184149,Somm,2013-06-21,2013,0,0,0,1.223673
184155,Legend No. 17,2013-04-17,2013,7720000,0,-7720000,2.02238
184219,Pee Mak Phrakanong,2013-03-28,2013,0,0,0,2.498497
184260,The Suram Fortress,1922-10-09,1922,0,0,0,0.001251
184267,The Young Rajah,1922-11-11,1922,0,0,0,0.292011
184314,Young & Beautiful,2013-08-20,2013,0,0,0,11.833023
184315,Hercules,2014-07-23,2014,100000000,243400000,143400000,19.606895
184322,Cheech & Chong's Animated Movie,2013-04-18,2013,0,0,0,1.457101
184323,Daylight,2013-04-10,2013,0,0,0,1.575298
184328,Triple Trouble,1950-08-13,1950,0,0,0,0.098143
184341,Hands of Stone,2016-08-26,2016,20000000,0,-20000000,6.482559
184345,A Haunted House 2,2014-04-17,2014,0,0,0,8.172603
184346,Deliver Us from Evil,2014-07-01,2014,30000000,0,-30000000,8.536777
184351,The Diamond Queen,1953-11-28,1953,0,0,0,0.0019
184352,Tom at the Farm,2014-04-16,2014,0,0,0,6.094529
184363,Kino-pravda no. 21 - Lenin Kino-Pravda. A Film Poem about Lenin,1925-01-22,1925,0,0,0,0.11545
184395,"In Youth, Beside the Lonely Sea",1925-04-09,1925,0,0,0,0.036477
184402,Opus IV,1925-04-09,1925,0,0,0,0.433345
184440,Awaken,2013-04-09,2013,0,0,0,0.837087
184507,The Plastic Age,1925-12-14,1925,0,0,0,0.071666
184522,Pie in the Sky,1935-04-09,1935,0,0,0,0.051255
184530,Spin,2003-10-23,2003,0,0,0,0.282639
184561,A Life Among Whales,2005-06-18,2005,0,0,0,0.002358
184578,The Dove,1974-06-16,1974,0,0,0,0.000662
184608,Saint Young Men,2013-05-09,2013,0,0,0,1.230396
184681,Tutto parla di te,2012-04-13,2012,0,0,0,0.016443
184710,Quarantine L.A.,2013-03-09,2013,1200000,0,-1200000,0.70729
184741,Cain and Mabel,1936-09-26,1936,0,0,0,0.214955
184781,Voices,1979-03-14,1979,0,0,0,0.792974
184795,The Sea Gull,1968-12-23,1968,0,0,0,0.529771
184799,Just Tell Me What You Want,1980-01-18,1980,0,0,0,0.548757
184802,Because You're Mine,1952-10-01,1952,0,0,0,0.927457
184819,Poil de Carotte,1925-12-22,1925,0,0,0,0.089113
184824,Sweepings,1933-04-14,1933,0,0,0,0.882129
184835,Teddy Bears' Picnic,2002-03-29,2002,0,28149,28149,0.022347
184846,Dear Mr. Watterson,2013-11-15,2013,0,0,0,1.924653
184862,The Red Kimona,1925-11-15,1925,0,0,0,0.03144
184866,Favor,2013-04-05,2013,0,0,0,0.765634
184868,The Red Detachment of Women,1961-01-30,1961,0,0,0,0.168993
184885,The Bells,1926-07-29,1926,0,0,0,0.061599
184936,Stingaree,1934-05-24,1934,0,0,0,0.622839
184958,The Miracle Rider,1935-04-11,1935,0,0,0,0.573303
184992,A Five Star Life,2013-04-24,2013,0,0,0,2.214654
185008,Yeh Jawaani Hai Deewani,2013-05-31,2013,7700000,46000000,38300000,4.262544
185057,Adventures of a Dentist,1965-01-01,1965,0,0,0,0.142357
185078,Without Pity,1948-08-04,1948,0,0,0,0.448027
185110,Onibi: The Fire Within,1997-04-19,1997,0,0,0,1.035742
185111,The Baldheaded Agent and the Land of Destruction Mission,1969-04-11,1969,0,0,0,0.211637
185147,The Quare Fellow,1962-10-02,1962,0,0,0,0.410124
185153,The Courtesans of Bombay,1983-01-01,1983,0,0,0,0.0525
185154,Autobiography of a Princess,1975-10-05,1975,0,0,0,0.459907
185156,Jane Austen in Manhattan,1980-07-01,1980,0,0,0,0.480404
185158,The Grace Lee Project,2005-03-11,2005,0,5965,5965,0.003305
185180,Mi adorado Juan,1950-02-12,1950,0,0,0,0.001358
185191,The Eye of Vichy,1993-05-20,1993,0,0,0,0.004117
185197,The Merry Widow,1952-09-04,1952,0,0,0,0.662362
185207,The Final Girl,2014-05-31,2014,0,0,0,0.37654
185248,Pig,2011-04-16,2011,0,0,0,0.767653
185263,The Bachelor Party,1957-04-09,1957,0,0,0,0.154986
185267,The Human Race,2013-04-10,2013,567000,0,-567000,2.563968
185273,Bowery Battalion,1951-01-24,1951,0,0,0,0.462816
185289,Blues Busters,1950-10-29,1950,0,0,0,0.012491
185291,Act One,1963-12-26,1963,0,0,0,1.013356
185292,Chesty: A Tribute to a Legend,1976-04-04,1976,0,0,0,0.182035
185326,Broadway Musicals: A Jewish Legacy,2013-01-01,2013,0,0,0,0.026866
185341,[REC]‚Å¥ Apocalypse,2014-09-09,2014,0,190000,190000,7.328242
185354,The War of the Worlds: Next Century,1981-09-29,1981,0,0,0,0.242601
185444,Evocateur: The Morton Downey Jr. Movie,2013-06-07,2013,300000,0,-300000,0.196681
185460,Willow Creek,2013-05-02,2013,0,0,0,8.742454
185465,Manito,2002-01-15,2002,0,0,0,0.131027
185471,Battle of the Damned,2013-07-25,2013,8000000,0,-8000000,4.805757
185476,Videograms of a Revolution,1992-08-13,1992,0,0,0,0.245602
185495,Terror in the Wax Museum,1973-05-02,1973,0,0,0,0.698608
185497,Assassins Run,2013-04-22,2013,4000000,0,-4000000,2.241405
185546,Upstairs and Downstairs,1959-11-02,1959,0,0,0,0.982495
185562,Shark Alarm at M√ºggel Lake,2013-03-12,2013,3774400,0,-3774400,1.559884
185564,A Crush on You,2011-06-11,2011,0,0,0,0.531266
185567,Zulu,2013-12-04,2013,16000000,0,-16000000,6.826661
185574,Louis C.K.: Oh My God,2013-04-13,2013,0,0,0,3.460311
185579,A Sixth Part of the World,1926-12-31,1926,0,0,0,0.554905
185591,The Eagle Has Two Heads,1948-09-21,1948,0,0,0,0.152636
185602,Shenandoah,2012-10-16,2012,0,0,0,0.990786
185640,Commando - A One Man Army,2013-04-11,2013,0,0,0,1.703768
185644,The End,2004-03-11,2004,0,0,0,0.00582
185720,Samoure,2005-11-27,2005,0,0,0,0.074153
185738,Stockholm,2013-04-25,2013,0,0,0,1.572629
185744,Amy Schumer: Mostly Sex Stuff,2012-08-18,2012,0,0,0,1.543344
185752,Albino,1976-03-15,1976,0,0,0,0.637846
185768,Boy Crazy,2009-01-26,2009,0,0,0,0.079254
185789,Mulholland Dr.,1999-01-01,1999,0,0,0,4.215811
185843,The Strangler,1970-09-11,1970,0,0,0,1.108458
185934,A Kiss for Corliss,1949-11-25,1949,0,0,0,0.398518
185949,The Pied Piper,1972-12-27,1972,0,0,0,0.736119
185987,Black Rain,1989-05-13,1989,0,0,0,4.227398
186019,Souvenir Strip of the Edison Kinetoscope,1894-05-18,1894,0,0,0,0.809025
186066,National Mechanics,1972-12-28,1972,0,0,0,0.148701
186079,K2: Siren of the Himalayas,2012-11-02,2012,210,0,-210,0.193997
186121,The Pit,2009-10-22,2009,0,0,0,0.021738
186129,Forgiven,2007-08-15,2007,0,0,0,0.008198
186161,The Gilded Cage,2013-04-19,2013,7000000,0,-7000000,4.617478
186201,The Red Lily,1924-09-08,1924,0,0,0,0.088297
186227,Vanessa: Her Love Story,1935-03-01,1935,0,0,0,0.401299
186254,Sirius,2013-04-23,2013,0,0,0,0.638957
186268,Angels in Disguise,1949-09-25,1949,0,0,0,0.039889
186279,The Battle of Amfar,2013-01-18,2013,0,0,0,0.166932
186292,The Collector,1997-01-01,1997,0,0,0,0.039117
186372,Scenes from the Class Struggle in Portugal,1977-10-11,1977,0,0,0,0.0
186399,A Deeper Shade of Blue,2011-06-15,2011,0,0,0,0.001819
186532,Death Is My Trade,1977-11-18,1977,0,0,0,0.571908
186584,Code Name: Diamond Head,1977-05-03,1977,0,0,0,0.000308
186585,Last of the Wild Horses,1948-12-27,1948,0,0,0,0.737664
186592,Winning Favour,,,0,0,0,0.0
186606,iSteve,2013-04-14,2013,0,0,0,1.589559
186610,Swearnet: The Movie,2014-08-29,2014,0,0,0,1.130942
186629,The Prophet,1968-02-15,1968,0,0,0,0.733914
186630,Il Gaucho,1964-01-01,1964,0,0,0,0.443395
186634,Kung Fu Rascals,1992-01-01,1992,0,0,0,0.293125
186691,Women in the Wind,1939-04-15,1939,0,0,0,0.624762
186705,"Love, etc.",1996-11-27,1996,0,0,0,0.227517
186729,Attila Marcel,2013-11-06,2013,0,0,0,2.044356
186738,The Red Light Bandit,1968-12-02,1968,0,0,0,0.745164
186747,Ek Thi Daayan,2013-04-19,2013,0,0,0,0.960239
186755,Territorio comanche,1997-03-07,1997,0,0,0,0.027563
186759,Get a Job,2016-03-25,2016,8000000,0,-8000000,5.826914
186766,Olympia 52,1952-07-10,1952,0,0,0,0.001187
186775,Hold That Baby!,1949-06-06,1949,0,0,0,0.001691
186809,Crossing The Bridge,1992-09-11,1992,0,0,0,1.230968
186845,Symphony of the Soil,2013-10-11,2013,0,0,0,0.047271
186869,The Vagrant,1992-05-15,1992,9500000,0,-9500000,3.47694
186881,Treasure Hunters,1981-07-09,1981,0,0,0,1.075427
186929,Borgman,2013-05-13,2013,0,0,0,4.38226
186935,Heli,2013-08-09,2013,1000000,0,-1000000,3.145307
186970,Grigris,2013-07-10,2013,0,0,0,0.36982
186971,Age of Uprising: The Legend of Michael Kohlhaas,2013-08-14,2013,0,0,0,7.70426
186975,"Norte, the End of History",2013-09-29,2013,0,0,0,1.70113
186976,The Golden Dream,2013-12-04,2013,0,0,0,2.085179
186982,Passione sinistra,2013-04-18,2013,2500000,0,-2500000,1.028915
186988,Honey,2013-05-01,2013,0,0,0,2.179796
186991,Grand Central,2013-08-28,2013,0,0,0,2.613487
186992,Stranger by the Lake,2013-05-17,2013,0,0,0,6.074431
186997,The Missing Picture,2014-03-19,2014,0,52164,52164,1.568839
187010,Buck Wild,2013-04-01,2013,0,0,0,1.174764
187017,22 Jump Street,2014-06-05,2014,50000000,188441614,138441614,10.901496
187022,A Touch of Sin,2013-10-04,2013,0,154120,154120,6.303552
187028,Omar,2013-05-21,2013,0,0,0,0.190158
187156,Jean-Luc Cinema Godard,2009-09-30,2009,0,0,0,0.004841
187219,Joshua Then and Now,1985-09-05,1985,0,0,0,0.64408
187238,Si pu√≤ fare l'amore vestiti?,2012-12-05,2012,0,0,0,0.150661
187252,In the Name of the Son,2012-09-29,2012,0,0,0,0.675695
187263,"You Lie, You Die",2012-10-13,2012,0,0,0,0.884455
187276,In Memorium,2005-10-01,2005,0,0,0,0.178745
187401,The Phantom Lover,1995-07-22,1995,0,0,0,0.273083
187422,Call to Arms,1973-01-18,1973,0,0,0,0.757754
187442,Asu Mare,2013-04-11,2013,700000,0,-700000,0.966484
187447,Supermen Against the Orient,1973-11-29,1973,0,0,0,0.0
187458,Woodstock Diary,1994-08-14,1994,0,0,0,0.002407
187462,Cody the Robosapien,2013-04-01,2013,0,0,0,8.49107
187482,My Blood Runs Cold,1965-03-24,1965,0,0,0,0.024045
187516,Crazy Over Horses,1951-09-09,1951,0,0,0,0.110691
187537,William S. Burroughs: Commissioner of Sewers,1991-01-01,1991,0,0,0,0.000308
187541,Call Me Crazy: A Five Film,2013-04-20,2013,0,0,0,2.627579
187569,Four Days in July,1985-01-28,1985,0,0,0,0.260534
187579,Kike Like Me,2007-06-01,2007,0,0,0,0.00496
187596,Walk of Shame,2014-05-02,2014,15000000,59209,-14940791,7.844705
187602,Once More,1988-05-27,1988,0,0,0,1e-06
187628,Shed No Tears,2013-07-19,2013,0,0,0,1.183554
187633,The Conquest of Mycenae,1963-04-22,1963,0,0,0,0.697504
187662,Tokyo Family,2013-01-18,2013,0,0,0,1.48277
187672,Mohamed Dubois,2013-05-01,2013,0,0,0,0.102061
187737,Il terrorista,1963-10-25,1963,0,0,0,0.634526
187744,The Seven Cervi Brothers,1968-02-16,1968,0,0,0,0.056468
187771,The Last Desperate Hours,1974-11-28,1974,0,0,0,0.586025
187782,Bedevil,1993-09-11,1993,0,0,0,0.036886
187790,Gunslinger,1956-06-01,1956,0,0,0,3.851089
187851,They Bite,1996-01-01,1996,0,0,0,0.466991
187897,The Deadly Duo,1971-12-22,1971,0,0,0,0.802135
187927,For Those in Peril,2013-05-18,2013,0,0,0,0.525711
187993,Halloween,1931-05-01,1931,0,0,0,0.150626
188001,Traveling Saleslady,1935-03-28,1935,0,0,0,0.390115
188044,Tales from the Organ Trade,2013-09-20,2013,0,0,0,0.709532
188066,Kiki,1926-04-04,1926,0,0,0,0.431795
188102,The Fraternity,2002-07-16,2002,4411044,0,-4411044,0.48991
188161,A Million Ways to Die in the West,2014-05-22,2014,0,0,0,10.38391
188166,Blue Ruin,2014-04-25,2014,0,258384,258384,11.509412
188180,Body Fat Index of Love,2012-12-20,2012,0,0,0,0.46951
188183,Finding Mr. Right,2013-03-20,2013,4881000,81350000,76469000,2.32186
188207,The Legend of Hercules,2014-01-10,2014,70000000,61279452,-8720548,6.599539
188222,Entourage,2015-06-03,2015,30000000,49263404,19263404,14.013413
188357,Richard The Lionheart,2013-02-09,2013,0,0,0,0.483269
188392,Fright to the Finish,1954-08-27,1954,0,0,0,0.268416
188421,A History of Horror with Mark Gatiss,2010-10-25,2010,0,0,0,0.48845
188465,The Life of Vergie Winters,1934-06-14,1934,0,0,0,0.651315
188468,Page Miss Glory,1935-09-07,1935,0,0,0,0.670175
188489,Birdemic 2: The Resurrection,2013-04-09,2013,0,0,0,1.330868
188505,Persona non grata,2005-04-01,2005,0,0,0,0.663971
188507,Space Warriors,2013-04-26,2013,0,0,0,2.442212
188509,Elway To Marino,2013-04-23,2013,0,0,0,0.248837
188521,Spies of Warsaw,2013-01-01,2013,0,0,0,2.224206
188524,Moving Out,1983-03-25,1983,0,0,0,0.242617
188529,Victoria Day,2009-01-17,2009,1,0,-1,0.336063
188538,Remember Sunday,2013-04-21,2013,0,0,0,11.190606
188540,Arrambam,2013-10-31,2013,9200000,21000000,11800000,0.882864
188560,The Secret Lives of Second Wives,2008-06-28,2008,0,0,0,0.600964
188588,Last Summer in the Hamptons,1995-11-22,1995,0,0,0,0.531159
188589,Babyfever,1994-05-04,1994,0,0,0,0.001687
188598,Ilo Ilo,2013-09-04,2013,0,0,0,2.402615
188640,Shootout at Wadala,2013-05-03,2013,0,0,0,0.036201
188684,Punishment Room,1956-06-28,1956,0,0,0,0.434999
188719,Khamosh,1985-01-01,1985,0,0,0,0.522812
188758,Nothing Bad Can Happen,2013-09-28,2013,0,0,0,0.422961
188761,The German Doctor,2013-05-19,2013,0,0,0,2.358343
188765,My Sweet Pepper Land,2014-04-09,2014,0,0,0,1.932314
188826,Copperhead,2013-06-28,2013,0,0,0,1.355365
188832,Trance,2001-01-01,2001,0,0,0,0.41754
188836,The Fearless Young Boxer,1979-01-01,1979,0,0,0,0.009192
188839,Aftermath,2012-08-24,2012,0,0,0,6.258251
188858,Lola,2006-09-28,2006,0,0,0,0.150906
188870,Leather Jacket Love Story,1998-02-20,1998,67000,0,-67000,0.488656
188927,Star Trek Beyond,2016-07-07,2016,185000000,343471816,158471816,20.659284
188981,The Blue Sky Maiden,1957-10-07,1957,0,0,0,0.36478
188984,Tiger Eyes,2012-04-04,2012,0,0,0,1.731435
188996,More Than a Secretary,1936-12-24,1936,0,0,0,0.113666
189005,Pennies from Heaven,1936-11-25,1936,0,0,0,0.588469
189019,La Fleur de l'√¢ge,2013-05-01,2013,0,0,0,0.893268
189054,"Luis Martinetti, Contortionist",1894-01-01,1894,0,0,0,0.160054
189076,Kuningasj√§tk√§,1998-02-09,1998,0,0,0,0.75045
189080,Sierra Leone's Refugee All Stars,2007-08-14,2007,0,0,0,0.153174
189133,"Mayday at 40,000 Feet!",1976-11-12,1976,0,0,0,0.946415
189151,Akko's Secret,2012-08-31,2012,0,0,0,0.993302
189197,The Pacific,2010-03-15,2010,120000000,0,-120000000,6.092242
189204,Lovestruck: The Musical,2013-04-21,2013,0,0,0,5.016949
189215,The Untold History of the United States,2012-11-12,2012,0,0,0,1.37316
189225,"Eldridge Cleaver, Black Panther",1970-08-24,1970,0,0,0,0.009233
189227,Soodhu Kavvum,2013-05-01,2013,310000,12000000,11690000,1.217786
189242,Alcan Highway,2013-04-19,2013,0,0,0,0.120931
189243,Don't Knock The Rock,1956-12-14,1956,0,0,0,0.634649
189277,See You Next Tuesday,2013-10-11,2013,0,0,0,0.175575
189279,The Invisible Menace,1938-01-22,1938,0,0,0,0.177771
189291,Tirano Banderas,1993-11-04,1993,0,0,0,0.473172
189332,The Gal√≠ndez File,2003-09-26,2003,0,0,0,0.9048
189334,The End of a Mystery,2003-01-30,2003,0,0,0,0.588734
189359,Marvin Gaye What's going on Life and Death of Marvin Gaye,2005-03-01,2005,0,0,0,0.004169
189364,Miguel and William,2007-02-02,2007,0,0,0,0.566517
189420,Mechanics of the Brain,1926-11-19,1926,0,0,0,0.150473
189472,La dama boba,2006-03-24,2006,0,0,0,0.054873
189498,Charge,2011-12-10,2011,0,0,0,0.0213
189505,"Stride, Soviet!",1926-07-25,1926,0,0,0,0.361717
189556,Svyato,2005-11-27,2005,10000,0,-10000,0.401541
189584,The Unchanging Sea,1910-05-05,1910,0,0,0,0.101471
189586,In the Border States,1910-06-13,1910,0,0,0,0.151147
189621,Beau Geste,1926-08-24,1926,0,0,0,0.351047
189650,Babies For Sale,1940-06-14,1940,0,0,0,0.044963
189682,Annie Laurie,1927-05-10,1927,0,0,0,0.008201
189696,Mickey Mouse in Vietnam,1968-01-01,1968,0,0,0,0.348257
189723,Hero's Island,1962-09-16,1962,0,0,0,1.643527
189747,Free the Mind,2013-05-03,2013,0,0,0,0.425492
189755,The Happy House,2013-05-05,2013,0,0,0,0.258788
189803,Jo pour Jonathan,2011-03-18,2011,0,0,0,0.353746
189807,Mounted Police Charge,1896-11-02,1896,0,0,0,0.100388
189820,"Fifth Avenue, New York",1897-03-05,1897,0,0,0,0.042297
189875,Angel City,1977-10-18,1977,0,0,0,0.068864
189888,The Baltimore Bullet,1980-03-31,1980,0,0,0,0.706101
189996,Edward and Caroline,1951-04-06,1951,0,0,0,0.406157
190000,In the Shadow of the Machine,1928-11-09,1928,0,0,0,0.129252
190091,Erotikon,1929-02-26,1929,0,0,0,0.430324
190148,Forks Over Knives Presents: The Engine 2 Kitchen Rescue,2011-12-19,2011,0,0,0,0.027978
190152,The Open Road,1926-01-01,1926,0,0,0,0.075775
190160,While the City Sleeps,1928-02-15,1928,0,0,0,0.385791
190163,Old Ironsides,1926-12-06,1926,0,0,0,0.524565
190165,First a Girl,1935-11-07,1935,0,0,0,0.418695
190167,9500 Liberty,2009-11-15,2009,0,0,0,1.590847
190173,Heart Beat,1980-04-25,1980,0,0,0,1.767099
190183,Midnight Shadow,1939-01-01,1939,0,0,0,0.21505
190213,Cry of the Wounded,1980-01-01,1980,0,0,0,0.001586
190250,ABE,2013-04-16,2013,0,0,0,1.586141
190269,New York Nights,1929-12-28,1929,0,0,0,0.657513
190326,Komunaris chibukhi,1929-07-29,1929,0,0,0,0.001177
190341,The Gypsy Charmer,1929-11-03,1929,0,0,0,0.036521
190352,Bouncing Babies,1929-10-11,1929,0,0,0,0.006143
190407,The Great Diamond Robbery,1954-01-29,1954,0,0,0,0.002628
190410,Maledimiele,2012-04-19,2012,0,0,0,1.088715
190469,Redirected,2014-01-10,2014,2700000,0,-2700000,6.174324
190474,The Hellions,1961-11-27,1961,0,0,0,0.661806
190496,Insatiability,2003-11-28,2003,0,0,0,0.22987
190553,Panorama du grand Canal pris d'un bateau,1896-01-01,1896,0,0,0,0.239236
190582,Black Diamond Express,1896-12-01,1896,0,0,0,0.03658
190605,Panorama of Esplanade by Night,1901-11-11,1901,0,0,0,0.066255
190681,The Piano Tuner,2011-01-04,2011,0,0,0,1.060486
190683,Jupiter's Thunderballs,1903-11-07,1903,0,0,0,0.26208
190754,On the Job,2013-05-23,2013,1052753,466088,-586665,2.934298
190795,Two Hundred Thousand Dirty,2014-07-16,2014,0,0,0,0.015309
190817,The Rendez-Vous of D√©j√†-Vu,2013-06-05,2013,0,0,0,1.096974
190824,H√¥tel Normandy,2013-05-06,2013,0,0,0,1.355193
190847,The Last Days on Mars,2013-08-11,2013,0,24084,24084,9.113415
190853,Suzanne,2013-12-17,2013,0,0,0,2.057347
190859,American Sniper,2014-12-11,2014,58800000,542307423,483507423,19.228561
190868,Occupy Love,2013-05-03,2013,0,0,0,0.065439
190870,Tip Top,2013-09-11,2013,0,0,0,4.112052
190876,The Auction,2013-05-17,2013,0,0,0,0.746357
190880,"Me, Myself and Mum",2013-11-20,2013,10735974,0,-10735974,5.225386
190883,The Miser's Heart,1911-11-20,1911,0,0,0,0.07602
190906,The Dark Tower,1943-10-18,1943,0,0,0,0.192959
190913,Screen Test,1985-08-09,1985,0,0,0,0.59
190940,Bombay Talkies,2013-05-03,2013,0,0,0,1.146057
190945,Mumbai Police,2013-05-02,2013,0,0,0,0.69783
190946,Curb Dance,2011-05-06,2011,0,0,0,0.266119
190950,Having You,2013-01-01,2013,0,0,0,0.935104
190955,Blood Ties,2013-08-22,2013,25500000,2415472,-23084528,14.934555
190967,3 Geezers!,2013-05-22,2013,0,0,0,1.538409
191024,The Arrested Development Documentary Project,2013-05-02,2013,75000,0,-75000,1.135016
191037,Mr Hockey The Gordie Howe Story,2013-04-28,2013,0,0,0,0.622598
191060,The Eye Above the Well,1988-01-01,1988,0,0,0,0.122015
191068,The Painted Lady,1912-11-24,1912,0,0,0,0.172089
191094,The Employer,2013-06-07,2013,0,0,0,1.903961
191096,The Green Van,1983-12-28,1983,0,0,0,0.069832
191104,Wolf,2013-09-11,2013,0,0,0,2.733359
191112,Premachi Goshta,2013-02-01,2013,0,0,0,0.062322
191120,"Kevin Nealon: Whelmed, But Not Overly",2012-08-04,2012,0,0,0,0.578612
191121,Raanjhanaa,2013-06-21,2013,6400000,18000000,11600000,1.856101
191185,My Sweet Orange Tree,2013-04-19,2013,0,0,0,1.000202
191186,The Living Idol,1957-05-02,1957,0,0,0,0.224308
191231,Sol,2012-04-18,2012,250000,0,-250000,0.061257
191293,Sorrow and Joy,2013-09-25,2013,0,0,0,2.185467
191294,We Are the Best!,2013-03-28,2013,0,180590,180590,3.727996
191312,For Elise,2013-09-20,2013,0,0,0,1.322456
191322,Dark Horse,1992-07-17,1992,0,0,0,0.955169
191385,Prisoner/Terrorist,2007-02-02,2007,0,0,0,0.004948
191402,Bigfoot Lives,2007-08-02,2007,35,0,-35,0.003539
191421,So Young,2013-04-25,2013,0,116000000,116000000,2.871986
191427,The House of Darkness,1913-05-10,1913,0,0,0,0.107083
191428,Lily Boy,1954-05-31,1954,0,0,0,0.208569
191465,The Manchu Eagle Murder Caper Mystery,1975-03-07,1975,0,0,0,0.465287
191476,42 One Dream Rush,2010-09-15,2010,1000000,0,-1000000,1.672234
191486,–ü–æ–µ–∑–¥ –≤–Ω–µ —Ä–∞—Å–ø–∏—Å–∞–Ω–∏—è,1986-05-12,1986,0,0,0,1e-06
191487,Getting Gertie's Garter,1945-11-27,1945,0,0,0,0.121015
191489,Bill Burr: You People Are All The Same,2012-08-16,2012,0,0,0,1.658407
191502,The Unbelievers,2013-12-13,2013,0,0,0,10.068759
191515,Everybody Street,2013-04-28,2013,0,0,0,0.081201
191536,In the Shadow of Death,1971-12-30,1971,0,0,0,0.038459
191550,Gaby: A True Story,1987-10-30,1987,5000000,125400,-4874600,0.889745
191562,Go Goa Gone,2013-05-10,2013,0,0,0,1.675292
191566,Crazy Kind of Love,2013-05-31,2013,0,0,0,7.471364
191595,The Impossible Convicts,1906-01-27,1906,0,0,0,0.145006
191599,Emmanuel's Gift,2005-10-21,2005,0,23578,23578,0.262384
191600,"John Huston: The Man, the Movies, the Maverick",1989-01-01,1989,0,0,0,0.662545
191608,Garpastum,2005-10-27,2005,0,0,0,0.64765
191619,Beneath,2013-07-19,2013,0,0,0,7.244622
191703,Pioneers in Ingolstadt,1971-05-19,1971,0,0,0,0.058285
191714,The Lunchbox,2013-09-19,2013,1000000,4235151,3235151,10.766409
191717,The Major,2013-08-07,2013,0,0,0,1.738268
191718,You and the Night,2013-05-13,2013,0,0,0,1.089444
191720,Jodorowsky's Dune,2013-08-30,2013,0,0,0,6.18442
191726,Ugly,2013-05-17,2013,0,0,0,1.890619
191731,Manuscripts Don't Burn,2013-05-24,2013,0,0,0,1.149166
191820,The Devil's Violinist,2013-01-30,2013,0,11294,11294,4.352904
191824,Rushlights,2013-06-21,2013,0,0,0,6.620285
191829,The Good Lie,2013-05-10,2013,0,0,0,0.115856
191850,Room 8,2013-04-26,2013,0,0,0,1.843184
191874,Stranger in the House,1997-01-01,1997,0,0,0,0.127077
191975,The Adventures of Mickey Matson and the Copperhead Conspiracy,2012-05-09,2012,0,0,0,0.59701
192023,The Invoking,2013-03-16,2013,0,0,0,2.756999
192028,Remote Area Medical,2013-04-06,2013,0,0,0,0.035766
192040,Planet Earth,2006-12-10,2006,0,0,0,4.501137
192097,Ghanchakkar,2013-06-28,2013,0,0,0,1.102538
192102,3 Days to Kill,2014-02-14,2014,28000000,52597999,24597999,17.861119
192126,Revenge for Jolly!,2012-07-17,2012,10000000,0,-10000000,6.206395
192132,Palo Alto,2014-05-09,2014,0,0,0,7.261527
192133,Jimi: All Is by My Side,2013-09-07,2013,0,340911,340911,4.250364
192134,Dom Hemingway,2013-11-15,2013,0,523511,523511,5.713974
192136,Mandela: Long Walk to Freedom,2013-12-06,2013,35000000,27330000,-7670000,11.318079
192137,Not Waving But Drowning,2012-06-06,2012,0,0,0,0.642468
192141,No Escape,2015-08-26,2015,5000000,54418872,49418872,14.13262
192142,The Better Angels,2014-01-18,2014,0,70918,70918,9.266214
192143,The Last Mogul,2005-06-24,2005,0,0,0,0.563171
192145,Third Person,2013-09-09,2013,28000000,1749201,-26250799,8.808328
192149,The Two Faces of January,2014-05-16,2014,0,4507463,4507463,10.652311
192160,This Is Our Time,2013-03-01,2013,0,0,0,0.306484
192178,Coming to Terms,2013-11-24,2013,0,0,0,0.048289
192184,A Walk Into the Sea: Danny Williams and the Warhol Factory,2007-09-19,2007,0,0,0,0.316999
192210,Open Road,2013-04-12,2013,3000000,0,-3000000,3.197646
192236,Tales from the Vienna Woods,1979-05-08,1979,0,0,0,0.69966
192301,The Mender of Nets,1912-02-14,1912,0,0,0,0.205335
192345,Cavemen,2013-10-26,2013,0,0,0,2.844979
192367,The Halloween That Almost Wasn't,1979-10-28,1979,0,0,0,0.903872
192371,Clipped Wings,1953-08-14,1953,0,0,0,0.003353
192393,Dreamworld,2012-03-09,2012,0,0,0,1.710635
192431,Carmen & Geoffrey,2005-02-04,2005,0,0,0,0.003427
192452,Hot Times at Montclair High,1989-01-01,1989,0,0,0,0.069488
192480,Schoffies,2006-12-06,2006,0,0,0,0.004942
192538,Hammer of the Gods,2013-07-05,2013,0,641,641,5.093586
192544,Naked Gun,1956-11-01,1956,0,0,0,0.714471
192558,Aashiqui 2,2013-04-25,2013,1300000,16000000,14700000,2.831069
192573,Zapatlela,1993-01-01,1993,0,0,0,0.000844
192577,Space Pirate Captain Harlock,2013-09-07,2013,30000000,17137302,-12862698,7.857666
192588,Ferryman Maria,1936-01-07,1936,0,0,0,0.03852
192623,White Frog,2012-03-07,2012,0,0,0,2.092801
192644,Ultrasonic,2012-06-01,2012,0,0,0,1.319479
192675,Eklavya: The Royal Guard,2007-01-01,2007,0,0,0,0.319771
192695,All Watched Over by Machines of Loving Grace,2011-06-06,2011,0,0,0,0.636167
192712,Kite,2014-06-13,2014,0,0,0,8.405694
192767,Noble,2014-09-19,2014,0,0,0,5.318667
192813,Age of Dinosaurs,2013-05-11,2013,0,0,0,11.785502
192868,The Sporting Club,1971-02-28,1971,0,0,0,0.616213
192911,Monster High: Scaris City of Frights,2013-03-03,2013,0,0,0,4.811864
192936,Frank Herbert's Children of Dune,2003-03-25,2003,20000000,0,-20000000,3.636791
192990,Sky West and Crooked,1965-08-31,1965,0,0,0,0.632929
193040,Slasher House,2012-04-29,2012,1550000,0,-1550000,0.258937
193065,Ballerina,1937-05-21,1937,0,0,0,0.001177
193103,Somewhere in the City,1998-06-11,1998,0,0,0,0.00765
193154,Ku! Kin-dza-dza,2013-04-10,2013,4520000,0,-4520000,1.55164
193177,The Lost Man,1969-07-11,1969,0,0,0,0.430623
193212,The Man Who Captured Eichmann,1996-11-08,1996,0,0,0,1.171478
193216,Travels of an Ant,1983-01-01,1983,0,0,0,0.013026
193223,Die Fighting,2014-11-03,2014,0,0,0,0.623054
193229,Black Field,2009-11-05,2009,0,0,0,1.090156
193284,Springtime in the Sierras,1947-07-15,1947,0,0,0,0.107436
193288,Extraterrestrial,2007-06-03,2007,0,0,0,0.332368
193309,Mississippi Damned,2009-01-16,2009,0,0,0,0.728953
193315,Too Much Johnson,1938-05-11,1938,0,0,0,0.969562
193321,The Deep Blue Sea,1955-11-01,1955,0,0,0,0.983896
193346,Big Star: Nothing Can Hurt Me,2013-07-03,2013,0,0,0,0.742895
193348,Jump,1965-06-10,1965,0,0,0,0.364454
193380,Les Mis√©rables,2000-09-03,2000,0,0,0,3.445547
193387,Me and the Kid,1993-10-22,1993,0,0,0,0.025143
193411,The Kiss,1900-03-09,1900,0,0,0,0.244609
193418,Regret,2013-06-18,2013,0,0,0,2.226212
193435,High Society,1955-04-17,1955,0,0,0,0.065699
193439,Smugglers' Cove,1948-10-10,1948,0,0,0,0.951418
193450,Second Fiddle to a Steel Guitar,1966-12-29,1966,0,0,0,0.037052
193459,Lucky Losers,1950-05-14,1950,0,0,0,0.002589
193460,Fighting Fools,1949-03-17,1949,0,0,0,0.002013
193502,Library Wars,2013-04-26,2013,0,0,0,0.433843
193523,Hotel,2013-09-06,2013,0,0,0,1.615384
193524,The Stone Roses: Made of Stone,2013-05-28,2013,0,729043,729043,1.058404
193544,Thou Gild'st the Even,2013-03-29,2013,0,0,0,0.512986
193547,Kind Lady,1951-06-20,1951,0,0,0,0.530468
193595,The Parallel Street,1962-06-01,1962,0,0,0,0.236121
193603,Hayride,2012-10-13,2012,60000,0,-60000,0.224043
193610,The Other Woman,2014-04-16,2014,40000000,196781193,156781193,9.389354
193612,The Quiet Ones,2014-04-01,2014,200000,17834867,17634867,6.322844
193613,Metallica: Through the Never,2013-09-25,2013,18000000,7972967,-10027033,5.229975
193638,A Soldier's Plaything,1930-11-01,1930,0,0,0,0.448339
193641,Adultery Italian Style,1966-05-04,1966,0,0,0,0.437836
193645,Seduced and Abandoned,2013-05-20,2013,0,0,0,2.12382
193650,Heathcliff: The Movie,1986-01-17,1986,0,0,0,0.000308
193652,An Optical Poem,1937-01-01,1937,0,0,0,1.066482
193661,The Talent Given Us,2004-06-11,2004,0,0,0,0.111352
193687,Z for Zachariah,2015-08-13,2015,0,121461,121461,5.30588
193704,Assisted Living,2005-02-02,2005,500,41,-459,0.261278
193717,The Gifted Hands,2013-03-06,2013,0,0,0,1.846382
193722,R100,2013-10-05,2013,5500000,0,-5500000,3.401742
193726,ABCs of Death 2,2014-10-02,2014,0,7171,7171,8.254856
193732,Il successo,1963-05-30,1963,0,0,0,0.712687
193756,Lone Survivor,2013-12-24,2013,40000000,149295601,109295601,10.855502
193784,The Dove Must Not Fly,1970-03-11,1970,0,0,0,3.9e-05
193793,Gold Rush Scenes in the Klondike,1899-01-01,1899,0,0,0,0.036471
193827,A Beast at Bay,1912-05-26,1912,0,0,0,0.162008
193873,The Seventh Sin,1957-06-28,1957,0,0,0,1.461728
193878,A Millionaire for Christy,1951-09-02,1951,0,0,0,0.151177
193893,Let's Be Cops,2014-08-13,2014,17000000,136621271,119621271,15.962793
193899,The Burglar‚Äôs Dilemma,1912-12-16,1912,0,0,0,0.048265
193959,Her Crowning Glory,1911-09-11,1911,0,0,0,0.434534
193976,The Adventures of Mary-Kate & Ashley: The Case of the Christmas Caper,1995-01-01,1995,0,0,0,0.055026
193977,Birth of a Flower,1910-11-16,1910,0,0,0,0.142357
194039,The Dentures,1909-11-16,1909,0,0,0,0.214915
194040,An Awful Symphony,1909-01-01,1909,0,0,0,0.115589
194079,Sallie Gardner at a Gallop,1878-06-14,1878,0,0,0,0.327841
194089,The Pickaninny Dance from the ‚ÄúPassing Show‚Äù,1894-05-16,1894,0,0,0,0.230014
194097,The Perfect Killer,1977-11-30,1977,0,0,0,0.003748
194099,Out Late,2011-10-25,2011,0,0,0,0.011845
194101,The Selfish Giant,2013-05-16,2013,0,0,0,5.921419
194104,Stop the Pounding Heart,2013-12-05,2013,0,0,0,0.561514
194113,Blackadder Back & Forth,1999-12-06,1999,4250000,0,-4250000,2.613528
194121,Dark Circles,2013-01-01,2013,0,0,0,6.708802
194126,Black Sun: The Mythological Background of National Socialism,1998-01-01,1998,0,0,0,0.660482
194144,"Pete Holmes: Nice Try, the Devil!",2013-05-12,2013,0,0,0,0.122692
194188,Punk's Dead: SLC Punk 2,2016-02-11,2016,0,0,0,0.700489
194310,Iron Man,1931-04-29,1931,0,0,0,0.418286
194393,The Disembodied,1957-08-25,1957,0,0,0,0.289541
194407,Red Salute,1935-09-12,1935,0,0,0,0.98586
194481,Once Before I Die,1966-12-01,1966,0,0,0,0.176989
194485,The Priest's Wife,1970-12-22,1970,0,0,0,0.944337
194498,The White Darkness,2002-09-07,2002,0,0,0,0.143995
194509,The Crystal Ball,1943-01-22,1943,0,0,0,0.981921
194516,A Stranger in Town,1943-04-01,1943,0,0,0,1.345679
194523,Blind Detective,2013-07-04,2013,0,0,0,2.536129
194537,A Story of Children and Film,2013-05-17,2013,0,0,0,0.717036
194548,Honey and the Pig,2005-01-07,2005,0,0,0,0.078545
194662,Birdman,2014-08-27,2014,18000000,103215094,85215094,18.193263
194668,New York: A Documentary Film,1999-11-14,1999,0,0,0,0.316897
194720,The Student Body,1976-05-18,1976,0,0,0,0.33955
194722,At Middleton,2013-05-17,2013,2500000,0,-2500000,6.195085
194736,Monday Night Mayhem,2002-01-14,2002,0,0,0,1.211919
194757,The Sidelong Glances of a Pigeon Kicker,1970-12-01,1970,0,0,0,0.871174
194817,Take a Girl Like You,1970-12-16,1970,0,0,0,0.341527
194853,The Guns,1964-06-25,1964,0,0,0,0.377094
194872,Running Man,2013-04-03,2013,0,0,0,0.478118
194880,School for Love,1955-04-25,1955,0,0,0,0.310225
194883,Indebted,2013-05-23,2013,0,0,0,0.012869
194931,Guest of Cindy Sherman,2008-04-08,2008,0,0,0,0.11243
195020,Gardenia,1979-05-05,1979,0,0,0,0.105834
195022,Kill Me Now,2012-12-05,2012,90,0,-90,0.056639
195029,"Coffee, Kill Boss",2013-08-30,2013,0,0,0,0.095628
195030,Palmipedarium,2012-09-14,2012,0,0,0,0.984033
195056,Beauty #2,1965-07-01,1965,0,0,0,0.372737
195065,Adventures of Mowgli: The Kidnapping,1968-01-01,1968,0,0,0,0.696279
195068,Hearts Divided,1936-06-20,1936,0,0,0,1.224306
195186,Old Man Drinking a Glass of Beer,1898-05-20,1898,0,0,0,0.150483
195204,"Skin, Skin",1966-10-20,1966,110125,0,-110125,0.223436
195269,12 Rounds 2: Reloaded,2013-06-01,2013,4000000,0,-4000000,6.35611
195276,Montage,2013-05-16,2013,0,0,0,2.535703
195311,The Human Pyramid,1899-05-20,1899,0,0,0,0.142316
195382,In the Name of the Law,1949-03-13,1949,0,0,0,1.249206
195385,The Magnificent Dare Devil,1973-11-20,1973,0,0,0,0.121877
195405,The Cheaters,1945-07-14,1945,0,0,0,1.105352
195413,L'Impiegato,1960-01-20,1960,0,0,0,0.009692
195423,Brazilian Western,2013-05-31,2013,0,0,0,2.53363
195450,Men and Women,1964-06-19,1964,0,0,0,0.382634
195468,Visiting One's Son,1967-12-10,1967,0,0,0,0.081712
195503,Love by Request,1982-11-01,1982,0,0,0,0.39257
195516,Baboona,1935-01-19,1935,0,0,0,0.001247
195522,Redes,1936-07-15,1936,0,0,0,1.381365
195535,Palace of Electricity,1900-01-01,1900,0,0,0,0.071779
195542,"Bird's-Eye View of Dock Front, Galveston",1900-09-21,1900,0,0,0,0.001247
195544,Crazy Me,2013-01-24,2013,0,0,0,2.51699
195557,Panorama of Eiffel Tower,1900-01-01,1900,0,0,0,0.071812
195561,Champs de Mars,1900-08-21,1900,0,0,0,0.204704
195562,Eiffel Tower from Trocadero Palace,1900-08-21,1900,0,0,0,0.036477
195589,Neighbors,2014-05-08,2014,18000000,268157400,250157400,11.90575
195590,Collide,2016-08-04,2016,21500000,4811525,-16688475,31.314013
195592,Gymnasium Exercises and Drill at Newport Training School,1900-05-21,1900,0,0,0,0.001656
195612,Why Jones Discharged His Clerks,1900-01-21,1900,0,0,0,0.001187
195617,It's a Bird,1930-01-01,1930,0,0,0,0.110204
195645,"Bombardment of Taku Forts, by the Allied Fleets",1900-08-21,1900,0,0,0,0.001662
195651,The Misadventures of Margaret,1998-12-23,1998,5,0,-5,0.196886
195653,Scene from the Elevator Ascending Eiffel Tower,1900-08-21,1900,0,0,0,0.071815
195713,"Captain Nissen Going Through Whirlpool Rapids, Niagara Falls",1901-10-21,1901,0,0,0,0.071756
195732,The Ghost Train,1901-01-21,1901,0,0,0,0.036488
195752,Tarzan in Manhattan,1989-04-15,1989,0,0,0,0.33017
195757,The Ultimate Life,2013-09-06,2013,0,0,0,1.779834
195763,Homerun,2003-08-06,2003,0,0,0,0.228197
195768,City Under Siege,1974-10-23,1974,0,0,0,0.411404
195796,Home Sweet Home,2013-05-13,2013,0,0,0,2.295958
195804,Feelings of Mountains and Waters,1988-12-31,1988,0,0,0,0.070716
195812,Normal Young Man,1969-11-28,1969,0,0,0,0.027804
195833,Caribe,2004-01-01,2004,0,0,0,0.995098
195834,Defenders of Riga,2007-01-01,2007,3550000,0,-3550000,0.445731
195841,Soleil O,1967-01-01,1967,0,0,0,0.106081
195862,O Amor Natural,1996-12-05,1996,0,0,0,0.081726
195867,Visitors of the Night,1995-11-26,1995,0,0,0,0.769962
195912,Success Is the Best Revenge,1984-05-26,1984,0,0,0,0.171944
195954,The Drawing Lesson,1903-01-01,1903,0,0,0,0.214788
196024,The Keeper of Lost Causes,2013-10-03,2013,0,0,0,7.721255
196027,Echoes from the Dead,2013-09-27,2013,0,0,0,1.16425
196032,Easy Money III,2013-08-29,2013,0,0,0,3.294321
196044,"Panorama View, Street Car Motor Room",1904-05-22,1904,0,0,0,0.100843
196065,Racquet,1979-12-30,1979,0,0,0,0.320804
196235,Steam,2007-11-15,2007,2200000,0,-2200000,0.351064
196253,Weekend of a Champion,1972-05-31,1972,0,0,0,0.24974
196254,Barbie: Mariposa and The Fairy Princess,2013-08-26,2013,0,0,0,4.320534
196255,Gregory Go Boom,2013-05-22,2013,0,0,0,0.995302
196257,Freaky Friday,1995-05-06,1995,0,0,0,0.934539
196280,Lakeboat,2000-04-13,2000,0,0,0,0.510724
196319,Escalation,1968-01-01,1968,0,0,0,0.007022
196324,The Good Life,2008-08-14,2008,0,0,0,1.084768
196325,American Dreams in China,2013-05-18,2013,0,88000000,88000000,3.282214
196328,Rockabilly Vampire,1996-10-31,1996,0,0,0,0.329985
196355,Muhammad Ali's Greatest Fight,2013-10-04,2013,0,0,0,1.656774
196359,Max Rose,2016-09-02,2016,0,0,0,0.965858
196398,2 Autumns 3 Winters,2013-10-11,2013,0,0,0,0.68062
196421,Diary Of A Telephone Operator,1969-11-06,1969,0,0,0,0.339829
196446,Last Summer,2013-05-16,2013,0,0,0,1.547286
196469,Animals with the Tollkeeper,1998-01-06,1998,0,0,0,1.225377
196491,Les tulipes,1907-05-23,1907,0,0,0,0.073093
196508,Easter Eggs,1907-07-24,1907,0,0,0,0.220818
196633,Botsman i Popugay,1982-06-06,1982,0,0,0,0.107338
196649,"In the blue sea, in the white foam.",1984-06-06,1984,0,0,0,1.163353
196738,Inside: 'Dr. Strangelove or: How I Learned to Stop Worrying and Love the Bomb',2000-05-04,2000,0,0,0,0.091934
196750,Ghost in the Shell Arise - Border 1: Ghost Pain,2013-06-22,2013,0,0,0,3.552425
196761,Hal,2013-06-08,2013,0,0,0,2.097211
196784,Something Big,1971-11-19,1971,0,0,0,0.277669
196789,Enchanted April,1935-02-01,1935,0,0,0,0.360422
196802,Romance in Manhattan,1935-01-11,1935,0,0,0,0.118509
196830,Stranded,2013-05-22,2013,0,0,0,4.78912
196847,La Legge Violenta Della Squadra Anticrimine,1976-12-30,1976,0,0,0,1.121595
196852,Asambhav,2004-07-22,2004,0,0,0,0.657994
196859,Jackpot,2001-07-26,2001,400000,43719,-356281,0.218588
196862,Never a Dull Moment,1950-08-19,1950,0,0,0,0.573075
196867,Annie,2014-12-19,2014,65000000,133821816,68821816,13.275529
196907,L'ange de goudron,2001-08-23,2001,0,0,0,0.043688
196918,The Sex of the Stars,1993-05-26,1993,0,0,0,0.058611
196940,Quartier Mozart,1992-05-26,1992,0,0,0,0.011938
197033,Geography Club,2013-05-22,2013,0,0,0,2.941353
197053,Lana: Queen of the Amazons,1964-11-10,1964,0,0,0,0.542416
197057,–ê –ø–æ—É—Ç—Ä—É –æ–Ω–∏ –ø—Ä–æ—Å–Ω—É–ª–∏—Å—å,2003-12-04,2003,0,234748,234748,0.402368
197082,Venus in Fur,2013-05-28,2013,0,342183,342183,6.012005
197089,A Castle in Italy,2013-10-30,2013,0,0,0,1.254597
197175,Rio das Mortes,1971-02-15,1971,0,0,0,0.871091
197177,The Left Hand of the Law,1975-09-03,1975,0,0,0,0.201565
197210,Polygon,1977-05-25,1977,0,0,0,0.742592
197239,The Gambler,1997-10-30,1997,0,0,0,1.650488
197276,The Ghost Army,2013-05-26,2013,300,0,-300,0.651101
197297,Law of the Border,1966-10-04,1966,0,0,0,0.199247
197335,Se tutto va bene siamo rovinati,1983-12-29,1983,0,0,0,9.4e-05
197366,War-Time Romance,1983-11-07,1983,0,0,0,0.732219
197446,Hattrick,2007-03-16,2007,0,0,0,0.041647
197467,Captain America,1979-01-19,1979,0,0,0,1.680242
197481,Captain America II: Death Too Soon,1979-11-23,1979,0,0,0,7.936894
197489,The Four Feathers,1978-01-01,1978,0,0,0,1.267188
197491,The Big Broadcast of 1936,1935-09-20,1935,0,0,0,0.175738
197528,s/y Gl√§djen,1989-05-30,1989,0,0,0,0.529432
197537,The Machine,1994-05-28,1994,0,0,0,0.935473
197552,Between the Devil and the Deep Blue Sea,1995-05-28,1995,0,0,0,0.178325
197562,An Enemy of the People,1990-01-19,1990,0,0,0,0.366271
197563,Love Forbidden,2002-05-28,2002,0,0,0,0.128164
197583,50 to 1,2014-03-21,2014,10000000,1064454,-8935546,2.691651
197592,Rage of Angels,1983-02-19,1983,0,0,0,0.978305
197599,Fateful Findings,2013-05-25,2013,0,0,0,0.65892
197602,Death Is a Woman,1966-02-01,1966,0,0,0,0.33135
197611,Dragonfly,1976-03-01,1976,0,0,0,0.646465
197624,AE: Apocalypse Earth,2013-05-28,2013,1000000,0,-1000000,2.838956
197626,Casualties,1997-04-15,1997,0,0,0,0.843872
197647,Encore,1951-06-11,1951,0,0,0,0.968603
197696,Welcome to New York,2014-05-17,2014,0,0,0,3.223466
197723,Lotte Reiniger: Homage to the Inventor of the Silhouette Film,2001-11-19,2001,0,0,0,0.002353
197725,John Henry,2000-05-27,2000,0,0,0,1.563748
197726,Lon Chaney: A Thousand Faces,2000-10-23,2000,0,0,0,0.646182
197733,Louise Brooks: Looking for Lulu,1998-05-27,1998,0,0,0,0.001202
197737,Let Freedom Ring,1939-02-24,1939,0,0,0,0.809578
197752,Lulu in Berlin,1984-05-27,1984,0,0,0,3.1e-05
197754,Winnie the Pooh Discovers the Seasons,1981-09-05,1981,0,0,0,0.074056
197772,Back in Crime,2013-06-05,2013,0,0,0,1.96973
197785,Saturday's Hero,1951-03-01,1951,0,0,0,0.472945
197788,Behave Yourself!,1951-03-15,1951,0,0,0,1.365193
197790,Ninja USA,1985-01-01,1985,0,0,0,0.531679
197796,Beauty and the Beast,2014-02-12,2014,33000000,49100000,16100000,19.628834
197849,Winter Wind,1969-12-04,1969,0,0,0,0.570793
197854,The Guyver: Bio-Booster Armor,1989-09-25,1989,0,0,0,0.025827
197864,Hail! Mafia,1965-08-10,1965,0,0,0,0.648327
197919,A Haunting at Silver Falls,2013-05-28,2013,0,0,0,1.539406
197926,Sincerely Yours,1955-11-05,1955,0,0,0,0.900521
197936,Bright Days Ahead,2013-06-19,2013,0,0,0,3.560089
197950,The Connection,2014-12-03,2014,26000000,0,-26000000,6.231766
198001,Bernice Bobs Her Hair,1976-10-06,1976,0,0,0,0.66584
198044,First Love,1970-10-07,1970,0,0,0,0.193574
198057,3 Days of Normal,2012-06-02,2012,0,0,0,1.044552
198062,Coffee Town,2013-07-09,2013,0,0,0,3.024814
198130,Pop Redemption,2013-06-05,2013,0,0,0,0.887637
198143,Society Lawyer,1939-03-21,1939,0,0,0,0.134254
198146,Upperworld,1934-04-28,1934,0,0,0,1.236137
198171,Mahoney's Last Stand,1972-01-01,1972,0,0,0,0.263934
198176,Broadway Babies,1929-06-29,1929,0,0,0,0.026726
198182,The Occupants,2014-01-13,2014,0,0,0,0.520853
198184,Chappie,2015-03-04,2015,49000000,104399548,55399548,30.206365
198185,Million Dollar Arm,2014-05-09,2014,25000000,38307627,13307627,9.453942
198200,Jodi Arias: Dirty Little Secret,2013-06-22,2013,0,0,0,1.110241
198204,So This Is College,1929-11-08,1929,0,0,0,0.345752
198210,Evidence,2013-07-19,2013,0,0,0,8.306389
198214,Ring of Fire,2013-05-27,2013,0,0,0,0.424697
198225,The Ghost Story of Oiwa's Spirit,1961-01-01,1961,0,0,0,0.13967
198227,Young Man of Manhattan,1930-05-17,1930,0,0,0,0.090705
198240,To Kill a Stranger,1987-11-18,1987,0,0,0,0.66989
198277,Begin Again,2013-09-07,2013,8000000,63464861,55464861,10.289628
198287,After the Dark,2013-07-06,2013,0,0,0,7.113372
198306,Ricky Gervais Live: Animals,2003-11-17,2003,0,0,0,0.868537
198307,Ricky Gervais Live 2: Politics,2004-11-15,2004,0,0,0,1.602457
198308,Ricky Gervais Live 3: Fame,2007-11-12,2007,0,0,0,1.411983
198311,Mademoiselle de Maupin,1966-05-30,1966,0,0,0,0.211781
198312,A Man Could Get Killed,1966-03-25,1966,0,0,0,0.175323
198317,Jacques Brel Is Alive and Well and Living in Paris,1975-01-27,1975,850000,0,-850000,2.1e-05
198326,Trinit√† & Bambino... e adesso tocca a noi,1995-07-29,1995,0,0,0,0.001665
198342,Family Band: The Cowsills Story,2011-08-10,2011,0,0,0,0.063214
198365,Apartment 4E,2012-12-01,2012,0,0,0,0.125385
198375,The Garden of Words,2013-05-31,2013,0,0,0,11.16068
198391,Ricky Gervais Live 4: Science,2010-11-21,2010,0,0,0,1.154887
198436,Antboy,2013-09-07,2013,0,0,0,6.383492
198450,The Cannibals,1988-06-02,1988,0,0,0,0.000308
198453,Pierre et Djemila,1987-06-02,1987,0,0,0,0.00273
198460,Boris Godunov,1986-10-14,1986,0,0,0,0.008673
198466,I Love You,1986-05-14,1986,0,0,0,1.469119
198469,Otello,1986-12-17,1986,0,0,0,0.001586
198474,The Two Lives of Mattia Pascal,1985-06-03,1985,0,0,0,0.620642
198491,The Return of the Soldier,1982-06-04,1982,0,0,0,0.645115
198511,The Left-Handed Woman,1978-05-25,1978,0,0,0,0.668134
198518,Letters from Marusia,1976-06-06,1976,0,0,0,0.24592
198521,Sweet Revenge,1976-06-06,1976,0,0,0,0.531228
198531,Somewhere Beyond Love,1974-06-06,1974,0,0,0,0.00022
198558,Colossus and the Headhunters,1963-01-10,1963,0,0,0,0.072197
198567,The Holy Man,1965-05-06,1965,0,0,0,0.74982
198600,Three Sailors and a Girl,1953-11-23,1953,0,0,0,0.174472
198646,"King, Queen, Knave",1972-06-06,1972,0,0,0,0.209888
198652,Loot,1970-05-01,1970,0,0,0,1.015563
198657,Tulips of Haarlem,1970-06-07,1970,0,0,0,0.129339
198661,Metello,1970-06-02,1970,0,0,0,1.086928
198663,The Maze Runner,2014-09-10,2014,34000000,348319861,314319861,76.93789
198667,Man on Horseback,1969-06-07,1969,0,0,0,0.157364
198677,SAGA: Curse of the Shadow,2013-06-17,2013,0,0,0,1.898751
198772,The Protagonists,1968-06-07,1968,0,0,0,0.622532
198782,Matthew's Days,1968-06-08,1968,0,0,0,0.150049
198783,Hagbard and Signe,1967-01-16,1967,0,0,0,0.552539
198795,Pedro P√°ramo,1967-06-08,1967,0,0,0,0.710962
198820,The Uninhibited,1965-06-08,1965,0,0,0,0.311648
198890,Madalena,1960-08-31,1960,0,0,0,0.147539
198951,Doctor Aybolit,1984-06-06,1984,0,0,0,0.731334
198993,Area 88,1985-02-05,1985,0,0,0,0.620677
199056,The Big Ask,2014-05-30,2014,0,0,0,0.712233
199072,Woman Obsessed,1959-05-27,1959,0,0,0,0.91305
199151,The Very Thought of You,1944-10-20,1944,0,0,0,0.724518
199155,Face of Fire,1959-08-09,1959,0,0,0,0.287522
199160,Happy Days,2007-09-28,2007,440141,2640850,2200709,0.815203
199177,Stars,1959-03-23,1959,0,0,0,0.190442
199184,Giovani mariti,1958-03-29,1958,0,0,0,0.118475
199196,The Harvest Month,1956-06-25,1956,0,0,0,0.079009
199198,Guendalina,1957-08-03,1957,0,0,0,0.765354
199206,The Mill of Good Luck,1955-05-01,1955,0,0,0,0.152897
199219,Shadow,1956-05-01,1956,0,0,0,0.30191
199222,Gli innamorati,1955-06-17,1955,0,0,0,0.405292
199273,Spaghetti Story,2013-12-18,2013,0,0,0,0.413702
199283,Babushka,2004-02-03,2004,0,0,0,0.248286
199291,The Dark Matter of Love,2012-11-01,2012,0,0,0,0.815851
199327,Gagarin: First in Space,2013-06-05,2013,7000000,0,-7000000,2.242009
199336,Sophia de Mello Breyner Andresen,1969-01-01,1969,0,0,0,0.071819
199341,Girl on a Bicycle,2013-03-04,2013,0,0,0,2.476452
199373,The Frozen Ground,2013-07-18,2013,27220000,5496951,-21723049,12.388833
199374,My Sister's Kids in Africa,2013-01-30,2013,0,0,0,0.724368
199415,Looking for Maria Sanchez,2013-06-14,2013,0,0,0,0.122935
199420,Pawn Shop Chronicles,2013-07-12,2013,5000000,0,-5000000,6.637114
199423,Visitors,2013-09-08,2013,0,0,0,0.769064
199456,Struggle in the Valley,1954-03-01,1954,0,0,0,0.345954
199463,Barabbas,1953-06-13,1953,0,0,0,0.081239
199512,The Forbidden Christ,1951-06-08,1951,0,0,0,0.521422
199534,Wolf Creek 2,2013-08-30,2013,8000000,9630444,1630444,6.842107
199556,Absolute Deception,2013-06-10,2013,5000000,0,-5000000,3.464579
199565,The Movie Out Here,2012-11-30,2012,0,0,0,0.973347
199571,Aim High In Creation,2013-11-19,2013,0,0,0,0.16518
199575,These Final Hours,2014-07-31,2014,0,0,0,6.732991
199578,Patrick,2013-10-15,2013,0,0,0,12.014928
199584,"Secretly, Greatly",2013-06-05,2013,0,0,0,2.723672
199591,Penthouse North,2013-04-17,2013,0,0,0,6.377068
199602,Dual,2013-08-22,2013,1000000,0,-1000000,0.747844
199615,The Notebook,2013-07-03,2013,0,66559,66559,3.485214
199644,Honeymoon,2013-08-22,2013,0,0,0,0.433842
199647,The Color of Time,2012-11-16,2012,0,0,0,4.585809
199655,With Clean Hands,1972-10-29,1972,0,0,0,0.002538
199661,Josephine,2013-06-19,2013,0,0,0,4.870482
199687,Yamla Pagla Deewana 2,2013-06-07,2013,6800000,0,-6800000,0.168763
199715,A Small Town in Texas,1976-07-09,1976,0,0,0,0.940985
199740,Nobody Owns Me,2013-11-08,2013,0,0,0,2.195103
199753,Tom and Jerry's Giant Adventure,2013-08-04,2013,0,0,0,4.342685
199782,Springsteen & I,2013-07-22,2013,0,0,0,1.5699
199818,Mystery Road,2013-06-05,2013,0,0,0,2.36946
199851,Hawaii,2013-04-12,2013,0,0,0,1.96471
199879,Lucid,2005-09-11,2005,0,0,0,1.142231
199883,Besame Mucho,1987-01-01,1987,0,0,0,0.068562
199887,Over/Under,2013-01-04,2013,0,0,0,0.704642
199916,Whitey,1980-12-17,1980,959300,0,-959300,1.847632
199925,Over Your Dead Body,2014-08-23,2014,0,0,0,0.459802
199929,Mister John,2013-06-27,2013,0,0,0,0.502973
199933,Atlas Shrugged Part III: Who is John Galt?,2014-09-12,2014,5000000,846704,-4153296,1.845554
199934,On Our Own,1998-02-06,1998,0,0,0,0.145858
199977,For a Woman,2013-07-03,2013,0,0,0,1.504809
199985,The Last Hours of a Virgin,1972-05-22,1972,0,0,0,0.00289
199989,In the Land of the Head Hunters,1914-12-07,1914,0,0,0,0.660269
200016,Tamas and Juli,1997-12-18,1997,0,0,0,0.036472
200035,Political Animals,2012-07-15,2012,0,0,0,2.53434
200044,Deranged,2012-06-06,2012,0,0,0,0.702316
200051,Super Hero Party Clown,2012-09-25,2012,0,0,0,0.013359
200063,Sunset Strip,2012-03-16,2012,0,0,0,0.383737
200066,The Sparrow's Fluttering,1988-01-01,1988,0,0,0,0.138621
200085,Flu,2013-08-14,2013,0,0,0,4.522582
200114,The Vals,1982-11-01,1982,0,0,0,0.292774
200117,Il mantenuto,1961-12-26,1961,0,0,0,0.004561
200119,Going Attractions: The Definitive Story of the American Drive-in Movie,2013-06-07,2013,0,0,0,0.464836
200145,A Story of Yonosuke,2013-02-23,2013,0,0,0,1.08648
200157,Walking with Beasts,2001-12-21,2001,0,0,0,1.79139
200236,Doctors' Wives,1971-02-03,1971,0,0,0,2.244142
200281,La sociedad del sem√°foro,2010-09-24,2010,0,0,0,0.077334
200311,Much Ado About Something,2001-09-08,2001,0,0,0,0.001263
200324,The Half-Breed,1916-07-30,1916,0,0,0,0.002948
200325,"Life, Love & Celluloid",1998-02-20,1998,0,0,0,0.142814
200331,Journey Into Fear,1975-08-08,1975,0,0,0,0.361562
200358,"See You Tomorrow, Everyone",2013-01-26,2013,0,0,0,1.270233
200383,North Star,1996-01-03,1996,0,0,0,2.753163
200390,Back in the Saddle,1941-03-14,1941,0,0,0,0.0025
200445,Where Is Parsifal?,1985-07-19,1985,0,0,0,0.374677
200447,Miss Annie Rooney,1942-05-29,1942,0,0,0,0.116585
200450,Rain Without Thunder,1993-02-05,1993,0,0,0,0.95587
200462,Hansel & Gretel,2013-01-07,2013,135000,0,-135000,5.617601
200481,The Blue Umbrella,2013-02-12,2013,0,0,0,6.568023
200487,Web Junkie,2014-01-20,2014,0,0,0,0.911901
200505,Draft Day,2014-04-11,2014,25000000,28831145,3831145,5.596449
200511,7 Minutes,2014-10-26,2014,0,0,0,7.755664
200547,Ten Minutes Older,1978-05-11,1978,0,0,0,0.182499
200548,Fanie Fourie's Lobola,2013-03-01,2013,0,0,0,0.346067
200549,The Secret of Crickley Hall,2012-10-28,2012,0,0,0,1.287106
200558,Kara,2012-05-08,2012,0,0,0,0.522593
200574,Topaze,1933-02-24,1933,0,0,0,0.297406
200580,Spud 2: The Madness Continues,2013-06-06,2013,0,0,0,1.999654
200645,Marius,2013-07-09,2013,0,0,0,1.700531
200654,Raffles,1939-12-29,1939,0,0,0,0.760053
200655,Janis,1974-10-18,1974,0,0,0,0.001021
200664,Killer Bean 2: The Party,2000-08-08,2000,0,0,0,0.022707
200713,9 Month Stretch,2013-10-16,2013,0,0,0,8.765334
200727,"Love, Rosie",2014-10-16,2014,0,4439431,4439431,14.566103
200796,Show,2003-03-19,2003,0,0,0,0.149818
200813,The Blue Planet,2001-09-12,2001,0,0,0,3.453657
200823,Fonzy,2013-10-30,2013,0,0,0,3.424798
200862,Vigil in the Night,1940-02-05,1940,0,0,0,0.030309
200863,Special Mission Lady Chaplin,1966-08-12,1966,0,0,0,0.520407
200867,One Man Against the Organization,1975-11-12,1975,0,0,0,0.012251
200868,Mingus: Charles Mingus 1968,1968-04-02,1968,0,0,0,0.002003
200918,The Secret Lives of Dorks,2013-09-27,2013,0,0,0,1.394295
200938,Intangible Asset Number 82,2008-06-12,2008,0,0,0,0.079254
200998,Three Bewildered People in the Night,1987-08-11,1987,0,0,0,0.035862
201006,Margarita,2012-04-01,2012,0,0,0,0.35971
201010,Cha cha cha,2013-06-20,2013,0,0,0,1.971406
201018,Fanny,2013-07-10,2013,0,0,0,2.189812
201066,Goodbye World,2013-06-15,2013,0,0,0,8.6054
201076,Mirage Men,2013-06-13,2013,0,0,0,0.686142
201085,Crimson Peak,2015-10-13,2015,55000000,74679822,19679822,13.492684
201086,Cuban Fury,2014-02-14,2014,0,0,0,6.739737
201088,Blackhat,2015-01-13,2015,70000000,17752940,-52247060,14.932368
201099,Don't Give a Damn,1995-02-17,1995,0,0,0,0.394038
201124,Vuonna 85,2013-01-24,2013,1600000,0,-1600000,0.345975
201132,Antarctica: A Year on Ice,2013-09-05,2013,1000000,0,-1000000,3.146793
201198,Dumbland,2002-03-18,2002,0,0,0,1.182522
201214,Hammer & Tickle,2007-01-08,2007,0,0,0,0.300646
201223,Blue Exorcist: The Movie,2012-12-28,2012,0,0,0,3.538578
201274,Infinite,2012-08-25,2012,5000,0,-5000,0.009412
201277,The Last Match,2013-05-04,2013,200000,0,-200000,1.386665
201283,Aaron Loves Angela,1975-12-25,1975,0,0,0,0.338197
201284,From the Head,2011-06-24,2011,0,0,0,0.188346
201350,The Confession,2013-05-13,2013,0,0,0,0.417361
201360,All of Me,2013-06-15,2013,0,0,0,0.065884
201361,American Revolutionary: The Evolution of Grace Lee Boggs,2013-06-16,2013,0,0,0,0.016661
201365,Belle du Seigneur,2012-11-29,2012,0,0,0,1.890075
201386,F.C. De Kampioenen: Kampioen zijn blijft plezant,2013-12-17,2013,3849796,7471304,3621508,0.852186
201405,An Unlikely Weapon,2009-04-10,2009,0,0,0,0.004713
201414,Ninja 3: Goemon Will Never Die!,1963-12-28,1963,0,0,0,0.147794
201419,Code Black,2014-06-20,2014,0,0,0,0.674411
201429,The Divided Heaven,1964-10-02,1964,0,0,0,0.433982
201430,Strange Frequency,2001-01-24,2001,0,0,0,0.183658
201445,Late Bloomers,1996-01-01,1996,0,0,0,0.071497
201485,American Idiots,2013-06-18,2013,750000,0,-750000,0.618902
201550,Life of a King,2013-06-22,2013,0,0,0,3.209655
201561,Human Touch,2005-04-14,2005,0,0,0,0.002694
201581,The Autumn Heart,1999-01-27,1999,0,11532,11532,0.413413
201633,Motion Picture ('La sortie des ouvriers de l'usine Lumi√®re √† Lyon'),1984-01-01,1984,0,0,0,0.013026
201639,Bloody Mondays & Strawberry Pies,2008-10-01,2008,0,0,0,0.023148
201643,Pit ‚Ññ8,2010-11-30,2010,0,0,0,0.602072
201646,My Kidnapper,2010-10-12,2010,0,0,0,0.005936
201676,My Little Pony: Equestria Girls,2013-06-15,2013,0,0,0,8.353231
201695,Remote Control,1930-11-15,1930,0,0,0,0.199795
201703,Love's Deadly Triangle: The Texas Cadet Murder,1997-02-20,1997,14000000,161001698,147001698,1.36737
201724,Prince of Central Park,2000-09-22,2000,0,0,0,1.191371
201729,Elektro Moskva,2013-06-12,2013,0,0,0,0.117647
201749,Mr. Morgan's Last Love,2013-08-22,2013,8200000,0,-8200000,6.510474
201752,Traitors,2013-09-05,2013,0,0,0,0.23149
201759,Miserere,2013-06-26,2013,20000000,0,-20000000,2.237861
201765,Three Many Weddings,2013-12-05,2013,0,0,0,7.524929
201777,Our Vinyl Weighs a Ton: This Is Stones Throw Records,2013-06-21,2013,0,0,0,1.050756
201783,Tapia,2013-06-15,2013,0,0,0,0.07896
201847,Compulsion,2013-06-21,2013,4000000,0,-4000000,2.681705
201859,The Sex and Violence Family Hour,1983-01-01,1983,0,0,0,1.44119
201867,The 'Socalled' Movie,2010-04-04,2010,0,0,0,0.066104
201913,Se√±orita Justice,,,0,0,0,0.011574
202020,Melody on Parade,1936-06-17,1936,0,0,0,0.036471
202043,Prime Suspect 3,1993-12-19,1993,0,0,0,1.354621
202125,Just A Gigolo,1931-06-06,1931,0,0,0,0.478877
202132,50 Children: The Rescue Mission of Mr. and Mrs. Kraus,2013-04-07,2013,0,0,0,0.054699
202140,Edith Stein: The Seventh Chamber,1996-06-06,1996,0,0,0,1.270125
202141,Particle Fever,2013-06-14,2013,0,0,0,10.743115
202152,An Inconvenient Tax,2011-04-15,2011,0,0,0,0.084805
202171,The Invitation,2003-12-23,2003,0,0,0,0.561609
202172,The Conspiracy to Rule the World: From 911 to the Illuminati,2009-08-11,2009,0,0,0,0.075294
202183,Ein Schnitzel f√ºr drei,2010-06-01,2010,0,0,0,0.066185
202198,It's a Dog's Life,1955-12-23,1955,0,0,0,0.058551
202214,Real Playing Game,2013-08-28,2013,704460,0,-704460,1.736224
202215,Queens of the Ring,2013-07-02,2013,0,0,0,1.486526
202220,Badges of Fury,2013-06-21,2013,0,0,0,8.313878
202238,Tercera Llamada,2013-03-03,2013,0,0,0,0.886775
202239,Start Liquidation,1983-03-12,1983,0,0,0,0.623522
202241,Mildred Pierce,2011-03-27,2011,20000000,0,-20000000,3.010129
202244,Unaware,2013-03-12,2013,0,0,0,0.18805
202253,Voices Through Time,1996-08-27,1996,0,0,0,0.517789
202337,Welcome to 18,1986-04-18,1986,0,0,0,1.17002
202425,Life is Rosy,1987-11-17,1987,0,0,0,0.514363
202436,The Story of Esther Costello,1957-11-06,1957,0,0,0,1.235519
202456,I Am Happiness on Earth,2014-05-04,2014,0,0,0,1.77912
202475,The Same River Twice,2003-01-17,2003,0,0,0,0.073597
202495,Polite People,2013-03-31,2013,0,0,0,0.113596
202515,One And Eight,1983-01-01,1983,0,0,0,0.009335
202570,Snails in the Rain,2013-06-20,2013,0,0,0,1.877417
202573,The Reunion,2013-11-15,2013,0,0,0,1.739089
202575,Thunder and the House of Magic,2013-12-24,2013,34000000,0,-34000000,11.249956
202587,Stella Street,2004-01-26,2004,0,0,0,0.143427
202637,A Cry in the Wilderness,1974-03-26,1974,0,0,0,2.6e-05
202639,Hurricane,1974-09-10,1974,0,0,0,0.595553
202662,Cantata,1963-02-28,1963,0,0,0,0.368265
202722,"Inara, the Jungle Girl",2012-01-26,2012,0,0,0,1.595531
202727,Cattle Town,1952-09-06,1952,0,0,0,0.314719
202744,Deja Vu,1985-05-01,1985,0,0,0,0.427129
202764,Blood on the Land,1966-01-11,1966,0,0,0,0.085196
202768,Three,1965-05-12,1965,0,0,0,0.158551
202831,The Fire Next Time,1993-04-20,1993,0,0,0,0.365056
202839,Final Accord,1936-06-26,1936,0,0,0,0.083733
202865,The Gerber Syndrome: Il Contagio,2011-06-21,2011,0,0,0,0.332114
202885,Tokyo Park,2011-06-17,2011,0,0,0,0.478645
202941,Mail Order Bride,1964-03-10,1964,0,0,0,0.650094
202960,uwantme2killhim?,2013-06-24,2013,0,0,0,1.328558
202973,The Return of Frank Cannon,1980-11-01,1980,0,0,0,0.077215
202980,Les Petits princes,2013-06-26,2013,0,0,0,2.83054
202984,When the Dragon Swallowed the Sun,2010-06-22,2010,0,0,0,0.301689
203024,A Lady of Chance,1928-12-01,1928,0,0,0,0.290308
203059,John Hodgman: RAGNAROK,2013-06-19,2013,0,0,0,0.724585
203060,Open Up to Me,2013-03-08,2013,1085400,0,-1085400,1.13055
203062,Things We Do for Love,2013-02-01,2013,0,0,0,0.178791
203066,Motorcycle Gang,1994-09-25,1994,0,0,0,0.590583
203071,Labyrinth of Flames,2000-09-25,2000,0,0,0,0.88494
203072,The Surrealist and His Naughty Hand,2013-06-02,2013,0,0,0,0.053204
203119,Open Season,1996-05-03,1996,0,0,0,0.012456
203124,Failure,2013-06-16,2013,0,0,0,0.585728
203179,Magic Camp,2012-04-28,2012,0,0,0,0.55015
203182,Can't Stand Losing You: Surviving The Police,2012-11-23,2012,0,0,0,0.43452
203186,The Mine,2013-08-15,2013,0,0,0,1.731899
203217,My Mom Is a Character,2013-06-21,2013,0,0,0,4.402871
203226,2084,1984-10-01,1984,0,0,0,0.726551
203245,The Clown and The Kid,1961-12-27,1961,0,0,0,0.002446
203252,Fellini: I'm a Born Liar,2003-06-20,2003,0,0,0,0.985867
203264,Percentage,2013-04-24,2013,0,0,0,1.657911
203273,Some Dogs Bite,2010-10-01,2010,0,0,0,0.709216
203321,Not Another Happy Ending,2013-10-11,2013,0,0,0,2.917593
203329,ARAL. Fishing in an Invisible Sea,2004-06-23,2004,0,0,0,0.152869
203351,Atlantic Rim,2013-07-09,2013,0,0,0,0.127455
203534,Dealin' with Idiots,2013-07-12,2013,0,0,0,1.369498
203539,Systemfehler - Wenn Inge tanzt,2013-07-10,2013,0,0,0,1.495858
203547,H.O.T. Human Organ Traffic,2009-10-18,2009,0,0,0,0.004991
203665,Paris √† tout prix,2013-07-15,2013,0,0,0,4.382053
203696,Scooby-Doo! Stage Fright,2013-08-20,2013,0,0,0,2.112011
203715,Aya of Yop City,2013-07-17,2013,0,0,0,1.329626
203720,Retribution,1967-06-06,1967,0,0,0,0.156708
203739,Vampire Academy,2014-02-07,2014,0,0,0,12.227198
203766,Long Way Round,2004-10-03,2004,0,0,0,2.091255
203780,The Game of Truth,2013-07-01,2013,0,0,0,1.187998
203793,Stalingrad,2013-10-09,2013,30000000,68129518,38129518,0.595196
203801,The Man from U.N.C.L.E.,2015-08-13,2015,75000000,108145109,33145109,14.656875
203819,Tracks,2014-03-06,2014,0,4878242,4878242,0.239993
203829,A Tickle in the Heart,1996-11-21,1996,0,0,0,0.001688
203833,The Book Thief,2013-11-08,2013,0,76586316,76586316,16.373622
203834,Jessabelle,2014-08-29,2014,0,0,0,6.757875
203835,Amityville: The Awakening,2017-06-30,2017,0,0,0,20.712818
203888,The Spy with Ten Faces,1966-02-24,1966,0,0,0,0.004595
203890,2 Hours,2012-09-29,2012,0,0,0,0.382739
203901,The Bespoke Overcoat,1955-11-01,1955,0,0,0,0.94626
203912,National Theatre Live: Frankenstein,2011-03-17,2011,0,0,0,2.093311
204007,A m√≠ las mujeres ni fu ni fa,1971-07-01,1971,0,0,0,0.016901
204016,In No Great Hurry: 13 Lessons in Life with Saul Leiter,2014-01-03,2014,0,0,0,0.311242
204040,Slave Ship,1937-06-16,1937,0,0,0,0.909946
204051,The Surrogate Womb,1987-03-21,1987,0,0,0,0.009919
204053,The Brain Man,2013-02-09,2013,0,0,0,1.285491
204082,Homefront,2013-11-27,2013,22000000,43058898,21058898,9.896704
204090,If You Don't Stop It...You'll Go Blind!!!,1975-02-01,1975,0,0,0,0.290113
204095,How to Sell a Banksy,2012-01-06,2012,0,0,0,0.055307
204113,Season of Monsters,1987-09-15,1987,0,0,0,0.034794
204128,Amorosa,1986-03-14,1986,0,0,0,0.932271
204213,An Eye for an Eye,1957-09-13,1957,0,0,0,0.01674
204255,We Are the Freaks,2014-04-25,2014,0,0,0,1.0285
204260,Killer Toon,2013-06-27,2013,0,0,0,1.730507
204269,I'm a Stranger Here Myself,1975-01-17,1975,0,0,0,0.136882
204342,HK: Forbidden Super Hero,2013-04-13,2013,0,0,0,4.095284
204344,Internet Story,2010-01-01,2010,0,0,0,0.112133
204349,Contracted,2013-07-07,2013,0,0,0,7.220003
204372,Smokers Only,2002-06-12,2002,0,0,0,0.181198
204384,Finsterworld,2013-06-28,2013,0,0,0,3.195818
204435,Krrish 3,2013-11-01,2013,6218100,0,-6218100,11.11403
204436,Jack and the Cuckoo-Clock Heart,2013-11-17,2013,33,0,-33,6.0457
204506,Tea Time,2014-09-30,2014,0,0,0,0.158022
204553,Cold Eyes,2013-07-03,2013,0,0,0,3.256125
204582,An American Girl: Saige Paints the Sky,2013-07-02,2013,0,0,0,0.877702
204607,Muirhouse,2013-06-18,2013,0,0,0,0.153208
204611,UFO Abduction,1989-01-01,1989,0,0,0,0.00022
204668,Belle and Sebastian,2013-12-18,2013,0,0,0,5.495053
204686,Ten Thousand Bedrooms,1957-04-03,1957,0,0,0,0.405247
204690,Intimate Parts,2013-09-11,2013,0,0,0,2.263853
204709,The Scapegoat,2013-10-16,2013,0,0,0,1.903155
204712,The Little Polar Bear: Lars and the Little Tiger,2002-12-04,2002,0,0,0,0.256353
204737,Off the Minnesota Strip,1980-05-05,1980,0,0,0,0.339137
204755,"Fuse, Memoirs of the Hunter Girl",2012-10-20,2012,0,0,0,1.342165
204762,Miss and the Doctors,2013-09-04,2013,0,0,0,1.222967
204765,Pr√™t √† tout,2014-01-21,2014,0,0,0,2.819565
204768,Les invincibles,2013-09-18,2013,0,0,0,1.225165
204771,Le Monde doit m'arriver,2013-09-18,2013,0,0,0,0.011823
204784,Anna Nicole,2013-06-29,2013,0,0,0,0.344896
204800,Lad: A Dog,1962-06-02,1962,0,0,0,0.89172
204802,Lenin in October,1937-11-07,1937,0,0,0,1.234167
204810,Hunting Elephants,2013-07-03,2013,2300000,4500000,2200000,1.050644
204821,Dragstrip Girl,1994-09-02,1994,0,0,0,0.579738
204839,The Stepdaughter,2000-10-31,2000,0,0,0,0.944486
204904,House of Last Things,2013-01-30,2013,0,0,0,5.963215
204912,Thunder in Paradise,1993-09-22,1993,0,0,0,1.031454
204922,Before I Go to Sleep,2014-09-03,2014,22000000,15447154,-6552846,14.921298
204965,Drei Stunden,2013-07-24,2013,0,0,0,0.425095
204968,Jack Strong,2014-02-07,2014,3335702,0,-3335702,1.963912
204994,Seminole Uprising,1955-05-01,1955,0,0,0,0.9754
204996,My first war,2008-04-06,2008,0,0,0,0.006588
204997,Murder with Pictures,1936-09-24,1936,0,0,0,0.201302
205004,Africa: Texas Style!,1967-05-01,1967,0,0,0,0.852405
205005,Fred & Vinnie,2011-01-01,2011,0,0,0,0.009883
205017,Lootera,2013-04-04,2013,4100000,4300000,200000,1.296259
205022,Chennai Express,2013-08-09,2013,18000000,62000000,44000000,4.19356
205054,The Gay Deceivers,1969-07-30,1969,0,0,0,0.068258
205055,Sign Painters,2014-05-13,2014,0,0,0,0.128444
205076,Not My Life,2006-09-03,2006,0,0,0,0.713935
205211,Saaya,2003-07-03,2003,0,0,0,0.093072
205220,Philomena,2013-11-01,2013,12000000,100129872,88129872,6.927182
205221,Rugged Gold,1994-12-10,1994,0,0,0,0.414039
205225,24 Exposures,2013-08-04,2013,0,0,0,0.997752
205236,El taxi de los conflictos,1973-05-31,1973,0,0,0,0.415923
205263,A Is for Autism,1992-10-01,1992,0,0,0,0.177512
205321,Sharknado,2013-07-11,2013,1000000,0,-1000000,4.928195
205349,I due Pompieri,1968-07-02,1968,0,0,0,0.08437
205361,Boycott,2001-02-24,2001,0,0,0,1.513402
205384,Los rollos perdidos de Pancho Villa,2003-03-21,2003,0,0,0,0.077319
205410,The Smart Set,1928-03-24,1928,0,0,0,0.653923
205463,One Minute to Zero,1952-09-19,1952,0,0,0,0.810907
205466,Dark Space,2013-01-15,2013,750000,0,-750000,1.017978
205481,The Intended,2002-06-06,2002,0,0,0,0.11524
205504,The Gardener,1912-10-16,1912,0,0,0,0.167329
205557,"Stanza 17-17 palazzo delle tasse, ufficio imposte",1971-07-05,1971,0,0,0,0.329994
205584,Gods of Egypt,2016-02-25,2016,140000000,150680864,10680864,13.337707
205587,The Judge,2014-10-08,2014,50000000,83719388,33719388,17.887943
205588,Our Kind of Traitor,2016-05-05,2016,0,9930095,9930095,8.569996
205596,The Imitation Game,2014-11-14,2014,14000000,233555708,219555708,31.59594
205601,Belle,2013-09-08,2013,10900000,16505460,5605460,13.454169
205608,Without Lying Down: Frances Marion and the Power of Women in Hollywood,2000-01-01,2000,0,0,0,0.104882
205651,Holiday for Drumsticks,1949-01-22,1949,0,0,0,0.003424
205673,Pretty Baby,1950-09-16,1950,0,0,0,0.065017
205724,Welcome to the Jungle,2013-04-27,2013,3500000,0,-3500000,6.381313
205749,The List,2013-07-05,2013,0,0,0,1.358638
205775,In the Heart of the Sea,2015-11-20,2015,100000000,93820758,-6179242,11.696923
205798,Another Chance,1989-11-23,1989,0,0,0,0.471335
205818,Eat,2011-03-12,2011,0,0,0,0.603376
205819,Aglaya,2012-10-11,2012,0,0,0,0.491642
205864,The Eternal Return of Antonis Paraskevas,2013-07-07,2013,0,0,0,0.465373
205865,Papusza,2013-06-30,2013,0,0,0,0.558596
205891,The Demented,2013-07-30,2013,0,0,0,2.092272
205908,Recon 2020:  The Caprini Massacre,2004-05-22,2004,100000,0,-100000,0.280237
205939,The Crown and the Dragon,2013-07-25,2013,0,0,0,2.897734
205943,Severed Footage,2013-08-20,2013,0,0,0,1.135373
205985,Miss You Can Do It,2013-06-24,2013,0,0,0,0.259069
206018,Asignatura pendiente,1977-04-18,1977,0,0,0,0.002317
206034,The Black Watch,1929-05-22,1929,0,0,0,0.525644
206042,Children on Their Birthdays,2002-02-16,2002,0,0,0,0.885044
206052,Out California Way,1946-12-15,1946,0,0,0,0.225376
206099,The Iron Glove,1954-04-01,1954,0,0,0,0.168193
206145,Tarzan's Magic Fountain,1949-02-05,1949,0,0,0,0.757377
206155,Waiting in the Dark,2006-09-05,2006,0,0,0,0.35159
206157,Into the Badlands,1991-07-24,1991,0,0,0,0.548013
206183,Bad Karma,2002-07-23,2002,0,0,0,0.271025
206188,Once Upon a Scoundrel,1974-08-15,1974,0,0,0,0.000904
206192,Perfect Sisters,2014-04-08,2014,0,0,0,5.654098
206197,The Sisterhood of Night,2015-04-10,2015,0,0,0,2.620891
206237,Ray of Sunshine,1933-08-25,1933,0,0,0,0.31851
206260,The Rooftop,2013-07-19,2013,0,0,0,3.180768
206266,Shining Night: A Portrait of Composer Morten Lauridsen,2012-02-07,2012,0,0,0,0.008243
206277,Shirley: Visions of Reality,2013-12-26,2013,0,0,0,0.967131
206284,Grace Unplugged,2013-10-04,2013,0,0,0,2.673105
206289,Mademoiselle C,2013-09-11,2013,0,0,0,0.575144
206292,The Desert,2013-01-01,2013,0,0,0,0.327595
206296,The Last Five Years,2014-11-03,2014,0,0,0,5.02494
206324,Bhaag Milkha Bhaag,2013-07-12,2013,4600000,25000000,20400000,4.342418
206328,You Lucky Dog,1998-06-27,1998,0,0,0,0.166874
206377,Second Honeymoon,1937-11-13,1937,0,0,0,0.464414
206390,The Girl from the Marsh Croft,1917-09-09,1917,0,0,0,0.001276
206397,Lynching Charlie Lynch,2012-04-20,2012,0,0,0,0.157907
206408,Chinese Puzzle,2013-12-04,2013,0,0,0,9.559788
206412,Lisa Picard Is Famous,2000-05-14,2000,0,0,0,0.476406
206461,The Madness of Youth,1960-10-08,1960,0,0,0,0.266545
206480,Trade Winds,1938-12-28,1938,0,0,0,1.131154
206487,Predestination,2014-08-28,2014,5500000,3000000,-2500000,10.524204
206514,"I, Claudius",1976-09-20,1976,0,0,0,1.648537
206563,Trash,2014-10-09,2014,0,0,0,7.346304
206574,Unrated II: Scary as Hell,2011-02-26,2011,15000,0,-15000,0.061307
206577,J.C. Chavez,2007-05-18,2007,0,0,0,0.216364
206581,The Divine Woman,1928-01-13,1928,0,0,0,0.149852
206591,Bodywork,2001-09-04,2001,0,0,0,0.106077
206630,"Scream, Pretty Peggy",1973-11-24,1973,0,0,0,0.35504
206647,Spectre,2015-10-26,2015,245000000,880674609,635674609,24.926577
206648,Red Bells Part I: Mexico on Fire,1982-10-01,1982,0,0,0,0.185758
206657,Truckfighters,2011-11-15,2011,0,0,0,0.066072
206725,¬°A m√≠ la legi√≥n!,1942-05-11,1942,0,0,0,0.103503
206789,The Kingdom of Diamonds,1980-12-18,1980,0,0,0,0.452808
206796,Cry Me a River,2008-07-11,2008,0,0,0,0.292279
206821,The Longest Week,2014-09-05,2014,0,0,0,5.680194
206822,No Nukes,1980-07-18,1980,0,0,0,0.035472
206851,D-Day,2013-07-19,2013,0,0,0,1.462374
206899,A Tale of Sorrow and Sadness,1977-01-01,1977,0,0,0,0.018017
206953,Louis Theroux: America's Most Hated Family in Crisis,2011-04-03,2011,0,0,0,1.64978
206997,Appropriate Adult,2011-09-03,2011,0,0,0,0.989832
207021,Generation Iron,2013-09-20,2013,0,0,0,3.824707
207178,The Lion and the Horse,1952-05-16,1952,0,0,0,1.167911
207260,Wrath of the Crows,2013-05-01,2013,500000,0,-500000,0.715155
207263,Dead of the Nite,2013-04-03,2013,0,0,0,0.590214
207270,The Hoarder,2015-05-21,2015,0,0,0,4.071952
207273,Chilling Visions: 5 Senses of Fear,2013-05-15,2013,0,0,0,1.527822
207323,The Olsen Gang in Deep Trouble,2013-10-09,2013,0,0,0,0.506507
207402,The Hardy Bucks Movie,2013-02-21,2013,0,0,0,0.269543
207413,I Am Breathing,2013-09-06,2013,0,0,0,0.047062
207441,Pilgrimage,2001-01-01,2001,0,0,0,1.073815
207454,Mystery Woman,2003-08-31,2003,0,0,0,0.708052
207459,Our City Dreams,2008-08-10,2008,0,0,0,0.075297
207475,The Ouija Experiment,2011-05-05,2011,0,0,0,2.484835
207541,The Turandot Project,2000-09-11,2000,0,0,0,0.001749
207558,Color Adjustment,1992-01-29,1992,0,0,0,1e-06
207625,Such a Long Journey,1998-09-13,1998,0,0,0,0.001207
207636,The Cossacks,1928-06-23,1928,0,0,0,0.373143
207641,Project Shadowchaser II,1994-05-14,1994,0,0,0,2.326927
207649,Vanaprastham,1999-05-13,1999,0,0,0,0.427798
207655,Dancing in the Rain,1961-03-26,1961,0,0,0,0.182979
207680,"Return to Return to Nuke 'Em High, aka Volume 2",2017-01-15,2017,0,0,0,0.906976
207681,Mister Buddwing,1966-07-15,1966,0,0,0,0.919898
207686,The House at the End of Time,2013-06-21,2013,0,0,0,4.154266
207696,713-–π –ø—Ä–æ—Å–∏—Ç –ø–æ—Å–∞–¥–∫—É,1961-12-31,1961,0,0,0,0.074215
207699,Punk Vacation,1990-05-01,1990,0,0,0,0.476227
207703,Kingsman: The Secret Service,2015-01-29,2015,81000000,414351546,333351546,28.224212
207720,Treasure Island,1982-12-31,1982,0,0,0,0.143167
207731,Boricua's Bond,,,0,0,0,0.035352
207752,Thief of Damascus,1952-04-01,1952,0,0,0,0.471628
207766,Missionary,2013-07-25,2013,0,0,0,0.30267
207768,I Spit on Your Grave 2,2013-08-25,2013,0,809,809,12.75872
207769,Banshee Chapter,2013-08-26,2013,950000,0,-950000,7.130195
207774,The Borderlands,2013-08-24,2013,0,0,0,4.73755
207780,Antisocial,2013-07-31,2013,0,0,0,4.107534
207850,Tio Papi,2013-09-06,2013,0,0,0,0.144015
207871,Savannah,2013-04-25,2013,5000000,0,-5000000,1.663204
207909,Battle of Westerplatte,2013-07-04,2013,0,0,0,1.126814
207932,Inferno,2016-10-13,2016,75000000,220021259,145021259,18.311054
207933,Stonehearst Asylum,2014-09-11,2014,0,0,0,21.991755
207936,Tumbledown,2015-04-18,2015,0,135026,135026,10.932742
207937,Don Quixote,2000-04-08,2000,0,0,0,0.745102
207999,Spring Fever,1927-10-22,1927,0,0,0,0.290804
208028,Exhibition,2013-08-09,2013,0,0,0,1.846128
208035,Cinema's Exiles: From Hitler to Hollywood,2009-01-01,2009,0,0,0,0.481921
208039,Howard Hawks: American Artist,1997-01-01,1997,0,0,0,0.038659
208091,Saving Norman,2013-05-25,2013,0,0,0,1.043899
208134,Bad Grandpa,2013-10-22,2013,15000000,151831537,136831537,8.000867
208173,El r√≠o que nos lleva,1988-09-08,1988,0,0,0,0.01575
208182,Asylum,1997-05-09,1997,0,0,0,0.870064
208198,Moses and Aaron,1975-03-29,1975,0,0,0,0.112475
208242,Assassins Tale,2013-01-01,2013,1500000,0,-1500000,1.700323
208277,Wetlands,2013-08-22,2013,0,0,0,4.42564
208284,The Strange Color of Your Body's Tears,2013-08-12,2013,0,7182,7182,1.998366
208286,Crimes Against Humanity,2014-01-19,2014,0,0,0,0.019207
208305,Cyanide,2013-02-26,2013,0,0,0,0.945176
208309,Hotel Pacific,1975-11-27,1975,0,0,0,1.042247
208327,Red Persimmons,2001-10-25,2001,0,0,0,0.00121
208333,The Naked Ape,1973-08-01,1973,0,0,0,0.061539
208366,Rabbit Heart,1987-07-30,1987,0,0,0,0.0002
208385,The Blue Hour,2007-01-01,2007,0,0,0,0.152984
208429,Platinum Data,2013-03-16,2013,0,0,0,1.786364
208431,Love in the End,2013-02-13,2013,0,0,0,0.116854
208434,The Scarlet Coat,1955-07-28,1955,0,0,0,0.487343
208436,The Salt Prince,1983-02-26,1983,0,0,0,0.612255
208447,Espacio interior,2013-07-26,2013,2500000,0,-2500000,0.164352
208478,Destricted,2006-09-15,2006,0,0,0,2.430308
208495,Mission Park,2013-09-06,2013,0,0,0,1.440951
208517,The Coward,1915-11-14,1915,0,0,0,0.412738
208529,Getting In,1994-12-07,1994,0,0,0,0.913218
208556,Prora,2012-03-24,2012,0,0,0,0.439132
208579,The Rites of May,1977-01-13,1977,0,0,0,0.000308
208637,Kaksparsh,2012-05-04,2012,0,0,0,0.085867
208700,The Last Chance: Diary of Comedians,2013-03-22,2013,0,0,0,1.355089
208756,Pune 52,2013-01-18,2013,0,0,0,0.131459
208763,Forbidden Kingdom,2014-01-30,2014,26000000,34592118,8592118,5.653476
208783,"Poor, Poor Pavel",2003-06-21,2003,0,0,0,0.114215
208869,Plastic,2014-04-30,2014,10,0,-10,7.809194
208947,Get Ready,1999-01-01,1999,0,0,0,0.145892
208968,Kumail Nanjiani: Beta Male,2013-07-21,2013,0,0,0,0.389546
208982,Vietnam in HD,2011-11-08,2011,0,0,0,0.326621
208988,The War,2007-09-23,2007,0,0,0,0.487489
209032,The Floating Castle,2012-11-02,2012,0,0,0,1.334135
209049,Tiny Times,2013-06-27,2013,0,79,79,1.832762
209091,Burton and Taylor,2013-07-22,2013,0,0,0,8.259261
209103,The Jungle,2013-06-30,2013,0,0,0,1.164692
209112,Batman v Superman: Dawn of Justice,2016-03-23,2016,250000000,873260194,623260194,31.435879
209185,The Grand Seduction,2014-05-30,2014,12700000,3430018,-9269982,15.108283
209189,Life of Crime,2013-09-14,2013,12000000,265452,-11734548,17.788579
209204,The Cheshire Murders,2013-07-22,2013,0,0,0,1.479249
209209,The Trip to Squash Land,1967-07-22,1967,0,0,0,0.254085
209232,Dampfnudelblues,2013-07-31,2013,0,0,0,1.406317
209244,Are You Here,2013-09-07,2013,0,0,0,10.10786
209247,The Art of the Steal,2013-09-11,2013,0,64065,64065,8.436614
209248,Gr√§fin Mariza,1958-12-17,1958,0,0,0,0.160651
209249,The Love Punch,2013-09-12,2013,0,0,0,6.136853
209251,Cannibal,2013-10-11,2013,0,0,0,5.291742
209262,Parkland,2013-10-02,2013,10000000,653651,-9346349,6.71518
209263,Enough Said,2013-09-18,2013,0,25288872,25288872,6.782909
209266,Exit Marrakech,2013-06-28,2013,6000000,0,-6000000,1.998735
209269,Felony,2014-08-28,2014,0,0,0,4.273751
209271,Hateship Loveship,2013-09-07,2013,0,0,0,10.608891
209274,Ida,2013-10-25,2013,2159280,15298355,13139075,8.651053
209276,Starred Up,2013-09-09,2013,0,54915,54915,7.047117
209282,Violette,2013-09-06,2013,0,0,0,1.888084
209293,Louis Cyr : The Strongest Man in the World,2013-07-12,2013,8500000,0,-8500000,2.000605
209312,A Tale of a Naughty Girl,2003-09-18,2003,0,0,0,0.116352
209345,Little Men,1998-05-08,1998,0,0,0,0.004228
209350,Le Week-End,2013-10-04,2013,0,2225098,2225098,3.74133
209355,The French Minister,2013-11-06,2013,5112027,0,-5112027,4.27285
209361,One Chance,2013-09-09,2013,0,10900434,10900434,5.89288
209367,Death Valley Rangers,1943-12-03,1943,0,0,0,0.335982
209369,Into the Sun,1992-01-01,1992,0,0,0,1.172193
209379,Knight Rider,2008-02-17,2008,0,0,0,1.980117
209385,Walesa: Man of Hope,2013-09-05,2013,0,0,0,1.101341
209401,Half of a Yellow Sun,2014-03-21,2014,0,0,0,1.015609
209403,Bad Words,2013-09-06,2013,9500000,7800000,-1700000,5.847166
209406,The Right Kind of Wrong,2013-10-11,2013,0,0,0,5.746841
209410,Shuddh Desi Romance,2013-09-06,2013,0,0,0,1.417692
209413,Intrepido: A Lonely Hero,2013-09-06,2013,0,0,0,0.54132
209414,The Kiss,2004-11-17,2004,0,0,0,0.631618
209415,Living Is Easy With Eyes Closed,2013-10-31,2013,0,0,0,8.762445
209416,Supermensch: The Legend of Shep Gordon,2014-06-06,2014,0,0,0,2.379799
209440,The Empty Hours,2013-10-24,2013,0,0,0,1.614261
209451,Jersey Boys,2014-06-05,2014,40000000,67347013,27347013,6.447072
209504,Bounty Killer,2013-09-05,2013,0,0,0,5.314063
209556,When Comedy Went to School,2013-06-06,2013,0,0,0,0.137572
209645,Pond Hockey,2008-08-12,2008,75,0,-75,0.006201
209686,3 Simoa,2012-09-13,2012,0,0,0,0.018845
209764,The Terror Live,2013-07-31,2013,0,0,0,2.973751
209780,Crawlspace,2013-01-03,2013,0,0,0,2.405696
209799,The Unknown Known,2013-08-29,2013,0,0,0,2.846973
209802,SUBWAYStories: Tales from the Underground,1997-07-24,1997,0,0,0,0.968414
209840,Stray Dogs,2014-02-21,2014,0,0,0,1.319475
209901,Nothing Left to Fear,2013-09-26,2013,3000000,1675381,-1324619,5.317284
209920,Finding Normal,2013-05-18,2013,0,0,0,1.001909
209921,Slimtime,2010-10-01,2010,0,0,0,0.521227
210019,The San Francisco Story,1952-05-11,1952,0,0,0,0.499595
210024,An Adventure in Space and Time,2013-11-21,2013,0,0,0,5.541556
210041,Mike Tyson: Undisputed Truth,2013-12-01,2013,0,0,0,2.775314
210047,Cold Comes the Night,2013-09-20,2013,0,16971,16971,11.823937
210050,One. Two. One,2011-01-01,2011,0,0,0,0.318892
210052,Wolfskinder,2013-08-28,2013,0,0,0,0.471842
210059,In the Dark,2013-01-12,2013,0,0,0,0.60312
210068,Mujhe Kucch Kehna Hai,2001-05-25,2001,0,0,0,0.768284
210079,Across the River,2013-06-21,2013,0,0,0,1.798651
210092,If You Could See What I Hear,1982-01-07,1982,0,0,0,0.25422
210126,Mail Early for Xmas,1959-01-01,1959,0,0,0,0.076902
210183,Held For Ransom,1938-06-17,1938,0,0,0,0.001684
210234,Skewered,2013-07-16,2013,346500,0,-346500,0.669257
210250,Louis Theroux: Gambling in Las Vegas,2007-02-04,2007,0,0,0,0.892363
210274,Filmage: The Story of Descendents/All,2014-09-30,2014,0,0,0,0.196385
210288,Gettin' In,2012-10-17,2012,0,0,0,0.115668
210293,The Smile Man,2013-06-15,2013,0,0,0,1.338163
210302,Love's Routine,2013-06-19,2013,0,0,0,0.723927
210306,Tetra Vaal,2004-01-01,2004,0,0,0,0.315238
210307,The Waiting Game,1999-03-25,1999,0,0,0,1.169592
210320,Science Fiction,2002-09-28,2002,0,0,0,0.12252
210365,The Brides Are Coming,1978-01-01,1978,0,0,0,0.555475
210408,A≈ük Kƒ±rmƒ±zƒ±,2013-03-15,2013,0,0,0,0.413849
210479,Locke,2014-04-10,2014,2000000,4635300,2635300,12.792394
210487,Cz≈Çowiek z M-3,1969-02-20,1969,0,0,0,0.162404
210577,Gone Girl,2014-10-01,2014,61000000,369330363,308330363,154.801009
210609,Pioneer Woman,1973-12-18,1973,0,0,0,0.898496
210615,The Son,1973-03-30,1973,0,0,0,0.002001
210621,The Searchers of Happiness,1936-01-01,1936,0,0,0,0.008354
210624,TWA Flight 800,2013-07-17,2013,0,0,0,0.955426
210653,The Man Without a Face,1950-07-29,1950,0,0,0,0.917711
210691,Wiseguy,1996-05-02,1996,0,0,0,0.412377
210708,It's Me It's Me,2013-05-24,2013,0,0,0,0.782208
210728,No Turning Back,2002-06-21,2002,0,0,0,0.003326
210734,Battlefield Death Tales,2012-08-13,2012,0,0,0,0.115317
210737,Yodha,1992-09-02,1992,0,0,0,0.80792
210739,Maniacts,2001-12-06,2001,0,0,0,0.357354
210769,Scooby-Doo! Adventures: The Mystery Map,2013-07-22,2013,0,0,0,1.129421
210777,Tell Me a Riddle,1980-12-15,1980,0,0,0,0.095124
210842,WNUF Halloween Special,2013-10-23,2013,0,0,0,0.542569
210860,Mortdecai,2015-01-21,2015,60000000,30418560,-29581440,10.241861
210864,Celsius 41.11: The Temperature at Which the Brain... Begins to Die,2004-10-22,2004,0,0,0,0.037648
210908,All Cheerleaders Die,2013-10-31,2013,0,0,0,6.007987
210910,Almost Human,2013-09-19,2013,0,0,0,2.642117
210911,Rigor Mortis,2013-09-06,2013,0,7865,7865,9.503762
210913,Blood Glacier,2013-09-27,2013,0,0,0,2.371857
210923,Bhuvan Shome,1969-05-12,1969,0,0,0,0.294706
210937,Pursuit of Happiness,2001-01-17,2001,0,0,0,0.001283
210938,Edie & Pen,1996-05-10,1996,0,0,0,1.727228
210940,The Monitors,1969-10-08,1969,0,0,0,1.224042
210947,Afflicted,2014-04-04,2014,318000,121179,-196821,8.93232
210966,Fallen City,2011-05-09,2011,0,0,0,0.609507
211005,"Sex, Drugs & Taxation",2013-08-29,2013,0,0,0,1.762114
211017,Mosaic,1965-07-29,1965,0,0,0,0.1148
211024,At Berkeley,2013-11-08,2013,0,0,0,1.231937
211029,Neal Cassady,2007-10-11,2007,0,0,0,0.161951
211052,Miss Violence,2013-09-09,2013,0,0,0,3.285031
211059,September,2013-09-21,2013,0,0,0,0.986668
211065,Proxy,2013-09-19,2013,0,0,0,2.344506
211067,The Sacrament,2013-09-02,2013,4000000,9221,-3990779,5.350658
211076,Bad Turn Worse,2014-08-15,2014,0,0,0,2.627035
211078,When Jews Were Funny,2013-11-14,2013,0,0,0,0.828836
211085,Filthy Gorgeous: The Bob Guccione Story,2013-04-25,2013,0,0,0,1.076442
211086,Faith Connections,2013-11-21,2013,550000,0,-550000,0.510598
211088,Beyond The Edge,2013-10-24,2013,0,0,0,1.263552
211105,Krishna Cottage,2004-07-30,2004,0,0,0,0.541131
211125,Strawberry Summer,2012-08-25,2012,0,0,0,0.253138
211139,The Lion of Thebes,1964-06-27,1964,0,0,0,1.783625
211144,The Party Never Stops: Diary of a Binge Drinker,2007-03-26,2007,0,0,0,0.646491
211158,Ein Teil von mir,2009-10-14,2009,0,0,0,0.00499
211166,"Rio, I Love You",2014-09-12,2014,0,0,0,2.564738
211179,The Magnificent Gladiator,1964-12-30,1964,0,0,0,0.00124
211220,The Pig Farm,2011-01-01,2011,1500000,0,-1500000,0.032165
211222,The Wildman of Kentucky: The Mystery of Panther Rock,2008-10-01,2008,0,0,0,0.008722
211231,Jonny Quest Vs. The Cyber Insects,1995-11-19,1995,0,0,0,0.148534
211233,The Hijack That Went South,2013-01-17,2013,1800000,532269,-1267731,0.474578
211247,The Fake,2013-11-21,2013,0,0,0,1.604893
211256,Children in the Wind,1937-01-01,1937,0,0,0,0.046349
211275,Kachche Dhaage,1999-07-31,1999,0,0,0,0.318881
211317,Standing Army,2010-01-10,2010,264000,0,-264000,0.170093
211331,Diamond Girl,1998-07-25,1998,0,0,0,0.907988
211337,Spiral Jetty,1970-08-01,1970,0,0,0,3.5e-05
211354,Public Enemies,2012-01-03,2012,0,0,0,0.132335
211387,Marvel One-Shot: Agent Carter,2013-09-08,2013,0,0,0,5.847531
211411,Musicwood,2012-11-13,2012,0,0,0,0.016067
211505,Dabbe: Bir cin vakasi,2012-08-02,2012,0,0,0,0.738837
211528,Get Lucky,2013-08-08,2013,5000000,0,-5000000,2.276378
211561,The City Defends Itself,1951-09-03,1951,0,0,0,0.419076
211579,Our Sunhi,2013-08-10,2013,0,0,0,1.494937
211587,Blood Shot,2013-08-01,2013,0,0,0,1.393393
211603,Beauty and the Beast,1962-03-01,1962,0,0,0,0.034443
211672,Minions,2015-06-17,2015,74000000,1156730962,1082730962,547.488298
211710,A Walk in the Old City of Warsaw,1958-12-31,1958,0,0,0,0.053252
211711,Tiny Times 2,2013-08-07,2013,0,47,47,0.867512
211714,Oblivion,2008-10-23,2008,0,0,0,0.080969
211722,A Spell to Ward Off the Darkness,2013-08-09,2013,0,0,0,0.223872
211729,Freeway,1988-09-02,1988,0,0,0,0.241093
211755,Hunter √ó Hunter: Phantom Rouge,2013-01-12,2013,0,0,0,5.961421
211798,Wallace & Gromit's Cracking Contraptions,2002-10-15,2002,0,0,0,1.090578
211830,DEFCON: The Documentary,2013-08-01,2013,0,0,0,0.482542
211845,The Bible,2013-03-03,2013,0,0,0,1.294087
211879,Free Range/Ballad on Approving of the World,2013-09-19,2013,0,0,0,0.489449
211914,Unlucky Charms,2013-06-05,2013,0,0,0,0.98718
211928,The Last Inch,1958-05-31,1958,0,0,0,1.721843
211930,Hostage,2005-03-04,2005,0,0,0,0.323406
211954,Instructions Not Included,2013-07-20,2013,5500000,99067206,93567206,6.507895
212051,Death of a Doctor,1991-01-01,1991,0,0,0,0.000808
212058,Ordinary Sinner,2001-10-21,2001,0,0,0,0.800079
212063,Tim's Vermeer,2013-12-06,2013,0,0,0,3.369105
212156,The Garden of Sinners: Future Gospel,2013-09-28,2013,0,0,0,1.580626
212162,Puella Magi Madoka Magica the Movie Part III: Rebellion,2013-10-26,2013,0,12947880,12947880,5.327787
212167,Patema Inverted,2013-11-09,2013,0,0,0,6.319675
212168,Ghost in the Shell Arise - Border 2: Ghost Whispers,2013-11-29,2013,0,0,0,3.739978
212231,Kid Cannabis,2014-04-18,2014,0,0,0,4.718862
212270,The Flying Man,2013-07-08,2013,0,0,0,0.5616
212362,Serpentine Dance: Lo√Øe Fuller,1897-08-05,1897,0,0,0,0.113778
212455,House Party: Tonight's the Night,2013-07-23,2013,0,0,0,0.957354
212470,Monster High: 13 Wishes,2013-10-08,2013,0,0,0,3.527047
212481,Ashens and the Quest for the Gamechild,2013-08-08,2013,123690,0,-123690,1.057541
212494,Don't Go to the Reunion,2013-10-05,2013,18000,0,-18000,0.223536
212503,King Ordinary,2013-09-04,2013,0,0,0,1.770861
212508,By Hook or by Crook,2001-06-17,2001,0,0,0,0.05154
212530,The Great King,1942-03-02,1942,0,0,0,0.330752
212606,A Thousand Times Good Night,2013-08-31,2013,0,0,0,3.18631
212622,Don't Drink the Water,1969-11-11,1969,0,0,0,0.330446
212640,One Night Surprise,2013-08-08,2013,0,0,0,2.005639
212713,Kisses For My President,1964-08-21,1964,0,0,0,0.63124
212716,What If,2013-09-07,2013,11000000,7847000,-3153000,10.841891
212721,Gerontophilia,2013-08-28,2013,0,4793,4793,2.815898
212747,All the Wrong Reasons,2013-11-01,2013,1105736,0,-1105736,0.492168
212748,Rhymes for Young Ghouls,2013-09-09,2013,0,0,0,0.66618
212752,Cinemanovels,2013-09-06,2013,0,0,0,0.73421
212753,Empire of Dirt,2013-11-22,2013,0,0,0,0.035763
212754,Siddharth,2013-10-10,2013,0,0,0,0.941482
212756,Stay,2013-09-08,2013,0,0,0,2.96721
212762,Second Chances,2013-07-27,2013,0,0,0,1.105143
212769,Make Your Move,2013-08-07,2013,15,122,107,6.792607
212778,Chef,2014-05-08,2014,11000000,45967935,34967935,8.720309
212836,People in Places,2013-12-20,2013,0,0,0,0.353707
212843,Burt's Buzz,2014-06-06,2014,0,0,0,0.850629
212846,Mission Congo,2013-09-09,2013,0,0,0,0.012493
212849,The Dog,2013-09-07,2013,0,0,0,1.245958
212865,Little Girls in Pretty Boxes,1997-01-18,1997,0,0,0,0.644042
212899,The Son-Daughter,1932-12-23,1932,0,0,0,0.140661
212926,Pardon My Past,1945-12-24,1945,0,0,0,0.356303
212927,Jamie and Jessie Are Not Together,2011-06-18,2011,0,0,0,0.527275
212934,Behind the Camera: The Unauthorized Story of 'Mork & Mindy',2005-04-14,2005,0,0,0,0.088172
212950,Eight Iron Men,1952-12-01,1952,0,0,0,0.805255
212967,Ashley,2013-08-09,2013,0,0,0,1.516169
212994,From One Second to the Next,2013-08-07,2013,0,0,0,0.466299
212996,Lee Rock,1991-09-18,1991,0,0,0,1.807175
213015,Unbeatable,2013-08-15,2013,0,0,0,3.293913
213095,Bersaglio altezza uomo,1979-03-08,1979,0,0,0,0.002945
213110,The Amazing Screw-On Head,2006-08-20,2006,0,0,0,1.173854
213121,Toy Story of Terror!,2013-10-15,2013,0,0,0,0.512025
213204,The Foxy Merkins,2013-08-09,2013,0,0,0,0.377664
213270,Dark Girls,2011-11-17,2011,0,0,0,0.591569
213321,Investigation Held by Kolobki,1986-01-01,1986,0,0,0,0.127253
213342,Brooklyn Babylon,2001-08-16,2001,0,0,0,0.009412
213373,What Now? Remind Me,2013-08-08,2013,0,0,0,0.354658
213386,Barabbas,2013-03-25,2013,0,0,0,0.823412
213417,How to Be a Man,2013-08-10,2013,0,0,0,1.393318
213443,Man-Proof,1938-01-07,1938,0,0,0,0.52597
213496,The Tracker,2001-11-21,2001,0,0,0,0.350197
213556,To Russia... With Elton,1979-01-01,1979,0,0,0,7.3e-05
213570,Mystery in Mexico,1948-08-21,1948,0,0,0,0.220996
213587,Leaving on the 15th Spring,2013-04-25,2013,0,0,0,0.989639
213595,Kokoyakyu: High School Baseball,2006-07-04,2006,0,0,0,0.011459
213598,La Morte Rouge,2006-02-09,2006,0,0,0,0.342814
213603,Home of the Brave,2004-01-01,2004,0,0,0,0.660996
213635,Luther,1974-01-21,1974,0,0,0,1.170857
213648,L'uomo della carit√†,,,0,0,0,0.003448
213681,Masterminds,2016-09-29,2016,25000000,29200000,4200000,9.434588
213683,–ü–µ—Ä–µ–∫—Ä–µ—Å—Ç–æ–∫,1998-12-30,1998,0,0,0,0.078478
213684,Manakamana,2013-08-12,2013,0,0,0,2.257329
213755,Extralarge: Black Magic,1992-11-22,1992,0,0,0,0.421229
213831,Drew: The Man Behind the Poster,2013-08-16,2013,0,0,0,5.583061
213842,Deadly Voyage,1996-06-14,1996,0,0,0,0.647717
213845,Miss M√©t√©o,2005-10-09,2005,0,0,0,0.109838
213857,Milosc,2012-11-20,2012,0,0,0,0.092183
213864,Fat Guy Goes Nutzoid,1986-09-05,1986,0,0,0,0.019235
213914,Borderline Normal,2000-12-01,2000,0,0,0,0.549975
213917,Every Other Weekend,1990-08-28,1990,0,0,0,0.629807
213927,Born to Race: Fast Track,2014-03-20,2014,0,0,0,2.634423
213938,The Runner,1984-01-01,1984,0,0,0,0.000578
213950,The Price of Life,1987-08-12,1987,0,0,0,0.009216
213955,The Green Hornet,1974-03-21,1974,0,0,0,0.92288
213983,Club Sandwich,2013-09-05,2013,0,0,0,0.660324
213985,Heaven,1999-04-29,1999,0,0,0,0.310475
214030,Fading Gigolo,2013-09-07,2013,0,2681345,2681345,9.596119
214041,Under The Sign Of Scorpio,1969-04-04,1969,0,0,0,0.76046
214069,When Evening Falls on Bucharest or Metabolism,2013-08-09,2013,0,0,0,0.271783
214074,October November,2013-09-05,2013,0,0,0,1.094712
214075,Words and Pictures,2013-09-06,2013,0,3346257,3346257,3.352204
214081,A Promise,2013-09-04,2013,0,0,0,3.144764
214083,The Armstrong Lie,2013-09-08,2013,0,383294,383294,3.237965
214086,The Face of Love,2013-10-25,2013,4000000,350006,-3649994,2.999052
214091,The Last of Robin Hood,2013-09-06,2013,0,0,0,11.096363
214093,Love Is the Perfect Crime,2013-09-07,2013,0,0,0,4.080294
214096,Lucky Them,2013-09-06,2013,0,0,0,6.513382
214099,Rock the Casbah,2013-09-11,2013,0,0,0,1.880634
214100,Sunshine on Leith,2013-10-03,2013,0,0,0,2.279636
214105,The Wonders,2013-06-05,2013,0,0,0,0.398623
214129,Bakit Hindi Ka Crush Ng Crush Mo?,2013-08-14,2013,0,0,0,0.834795
214134,Laughter of Others,2012-01-12,2012,0,0,0,0.080594
214135,A Wolf at the Door,2013-10-03,2013,0,0,0,2.267389
214137,The Man Who Saved the World,2014-08-13,2014,0,0,0,3.165887
214138,Bad Hair,2013-09-07,2013,0,0,0,1.869016
214139,The Dinner,2013-11-07,2013,0,0,0,1.617138
214146,UncuT: Member Only,2003-03-31,2003,0,0,0,0.667643
214157,Gagarin,1994-01-01,1994,0,0,0,0.524237
214170,When Bjork Met Attenborough,2013-07-26,2013,0,0,0,0.684293
214181,It's My Turn,1980-10-24,1980,0,0,0,1.288694
214187,The Death of Kevin Carter: Casualty of the Bang Bang Club,2004-09-17,2004,11000,0,-11000,0.002356
214209,Hide and Seek,2013-08-14,2013,0,0,0,2.973011
214210,Eastern Boys,2013-04-02,2013,0,0,0,2.569986
214215,Friends from France,2013-11-27,2013,0,0,0,0.896636
214216,Babycakes,1989-02-14,1989,0,0,0,0.141336
214217,Heart of a Lion,2013-10-18,2013,1650000,0,-1650000,2.058307
214218,Life's a Breeze,2013-07-19,2013,0,0,0,1.472041
214219,iNumber Number,2013-09-12,2013,747487,0,-747487,0.577547
214250,Cosmic Psychos: Blokes You Can Trust,2013-08-08,2013,80000,0,-80000,0.081655
214251,Story of My Death,2013-10-23,2013,0,0,0,0.303212
214256,AfterDeath,2015-10-19,2015,0,0,0,2.503486
214264,The Gamers: Hands of Fate,2013-08-15,2013,0,0,0,0.447626
214280,Les papillons japonais,1908-05-15,1908,0,0,0,0.072422
214314,Bears,2014-04-17,2014,0,0,0,3.661961
214348,Qissa: The Tale of a Lonely Ghost,2014-07-10,2014,0,0,0,1.079835
214349,The Liar,1981-02-27,1981,0,0,0,0.059731
214355,Cine Holli√∫dy,2013-08-09,2013,0,4900000,4900000,0.655482
214418,Amazonia,2013-11-26,2013,0,0,0,4.991293
214430,Bianca Beauchamp: All Access,2007-07-21,2007,7500,0,-7500,0.44374
214436,Maria,2003-11-21,2003,0,0,0,0.106644
214446,Someone to Love,1988-04-21,1988,0,0,0,0.868693
214447,New Year's Day,1990-02-09,1990,0,0,0,0.278804
214464,The Dead 2: India,2013-08-22,2013,0,0,0,0.957287
214472,The Roller Skate Craze,1907-08-02,1907,0,0,0,0.036471
214597,Fright Night 2: New Blood,2013-08-31,2013,8000000,0,-8000000,10.752888
214600,Le myst√®re de la tour Eiffel,1928-01-06,1928,0,0,0,0.014963
214629,Sleepwalker,1984-07-05,1984,0,0,0,1.163704
214641,Schalcken the Painter,1979-12-22,1979,0,0,0,0.795333
214671,Spinning Plates,2013-10-25,2013,0,0,0,0.270922
214676,Mr. Dough and the Egg Princess,2010-11-18,2010,0,0,0,1.695936
214699,The Marriage of Figaro,1975-01-01,1975,0,0,0,1e-06
214717,2103: The Deadly Wake,1997-08-26,1997,0,0,0,0.108552
214735,Men Cry Bullets,1998-10-08,1998,0,2303,2303,0.920469
214753,The Airzone Solution,1993-01-01,1993,0,0,0,0.000108
214756,Ted 2,2015-06-25,2015,68000000,217022588,149022588,42.061481
214758,"Easy Sex, Sad Movies",2014-03-11,2014,0,0,0,2.900585
214761,The 7th Floor,2013-09-05,2013,0,0,0,4.015585
214775,'Til Madness Do Us Part,2013-09-05,2013,0,0,0,0.561471
214827,Body Waves,1992-05-26,1992,0,0,0,1.233935
214857,Dragon Age: Redemption,2011-10-11,2011,0,0,0,0.270341
214909,We Were Dancing,1942-04-30,1942,0,0,0,0.058922
214910,Hwayi: A Monster Boy,2013-10-09,2013,0,0,0,2.947865
214938,King for a Day,1983-05-16,1983,0,0,0,0.046649
214948,New York Lightboard Record,1961-01-01,1961,0,0,0,0.001679
214990,An American Ghost Story,2012-10-01,2012,10000,0,-10000,0.862652
215012,Poor Us: An Animated History of Poverty,2012-11-28,2012,0,0,0,0.055453
215016,Chantilly Lace,1993-07-18,1993,0,0,0,0.560405
215023,Greg Fitzsimmons: Life on Stage,2013-08-18,2013,0,0,0,0.211032
215031,Gabrielle,2013-09-20,2013,0,0,0,1.138099
215032,Watermark,2013-10-11,2013,0,0,0,0.879225
215042,Metalhead,2013-10-11,2013,0,0,0,2.244867
215061,Synchromy,1971-01-01,1971,0,0,0,0.164095
215107,Vermont Is for Lovers,,,0,0,0,0.75
215134,Moving the Mountain,1994-09-15,1994,0,0,0,0.146446
215211,Grace of Monaco,2014-05-14,2014,30000000,0,-30000000,6.773278
215299,Music for Millions,1944-12-18,1944,0,0,0,0.577087
215302,"What Next, Corporal Hargrove?",1945-11-21,1945,0,0,0,0.741699
215373,Love Walked In,1997-01-18,1997,0,0,0,0.376985
215379,Young Ones,2014-06-28,2014,0,0,0,5.916252
215405,Magic Kid,1993-10-27,1993,0,0,0,0.696532
215407,Trances,1981-10-03,1981,200000,0,-200000,0.717206
215408,The Aviators,2009-06-19,2009,0,0,0,0.141071
215453,The Cariboo Trail,1950-08-01,1950,0,0,0,0.077294
215471,Gold Raiders,1951-09-09,1951,0,0,0,0.014647
215478,The Little Mermaid,1976-12-17,1976,0,0,0,0.206356
215520,Rags & Tatters,2013-09-10,2013,0,0,0,0.343031
215538,The Love Machine,1971-08-14,1971,0,0,0,0.482649
215562,How to Live in the German Federal Republic,1990-02-09,1990,0,0,0,0.03529
215579,Family Ties Vacation,1985-09-22,1985,0,0,0,0.731225
215628,The Human Factor,2013-08-28,2013,0,0,0,0.637629
215637,Coast of Death,2013-08-11,2013,0,0,0,0.369544
215646,The Special Need,2013-01-23,2013,0,0,0,0.182584
215656,All About the Feathers,2013-09-20,2013,0,0,0,0.1257
215657,Syrinx,1966-05-31,1966,0,0,0,0.291638
215658,Luton,2013-10-10,2013,0,0,0,0.23574
215711,When the Iron Bird Flies,2012-10-20,2012,0,0,0,0.013177
215726,Shuttlecock Boys,2012-08-02,2012,70000,0,-70000,0.071618
215736,Fisherman's Wharf,1939-02-03,1939,0,0,0,0.001681
215739,Concrete Night,2013-11-01,2013,0,0,0,1.171222
215740,Home from Home ‚Äì Chronicle of a Vision,2013-10-03,2013,0,0,0,1.824098
215741,How Strange to be Named Federico: Scola Narrates Fellini,2013-09-12,2013,96,0,-96,1.23031
215743,Moebius,2013-09-05,2013,0,2340,2340,4.333617
215776,Madras Cafe,2013-08-23,2013,5400000,6500000,1100000,2.39989
215797,The Thorn,1971-01-01,1971,0,0,0,4e-06
215814,Forbidden Ground,2013-08-16,2013,0,0,0,2.414792
215830,Open Grave,2013-08-13,2013,0,0,0,5.72991
215848,Family United,2013-09-13,2013,0,0,0,2.629221
215875,Violets Are Blue,1986-04-04,1986,0,0,0,0.896878
215881,Plush,2013-09-13,2013,0,0,0,3.488758
215908,Noah,2013-09-09,2013,0,0,0,0.6151
215924,The Amazing Catfish,2013-08-10,2013,1300000,0,-1300000,1.573126
215928,Around the Block,2013-09-06,2013,0,0,0,1.560032
215931,Beneath the Harvest Sky,2013-09-08,2013,0,0,0,7.558162
215935,Bethlehem,2013-09-01,2013,0,0,0,1.427598
215946,Canopy,2013-09-08,2013,0,0,0,0.898904
215962,The Stag,2013-09-10,2013,600000,0,-600000,9.208127
215976,Reminiscence,2014-10-14,2014,500000,0,-500000,1.156922
215991,"Louise Bourgeois: The Spider, The Mistress And The Tangerine",2008-06-28,2008,0,0,0,0.011742
215993,Prime Suspect 2,1992-12-05,1992,0,0,0,1.874711
215999,Prime Suspect: The Lost Child,1995-10-08,1995,0,0,0,1.411324
216015,Fifty Shades of Grey,2015-02-11,2015,40000000,571006128,531006128,33.068431
216016,The Amityville Asylum,2013-06-03,2013,20000,0,-20000,1.621948
216035,Prime Suspect: Inner Circles,1995-05-07,1995,0,0,0,0.991837
216037,Prime Suspect 5: Errors of Judgement,1996-08-20,1996,0,0,0,0.875901
216043,The Iceman: Confessions of a Mafia Hitman,2001-03-01,2001,0,0,0,0.565873
216046,Revenge,1989-01-01,1989,0,0,0,0.151977
216068,The Big Broadcast of 1937,1936-10-05,1936,0,0,0,0.331503
216138,10 Rules for Sleeping Around,2014-04-04,2014,0,0,0,3.852766
216153,One in a Million: The Ron LeFlore Story,1978-09-26,1978,0,0,0,0.941714
216156,Still Life,2013-11-28,2013,0,0,0,4.999237
216163,Cry Wilderness,1987-02-01,1987,0,0,0,0.541464
216203,Pieces of Talent,2012-01-01,2012,0,0,0,1.17128
216282,Into the Storm,2014-08-06,2014,50000000,160602194,110602194,9.092925
216363,The Eternal Rainbow,1958-10-28,1958,0,0,0,0.133098
216369,Tenta√ß√£o,1997-12-26,1997,0,0,0,0.246491
216374,I Will Follow You Into the Dark,2012-12-20,2012,5000000,0,-5000000,1.940777
216440,Paradise,2013-11-30,2013,0,0,0,1.117197
216457,Jealousy,2013-10-03,2013,4000000,0,-4000000,1.451464
216472,A Great Wall,1986-05-30,1986,0,0,0,0.000354
216521,Doomsdays,2013-09-26,2013,0,0,0,0.165532
216529,Doomed! The Untold Story of Roger Corman's The Fantastic Four,2015-07-10,2015,50000,0,-50000,0.851054
216539,Ghost Shark,2013-08-22,2013,0,0,0,6.413331
216541,Ambushed,2013-09-21,2013,0,0,0,5.354069
216546,Ragin Cajun Redneck Gators,2013-09-05,2013,0,0,0,1.847925
216550,Dolpo Tulku - Heimkehr in den Himalaya,,,0,0,0,0.0
216553,Jim Norton: American Degenerate,2013-08-23,2013,0,0,0,0.483224
216580,Savaged,2014-08-06,2014,0,0,0,4.960171
216647,Aschenputtel,1989-01-01,1989,0,0,0,2.1e-05
216652,Mike Birbiglia: My Girlfriend's Boyfriend,2013-08-22,2013,0,0,0,0.892006
216672,Kill by Inches,1999-09-12,1999,0,0,0,0.003174
216736,Lady Liberty,1971-01-01,1971,0,0,0,0.668865
216755,The Human Behavior Experiments,2006-05-30,2006,0,0,0,0.212655
216790,Sacro GRA,2013-09-19,2013,0,0,0,1.107321
216794,Men of Means,1999-05-25,1999,0,0,0,0.022078
216822,Laura Lansing Slept Here,1988-03-06,1988,0,0,0,0.209672
216859,Career,1959-10-08,1959,0,0,0,0.391018
216876,Unchained,1955-08-25,1955,0,0,0,0.579907
216919,Deseo,2012-11-23,2012,0,0,0,1.526115
216983,Madeline: Lost in Paris,1999-08-20,1999,0,0,0,0.912352
216989,Doug Stanhope: Beer Hall Putsch,2013-08-19,2013,0,0,0,0.863675
217014,De Nieuwe Wildernis,2013-09-26,2013,0,0,0,0.77019
217038,Dolly and Her Lover,1990-02-01,1990,0,0,0,0.75899
217057,The Hero of Color City,2014-10-03,2014,0,0,0,1.066926
217085,Night Slaves,1970-09-29,1970,0,0,0,0.682062
217129,SampleThis,2013-09-12,2013,0,0,0,0.482461
217172,Sing Your Way Home,1945-11-14,1945,0,0,0,0.518113
217185,I'll Get By,1950-10-02,1950,0,0,0,0.625881
217197,Marilyn: The Untold Story,1980-11-10,1980,0,0,0,0.253299
217247,The Issa Valley,1982-01-01,1982,0,0,0,0.473698
217250,Magnificent Doll,1946-12-08,1946,0,0,0,0.467736
217268,The Epic of Everest,1924-01-01,1924,0,0,0,1.118466
217313,Crossroad Street,1988-01-03,1988,0,0,0,0.011917
217316,1,2013-09-30,2013,0,0,0,7.732143
217324,Trail Guide,1952-02-15,1952,0,0,0,0.121225
217341,Rewind,2013-08-26,2013,0,0,0,2.065884
217389,Memories,2013-08-08,2013,0,0,0,0.668117
217412,Da geht noch was!,2013-09-12,2013,0,0,0,1.21392
217414,¬øQui√©n mat√≥ a Bambi?,2013-11-15,2013,0,850259,850259,1.926826
217428,Markova: Comfort Gay,2000-12-25,2000,0,0,0,0.002328
217471,Medeas,2013-09-01,2013,0,0,0,2.517507
217477,One Way Boogie Woogie,1977-01-01,1977,0,0,0,0.038888
217576,Walking the Camino: Six Ways to Santiago,2013-02-27,2013,0,0,0,0.049415
217587,Being Ginger,2013-08-25,2013,0,0,0,0.288222
217590,A Year Along the Abandoned Road,1991-06-01,1991,0,0,0,0.220664
217605,The Grave Digger,2010-01-01,2010,0,0,0,0.042332
217632,The Way You Wanted Me,1944-10-15,1944,0,0,0,0.27606
217648,Padri e figli,1957-02-21,1957,0,0,0,0.399234
217672,Snowed Under,1936-04-04,1936,0,0,0,0.001754
217708,Of Horses and Men,2013-08-30,2013,10,11,1,2.861451
217719,Snake & Mongoose,2013-09-06,2013,0,0,0,0.615562
217724,Les mod√®les de 'Pickpocket',2004-09-17,2004,0,0,0,0.002353
217763,Show Girl in Hollywood,1930-04-20,1930,0,0,0,0.960061
217775,Chez Nous,2013-10-02,2013,0,0,0,1.31963
217787,Paranormal Whacktivity,2013-07-24,2013,3600000,0,-3600000,1.700237
217802,Love In Bloom,1935-04-20,1935,0,0,0,0.003387
217896,Suddenly,2013-08-08,2013,0,0,0,2.604777
217917,The Wrong Road,1937-10-11,1937,0,0,0,0.316432
217919,Salom√©,2013-08-10,2013,0,0,0,1.654191
217923,Young Detective Dee: Rise of the Sea Dragon,2013-09-27,2013,0,72287783,72287783,14.164519
217925,Jay-Z: Made in America,2013-10-11,2013,0,0,0,1.320353
217948,Teresa,1951-04-05,1951,0,0,0,0.620008
217993,Justice League: War,2014-02-02,2014,3500000,5155325,1655325,8.138622
218043,Left Behind,2014-10-03,2014,16000000,19682924,3682924,11.519053
218098,Song of the Open Road,1944-06-21,1944,0,0,0,0.001307
218150,Nightfall,1999-09-05,1999,0,0,0,0.075996
218212,Apartment for Peggy,1948-09-30,1948,0,0,0,0.15346
218213,You Were Meant for Me,1948-01-28,1948,0,0,0,0.03652
218221,The Garden of Women,1954-03-16,1954,0,0,0,0.179424
218233,The Living Magoroku,1943-01-01,1943,0,0,0,0.643516
218238,Blinker,1999-01-01,1999,0,0,0,0.05235
218262,Memphis,2013-08-31,2013,0,0,0,0.702054
218275,The Letters,2015-12-04,2015,1,1,0,2.240259
218277,Pretty/Handsome,2008-06-01,2008,0,0,0,1.269181
218296,The Secret Life of Plants,1979-12-09,1979,0,0,0,0.028347
218299,The Mayor of 44th Street,1942-10-15,1942,0,0,0,0.789813
218305,So Ends Our Night,1941-02-27,1941,0,0,0,0.620732
218329,Breakout,2013-09-04,2013,0,0,0,7.152793
218351,The Girl Said No,1937-09-18,1937,0,0,0,0.468959
218369,That Girl From Paris,1936-12-31,1936,0,0,0,0.125647
218381,Extraction,2013-09-05,2013,1100000,0,-1100000,2.477723
218389,I Dream Too Much,1935-11-29,1935,0,0,0,0.953152
218393,"Standing Aside, Watching",2013-11-08,2013,0,0,0,0.051914
218408,Trapped in a Purple Haze,2000-04-17,2000,0,0,0,0.311636
218425,Frequencies,2013-09-27,2013,0,0,0,4.701726
218443,Graveyard Shift,2005-01-20,2005,0,0,0,0.506439
218473,"The Beans of Egypt, Maine",1994-01-01,1994,0,0,0,0.38247
218482,Stripped,2014-04-01,2014,0,0,0,1.092963
218508,Setouchi Moonlight Serenade,1997-03-15,1997,0,0,0,0.002307
218576,Our Man in Tehran,2013-09-20,2013,0,0,0,0.555367
218582,Thieves Fall Out,1941-05-03,1941,0,0,0,0.339049
218624,Choices,1981-10-01,1981,0,0,0,0.304363
218658,Lines: Horizontal,1962-01-01,1962,0,0,0,0.072187
218670,One Eyed Girl,2014-10-24,2014,1000000,0,-1000000,1.552731
218688,UMMAH - Unter Freunden,2013-09-12,2013,0,0,0,0.317611
218689,Backstreet Dreams,1990-09-29,1990,0,0,0,0.759966
218713,Here Comes Cookie,1935-09-10,1935,0,0,0,0.083133
218728,Prinzessin,2006-11-10,2006,0,0,0,0.106238
218772,I guappi non si toccano,1979-09-02,1979,0,0,0,0.013587
218778,"Alexander and the Terrible, Horrible, No Good, Very Bad Day",2014-10-08,2014,28000000,100654149,72654149,7.861004
218784,Freaks of Nature,2015-10-30,2015,0,70958,70958,8.515073
218836,Planes: Fire & Rescue,2014-07-17,2014,50000000,151165787,101165787,7.579855
218850,The Disciple,2013-09-26,2013,0,0,0,0.269808
218898,Zanjeer,2013-09-05,2013,0,0,0,1.29234
218901,Mindfulness and Murder,2011-09-04,2011,0,0,0,0.079324
218909,Summer House,2013-04-21,2013,0,0,0,0.096496
218931,Gleason,2002-10-13,2002,0,0,0,1.427217
218974,Redemption,2013-10-11,2013,0,0,0,0.090273
218993,Before the Winter Chill,2013-11-26,2013,0,0,0,1.99177
219043,Un marido de ida y vuelta,1957-08-26,1957,0,0,0,0.006744
219054,Double Play: James Benning and Richard Linklater,2013-09-03,2013,0,0,0,0.091895
219067,Venti anni,2012-03-26,2012,0,0,0,0.016145
219166,Die Tigerin,1992-01-01,1992,0,0,0,1.173119
219233,The River Fuefuki,1960-10-19,1960,0,0,0,0.060518
219247,Zombie Night,2013-10-08,2013,1000000,0,-1000000,1.438547
219248,Wicked Ways,1999-12-21,1999,0,0,0,0.580768
219288,Dragon Day,2013-01-10,2013,0,0,0,1.439026
219302,A Man Called Gannon,1968-03-08,1968,0,0,0,1.011509
219318,The Volcano,2013-10-02,2013,0,0,0,5.289252
219335,The Witch Returns to Life,1952-12-05,1952,0,0,0,0.079428
219343,Lucia,2013-10-19,2013,79000,170000,91000,0.449582
219345,Grief,1993-05-10,1993,0,0,0,0.329655
219424,The Affairs of Martha,1942-06-21,1942,0,0,0,0.007557
219435,Naked Under the Moon,1999-09-08,1999,0,0,0,0.298992
219466,Dancing on the Edge,2013-02-04,2013,0,0,0,1.531293
219553,Pulling Strings,2013-10-05,2013,0,0,0,2.587398
219572,Police Story 2013,2013-12-24,2013,0,81170000,81170000,11.982088
219645,Criminal Passion,1994-09-21,1994,0,0,0,1.103071
219666,Letters To Sofija,2013-08-28,2013,0,0,0,0.094366
219674,Euro Trapped,2013-02-28,2013,0,0,0,1.715923
219693,Dopo quella notte,2010-07-09,2010,0,0,0,0.38098
219781,Hilton!,2013-01-01,2013,0,0,0,0.085108
219808,Despiser,2003-04-15,2003,0,0,0,0.28351
219823,The Friends,1971-09-07,1971,0,0,0,0.00022
219924,Days of Hope,1945-06-12,1945,0,0,0,0.387337
219931,Argentina latente,2007-05-24,2007,0,0,0,0.408213
219956,Act Of Love,1980-09-24,1980,0,0,0,0.010648
220002,Bizim Aile,1975-09-07,1975,65700,214600,148900,0.96053
220005,At the First Breath of Wind,2003-09-25,2003,0,0,0,0.07334
220029,When I'm Sixty-four,2004-08-04,2004,0,0,0,0.984786
220075,Nine Muses of Star Empire,2014-09-25,2014,0,0,0,0.528669
220106,We Should Not Exist,2006-05-23,2006,1,0,-1,0.148407
220124,The Optimists of Nine Elms,1973-10-17,1973,0,0,0,1.575666
220153,Iliza Shlesinger: War Paint,2013-01-01,2013,0,0,0,1.978436
220154,The King's Beard,2002-10-02,2002,0,0,0,0.002888
220176,The Face Reader,2013-09-11,2013,0,0,0,1.479373
220200,"Honeybaby, Honeybaby",1974-10-01,1974,0,0,0,4.8e-05
220286,Grand Piano,2013-10-11,2013,0,0,0,6.801095
220287,Chanthaly,2013-05-18,2013,5000,0,-5000,0.572235
220289,Coherence,2013-09-19,2013,0,102617,102617,6.851243
220436,Language of Love,1969-10-02,1969,0,0,0,0.282223
220443,Leave to Remain,2013-10-11,2013,0,0,0,1.107268
220447,Black Butler,2014-01-18,2014,0,0,0,2.106661
220471,The Devil's Hand,2014-10-10,2014,7000000,0,-7000000,3.454884
220488,My Lucky Star,2013-09-17,2013,0,0,0,1.403124
220493,Sal,2013-11-01,2013,0,0,0,1.459401
220494,Bettie Page Reveals All,2013-11-22,2013,0,0,0,2.038869
220500,The Bed You Sleep In,1993-09-10,1993,0,0,0,0.325
220504,Voodoo Tiger,1952-11-15,1952,0,0,0,0.002418
220514,HazMat,2013-08-16,2013,0,0,0,0.452568
220515,Queenie in Love,2001-09-11,2001,0,0,0,0.002696
220565,Donatella,1956-10-28,1956,0,0,0,0.374169
220620,Ismael,2013-12-26,2013,0,0,0,1.246459
220653,Abou Ben Boogie,1944-09-18,1944,0,0,0,0.00695
220656,The Greatest Man in Siam,1944-03-27,1944,0,0,0,0.001187
220669,–ö–æ—Ä–æ–ª—ë–≤,2007-10-29,2007,6000000,31000,-5969000,0.292296
220674,The Wipers Times,2013-09-11,2013,0,0,0,5.207055
220690,Distant Thunder,1988-11-11,1988,0,0,0,0.407729
220714,Grand Masti,2013-09-13,2013,5500000,47000000,41500000,1.250293
220724,Armageddon,1997-01-01,1997,0,0,0,0.580803
220731,The Jewish Cardinal,2013-01-24,2013,0,0,0,0.147828
220746,Jewtopia,2012-04-26,2012,0,0,0,3.74131
220782,Eco-Pirate: The Story of Paul Watson,2011-11-10,2011,0,0,0,0.02037
220809,The Phone Call,2013-10-01,2013,0,0,0,0.488354
220820,Blood of Redemption,2013-09-23,2013,0,0,0,4.314918
220890,The Batman Shootings,2012-08-19,2012,0,0,0,0.194085
220903,Life,2009-12-14,2009,0,0,0,3.267728
220916,Be Seeing You,1968-03-01,1968,0,0,0,0.36791
220933,"No God, No Master",2014-04-11,2014,0,0,0,0.558326
220949,The Halt,2000-10-21,2000,0,0,0,0.371636
220976,The Amati Girls,2001-01-09,2001,0,0,0,0.339692
221112,The Stolen Years,2013-08-29,2013,0,0,0,1.514197
221135,Katherine,1975-10-05,1975,0,0,0,0.230749
221144,Maybe I'll Come Home in the Spring,1971-01-16,1971,0,0,0,0.807754
221148,The Missouri Traveler,1958-01-21,1958,0,0,0,0.457395
221161,Devoured,2012-05-05,2012,0,0,0,1.343647
221171,Kilplased,1974-09-12,1974,0,0,0,0.04958
221234,Suur T√µll,1980-01-01,1980,0,0,0,0.07533
221240,City Slacker,2012-10-04,2012,0,0,0,0.20293
221241,Pero Kvrzica's Comradeship,1970-11-26,1970,0,0,0,0.000603
221317,New Dominion Tank Police,1993-09-13,1993,0,0,0,0.001001
221343,Locked In,2010-09-17,2010,0,0,0,1.083781
221346,Stage Struck,1936-09-12,1936,0,0,0,0.019673
221395,Not So Dumb,1930-02-02,1930,0,0,0,0.630824
221410,Ruins,2013-09-15,2013,0,0,0,0.261283
221418,Hank: 5 Years from the Brink,2013-09-01,2013,0,0,0,0.019561
221437,Miss Zombie,2013-09-14,2013,0,0,0,2.619554
221444,Septic Man,2013-09-20,2013,0,0,0,0.762328
221488,8 Minutes Idle,2012-03-29,2012,400000,0,-400000,4.39814
221510,Dear Dumb Diary,2013-09-06,2013,0,0,0,1.808748
221527,The Girl from Parma,1963-09-14,1963,0,0,0,0.020045
221656,Polly of the Circus,1932-02-26,1932,0,0,0,0.238776
221667,Saint Laurent,2014-09-23,2014,0,0,0,5.657197
221717,The Queens,1966-09-14,1966,0,0,0,0.673996
221731,Rurouni Kenshin: Kyoto Inferno,2014-08-01,2014,0,0,0,10.9506
221732,Rurouni Kenshin: The Legend Ends,2014-09-13,2014,0,0,0,12.253429
221737,RoboCroc,2013-09-14,2013,0,0,0,0.91042
221791,Garage Sale Mystery,2013-09-14,2013,0,0,0,1.975668
221800,Money for Nothing: Inside the Federal Reserve,2013-09-06,2013,0,0,0,1.13826
221801,Naked as We Came,2013-09-13,2013,0,0,0,1.095329
221861,Aspen,1991-01-01,1991,0,0,0,0.091249
221902,"Two Days, One Night",2014-05-21,2014,7000000,6860853,-139147,6.868022
221917,The Run of the Country,1995-09-22,1995,0,0,0,0.117662
221981,The Wrong Girl,1999-01-04,1999,0,0,0,0.563489
222030,Violet,2014-02-02,2014,0,0,0,0.651628
222216,Special ID,2013-10-17,2013,0,12666,12666,4.099795
222220,Shooting Stars,1928-02-06,1928,0,0,0,0.6948
222297,On the Way to School,2013-09-25,2013,0,7424,7424,1.784682
222339,Dune Warriors,1991-01-01,1991,0,0,0,1.292541
222370,Jim Breuer: And Laughter for All,2013-06-07,2013,0,0,0,0.219048
222383,How to Be Louise,1990-01-01,1990,0,0,0,0.015435
222388,One Kine Day,2011-03-11,2011,0,0,0,0.119382
222413,Hellyys,1972-02-17,1972,0,0,0,0.0
222454,3 Hati Dua Dunia Satu Cinta,2010-07-01,2010,0,0,0,0.005882
222461,Wer,2013-11-16,2013,0,0,0,6.635861
222487,scissere,1982-09-13,1982,0,0,0,0.01125
222517,Snow White and 7 Wise Men,1982-04-03,1982,0,0,0,1.382398
222581,Five Thirteen,2013-06-11,2013,0,0,0,1.303049
222600,Matin√©e,1977-09-18,1977,0,0,0,0.654189
222619,The Flash 2 - Revenge of the Trickster,1991-09-18,1991,0,0,0,1.514493
222649,Rosewater,2014-11-07,2014,0,0,0,7.785779
222671,Dick Figures: The Movie,2013-09-16,2013,313411,0,-313411,0.845141
222715,Someone's Gaze,2013-02-08,2013,0,0,0,1.631553
222724,Crystal Lake Memories: The Complete History of Friday the 13th,2013-09-13,2013,0,0,0,2.60673
222731,Chatterbox,1936-01-17,1936,0,0,0,0.763784
222759,"Puerta de Hierro, el exilio de Per√≥n",2013-03-14,2013,0,0,0,0.0291
222772,Lion's Heart,2013-08-15,2013,0,0,0,0.984612
222832,Tales From The Dark 2,2013-09-20,2013,0,0,0,0.283322
222848,Caged Heat 3000,1995-01-01,1995,0,0,0,0.661558
222858,A Bucket of Blood,1995-09-12,1995,0,0,0,0.600683
222870,Subliminal Seduction,1996-01-01,1996,0,0,0,1.013575
222872,Starquest II,1996-01-01,1996,0,0,0,1.188052
222885,Design Is One,2012-10-18,2012,0,0,0,0.126686
222890,Stonados,2013-08-31,2013,0,0,0,0.98076
222899,About Last Night,2014-02-14,2014,12500000,49002684,36502684,9.543004
222911,The Monkey's Paw,2013-10-08,2013,0,0,0,3.062433
222932,The Deathhead Virgin,1974-01-01,1974,0,0,0,4e-06
222935,The Fault in Our Stars,2014-05-16,2014,12000000,307166834,295166834,16.274653
222936,Aloha,2015-05-27,2015,37000000,26250020,-10749980,8.451297
222939,Middle Sexes: Redefining He and She,2005-04-30,2005,0,0,0,0.013087
222951,B.A. Pass,2013-08-02,2013,0,0,0,1.015633
223046,Really Rosie,1975-02-19,1975,0,0,0,2e-06
223195,The Making of a Legend: Gone with the Wind,1988-10-01,1988,0,0,0,0.794217
223202,The Referee,2013-09-12,2013,0,0,0,0.91677
223243,A Phantasy,1952-01-01,1952,0,0,0,0.281658
223249,Documented,2014-05-02,2014,0,0,0,0.278398
223318,Let's Talk About Sex,1998-09-11,1998,0,0,0,0.028316
223346,Bounce: Behind The Velvet Rope,2001-09-07,2001,0,0,0,0.03652
223365,Anjali,1990-07-12,1990,2000000,0,-2000000,0.247816
223389,Dead Silence,1997-09-22,1997,0,0,0,1.28251
223391,7 Days of Himawari & Her Puppies,2013-03-15,2013,0,0,0,0.377677
223485,Slow West,2015-04-16,2015,0,229094,229094,10.132064
223497,Professional Sweetheart,1933-06-09,1933,0,0,0,0.637794
223519,Project Wild Thing,2013-10-25,2013,0,0,0,0.012983
223551,Feuten: Het Feestje,2013-10-24,2013,0,0,0,0.487145
223566,Ghadi,2013-10-31,2013,0,0,0,0.202644
223574,"Tent City, U.S.A",2012-04-05,2012,0,0,0,0.363258
223613,Jackpot 2,1982-03-05,1982,0,0,0,0.319819
223632,The Galapagos Affair: Satan Came to Eden,2014-04-03,2014,0,0,0,2.025628
223655,The Beloved Vagabond,1936-08-24,1936,0,0,0,0.428299
223680,Love Building,2013-09-13,2013,0,0,0,0.049896
223702,Sausage Party,2016-07-11,2016,19000000,140705322,121705322,17.56963
223706,Boy & the World,2014-01-17,2014,0,0,0,5.17816
223816,Hell Below,1933-06-08,1933,0,0,0,1.181772
223895,Class Enemy,2013-08-01,2013,0,0,0,2.441793
223922,Let My Puppets Come,1976-02-14,1976,0,0,0,0.038963
223932,Cupcakes,2013-03-13,2013,0,0,0,0.347375
223946,Les Gazelles,2014-03-26,2014,0,0,0,2.935943
223954,Jacky in the Kingdom of Women,2014-01-29,2014,0,0,0,2.921823
223971,Hunt vs Lauda: F1's Greatest Racing Rivals,2013-07-14,2013,0,0,0,0.520616
224040,Border Feud,1947-05-10,1947,0,0,0,0.141081
224061,Atharintiki Daaredi,2013-09-27,2013,0,0,0,0.915895
224063,The Duel,1981-06-14,1981,0,0,0,0.038308
224076,The Saratov Approach,2013-10-09,2013,0,0,0,0.600061
224079,Revenge,1978-11-12,1978,0,0,0,0.070329
224084,The Last Bullet,1973-05-26,1973,0,0,0,0.015278
224087,Run,2013-10-10,2013,0,0,0,1.041739
224089,A Commissioner's Accusations,1974-07-31,1974,0,0,0,0.022989
224098,The Survivor,2008-04-10,2008,0,0,0,0.289253
224100,The Paw Project,2013-09-27,2013,0,0,0,0.047234
224113,Zombie Fever,2013-08-14,2013,0,750000,750000,0.918522
224141,Into the Woods,2014-12-25,2014,50000000,212902372,162902372,9.580785
224162,Tarnished Angel,1938-10-28,1938,0,0,0,0.048443
224204,Lad: A Yorkshire Story,2013-04-25,2013,0,0,0,0.048779
224233,Mato sem Cachorro,2013-10-04,2013,0,0,0,1.18406
224243,Soulmate,2013-10-18,2013,0,0,0,1.624938
224251,Hunger Point,2003-01-01,2003,0,0,0,0.693522
224282,Torn,2013-10-18,2013,0,0,0,0.316591
224293,Two: The Story of Roman & Nyro,2013-09-28,2013,0,0,0,0.027037
224297,The New Black,2014-02-12,2014,0,0,0,0.069292
224303,Restless Virgins,2013-10-06,2013,0,0,0,1.9057
224339,Onaayum Aattukkuttiyum,2013-09-27,2013,0,0,0,0.38313
224404,Silent Youth,2012-06-01,2012,0,0,0,1.534936
224414,Bound by Flesh,2012-10-19,2012,0,0,0,0.790815
224600,The Executioner,1970-09-06,1970,0,0,0,1.252001
224642,The Scarlet Dove,1961-03-09,1961,0,0,0,0.159754
224659,Sel8nne,2013-09-26,2013,0,0,0,0.849368
224714,Kshanbhar Vishranti,2010-04-09,2010,0,0,0,0.046544
224746,Bekas,2012-11-09,2012,2000000,0,-2000000,1.876356
224778,The Gauntlet,2013-08-23,2013,0,0,0,1.674848
224813,One Man's War,1973-02-27,1973,0,0,0,0.003921
224815,Skinwalker Ranch,2013-10-30,2013,0,0,0,2.750956
224885,Red Wing,2013-10-04,2013,0,0,0,1.204582
224894,The Man Whose Mind Exploded,2014-06-13,2014,0,0,0,0.743082
224903,Final: The Rapture,2013-09-13,2013,0,92100,92100,0.32926
224908,Embrace of the Vampire,2013-10-15,2013,0,0,0,0.562195
224919,A Mother's Rage,2013-04-06,2013,0,0,0,0.576124
224923,Aleksandr's Price,2013-09-23,2013,0,0,0,0.986074
224937,Nervous Ticks,1992-03-01,1992,0,0,0,0.932111
224944,Silent Retreat,2013-10-20,2013,0,0,0,1.108737
224946,Motivational Growth,2013-02-15,2013,176199,0,-176199,0.753227
224950,Solo,2013-08-29,2013,0,0,0,2.080274
224951,Evil Feed,2013-10-23,2013,0,0,0,8.097234
224972,The Mask You Live In,2015-01-01,2015,0,0,0,1.250498
224992,Chasing Beauty,2013-04-02,2013,0,0,0,0.191493
225038,Children of the Age,1915-12-02,1915,0,0,0,0.272696
225044,"Like Sunday, Like Rain",2014-03-01,2014,0,28208,28208,3.524327
225184,Lure of the Sila,1949-12-27,1949,0,0,0,0.093792
225235,The Geographer Drank His Globe Away,2013-07-26,2013,0,4037782,4037782,1.99353
225244,Hokuspokus,1953-08-31,1953,0,0,0,0.083384
225283,Gone Too Far!,2014-10-10,2014,0,0,0,0.369106
225285,Blackwood,2014-08-01,2014,0,0,0,4.658088
225403,A Brief Season,1969-11-26,1969,0,0,0,0.005298
225408,Ernesto,1979-02-01,1979,0,0,0,0.173507
225499,Three Wise Fools,1946-09-26,1946,0,0,0,0.354228
225503,The Adventures of Tarzan,1921-12-01,1921,0,0,0,0.00461
225525,Perry Mason: The Case of the Lost Love,1987-02-23,1987,0,0,0,0.909611
225534,Separation,1968-10-19,1968,0,0,0,0.207129
225564,The Ultimate Accessory,2013-12-11,2013,1400000,0,-1400000,2.912044
225565,That Awkward Moment,2014-01-29,2014,8000000,26049082,18049082,8.060403
225574,Non-Stop,2014-01-26,2014,50000000,222809600,172809600,19.650229
225577,Perry Mason: The Case of the Murdered Madam,1987-10-04,1987,0,0,0,1.496166
225614,My Sons,1991-10-12,1991,0,0,0,0.0
225703,The Starving Games,2013-11-07,2013,4500000,0,-4500000,0.265046
225719,Playing Dead,2013-12-11,2013,0,0,0,3.163048
225728,Macbeth,2015-08-16,2015,15000000,12601706,-2398294,12.493466
225745,Steins;Gate: The Movie ‚àí Load Region of D√©j√† Vu,2013-04-20,2013,0,0,0,3.384668
225747,Vendetta,2013-11-08,2013,0,0,0,3.587006
225760,Lulu,2005-12-07,2005,0,0,0,0.304627
225762,Breakfast With Jonny Wilkinson,2013-11-22,2013,0,0,0,0.19553
225776,Can't You Hear the Wind Howl? The Life & Music of Robert Johnson,1998-09-26,1998,0,0,0,0.668678
225816,Perry Mason: The Case of the Avenging Ace,1988-02-28,1988,0,0,0,0.061195
225834,Operation Diplomat,1953-12-01,1953,0,0,0,0.99295
225850,A Sister's Nightmare,2013-09-07,2013,0,0,0,1.206124
225886,Sex Tape,2014-07-17,2014,40000000,126069509,86069509,27.470696
225898,Exit to Hell,2013-09-30,2013,0,0,0,0.041405
225940,A Man for Burning,1962-06-06,1962,0,0,0,1.534874
225951,"I Am Taraneh, I Am Fifteen Years Old",2002-11-13,2002,0,0,0,0.153677
225958,Walk the Proud Land,1956-08-31,1956,0,0,0,0.51046
225975,The Verdict,2013-10-09,2013,0,0,0,1.963789
225982,From Inside,2008-10-17,2008,0,0,0,0.933743
226001,Die Sch√∂ne und das Biest,2012-08-06,2012,0,0,0,1.248014
226050,Perry Mason: The Case of the Fatal Fashion,1991-09-24,1991,0,0,0,0.502877
226072,Sorry for Kung Fu,2004-07-22,2004,0,0,0,0.078268
226092,Jaane Hoga Kya,2006-08-31,2006,0,0,0,0.008348
226140,See No Evil 2,2014-10-20,2014,0,0,0,4.526854
226163,Il mundial dimenticato,2011-09-05,2011,0,0,0,0.027318
226167,Be My Valentine,2013-02-08,2013,0,0,0,1.422428
226188,Hidden Away,2013-07-26,2013,0,0,0,1.450857
226227,The Disappeared,2008-06-08,2008,0,0,0,0.379198
226229,Mirage,1995-11-21,1995,0,0,0,0.302957
226236,Perry Mason: The Case of the Telltale Talk Show Host,1993-05-21,1993,0,0,0,0.016999
226247,Beautiful Darling,2010-04-02,2010,0,0,0,0.822168
226268,Convenience,2015-10-02,2015,0,0,0,1.184523
226269,13/13/13,2013-09-30,2013,0,0,0,1.714883
226288,Would-Be Gentleman,1968-12-28,1968,0,0,0,0.002307
226354,The Christmas Candle,2013-11-22,2013,0,0,0,1.858675
226363,Powder Room,2013-11-29,2013,0,0,0,3.056024
226437,Life Feels Good,2013-10-11,2013,996519,0,-996519,1.591464
226448,In Your Eyes,2014-04-20,2014,1000000,0,-1000000,8.448518
226458,Backmask,2015-01-16,2015,0,0,0,3.614388
226486,Tammy,2014-07-02,2014,20000000,100525432,80525432,7.359522
226524,Santo en An√≥nimo mortal,1975-04-11,1975,0,0,0,0.000136
226594,Jerusalem,1996-09-05,1996,0,0,0,0.192726
226630,Blackout,1985-07-28,1985,0,0,0,1.018543
226632,Marc Maron: Thinky Pain,2013-10-07,2013,0,0,0,0.45759
226672,Legendary: Tomb of the Dragon,2013-05-16,2013,12000000,0,-12000000,6.554194
226673,Pororo: The Racing Adventure,2013-11-17,2013,0,0,0,1.92858
226675,A Perry Mason Mystery: The Case of the Grimacing Governor,1994-11-09,1994,0,0,0,0.041027
226679,A Perry Mason Mystery: The Case of the Jealous Jokester,1995-04-10,1995,0,0,0,0.88485
226686,Perry Mason: The Case of the Notorious Nun,1986-05-29,1986,0,0,0,0.000844
226693,Spieltrieb,2013-10-10,2013,0,0,0,0.046509
226701,The Nightmare Nanny,2013-07-22,2013,0,0,0,0.987368
226702,The Closed Circuit,2013-04-05,2013,0,0,0,1.027157
226792,Complicity,2013-10-07,2013,0,0,0,0.745203
226857,Endless Love,2014-02-12,2014,20000000,34077920,14077920,8.757277
226936,Aspirante vedovo,2013-10-10,2013,0,0,0,4.195326
226948,Scarecrow,2013-10-05,2013,2000000,0,-2000000,4.322592
226968,Waltz Across Texas,1982-10-01,1982,0,0,0,0.419139
227077,The Undesirable,1915-03-20,1915,0,0,0,1.167734
227094,The Returned,2013-11-15,2013,0,0,0,4.761441
227143,–Ü–≤–∞–Ω –°–∏–ª–∞,2013-10-02,2013,2,0,-2,0.067263
227156,The Giver,2014-08-11,2014,25000000,66980456,41980456,12.472206
227159,Horrible Bosses 2,2014-11-26,2014,42000000,107670357,65670357,20.903362
227196,Freedom Park,2004-09-10,2004,275000,0,-275000,0.003324
227200,Barbie & Her Sisters in A Pony Tale,2013-10-07,2013,0,0,0,9.22546
227245,The Last Day of Summer,1958-08-04,1958,0,0,0,0.15018
227257,Monster High: Fright On!,2011-10-31,2011,500000,0,-500000,2.874652
227261,Love Is Blind,2013-10-11,2013,0,0,0,0.31241
227262,Frau Ella,2013-10-17,2013,0,0,0,4.772213
227266,Desolate,2013-01-01,2013,0,0,0,0.009603
227300,Stretch,2014-10-14,2014,0,0,0,5.700006
227306,Unbroken,2014-12-25,2014,65000000,163442937,98442937,10.543955
227325,A Fighting Man,2014-04-24,2014,0,0,0,1.790372
227334,"Gahan Wilson: Born Dead, Still Weird",2013-10-11,2013,0,0,0,0.024606
227348,Paranormal Activity: The Marked Ones,2014-01-01,2014,5000000,86362372,81362372,8.898523
227350,Mediastan,2013-10-02,2013,0,0,0,1.028643
227359,Force of Execution,2013-12-31,2013,10000000,0,-10000000,2.151259
227370,The Handcuff King,2002-10-04,2002,0,0,0,0.498167
227383,Kolmistaan,2008-02-01,2008,0,0,0,0.455498
227402,Three Wise Girls,1932-02-10,1932,0,0,0,0.209672
227425,Alpha and Omega 2: A Howl-iday Adventure,2013-10-08,2013,0,0,0,2.771081
227462,The Other Side,1994-09-30,1994,0,0,0,0.100404
227481,Trench of Hope,2003-11-10,2003,0,0,0,0.411336
227506,Satan Triumphant,1917-10-21,1917,0,0,0,0.003503
227552,Fixing Pete,2012-01-07,2012,0,0,0,2.353613
227600,Dombivali Fast,2006-10-30,2006,0,0,0,0.007097
227627,El Viaje de la Nonna,2008-02-07,2008,0,0,0,0.077519
227667,Perry Mason: The Case of the Shooting Star,1986-11-08,1986,0,0,0,0.089789
227668,Perry Mason: The Case of the Lady in the Lake,1988-05-15,1988,0,0,0,0.628758
227679,Pok√©mon the Movie: Genesect and the Legend Awakened,2013-07-13,2013,0,50000000,50000000,2.199471
227690,"A la legi√≥n le gustan las mujeres... y a las mujeres, les gusta la legi√≥n",1976-03-16,1976,0,0,0,0.659568
227700,Mindscape,2013-10-13,2013,4357373,1200000,-3157373,10.860471
227707,The Adventurer: The Curse of the Midas Box,2013-12-05,2013,25000000,6399,-24993601,5.955203
227717,A Letter for Evie,1946-01-28,1946,0,0,0,0.741787
227719,Project Almanac,2015-01-29,2015,12000000,32248241,20248241,9.363482
227735,Dolphin Tale 2,2014-09-12,2014,36000000,52424533,16424533,8.268684
227783,The Nut Job,2014-01-17,2014,0,0,0,7.875793
227800,Here Be Dragons,2013-08-30,2013,0,0,0,0.165477
227832,Hogi Pyar Ki Jeet,1999-05-07,1999,0,0,0,0.201944
227859,The Book of Daniel,2013-10-01,2013,0,0,0,0.281921
227871,Skull Forest,2012-06-09,2012,0,0,0,0.286401
227877,Torment,2013-10-11,2013,0,0,0,2.764915
227932,My Mom Is a Character 2,2016-12-22,2016,0,0,0,4.117801
227964,A Esperan√ßa √© a √öltima Que Morre,2015-09-03,2015,0,0,0,1.012104
227970,Men Are From Mars... And That‚Äôs Where I‚Äôm Going!,2014-05-02,2014,0,0,0,1.45267
227973,The Peanuts Movie,2015-11-05,2015,99000000,246233113,147233113,12.338346
227975,Futuro Beach,2014-05-01,2014,0,0,0,2.041913
227998,Tomorrow Was the War,1987-10-18,1987,0,0,0,0.985424
228012,Raat,1992-02-06,1992,0,0,0,0.473169
228028,Back in the Day,2014-01-07,2014,0,0,0,3.761562
228034,The Bronx Bull,2016-06-13,2016,7000000,0,-7000000,1.906459
228039,Losers Take All,2013-10-25,2013,0,0,0,0.711452
228066,Victor Frankenstein,2015-11-10,2015,40000000,34227298,-5772702,9.447808
228074,The Blue Lagoon,1949-03-01,1949,0,0,0,0.99654
228101,Waar,2013-10-16,2013,2000000,0,-2000000,1.423913
228108,The Road Within,2014-10-24,2014,0,0,0,10.968889
228109,Two-Bit Waltz,2014-11-21,2014,0,0,0,1.320951
228150,Fury,2014-10-15,2014,68000000,211817906,143817906,36.713807
228161,Home,2015-03-18,2015,135000000,368871007,233871007,13.422713
228165,The SpongeBob Movie: Sponge Out of Water,2015-02-05,2015,74000000,311594032,237594032,12.334689
228184,Os Caras de Pau em O Misterioso Roubo do Anel,2014-12-25,2014,0,0,0,0.747073
228194,The Hundred-Foot Journey,2014-08-06,2014,22000000,88880821,66880821,14.466789
228198,Eu N√£o Fa√ßo a Menor Ideia do que eu T√¥ Fazendo Com a Minha Vida,2013-12-20,2013,0,0,0,1.247536
228202,Meu Passado me Condena,2013-10-25,2013,0,0,0,2.994109
228203,"McFarland, USA",2015-02-20,2015,0,45710059,45710059,6.894606
228204,Bayou Blue,2011-11-23,2011,0,0,0,0.060943
228205,The Longest Ride,2015-04-09,2015,34000000,63013281,29013281,10.264416
228216,Molly's Way,2007-03-16,2007,0,0,0,0.027063
228221,The Edge of Dreaming,2010-11-12,2010,0,0,0,0.041197
228245,The Suspect,2013-10-16,2013,0,0,0,7.130407
228257,Perry Mason: The Case of the Fatal Framing,1992-03-01,1992,0,0,0,0.91233
228290,Una piccola impresa meridionale,2013-10-17,2013,0,0,0,1.839066
228294,Now Add Honey,2015-11-05,2015,0,0,0,2.44269
228326,The Book of Life,2014-10-01,2014,50000000,97437106,47437106,10.337994
228331,A Perfect Man,2013-11-01,2013,5000000,388,-4999612,1.740242
228339,Little England,2013-12-05,2013,0,0,0,1.244045
228355,Boss,2013-10-16,2013,0,0,0,1.368442
228358,The Pact II,2014-09-05,2014,0,0,0,3.957941
228381,Broken Glass Park,2013-11-21,2013,0,0,0,0.386259
228384,Eltern,2013-11-14,2013,0,0,0,0.717777
228407,Snow on the Pines,2013-04-09,2013,0,0,0,0.175791
228426,Jellyfish Eyes,2013-04-23,2013,0,0,0,1.512573
228432,The Dogs of Riga,1995-11-09,1995,0,0,0,0.407625
228442,D√©jeuner du matin,1974-01-01,1974,0,0,0,0.00022
228444,Hell Is Sold Out,1951-06-01,1951,0,0,0,0.063133
228445,Stockholm Stories,2013-10-12,2013,0,0,0,1.343408
228455,The Order,1973-01-01,1973,0,0,0,0.000431
228496,Sx_Tape,2014-05-16,2014,600000,0,-600000,2.558803
228558,The Harry Hill Movie,2013-12-20,2013,0,0,0,0.918007
228606,The Secret Village,2013-10-18,2013,0,0,0,1.072757
228634,Wodehouse In Exile,2013-03-25,2013,0,0,0,0.502063
228642,Exit,2000-07-11,2000,1000000,0,-1000000,2.115358
228647,Miracles For Sale,1939-08-14,1939,0,0,0,0.360066
228650,Tahkhana,1986-12-11,1986,0,0,0,0.003086
228676,Mischief Night,2013-10-30,2013,0,0,0,5.26591
228687,Playboy Bong,2013-08-29,2013,0,0,0,0.634213
228692,Cheatin',2013-10-18,2013,0,0,0,1.246418
228736,Banklady,2013-09-29,2013,0,0,0,2.316797
228813,Neurons to Nirvana,2013-10-19,2013,0,0,0,0.12616
228890,Milk and Honey,2003-01-18,2003,0,0,0,0.002353
228915,Lord of Tears,2013-10-25,2013,0,0,0,0.950974
228941,Au revoir l'√©t√©,2013-10-19,2013,0,0,0,0.908361
228967,The Interview,2014-12-25,2014,44000000,12342632,-31657368,14.526049
228968,Kidnapping Mr. Heineken,2015-03-12,2015,0,2633527,2633527,10.588578
228970,Wild,2014-12-05,2014,15000000,52501541,37501541,11.209154
228973,Backcountry,2015-03-20,2015,0,0,0,8.101355
228987,Gossip,2000-12-24,2000,0,0,0,1.02508
229005,The Bachelor Father,1931-01-10,1931,0,0,0,0.687631
229007,"The Fj√§llbacka Murders: The Sea Gives, the Sea Takes",2013-09-22,2013,0,0,0,1.657725
229056,The Christmas Carol,1949-12-25,1949,0,0,0,0.625043
229065,A Fuller Life,2013-08-28,2013,0,0,0,0.773687
229081,Perry Mason: The Case of the Musical Murder,1989-04-09,1989,0,0,0,0.960987
229087,Perry Mason: The Case of the Lethal Lesson,1989-02-12,1989,0,0,0,0.081165
229088,Perry Mason: The Case of the Poisoned Pen,1990-01-21,1990,0,0,0,0.098745
229094,Perry Mason: The Case of the Defiant Daughter,1990-09-30,1990,0,0,0,1.160214
229097,Perry Mason: The Case of the All-Star Assassin,1989-11-09,1989,0,0,0,1.181879
229113,The Kiyosu Conference,2013-11-09,2013,0,0,0,1.119661
229134,Catherine of Russia,1963-01-12,1963,0,0,0,0.699076
229138,Djinn,2013-10-31,2013,0,0,0,3.650947
229154,Styria,2013-10-20,2013,0,0,0,1.819556
229182,The Harvest,2013-10-19,2013,0,0,0,3.7258
229194,Kamikaze,2014-03-28,2014,0,0,0,1.22002
229221,Spring Is Here,1930-04-13,1930,0,0,0,0.159771
229254,Veranda f√∂r en tenor,1998-09-10,1998,0,0,0,0.228584
229296,Justin Bieber's Believe,2013-12-19,2013,0,0,0,3.389968
229297,Magic in the Moonlight,2014-07-25,2014,16800000,51029361,34229361,6.626077
229304,Han Gong-ju,2015-05-08,2015,0,0,0,3.447972
229328,Electricity,2014-12-12,2014,0,0,0,6.634536
229353,No M√°s,2013-10-15,2013,0,0,0,0.393128
229373,F√∂delsedagen,2000-03-23,2000,0,0,0,0.062888
229526,Killer Holiday,2013-10-18,2013,0,0,0,2.150981
229559,The Unexpected Love,2014-04-25,2014,0,0,0,2.270692
229582,Marina,2013-11-06,2013,0,0,0,2.49939
229594,A Dangerous Place,1995-04-25,1995,0,0,0,0.604166
229610,Adventure in Baltimore,1949-04-19,1949,0,0,0,1.043631
229613,Trailer Park Jesus,2012-03-30,2012,0,0,0,0.396249
229638,Alcatraz Island,1937-11-06,1937,0,0,0,0.185221
229670,Manrape,1978-02-24,1978,0,0,0,0.563926
229693,Supervention,2013-10-24,2013,0,0,0,1.02124
229702,Zephyr Springs,2013-06-01,2013,0,0,0,0.667285
229757,The Romance of Rosy Ridge,1947-08-04,1947,0,0,0,0.552976
229768,Living on One Dollar,2013-04-22,2013,0,0,0,1.510944
229839,Grave Halloween,2013-10-19,2013,0,0,0,8.872865
229878,Blood and Ties,2013-10-24,2013,0,0,0,1.919238
229974,Bitterly!,2013-10-24,2013,0,0,0,2.189262
230029,Top Star,2013-10-24,2013,0,0,0,1.772446
230031,Evacuate Earth,2012-12-02,2012,0,0,0,0.222715
230058,Tumbledown,2013-10-25,2013,0,0,0,0.19187
230095,"Jack, Jules, Esther, & Me",2013-10-25,2013,0,0,0,0.215562
230158,Aziz Ansari: Buried Alive,2013-11-01,2013,0,0,0,2.609603
230170,Sarah Silverman: We Are Miracles,2013-11-23,2013,0,0,0,0.571269
230179,Big Game,2014-09-05,2014,8500000,7500000,-1000000,6.911759
230182,Crashing Las Vegas,1956-04-27,1956,0,0,0,0.140066
230210,Kotsutsubo,2012-05-26,2012,0,0,0,0.760241
230211,Bros Before Hos,2013-12-05,2013,0,0,0,1.890572
230217,Soof,2013-12-12,2013,0,0,0,1.54419
230222,Tarzan,2013-07-25,2013,0,0,0,8.651247
230232,Heavenly Shift,2013-10-24,2013,0,0,0,0.293873
230235,Ma√Øna,2014-03-21,2014,0,0,0,0.731458
230266,Miss Julie,2014-09-07,2014,5500000,5000000,-500000,3.791712
230284,One Man's Journey,1933-08-31,1933,0,0,0,0.625556
230295,Hur som helst √§r han j√§vligt d√∂d,2000-08-31,2000,0,0,0,0.024416
230428,Cas & Dylan,2013-09-17,2013,0,0,0,2.654508
230437,Phool Aur Kaante,1991-11-22,1991,0,0,0,0.000118
230471,Colossus of the Arena,1962-09-12,1962,0,0,0,0.11984
230588,Peace After Marriage,2013-10-28,2013,0,0,0,0.67275
230606,Pigs with a P.38,1978-09-23,1978,0,0,0,0.053761
230628,Hayabusa: The Long Voyage Home,2012-02-11,2012,0,0,0,0.631228
230680,Nachbarinnen,2004-11-10,2004,0,0,0,0.147153
230722,Steel Cold Winter,2013-11-07,2013,0,0,0,0.725267
230731,Louis & Luca and the Snow Machine,2013-11-08,2013,0,0,0,0.992521
230743,My Prairie Home,2013-11-29,2013,0,0,0,0.150494
230779,Cesar Chavez,2014-03-28,2014,10000000,0,-10000000,2.851638
230836,Levitated Mass,2013-06-20,2013,0,0,0,0.360916
230846,The Pig,2013-10-09,2013,0,0,0,0.732843
230864,Marvin Hamlisch: What He Did For Love,2013-10-12,2013,0,0,0,0.371755
230867,"Ta≈ükafa, Stories of the Street",2013-10-15,2013,0,0,0,0.023512
230896,Iron Man & Hulk: Heroes United,2013-12-03,2013,0,0,0,4.704713
231001,All Hallows' Eve,2013-10-29,2013,0,0,0,6.556384
231009,Sogno di una notte di mezza sbornia,1959-10-28,1959,0,0,0,0.035269
231020,My Class,2013-10-10,2013,0,0,0,0.049983
231038,The Enemy Within,2013-11-13,2013,0,0,0,0.243041
231082,Gingerdead Man vs. Evil Bong,2013-10-29,2013,0,0,0,1.136578
231145,Tom Papa: Freaked Out,2013-04-16,2013,0,0,0,0.476319
231176,Sole a catinelle,2013-10-31,2013,0,0,0,5.52971
231216,Villa Henriette,2004-12-02,2004,0,0,0,0.002513
231218,Dog,2001-08-16,2001,0,0,0,0.107046
231263,Little Hope Was Arson,2013-10-19,2013,0,0,0,0.201735
231304,Faustina,1968-10-10,1968,0,0,0,0.016703
231392,Lost in the Stars,1974-04-08,1974,0,0,0,0.298147
231401,The Sound of Music Live!,2013-12-05,2013,0,0,0,1.277081
231472,The Christmas Party,1996-11-29,1996,0,0,0,0.235641
231474,The Hunters,2013-10-25,2013,0,0,0,4.868184
231510,Inseparable,2013-04-27,2013,0,0,0,0.479777
231540,Unter Strom,2009-12-10,2009,0,0,0,0.327866
231562,Living Images,2013-02-21,2013,0,0,0,0.200704
231565,"Zoran, il mio nipote scemo",2013-10-31,2013,0,0,0,0.361771
231576,Wish I Was Here,2014-01-18,2014,5500000,5483299,-16701,6.149295
231616,Brother's Keeper,2013-04-05,2013,0,0,0,0.493106
231617,"Signed, Sealed, Delivered",2013-10-13,2013,0,0,0,0.811948
231625,The Cheating Pact,2013-09-28,2013,0,0,0,0.414467
231762,8,2010-04-30,2010,0,0,0,0.087512
231763,"Boys Diving, Honolulu",1901-01-01,1901,0,0,0,0.002307
231811,The Fj√§llbacka Murders: The Queen of Lights,2013-09-29,2013,0,0,0,1.986595
231812,The Fj√§llbacka Murders: The Coast Rider,2013-09-22,2013,0,0,0,1.568161
232005,Jude the Obscure,1971-10-03,1971,0,0,0,0.109213
232018,Parineeta,1953-01-01,1953,0,0,0,0.001253
232034,The Desert Song,1953-05-30,1953,0,0,0,0.808048
232048,This Is What They Want,2013-10-29,2013,0,0,0,0.015427
232078,Triple Crossed,2013-11-12,2013,41000,0,-41000,1.526916
232100,Riley Rewind,2013-12-12,2013,70,0,-70,0.549689
232137,"Annual Baby Parade, 1904, Asbury Park, N.J.",1904-09-01,1904,0,0,0,0.001177
232175,Gimme Shelter,2013-10-17,2013,7500000,1359910,-6140090,5.636855
232351,Two Raging Grannies,2013-11-13,2013,0,0,0,0.061298
232420,Twinkle,1992-10-24,1992,0,0,0,0.464681
232462,Styx,2001-10-15,2001,0,0,0,1.067588
232496,Bicchoo,2000-07-06,2000,0,0,0,0.150754
232572,A Walk in the Woods,2015-09-02,2015,8000000,35991087,27991087,12.019571
232610,JFK: The Smoking Gun,2013-11-15,2013,0,0,0,0.854159
232672,Blended,2014-05-21,2014,40000000,123494610,83494610,10.395472
232679,When the Game Stands Tall,2014-08-22,2014,15000000,30127963,15127963,6.617708
232711,Khauff,2000-03-02,2000,0,0,0,0.057319
232728,Takkar,1995-07-13,1995,0,0,0,0.11317
232731,Attila,2013-12-31,2013,0,0,0,1.369503
232739,Perfumed Ball,1997-08-01,1997,0,0,0,0.020369
232795,Albela,2001-04-19,2001,0,0,0,0.280706
232817,Plan,2004-01-08,2004,0,0,0,0.043816
232860,Who Killed Aunt Maggie?,1940-11-01,1940,0,0,0,0.343011
232862,A Little Stiff,1991-03-16,1991,0,0,0,0.0375
232866,And So It Is,1966-11-06,1966,0,0,0,0.640637
232898,Storm Rider,2013-10-22,2013,0,0,0,1.418856
232943,Diabolical Pickpocket,1908-01-01,1908,0,0,0,0.280909
233063,Fuck You Goethe,2013-11-07,2013,5000000,0,-5000000,12.957093
233112,The White Storm,2013-11-29,2013,0,0,0,3.437346
233204,The Pink Jungle,1968-10-16,1968,0,0,0,0.480577
233208,Warhouse,2013-10-28,2013,0,0,0,0.95326
233383,Robin Redbreast,1970-12-10,1970,0,0,0,0.560004
233423,The Legend of Sarila,2013-02-22,2013,0,15000000,15000000,3.296338
233438,The Fat Spy,1966-05-11,1966,0,0,0,0.768536
233444,Cold Harbour,2014-07-25,2014,0,0,0,0.974266
233466,Hawaiian: The Legend of Eddie Aikau,2013-10-01,2013,0,0,0,0.867766
233470,Jamesy Boy,2014-01-03,2014,0,0,0,4.149254
233487,He Who Dares,2014-01-31,2014,1000000,0,-1000000,1.42988
233490,Underdog Kids,2015-06-07,2015,0,0,0,0.561918
233564,Dumbbells,2014-01-10,2014,0,0,0,1.231539
233639,Windstorm,2013-03-21,2013,0,0,0,5.912736
233805,Bakhita,2009-04-04,2009,0,0,0,1.282949
233841,i hate myself :),2013-07-19,2013,0,0,0,0.053694
233863,Jimi Hendrix: Hear My Train A Comin',2013-11-05,2013,0,0,0,1.164304
233880,At the Ends of the Earth,1999-01-01,1999,0,0,0,0.474312
233917,Kalevala - Uusi aika,2013-11-14,2013,0,0,0,0.07281
234004,Ratchet & Clank,2016-04-13,2016,20000000,8821329,-11178671,9.115939
234154,Mr. Baum,1997-01-01,1997,0,0,0,0.338423
234155,Asier ETA biok,2014-01-17,2014,0,0,0,0.052853
234200,Pride,2014-09-12,2014,0,7523634,7523634,9.111867
234212,Demonic,2015-02-12,2015,3000000,3387000,387000,9.234943
234284,Time of Eve: The Movie,2010-03-05,2010,0,0,0,1.768157
234356,L'ultima ruota del carro,2013-11-14,2013,0,0,0,1.875188
234377,Corn on the Cop,1965-07-23,1965,0,0,0,0.328171
234555,Speciesism: The Movie,2013-09-18,2013,0,0,0,0.132374
234567,Get a Horse!,2013-11-27,2013,0,0,0,5.418712
234652,I Heart Monster Movies,2012-10-12,2012,0,0,0,0.192983
234815,Las Poquianchis,1976-11-17,1976,0,0,0,0.824564
234850,Tommy and the Wildcat,1998-12-18,1998,0,0,0,0.211338
234862,Mr Hublot,2013-10-14,2013,295000,0,-295000,2.910784
234868,The Shiralee,1957-07-11,1957,0,0,0,0.400818
234931,Russell Brand - From Addiction to Recovery,2012-10-01,2012,0,0,0,0.36059
234937,Forever,2006-10-05,2006,130,0,-130,0.554205
234942,Shades of Fern,1986-01-01,1986,0,0,0,0.007795
235044,The Little Ghost,2013-11-07,2013,0,0,0,3.288602
235046,Darkroom,2013-03-10,2013,0,0,0,1.906993
235092,The Boys,1962-08-31,1962,0,0,0,0.442789
235093,Killing Kennedy,2013-11-10,2013,0,0,0,10.705301
235199,We Stand Alone Together,2001-11-10,2001,0,0,0,0.807334
235201,I-Be Area,2007-09-08,2007,0,0,0,0.005286
235208,Come il vento,2013-11-10,2013,110,0,-110,1.497667
235260,Son of God,2014-02-28,2014,22000000,67800064,45800064,6.477292
235271,Addicted,2014-10-10,2014,0,0,0,11.005911
235373,The Flaying,2012-07-17,2012,0,0,0,0.047401
235450,Bloodmoney,2010-05-14,2010,0,0,0,0.008348
235662,Snow Bride,2013-11-09,2013,0,0,0,2.443418
235679,Dr. Socrates,1935-10-18,1935,0,0,0,0.633664
235690,Low: You May Need a Murderer,2008-06-04,2008,0,0,0,0.080191
235704,Commitment,2013-11-05,2013,0,0,0,6.555233
235708,Going Under,2004-10-21,2004,0,0,0,0.982345
235932,Le grand M√©li√®s,1952-11-12,1952,0,0,0,0.036519
235984,Goliyon Ki Raasleela Ram-Leela,2013-11-15,2013,0,32000000,32000000,6.034115
236007,Naksha,2006-09-07,2006,0,0,0,0.083143
236017,A Hound for Trouble,1951-04-27,1951,0,0,0,0.067518
236035,Gunfighter's Moon,1997-03-25,1997,0,0,0,0.722797
236041,En B√ºy√ºk ≈ûaban,1983-02-21,1983,0,0,0,0.162816
236053,Japon ƒ∞≈üi,1987-11-29,1987,0,0,0,0.219218
236112,Hurdy-Gurdy Hare,1950-01-20,1950,0,0,0,0.393392
236314,Alphabet,2013-10-31,2013,0,0,0,0.872106
236317,Benim D√ºnyam,2013-10-25,2013,0,0,0,1.078967
236324,Social Nightmare,2013-08-31,2013,0,0,0,2.1238
236329,Something good,2013-11-07,2013,0,0,0,0.410423
236368,Song 'e napule,2013-11-11,2013,0,0,0,1.673506
236395,Success At Any Price,1934-03-16,1934,0,0,0,0.400912
236399,Flowers in the Attic,2014-01-18,2014,0,0,0,5.658774
236417,A Golden Christmas 3,2013-10-16,2013,0,0,0,1.00752
236539,The Field Mouse,1941-12-26,1941,0,0,0,0.001177
236570,The Battle Of The Villa Fiorita,1965-05-26,1965,0,0,0,1.000416
236655,Fresh Hare,1942-08-21,1942,0,0,0,0.566334
236661,Kinbaku,2010-03-12,2010,0,0,0,0.008558
236696,Fin'n Catty,1943-10-22,1943,0,0,0,1.210431
236735,Marshland,2014-09-25,2014,4000000,5169755,1169755,11.127717
236737,Spanish Affair,2014-03-14,2014,3000000,0,-3000000,5.255451
236751,Heaven is for Real,2014-04-16,2014,12000000,101332962,89332962,7.88371
236808,Pizza 2: Villa,2013-11-14,2013,0,0,0,0.789104
236873,Lulu in the Nude,2013-09-28,2013,0,0,0,1.445183
237139,McDougal's Rest Farm,1947-01-30,1947,0,0,0,0.001287
237156,Stupidstitious Cat,1947-04-24,1947,0,0,0,0.079688
237171,Londra chiama Polo Nord,1956-11-30,1956,0,0,0,0.671717
237200,Jerusalem,2013-11-16,2013,0,0,0,1.758496
237202,A Soldier's Tale,1988-06-16,1988,0,0,0,1.162388
237214,Duniyadari,2014-07-19,2014,390000,3,-389997,0.016219
237303,Home,2013-11-22,2013,0,0,0,0.674967
237422,Avetik,1992-04-04,1992,0,0,0,0.149675
237433,Paris in Spring,1935-05-27,1935,0,0,0,1.163641
237506,The King,2002-11-09,2002,0,0,0,0.418789
237549,Long Day's Journey Into Night,1987-04-12,1987,0,0,0,1.046644
237584,Mojave,2015-04-18,2015,0,0,0,4.393887
237672,Devasuram,1993-04-14,1993,0,0,0,1.140929
237692,This American Journey,2013-10-22,2013,0,0,0,0.322836
237709,The Twelve Trees of Christmas,2013-11-16,2013,0,0,0,1.224565
237710,Pete's Christmas,2013-11-16,2013,0,0,0,7.473462
237718,How Sherlock Changed the World,2013-10-18,2013,0,0,0,0.011959
237756,Kill Me Three Times,2015-04-10,2015,0,0,0,11.616811
237791,The Way He Looks,2014-03-28,2014,0,0,0,5.711274
237796,Don Juan,1998-04-28,1998,0,0,0,0.607746
237799,Un grand cri d'amour,1998-01-07,1998,0,0,0,0.041901
237808,Quod erat demonstrandum,2013-11-12,2013,0,0,0,0.275499
237811,Blue Sky Bones,2013-11-13,2013,0,0,0,0.223245
237925,The Squeeze,1978-10-25,1978,0,0,0,0.404348
237957,Nostos: The Return,1989-12-31,1989,0,0,0,1.579447
237960,Starring Adam West,2013-03-13,2013,0,0,0,0.363086
237983,Just Ask My Children,2001-09-10,2001,0,0,0,1.373713
238006,Utopia,2013-11-15,2013,0,0,0,0.783818
238008,Death Mills (Die Todesm√ºhlen),1945-07-10,1945,0,0,0,0.036523
238067,Wrestling For Jesus: The Tale of T-Money,2011-01-01,2011,0,0,0,0.084771
238090,Rage of Angels: The Story Continues,1986-11-02,1986,0,0,0,0.567895
238124,The Plainsman,1966-08-01,1966,0,0,0,0.881416
238177,Jimmy Carr: Laughing and Joking,2013-11-17,2013,0,0,0,0.170595
238185,Russell Brand: Messiah Complex,2013-11-25,2013,0,0,0,1.197497
238203,A Star Athlete,1937-05-01,1937,0,0,0,0.001247
238204,Bending the Rules,2013-03-15,2013,0,0,0,0.011789
238206,Eddie Izzard: Force Majeure Live,2013-11-18,2013,0,0,0,0.119615
238215,The Cobbler,2014-09-11,2014,0,0,0,8.144255
238222,Bill Bailey: Qualmpeddler,2013-11-19,2013,0,0,0,1.331378
238255,Micky Flanagan: Live - Back In The Game Tour,2013-11-18,2013,0,0,0,0.308739
238302,Saving Santa,2013-11-05,2013,7500000,0,-7500000,3.928468
238304,Catch a Christmas Star,2013-11-17,2013,0,0,0,1.172252
238307,The Isle of Lost Ships,1987-04-19,1987,0,0,0,0.051647
238358,Fear Lives Here,2013-05-16,2013,0,0,0,0.086426
238362,Morsian yll√§tt√§√§,1941-04-27,1941,0,0,0,0.038957
238368,High Barbaree,1947-05-01,1947,0,0,0,0.376197
238397,James Dean Remembered,1974-01-01,1974,0,0,0,0.011025
238398,Grantham and Rose,2014-03-23,2014,0,0,0,0.428953
238399,Bill Cosby: Far From Finished,2013-11-23,2013,0,0,0,0.560453
238407,Aningaaq,2013-10-19,2013,0,0,0,2.411144
238436,The Robber Symphony,1937-07-01,1937,0,0,0,0.001951
238442,Lunch Box,2004-11-20,2004,35000,0,-35000,0.350152
238456,Een Monument voor een Gorilla,1987-01-01,1987,0,0,0,0.060375
238458,Dead Before Dawn,1993-01-09,1993,0,0,0,1.875793
238475,Best Night Ever,2014-01-31,2014,0,0,0,2.546891
238478,Six by Sondheim,2013-12-09,2013,0,0,0,1.718417
238529,Triangle: Remembering the Fire,2011-03-21,2011,0,0,0,0.053228
238561,Return to Homs,2013-11-20,2013,0,0,0,0.855689
238589,Enemies Closer,2013-12-04,2013,5000000,0,-5000000,10.349323
238593,How to Follow Strangers,2013-10-28,2013,0,0,0,0.779087
238603,Earth to Echo,2014-06-14,2014,13000000,45300000,32300000,12.412221
238615,Self/less,2015-07-10,2015,26000000,30523226,4523226,25.301568
238616,The Big Hangover,1950-05-26,1950,0,0,0,0.006394
238628,Tangerines,2013-10-16,2013,0,0,0,4.486649
238636,The Purge: Anarchy,2014-07-17,2014,9000000,108782847,99782847,27.756026
238705,The Bad Child,2013-11-20,2013,0,0,0,0.116686
238713,Spy,2015-05-06,2015,65000000,235666219,170666219,13.257467
238748,Aloha Summer,1988-02-26,1988,0,0,0,1.256126
238749,A Very Merry Mix-Up,2013-11-10,2013,0,0,0,1.249753
238781,24 Days,2014-04-30,2014,0,0,0,2.034935
238792,The Mayor of Casterbridge,2003-12-28,2003,0,0,0,0.666079
238811,No Man's Land,2013-12-03,2013,0,0,0,1.33256
238869,All Inclusive 2,2013-10-03,2013,0,0,0,0.715996
238923,The Art of Happiness,2013-11-21,2013,0,0,0,1.884509
238925,Il terzo tempo,2013-11-21,2013,0,0,0,0.132724
238952,Along the Coast,1958-01-01,1958,0,0,0,0.382091
238972,Blind Faith,1998-11-23,1998,0,0,0,1.325824
238985,Hiawatha,1952-12-28,1952,0,0,0,0.337448
238997,Louis Theroux: America's Most Dangerous Pets,2011-10-29,2011,0,0,0,0.198665
239018,A Lesson in Romance,2014-02-19,2014,0,0,0,1.386846
239030,Love Steaks,2013-06-29,2013,0,0,0,1.932176
239033,Escape to Witch Mountain,1995-04-29,1995,0,0,0,1.749574
239056,Hairbrained,2013-05-31,2013,0,0,0,3.093346
239091,Forbidden Island,1959-03-01,1959,0,0,0,0.019608
239103,Run Boy Run,2013-11-12,2013,0,0,0,3.21968
239123,1000 Journals,2007-11-01,2007,0,0,0,0.041202
239155,Schooled: The Price of College Sports,2013-10-16,2013,0,0,0,1.020954
239180,Window Wonderland,2013-11-23,2013,0,0,0,0.883931
239367,Giovanni's Island,2014-02-22,2014,0,0,0,2.748559
239368,Do We Really Need the Moon?,2011-02-01,2011,0,0,0,0.095046
239395,Workers Leaving the Factory,1995-01-01,1995,0,0,0,0.148929
239417,The Wedding Chest,2005-12-01,2005,0,0,0,0.080188
239498,"Girl, Positive",2007-06-25,2007,0,0,0,1.442375
239513,The Perfect Wife,2001-05-21,2001,0,0,0,0.473526
239519,Close to My Heart,1951-10-01,1951,0,0,0,0.307726
239523,Hunter √ó Hunter: The Last Mission,2013-12-27,2013,0,0,0,1.771411
239534,Beni Unutma,2011-11-11,2011,0,0,0,0.014553
239536,The Golden Key,1939-12-20,1939,0,0,0,0.117004
239553,Ito: Diary of an Urban Priest,2010-11-12,2010,560000,0,-560000,0.006265
239562,The Single Moms Club,2014-03-14,2014,0,16337881,16337881,12.017861
239563,St. Vincent,2014-10-09,2014,13000000,54837234,41837234,13.655752
239566,Get on Up,2014-08-01,2014,0,31911598,31911598,7.92736
239568,Search Party,2014-10-30,2014,20000000,0,-20000000,9.003162
239571,The Best of Me,2014-10-16,2014,26000000,35926213,9926213,8.196975
239573,Unfinished Business,2015-03-05,2015,35000000,14431253,-20568747,10.24952
239619,Hanna's Journey,2014-01-23,2014,0,0,0,1.084761
239628,Dead End Road,2004-11-26,2004,100000,0,-100000,0.237293
239650,A Madea Christmas,2011-11-22,2011,0,0,0,1.143067
239678,This Is Where I Leave You,2014-09-10,2014,19800000,41296320,21496320,11.313659
239706,Sam Peckinpah's West: Legacy of a Hollywood Renegade,2004-07-25,2004,0,0,0,0.853458
239747,The Wankers,2011-07-06,2011,0,0,0,0.04241
239783,Figli di Annibale,1998-11-27,1998,0,0,0,0.234146
239798,"Water, Wind, Dust",1989-11-27,1989,0,0,0,0.071422
239804,Path of Destruction,2005-09-24,2005,0,0,0,1.459471
239845,The Patrol,2013-10-04,2013,1000000,0,-1000000,0.700185
239853,11 A.M.,2013-11-28,2013,0,0,0,1.585162
239877,The Mafia Kills Only in Summer,2013-11-28,2013,0,0,0,7.791341
239895,Twisted,2013-11-28,2013,140000,0,-140000,0.305248
240154,The Life Coach,2005-11-29,2005,0,0,0,0.778952
240177,Dirt,2001-04-21,2001,0,0,0,0.078905
240268,Sriracha,2013-11-29,2013,20000,0,-20000,0.387837
240334,Blablabl√°,1968-01-02,1968,0,0,0,0.006336
240341,Ghost in the Shell Arise - Border 3: Ghost Tears,2014-06-28,2014,0,0,0,4.522408
240478,Nobody's Perfect,2008-01-01,2008,0,0,0,0.105521
240483,Robot Overlords,2015-01-29,2015,21000000,0,-21000000,6.184303
240491,Ngati,1987-07-01,1987,0,0,0,0.023569
240510,Stromberg - Der Film,2014-02-20,2014,0,0,0,4.690582
240566,Tokyo Tribe,2014-08-30,2014,0,0,0,3.527196
240581,Best in Bed,2014-01-15,2014,0,0,0,1.210937
240594,Born Reckless,1937-07-09,1937,0,0,0,0.861046
240607,The Sicilian Connection,1972-12-21,1972,0,0,0,0.584682
240628,Black Wind,1964-01-02,1964,0,0,0,0.155926
240629,The Class of '92,2013-12-01,2013,0,0,0,1.941454
240634,How Videogames Changed the World,2013-11-30,2013,0,0,0,1.199804
240636,Rhinoceros,1964-01-01,1964,0,0,0,0.142337
240679,My way to Olympia,2013-10-17,2013,0,0,0,0.047085
240704,Island of Lemurs: Madagascar,2014-04-03,2014,0,0,0,3.468118
240723,Coming Home for Christmas,2013-10-29,2013,0,0,0,0.716966
240733,Shame the Devil,2013-12-02,2013,3000000,0,-3000000,1.731445
240737,Live at the Foxes Den,2013-12-06,2013,0,0,0,1.05602
240745,Cymbeline,2014-09-03,2014,0,0,0,4.215784
240789,The Miracle,2009-10-09,2009,0,50656,50656,0.436028
240820,Christmas in Conway,2013-12-01,2013,0,0,0,6.607246
240832,Lucy,2014-07-14,2014,40000000,126546825,86546825,36.447603
240881,Free Ride,2013-10-10,2013,0,0,0,2.876327
240906,Let It Snow,2013-11-30,2013,0,0,0,1.643516
240913,Non-Stop,2013-11-29,2013,0,0,0,1.742471
240916,Reasonable Doubt,2014-01-17,2014,8000000,0,-8000000,11.072355
240968,The Red Detachment of Women,1970-12-03,1970,0,0,0,0.007398
240982,"The Missing Piece: Mona Lisa, Her Thief, the True Story",2012-10-12,2012,0,0,0,0.062588
240992,Santo vs. the Zombies,1961-01-02,1961,0,0,0,0.347297
241004,Tintin and the Lake of Sharks,1972-12-13,1972,0,0,0,2.105854
241058,Lover's Knot,1996-07-12,1996,0,0,0,0.14315
241070,Divorce Corp.,2014-01-10,2014,0,0,0,0.872672
241071,Brightest Star,2014-01-31,2014,0,0,0,1.158604
241140,My Beautiful Country,2013-12-11,2013,0,0,0,0.19529
241170,Inside The X-Files,1998-02-01,1998,0,0,0,0.601097
241174,Beloved Enemy,1979-05-22,1979,0,0,0,0.034545
241206,The Life of Riley,1949-04-16,1949,0,0,0,0.07784
241239,A Most Violent Year,2014-12-30,2014,20000000,12007070,-7992930,17.187708
241251,The Boy Next Door,2015-01-23,2015,4000000,52425855,48425855,10.200398
241254,The Prince,2014-08-22,2014,18000000,266586800,248586800,16.219485
241257,Regression,2015-10-01,2015,0,17671101,17671101,10.03628
241258,Incarnate,2016-12-01,2016,5000000,6341855,1341855,15.909181
241259,Alice Through the Looking Glass,2016-05-25,2016,170000000,299370084,129370084,14.61608
241261,The Girl on the Train,2014-07-03,2014,0,0,0,0.861968
241287,Tropico,2013-12-05,2013,0,0,0,1.759584
241302,The Importance of Being Earnest,1986-01-01,1986,0,0,0,0.125014
241340,The Forsyte Saga,1967-01-01,1967,0,0,0,0.023148
241374,The Lady of Scandal,1930-05-24,1930,0,0,0,0.055608
241396,Medusa,1998-11-15,1998,0,0,0,0.07635
241432,Days and Nights,2014-09-26,2014,0,0,0,5.480158
241448,Village People,2013-04-15,2013,1059300,0,-1059300,0.374601
241552,Take a Giant Step,1959-12-01,1959,0,0,0,0.447164
241553,Tricked: The Documentary,2013-12-13,2013,0,0,0,1.670812
241554,Run All Night,2015-03-11,2015,50000000,71561644,21561644,16.838145
241562,Ten Zan - Ultimate Mission,1988-01-01,1988,0,0,0,0.006091
241568,Death of a Salesman,1966-05-07,1966,0,0,0,0.790439
241573,If You Build It,2014-01-10,2014,0,0,0,0.46175
241574,Wild Heritage,1958-08-01,1958,0,0,0,1.211691
241593,The Nun,2007-09-29,2007,0,0,0,0.116866
241618,Louis Theroux: Law and Disorder in Lagos,2010-10-10,2010,0,0,0,0.848094
241619,Louis Theroux: Law and Disorder in Philadelphia,2008-10-29,2008,0,0,0,0.741999
241620,Louis Theroux: Law and Disorder in Johannesburg,2008-12-07,2008,0,0,0,0.73039
241639,The Nightingale,2014-02-26,2014,0,0,0,1.821109
241693,Beyond Beauty: Taiwan from Above,2013-11-01,2013,3400000,0,-3400000,0.708974
241739,Hell and Mr Fudge,2012-07-07,2012,800000,0,-800000,0.126732
241742,Alone For Christmas,2013-10-04,2013,0,0,0,0.671801
241754,The Walking Hills,1949-03-05,1949,0,0,0,0.419744
241763,Skateboard,1978-03-05,1978,0,0,0,0.290618
241765,The Outsider,2014-03-11,2014,4000000,0,-4000000,9.577533
241771,Beyond the Lights,2014-09-10,2014,7000000,14618727,7618727,6.293515
241797,A Covenant with Death,1967-02-15,1967,0,0,0,0.626622
241804,Fearless Fagan,1952-08-15,1952,0,0,0,0.351728
241842,Dead Snow 2: Red vs. Dead,2014-02-12,2014,0,37473,37473,10.287127
241843,Cooties,2014-10-10,2014,0,581011,581011,7.350821
241848,The Guest,2014-09-17,2014,5000000,2367161,-2632839,6.441964
241855,Spring,2014-03-20,2014,0,49970,49970,6.976514
241863,As the Gods Will,2014-11-15,2014,0,0,0,2.752384
241868,Lupin the 3rd,2014-08-30,2014,10500000,0,-10500000,6.730243
241882,Ankhon Dekhi,2013-12-05,2013,0,0,0,0.971024
241885,Red Family,2013-11-06,2013,0,0,0,0.458048
241927,Hellions,2015-09-25,2015,0,0,0,4.174653
241928,Manshin: Ten Thousand Spirits,2014-03-06,2014,0,0,0,0.101773
241930,Implanted,2013-12-06,2013,0,0,0,0.477036
241939,Threshold,1981-09-19,1981,0,0,0,1.335069
241953,Independents,2007-07-21,2007,0,0,0,0.004454
241968,Carmina and Amen,2014-04-30,2014,0,0,0,1.953346
241982,One Husband Too Many,2010-10-04,2010,0,0,0,0.164542
241999,A Star for Christmas,2012-12-02,2012,0,0,0,1.482309
242022,The Inbetweeners 2,2014-08-06,2014,0,0,0,6.3567
242033,Scorned,2013-11-14,2013,1700000,0,-1700000,2.788972
242042,Barefoot,2014-02-02,2014,6000000,15071,-5984929,5.939334
242049,Beautiful Noise,2014-05-17,2014,0,0,0,0.677652
242065,Accused,2014-03-27,2014,0,0,0,2.770409
242076,The Bag Man,2014-02-28,2014,0,56574,56574,10.896238
242083,Hits,2014-01-21,2014,1000000,0,-1000000,9.140108
242088,The Trip to Italy,2014-04-24,2014,0,0,0,5.61555
242090,The One I Love,2014-08-08,2014,0,0,0,5.34697
242093,Under the Electric Sky,2014-05-29,2014,0,0,0,0.891692
242095,The Signal,2014-03-15,2014,4000000,600896,-3399104,8.536786
242097,How Sweet It Is!,1968-08-21,1968,0,0,0,1.070586
242102,Russian Roulette,1975-08-20,1975,1250000,0,-1250000,0.998533
242115,The Missing Corpse,1945-06-01,1945,0,0,0,0.149416
242131,Ann Carver's Profession,1933-06-09,1933,0,0,0,0.673378
242203,What Matters Most,2001-09-06,2001,0,0,0,0.002608
242224,The Babadook,2014-05-22,2014,2000000,6676471,4676471,8.832788
242240,Lost Youth,1948-04-02,1948,0,0,0,0.15381
242262,La sedia della felicit√†,2013-11-24,2013,0,0,0,2.507551
242289,Hollow City,2006-01-18,2006,0,0,0,0.038842
242310,Rage,2014-05-09,2014,21000000,0,-21000000,12.397494
242332,Escape by Night,1937-09-01,1937,0,0,0,0.42254
242354,I Passed for White,1960-03-18,1960,0,0,0,0.640354
242376,Reality Terror Night,2013-09-10,2013,0,0,0,0.146679
242378,That Hagen Girl,1947-11-01,1947,0,0,0,0.152037
242382,An Annapolis Story,1955-04-10,1955,0,0,0,0.151773
242409,The Thirteenth Tale,2013-12-30,2013,0,0,0,9.790376
242441,Horror Story,2013-09-13,2013,0,0,0,0.351319
242452,The Attorney,2013-12-18,2013,0,0,0,6.549272
242454,The Suspect,2013-12-24,2013,0,0,0,2.881797
242458,Way Back Home,2013-12-11,2013,0,0,0,2.329351
242462,The Activist,2014-03-07,2014,0,0,0,0.400945
242466,The Surrogate,2013-01-01,2013,0,0,0,1.431687
242475,Boy of the Streets,1937-12-08,1937,0,0,0,0.518396
242512,Ouija,2014-10-24,2014,5000000,103590271,98590271,13.288564
242546,Bayonetta: Bloody Fate,2013-11-23,2013,0,0,0,3.424565
242551,Act Like You Love Me,2013-08-06,2013,0,0,0,0.375314
242555,Holidaze,2013-11-28,2013,0,0,0,2.212869
242575,"Guten Tag, Ram√≥n",2013-10-18,2013,4000000,0,-4000000,3.471168
242582,Nightcrawler,2014-10-23,2014,8500000,38697217,30197217,21.277073
242621,Nob Hill,1945-06-13,1945,0,0,0,0.966719
242628,"Go West, Young Lady",1941-11-27,1941,0,0,0,0.807261
242629,The Iron Sheriff,1957-04-01,1957,0,0,0,0.661419
242631,So This Is Love,1953-07-15,1953,0,0,0,0.621613
242643,Batman: Assault on Arkham,2014-08-12,2014,0,4571025,4571025,6.0955
242661,Not My Day,2014-01-16,2014,0,0,0,4.065438
242675,"Another Day, Another Time: Celebrating the Music of ""Inside Llewyn Davis""",2013-12-13,2013,0,0,0,0.400351
242683,Zaza,1938-12-29,1938,0,0,0,1.12062
242737,Irena do domu!,1955-11-26,1955,0,0,0,0.313002
242828,When Marnie Was There,2014-07-19,2014,0,561085,561085,9.342061
242835,For Love or Money,1963-08-07,1963,0,0,0,0.009913
242906,The Perfect Boyfriend,2013-07-04,2013,0,0,0,1.473827
242920,The Glass House,1972-02-04,1972,0,0,0,0.223332
243026,The Battle of Gettysburg,1955-01-01,1955,0,0,0,0.1913
243059,Questi fantasmi,1962-01-29,1962,0,0,0,0.002681
243233,West,2013-10-25,2013,0,0,0,1.545541
243279,Low Fidelity,2011-01-01,2011,0,0,0,0.502209
243306,The Perfect Wedding,2012-04-22,2012,0,0,0,0.142409
243312,What on Earth!,1966-01-01,1966,0,0,0,0.106361
243352,Where Hope Grows,2014-04-06,2014,0,1156000,1156000,2.969721
243416,Ac√©phale,1969-01-01,1969,0,0,0,0.052426
243442,Un fantastico via vai,2013-12-12,2013,0,0,0,2.791857
243462,The Exonerated,2006-03-06,2006,0,0,0,0.033579
243473,Mary of Nazareth,1995-03-29,1995,0,0,0,0.001209
243526,Faults,2014-03-06,2014,0,0,0,4.394891
243531,Freezer,2014-01-17,2014,0,0,0,9.115124
243565,Mother Carey's Chickens,1938-07-29,1938,0,0,0,0.591826
243568,Lizzie Borden Took An Ax,2014-01-25,2014,0,0,0,7.185427
243599,A Holiday Heist,2011-11-27,2011,0,0,0,1.291352
243664,"Didi, the Goofy Cupid",2003-04-27,2003,0,0,0,0.429906
243683,Step Up All In,2014-07-16,2014,45000000,86165646,41165646,8.588926
243684,"Men, Women & Children",2014-10-17,2014,0,461162,461162,6.785735
243688,Poltergeist,2015-05-20,2015,35000000,95437994,60437994,15.968492
243752,No Stranger Than Love,2015-04-30,2015,0,0,0,3.79384
243764,As You See,1986-01-01,1986,0,0,0,0.035521
243794,Alone Yet Not Alone,2013-09-01,2013,7000000,0,-7000000,1.34867
243856,Blast,1997-03-13,1997,700000,0,-700000,1.22525
243860,The Third Sex,1957-08-29,1957,0,0,0,0.352379
243881,Adios Carmen,2013-12-08,2013,0,0,0,0.048314
243884,Fish & Cat,2013-09-06,2013,0,0,0,0.769553
243919,Personal Tailor,2013-12-20,2013,0,0,0,0.518826
243934,Pin Boy,2004-03-31,2004,0,0,0,0.04307
243935,Rob the Mob,2014-03-21,2014,0,206909,206909,7.731183
243938,Hot Tub Time Machine 2,2015-02-20,2015,14000000,12314651,-1685349,6.575393
243940,The Lazarus Effect,2015-01-29,2015,3300000,64110728,60810728,5.840554
243984,Persuasion,1971-01-01,1971,0,0,0,0.001459
243987,Sense and Sensibility,1971-01-01,1971,0,0,0,0.010759
244001,Bo Burnham: what.,2013-12-18,2013,0,0,0,2.128885
244046,10 Minutes,2014-04-24,2014,0,0,0,0.173285
244049,Drishyam,2013-12-19,2013,750000,12000000,11250000,1.908761
244063,Boys,2014-01-08,2014,0,0,0,5.653371
244088,Human Capital,2014-01-09,2014,6000000,5809330,-190670,7.217205
244114,Firestorm,2013-12-12,2013,0,0,0,3.159205
244115,The Straits of Love and Hate,1937-06-17,1937,0,0,0,0.002736
244117,Emily & Tim,2015-08-29,2015,0,0,0,0.933057
244145,The Bottom of the Sea,2003-08-27,2003,0,0,0,0.302424
244151,Big Fella,1937-07-17,1937,0,0,0,0.444746
244182,Emma,1972-01-01,1972,0,0,0,0.361228
244201,"Yes, My Darling Daughter",1939-02-25,1939,0,0,0,1.324207
244260,Little Accidents,2015-01-16,2015,0,0,0,2.725411
244264,Laggies,2014-09-25,2014,0,1066981,1066981,12.938085
244267,I Origins,2014-07-18,2014,0,336472,336472,11.901185
244268,Love Is Strange,2014-02-07,2014,0,2262223,2262223,6.15698
244316,Into the Grizzly Maze,2015-02-27,2015,10000000,0,-10000000,15.860139
244331,Homeless in America,2004-08-18,2004,0,0,0,0.468157
244403,Rudderless,2014-10-17,2014,5000000,0,-5000000,10.964584
244418,The Bear,1984-01-01,1984,0,0,0,0.353172
244447,Another Face,1935-12-20,1935,0,0,0,0.014357
244449,Flamenco at 5:15,1983-01-01,1983,0,0,0,0.041032
244458,The Voices,2014-01-19,2014,0,0,0,9.104429
244506,Camp X-Ray,2014-10-17,2014,1000000,59744,-940256,11.153327
244509,Cold in July,2014-05-23,2014,0,427418,427418,7.327216
244517,God's Pocket,2014-05-09,2014,0,169976,169976,4.18526
244534,Happy Christmas,2014-06-26,2014,0,0,0,3.723574
244536,Hellion,2014-06-13,2014,0,0,0,13.079538
244539,Infinitely Polar Bear,2014-01-18,2014,6700000,1430655,-5269345,6.502973
244562,Jamie Marks Is Dead,2014-08-29,2014,0,0,0,8.442355
244563,"Kumiko, the Treasure Hunter",2015-02-20,2015,0,0,0,4.580804
244566,Life After Beth,2014-08-15,2014,2400000,88273,-2311727,5.486893
244575,–ö–µ–Ω—Ç–µ—Ä–≤–∏–ª—å—Å–∫–æ–µ –ø—Ä–∏–≤–∏–¥–µ–Ω–∏–µ,1970-12-19,1970,0,0,0,0.28806
244580,Low Down,2014-01-19,2014,0,0,0,3.155747
244610,The Den,2013-12-12,2013,0,0,0,7.752544
244636,Scarlet Angel,1952-06-20,1952,0,0,0,0.941927
244688,The Hungover Games,2014-02-01,2014,0,0,0,6.125484
244698,Radio Bikini,1988-06-10,1988,0,0,0,0.23742
244761,The Captive,2014-06-10,2014,0,1075178,1075178,14.623692
244772,The Skeleton Twins,2014-01-18,2014,0,5284309,5284309,9.44394
244776,The Sleepwalker,2014-01-20,2014,0,0,0,2.024245
244783,Song One,2014-01-20,2014,6000000,32251,-5967749,6.743182
244786,Whiplash,2014-10-10,2014,3300000,13092000,9792000,64.29999
244801,52 Tuesdays,2014-05-01,2014,0,0,0,0.617852
244836,The Ballad of Johnny Guitar,1996-05-01,1996,0,0,0,0.209215
244838,Lettera Amorosa,1995-01-01,1995,0,0,0,0.140834
244839,Into Pitch Black,2000-01-30,2000,0,0,0,4.013649
244852,Poseidon Rex,2014-04-18,2014,0,0,0,1.93453
244956,Basara: Princess Goh,1992-04-11,1992,0,0,0,0.644204
244971,Fall of Ming,2013-10-24,2013,0,0,0,0.459709
245003,Lorenzo,2004-03-06,2004,0,0,0,1.161778
245013,A Note of Triumph: The Golden Age of Norman Corwin,2005-08-19,2005,0,0,0,0.833216
245017,Binta and the Great Idea,2004-10-25,2004,0,0,0,0.110112
245019,The Saviour,2005-06-18,2005,0,0,0,0.453974
245025,Freeheld,2007-01-18,2007,0,0,0,0.104152
245072,The House Under the Rocks,1959-01-15,1959,0,0,0,0.14971
245073,Family Life,1971-09-24,1971,0,0,0,0.241109
245158,Kids for Cash,2014-02-07,2014,0,0,0,1.802009
245168,Suffragette,2015-10-16,2015,14000000,16002420,2002420,8.093442
245169,Three Night Stand,2013-12-06,2013,0,0,0,2.430634
245170,Pok√©mon Origins,2013-10-02,2013,0,0,0,1.220514
245175,Black Coffee,2014-01-10,2014,0,0,0,0.580806
245184,"I Love, You Love",1989-02-15,1989,0,0,0,0.108353
245226,James Gandolfini: Tribute To A Friend,2013-12-22,2013,0,0,0,1.690387
245260,Six Days in Roswell,1998-01-02,1998,0,0,0,0.073486
245268,The Man from Down Under,1943-08-04,1943,0,0,0,0.068254
245324,Egomania: Island Without Hope,1986-10-24,1986,0,0,0,1.112241
245367,Summer of Fear,1996-04-03,1996,0,0,0,0.826391
245394,Fry and Laurie Reunited,2010-11-24,2010,0,0,0,0.6466
245473,Cloud 9,2014-01-17,2014,0,0,0,6.216199
245527,Convict,2014-01-23,2014,0,0,0,1.420004
245536,Rabbit and Deer,2013-12-25,2013,0,0,0,0.322276
245589,Voodoo Possession,2014-01-14,2014,0,0,0,1.635274
245597,Steal My Heart,2013-12-18,2013,0,0,0,1.679142
245622,Black Wax,1983-01-12,1983,0,0,0,0.167118
245627,Abattoir,2016-12-08,2016,0,0,0,4.541007
245685,Postman Pat: The Movie,2014-05-23,2014,0,0,0,2.975178
245692,The Search,2014-11-26,2014,25000000,0,-25000000,2.443432
245697,The Wicked Uncle,2011-10-26,2011,0,0,0,0.367888
245698,Pawn Sacrifice,2015-09-16,2015,19000000,5578519,-13421481,7.399209
245700,Mr. Turner,2014-10-31,2014,0,5405500,5405500,6.328696
245703,Midnight Special,2016-02-18,2016,18000000,6212282,-11787718,12.682927
245706,True Story,2015-04-17,2015,0,4719695,4719695,7.87202
245739,Gangsta Granny,2013-12-26,2013,0,0,0,1.210607
245775,Yves Saint Laurent,2014-01-08,2014,12000000,21026290,9026290,4.726238
245792,Christmas Belle,2013-12-08,2013,0,0,0,1.04707
245842,The King's Daughter,2017-12-30,2017,0,0,0,1.138419
245844,Blind,2014-02-28,2014,0,0,0,5.54722
245846,Strangerland,2015-07-01,2015,10000000,17472,-9982528,5.975657
245855,Difret,2014-01-19,2014,0,49667,49667,2.165608
245859,God Help the Girl,2014-08-22,2014,0,0,0,6.684283
245891,John Wick,2014-10-22,2014,20000000,88761661,68761661,183.870374
245906,She's Funny That Way,2014-10-27,2014,0,111996,111996,7.032964
245909,Mumblecore,2011-06-19,2011,0,0,0,0.051342
245913,Pel√©: Birth of a Legend,2016-05-06,2016,0,27312,27312,6.979073
245916,Kill the Messenger,2014-10-09,2014,5000000,2450846,-2549154,13.524048
245917,Gintama: The Final Chapter - Be Forever Yorozuya,2013-07-04,2013,0,0,0,1.046323
245950,The Dragonphoenix Chronicles: Indomitable,2014-01-23,2014,14000,0,-14000,0.381124
245963,Milk?,2014-09-01,2014,0,0,0,0.084948
245984,The Singing Marine,1937-07-03,1937,0,0,0,0.060994
246006,The Most Beautiful Thing,2012-05-15,2012,0,0,0,0.306599
246007,Palestine Is Still the Issue,2003-01-06,2003,0,0,0,0.003294
246011,Ping Pong Summer,2014-06-06,2014,0,25781,25781,4.572751
246013,War Story,2014-01-19,2014,0,0,0,1.829928
246049,France soci√©t√© anonyme,1974-06-04,1974,0,0,0,0.11997
246080,Black Sea,2014-12-05,2014,0,1171559,1171559,9.989679
246127,Every Thing Will Be Fine,2015-04-02,2015,0,8034,8034,5.723103
246133,Entertainment,2015-08-11,2015,0,0,0,1.311874
246205,Control,2013-11-22,2013,0,0,0,0.439722
246213,Fiddle-de-dee,1947-01-01,1947,0,0,0,0.100568
246218,The Underneath,2013-12-19,2013,0,0,0,0.775092
246252,The Strange Ones,2011-01-20,2011,0,0,0,0.161743
246299,Young Bride,1932-04-07,1932,0,0,0,0.622545
246308,Master of the Universe,2013-11-07,2013,0,0,0,0.911924
246314,Bad Fucking,2013-12-20,2013,0,0,0,0.401937
246320,The Three Brothers: The Return,2014-02-12,2014,13640000,0,-13640000,5.084853
246355,Saw,2003-01-01,2003,0,0,0,5.160339
246381,Why Did I Get Married? The Play,2006-06-27,2006,0,0,0,0.385797
246400,"20,000 Days on Earth",2014-07-05,2014,0,0,0,11.922021
246403,Tusk,2014-09-19,2014,2800000,1826705,-973295,6.820925
246415,Redland,2009-03-11,2009,0,0,0,0.088812
246417,"Daddy, Father Frost Is Dead",1991-12-29,1991,0,0,0,0.002001
246422,Fracture,2010-11-29,2010,0,0,0,1.706097
246438,–°–µ–º—å –∫–∞–±–∏–Ω–æ–∫,2007-02-07,2007,0,0,0,0.105533
246457,Antonio Gramsci: The Days of Prison,1977-02-06,1977,0,0,0,0.132633
246594,Mega Shark vs. Mecha Shark,2014-01-28,2014,0,0,0,2.251209
246648,Canon,1964-01-01,1964,0,0,0,0.249773
246654,G√©raldine,2000-01-01,2000,0,0,0,0.007379
246655,X-Men: Apocalypse,2016-05-18,2016,178000000,543934787,365934787,28.712522
246699,Death Comes to Pemberley,2013-12-02,2013,0,0,0,5.06044
246741,What We Do in the Shadows,2014-06-19,2014,0,3333000,3333000,10.504198
246743,Whitey: United States of America v. James J. Bulger,2014-01-18,2014,0,0,0,2.090438
246749,Time to Die,1966-08-11,1966,0,0,0,0.941923
246829,Metronotte,2000-03-31,2000,0,0,0,0.413144
246860,Clouds of Sils Maria,2014-08-20,2014,6600000,1851517,-4748483,8.151346
246882,Then I Sentenced Them All to Death,1972-01-24,1972,0,0,0,0.036044
246916,The Universal Clock: The Resistance of Peter Watkins,2001-09-07,2001,0,0,0,0.117208
246917,The Bonesetter,2004-07-15,2004,0,0,0,0.10801
247112,Smoke on the Potato Fields,1977-10-01,1977,0,0,0,0.139168
247124,M√°g,1988-03-01,1988,0,0,0,0.030253
247158,Into the Woods,2011-03-31,2011,0,0,0,0.551363
247182,El ni√±o,2014-08-29,2014,0,0,0,5.818608
247218,Un boss in salotto,2014-01-01,2014,0,0,0,4.40496
247354,Veiled Aristocrats,1932-02-01,1932,0,0,0,0.001786
247414,Arisan!,2003-12-10,2003,0,0,0,0.319549
247436,Wind,1996-01-01,1996,0,0,0,0.107099
247437,Hen Hop,1942-01-01,1942,0,0,0,0.244887
247446,Long Live the Republic,1965-11-05,1965,0,0,0,0.222778
247447,Willow and Wind,2000-01-01,2000,0,0,0,0.139262
247451,The Yellow Balloon,1953-02-10,1953,0,0,0,0.848466
247488,"Cheating Death, Stealing Life: The Eddie Guerrero Story",2004-05-26,2004,0,0,0,0.012937
247500,Le 7√®me jur√©,2008-05-16,2008,0,0,0,0.795963
247504,Veeram,2014-01-10,2014,5900000,19000000,13100000,1.915168
247604,Paradise for Three,1938-06-04,1938,0,0,0,0.084008
247645,Queen,2014-02-27,2014,0,0,0,3.643803
247691,Three Brave Men,1956-12-01,1956,0,0,0,0.370534
247695,The Inspectors,1998-09-20,1998,0,0,0,0.193722
247720,Ghosts of Ole Miss,2012-10-30,2012,0,0,0,0.18503
247749,Apple in the River,1974-01-03,1974,0,0,0,0.348978
247773,The Big Timer,1932-03-10,1932,0,0,0,0.25774
247777,L for Leisure,2014-01-24,2014,0,0,0,0.04867
247780,The Conquerors,1932-11-18,1932,0,0,0,0.339181
247845,The Great Martian War 1913 - 1917,2013-12-08,2013,0,0,0,1.040173
247954,As the Light Goes Out,2014-01-02,2014,0,0,0,1.252137
248001,Buck Rogers,1939-04-10,1939,0,0,0,0.797124
248087,The Eternal Zero,2013-12-20,2013,0,84500000,84500000,1.719225
248211,Liar's Dice,2014-01-18,2014,0,0,0,0.17768
248212,Lilting,2014-08-07,2014,0,0,0,3.264401
248223,Dark World: Equilibrium,2013-12-05,2013,0,2118871,2118871,2.073139
248231,Miraculum,2014-02-28,2014,4600000,0,-4600000,0.82134
248268,$50K and a Call Girl: A Love Story,2014-01-10,2014,0,0,0,0.984593
248376,Once Upon a Time in Shanghai,2014-01-06,2014,0,0,0,3.550047
248379,American Courtesans,2013-07-12,2013,0,0,0,0.054068
248390,Le Crocodile du Botswanga,2014-02-19,2014,10916704,0,-10916704,4.420544
248417,Patch Town,2014-01-04,2014,0,0,0,0.581967
248424,"Papita, Man√≠, Tost√≥n",2013-12-20,2013,0,0,0,0.519523
248426,Babysitter Massacre,2013-04-12,2013,0,0,0,0.430172
248469,Two Loves,1961-06-21,1961,0,0,0,0.385559
248503,Girl in the Sunny Place,2013-10-11,2013,0,0,0,1.941682
248504,Sharknado 2: The Second One,2014-07-30,2014,0,0,0,5.281329
248507,Superchondriac,2014-02-26,2014,0,0,0,6.741118
248513,Pablo Escobar: King of Cocaine,1998-12-12,1998,0,0,0,0.036525
248543,Good Luck,2014-05-30,2014,0,0,0,0.877542
248553,Submarine,1928-08-28,1928,0,0,0,0.067138
248559,Let's Do It!,1982-07-09,1982,0,0,0,0.078925
248561,Krampus: The Christmas Devil,2013-08-17,2013,0,0,0,0.960142
248574,Barely Lethal,2015-04-30,2015,0,6075,6075,11.009871
248576,Sanatorium,2013-10-18,2013,0,0,0,1.59911
248611,Mea Culpa,2014-02-05,2014,0,0,0,10.474896
248633,Zombie Killers: Elephant's Graveyard,2015-02-03,2015,0,0,0,5.667845
248639,The Narrow Corner,1933-07-07,1933,0,0,0,0.001669
248688,A Night in Old Mexico,2013-11-08,2013,2000000,0,-2000000,3.343938
248694,Truth,2013-07-12,2013,0,0,0,0.716906
248698,Dedh Ishqiya,2014-01-10,2014,0,0,0,1.396518
248705,The Visitors: Bastille Day,2016-03-23,2016,25868826,0,-25868826,7.29492
248706,Mrs. Lambert Remembers Love,1991-05-12,1991,0,0,0,1.162197
248710,The Only Ones,2013-12-27,2013,1490000,0,-1490000,0.13073
248741,Alexander Hamilton,1931-09-12,1931,0,0,0,0.130785
248747,Six Degrees of Celebration 3,2013-12-26,2013,0,0,0,1.062573
248757,Punks,2000-01-24,2000,0,0,0,0.535518
248774,Obvious Child,2014-06-06,2014,0,3123963,3123963,6.480574
248781,ABCs of Death 2.5,2016-08-02,2016,0,0,0,1.857453
248808,Crisis Hotline: Veterans Press 1,2013-11-11,2013,0,0,0,0.192227
248833,Everything I Can See From Here,2013-02-01,2013,0,0,0,0.045882
248870,An Apology to Elephants,2013-04-13,2013,0,0,0,0.610441
248888,Questioning Darwin,2014-02-10,2014,0,0,0,0.020194
248921,Babylon XX,1979-01-01,1979,0,0,0,0.644598
248933,The Dark Valley,2014-02-14,2014,6350000,0,-6350000,5.617232
248934,Beloved Sisters,2014-07-31,2014,0,0,0,14.061194
248946,The Spoils of Babylon,2014-01-09,2014,0,0,0,2.346466
249021,Android Cop,2014-02-04,2014,0,0,0,2.459052
249057,Finding Christmas,2013-12-15,2013,0,0,0,0.662586
249070,Hitman: Agent 47,2015-08-20,2015,35000000,81967450,46967450,10.721799
249072,We Need a Vacation,2004-07-24,2004,0,0,0,0.037652
249075,Catching Out,2003-01-11,2003,0,0,0,0.072941
249164,If I Stay,2014-08-21,2014,11000000,78874843,67874843,9.659244
249170,Dinosaur 13,2014-08-15,2014,0,0,0,3.22314
249233,Anjelah Johnson: The Homecoming Show,2013-09-17,2013,0,0,0,0.052433
249260,,,,0,0,0,0.0
249264,Watch the Birdie,1950-12-11,1950,0,0,0,0.21569
249266,Small Time,2014-04-18,2014,0,0,0,7.418423
249333,An Innocent Affair,1948-10-15,1948,0,0,0,0.589427
249347,Landscape,2003-10-16,2003,0,0,0,0.040395
249358,The Innocent Sleep,1996-01-25,1996,0,0,0,1.221766
249368,Ciudad de Ciegos,1991-10-31,1991,0,0,0,0.087611
249397,Nymphomaniac: Vol. II,2013-12-25,2013,0,2227167,2227167,9.594157
249457,La gente che sta bene,2014-01-29,2014,0,0,0,1.585518
249567,Night Into Morning,1951-06-08,1951,0,0,0,0.402496
249660,God's Not Dead,2014-03-21,2014,17000000,29789000,12789000,6.097499
249677,Time Pass,2014-01-03,2014,200,0,-200,0.110029
249688,The End of the Tour,2015-07-31,2015,0,3002884,3002884,9.201378
249703,Do I Have to Take Care of Everything?,2014-02-28,2014,0,0,0,0.462593
249719,Facing Fear,2013-07-13,2013,0,0,0,0.011871
249724,The Lady in Number 6,2013-01-01,2013,0,0,0,0.994216
249726,Prison Terminal: The Last Days of Private Jack Hall,2013-01-01,2013,0,0,0,0.150765
249772,1 - Nenokkadine,2014-01-10,2014,0,0,0,2.216623
249882,Virgin Mary,1995-10-12,1995,0,0,0,0.918504
249914,Pestonjee,1988-03-01,1988,0,0,0,0.005219
249916,Appropriate Behavior,2015-03-14,2015,0,0,0,2.270286
249923,Someone Marry Barry,2014-02-07,2014,0,0,0,5.916675
249926,The 7:39,2014-01-06,2014,0,0,0,2.661686
249931,Helium,2014-01-26,2014,0,0,0,0.116977
249934,The Slow Business of Going,2000-01-01,2000,0,0,0,0.152958
249969,Three Cheers for the Irish,1940-03-16,1940,0,0,0,0.059756
250029,Absence,1992-04-01,1992,0,0,0,0.226086
250066,American Heist,2014-09-11,2014,10000000,0,-10000000,6.278168
250093,The Man,1972-07-19,1972,0,0,0,0.479367
250096,Shadey,1985-05-31,1985,0,0,0,0.47762
250114,Nick Offerman: American Ham,2014-01-23,2014,0,0,0,1.234448
250124,The Diary of a Teenage Girl,2015-08-07,2015,2000000,1477002,-522998,14.986654
250155,The Marva Collins Story,1981-12-01,1981,0,0,0,0.589499
250219,I Can Quit Whenever I Want,2014-02-06,2014,2000000,0,-2000000,6.592949
250225,The Duke of Burgundy,2014-10-18,2014,1000000,0,-1000000,6.509546
250230,The Cut,2014-10-16,2014,16000000,0,-16000000,4.465481
250235,Tutta colpa di Freud,2014-01-23,2014,0,0,0,4.221003
250251,Lucky Island,2013-12-05,2013,2000000,4803665,2803665,0.536756
250275,Getting That Girl,2011-10-23,2011,0,0,0,0.825218
250278,Seventh Code,2013-11-13,2013,0,0,0,0.664917
250312,"Mary Is Happy, Mary Is Happy.",2013-09-01,2013,170000,0,-170000,0.342009
250332,The Green Hornet,1940-01-08,1940,0,0,0,0.199552
250349,Barbecue,2014-04-30,2014,6000000,14348529,8348529,4.707275
250374,To Kill a Man,2014-08-01,2014,0,0,0,2.278633
250376,Beside Still Waters,2013-10-12,2013,0,0,0,0.434189
250388,Rampage: Capital Punishment,2014-07-19,2014,0,0,0,7.733723
250434,Superstar: The Life and Times of Andy Warhol,1990-07-18,1990,0,0,0,0.2875
250503,Bad Chicken,,,0,0,0,0.007875
250535,Get Santa,2014-12-05,2014,0,0,0,2.112557
250538,The Good Lie,2014-09-09,2014,0,0,0,10.831362
250546,Annabelle,2014-10-02,2014,6500000,255273813,248773813,23.242452
250551,Gunday,2014-02-14,2014,0,0,0,2.380826
250556,Trevor Noah: African American,2013-07-05,2013,0,0,0,0.983642
250558,Water Damage,1999-07-30,1999,0,0,0,0.301305
250572,Break Point,2014-03-08,2014,0,0,0,4.849175
250574,Creep,2014-06-23,2014,0,0,0,8.411803
250577,Doc of the Dead,2014-06-14,2014,0,0,0,1.195504
250578,Leave the World Behind,2014-03-12,2014,750000,0,-750000,1.404872
250605,Broken Kingdom,2012-10-02,2012,0,0,0,0.333806
250608,Concrete Blondes,2013-05-02,2013,3100000,0,-3100000,1.139789
250610,The Crew,1994-10-01,1994,0,0,0,0.089596
250622,National Lampoon Presents: Endless Bummer,2009-10-20,2009,0,0,0,2.115772
250624,Jay Mohr: Funny for a Girl,2012-09-08,2012,0,0,0,1.172097
250625,Looking for Palladin,2008-03-05,2008,0,0,0,0.01982
250638,Witch from Nepal,1986-02-27,1986,0,0,0,0.096751
250643,Alive Inside,2014-01-18,2014,0,0,0,2.020862
250650,Captivated: The Trials of Pamela Smart,2014-01-17,2014,0,0,0,1.527183
250651,The Case Against 8,2014-06-06,2014,0,0,0,0.996049
250653,E-Team,2014-01-18,2014,0,0,0,0.420969
250657,Fed Up,2014-05-09,2014,0,0,0,6.133204
250658,The Internet's Own Boy: The Story of Aaron Swartz,2014-06-27,2014,0,48911,48911,6.114898
250660,Ivory Tower,2014-06-13,2014,0,0,0,0.935948
250665,No No: A Dockumentary,2014-01-20,2014,0,0,0,1.16206
250666,The Overnighters,2014-10-10,2014,0,0,0,2.068798
250668,Rich Hill,2014-01-19,2014,0,0,0,1.576038
250671,Watchers of the Sky,2014-01-20,2014,0,0,0,0.154369
250686,Eager,2014-04-13,2014,0,0,0,0.12
250700,The Battered Bastards of Baseball,2014-01-20,2014,0,0,0,1.531619
250705,Finding Fela,2014-08-01,2014,0,0,0,0.776164
250734,Far from the Madding Crowd,2015-04-23,2015,0,30229977,30229977,7.832484
250745,Happy Valley,2014-11-14,2014,0,0,0,1.436689
250756,Lambert & Stamp,2015-04-03,2015,0,0,0,0.475216
250761,Last Days in Vietnam,2014-09-05,2014,0,161,161,1.566256
250766,Life Itself,2014-07-04,2014,0,0,0,7.615552
250769,Mitt,2014-01-17,2014,0,0,0,1.580129
250777,To Be Takei,2014-08-22,2014,0,0,0,4.641786
250784,Concerning Violence,2014-01-17,2014,0,0,0,0.083801
250798,The Green Prince,2014-01-16,2014,0,0,0,1.103495
250810,Great Communist Bank Robbery,2004-05-10,2004,0,0,0,0.077871
250833,Happiness,2014-01-17,2014,0,0,0,0.048315
250852,The Notorious Mr. Bout,2014-01-17,2014,0,0,0,0.154342
250880,Adolf Hitler: The Greatest Story Never Told,2013-01-27,2013,5000,0,-5000,1.725653
250895,Ivan Tsarevich & the Grey Wolf 2,2013-12-26,2013,0,18315000,18315000,2.115609
250902,The Image Revolution,2013-11-21,2013,50000,0,-50000,0.673775
250919,Der Struwwelpeter,1955-01-23,1955,0,0,0,0.106199
250974,I'm the One You Want,2014-06-13,2014,0,0,0,0.1906
250989,Berlin Babylon,2001-09-27,2001,0,0,0,0.065694
251016,Patton Oswalt: Tragedy Plus Comedy Equals Time,2014-01-17,2014,0,0,0,0.861083
251028,Morgan Murphy: Irish Goodbye,2014-01-21,2014,0,0,0,0.01324
251053,Washington Heights,2002-05-22,2002,0,156021,156021,0.601936
251220,Who Took Johnny,2014-01-17,2014,0,0,0,1.843645
251227,Camp Takota,2014-02-14,2014,0,0,0,1.488241
251232,Copenhagen,2014-10-03,2014,0,0,0,4.304458
251241,Plastic Jesus,1971-01-01,1971,0,0,0,0.03803
251260,Over the Brooklyn Bridge,1984-03-02,1984,0,0,0,0.69628
251281,Thomas Pynchon: A Journey Into the Mind of P.,2003-05-02,2003,0,0,0,0.002844
251321,Aloft,2014-02-12,2014,8000000,53086,-7946914,3.851653
251367,Club Fed,1990-08-09,1990,0,0,0,0.438252
251419,Senior Week,1988-08-01,1988,0,0,0,0.104838
251421,Private Property,1960-01-20,1960,0,0,0,0.81767
251425,The Price of Gold,2014-01-16,2014,0,0,0,0.24298
251471,A LEGO Brickumentary,2015-07-31,2015,650000,0,-650000,4.201151
251481,Wonderland,1997-10-17,1997,0,0,0,0.002635
251489,Dream Trap,1990-01-01,1990,0,0,0,0.000148
251516,Kung Fury,2015-05-22,2015,630019,0,-630019,7.741143
251519,Son of Batman,2014-04-20,2014,0,0,0,12.317738
251544,The Secret Pact,2001-07-16,2001,0,0,0,0.231627
251555,"Pancho, el perro millonario",2014-06-06,2014,0,2483130,2483130,0.661399
251577,The Treatment,2014-01-29,2014,0,0,0,3.667468
251584,The Mighty Angel,2014-01-17,2014,2100000,0,-2100000,0.683212
251619,Kenau,2014-03-06,2014,0,0,0,1.515504
251626,"She Smiles, She‚Äôs Snared!",2014-02-07,2014,0,0,0,1.739309
251630,A Kiss at Midnight,2008-12-26,2008,0,0,0,0.631015
251657,Blue Week,1954-02-26,1954,0,0,0,0.409689
251671,Heart Street,2014-03-13,2014,0,0,0,0.90414
251732,Deadly Advice,1994-01-21,1994,0,0,0,0.063417
251736,Listen Up Philip,2014-10-17,2014,0,0,0,4.564875
251768,JLA Adventures: Trapped in Time,2014-01-21,2014,0,0,0,4.217098
251783,Pleasure or Pain,2013-10-22,2013,0,0,0,4.229239
251797,The Unknown Woman,2011-02-04,2011,0,0,0,0.017455
251803,Smokers,2008-03-24,2008,0,0,0,0.056092
251852,The Scribbler,2014-09-19,2014,0,0,0,6.703925
251959,Eye for an Eye,1966-03-18,1966,0,0,0,0.118931
251981,The World of Kanako,2014-07-04,2014,0,0,0,7.883507
251987,A Short History of Decay,2014-05-16,2014,0,0,0,0.660643
251994,Reach Me,2014-03-14,2014,5000000,0,-5000000,9.258194
252028,Halfweg,2014-02-26,2014,0,0,0,0.269632
252034,Love and the City 3,2013-12-31,2013,0,0,0,0.780695
252059,Through and Through,1973-05-11,1973,0,0,0,0.003013
252063,Dangerous Liaisons,2003-08-26,2003,0,0,0,0.378049
252067,Hot Young Bloods,2014-01-22,2014,0,0,0,6.121599
252073,Anubhav,1986-12-19,1986,0,0,0,0.130806
252096,"Goodbye, Mr. President",1987-01-16,1987,0,0,0,0.001282
252102,Land Ho!,2014-07-11,2014,0,0,0,4.01643
252143,Mortified Nation,2013-11-05,2013,0,0,0,0.349591
252144,Get Christie Love!,1974-01-22,1974,0,0,0,0.103599
252147,Mile... Mile & A Half,2013-06-01,2013,0,0,0,1.097326
252164,Pressure,2015-06-04,2015,0,0,0,5.176064
252171,A Girl Walks Home Alone at Night,2014-01-19,2014,1000000,395000,-605000,6.039895
252178,'71,2014-10-10,2014,0,1625847,1625847,7.08055
252189,Camp Dread,2014-04-15,2014,0,0,0,0.985039
252200,The Sunfish,2014-01-27,2014,0,0,0,1.630916
252360,In the Name of the King III,2013-12-27,2013,3500000,0,-3500000,2.433784
252385,American Addict,2012-05-18,2012,0,0,0,0.295863
252391,Kiki's Delivery Service,2014-03-01,2014,0,0,0,3.2139
252406,Dutch in Seven Lessons,1948-05-07,1948,0,0,0,0.388282
252407,Me and Him,1988-09-14,1988,0,0,0,0.645652
252431,Prem Mhanje Prem Mhanje Prem Asta,2013-12-21,2013,0,0,0,0.077637
252457,The Condemned,2013-06-27,2013,0,0,0,0.227255
252476,Harvest Time,2004-06-25,2004,0,0,0,0.037647
252511,The Kingdom of Dreams and Madness,2013-11-16,2013,0,0,0,5.463002
252512,While We're Young,2015-04-03,2015,10000000,7587485,-2412515,9.42755
252520,Short Peace,2013-07-20,2013,0,0,0,1.273737
252529,Another Me,2013-11-15,2013,0,0,0,5.203937
252596,German Angst,2015-01-24,2015,0,0,0,1.808086
252607,Junior,2014-03-12,2014,8358460,0,-8358460,5.187128
252622,The Mating of Millie,1948-03-08,1948,0,0,0,0.38927
252637,Time in the Minors,2010-11-01,2010,0,0,0,0.005882
252674,A Second Chance,2013-01-01,2013,0,0,0,0.873852
252680,Moms' Night Out,2014-03-25,2014,5000000,10429707,5429707,6.127302
252682,Burning Down the House,2001-02-07,2001,0,0,0,0.378876
252714,"Congratulations, It's a Boy!",1971-09-22,1971,0,0,0,0.002478
252721,An Alligator Named Daisy,1955-12-13,1955,0,0,0,0.161402
252724,Mary and Rhoda,2000-02-07,2000,0,0,0,0.859831
252735,Griffin and Phoenix,1976-02-27,1976,0,0,0,0.000241
252746,Three Men in a Boat,1956-12-23,1956,0,0,0,0.276287
252773,WTF,2014-03-05,2014,0,0,0,1.569352
252822,In Order of Disappearance,2014-02-21,2014,4161012,0,-4161012,5.480099
252838,The Wedding Ringer,2015-01-16,2015,23000000,79799880,56799880,12.21459
252841,Highway,2014-02-20,2014,0,0,0,2.65071
252845,I prosseneti,1976-04-28,1976,0,0,0,0.579083
252853,Dr. Cook's Garden,1971-01-19,1971,0,0,0,0.1501
252874,„Éï„Ç°„É≥„Çø„Çπ„ÉÜ„Ç£„Éù,2005-02-10,2005,0,0,0,0.002354
252886,The Lion Hunters,1951-03-25,1951,0,0,0,0.065153
252888,Thief,1971-10-09,1971,0,0,0,0.334384
252894,Bomba and the Jungle Girl,1952-12-07,1952,0,0,0,0.025136
252916,Here Come the Marines,1952-06-29,1952,0,0,0,0.08455
252956,Bullet Scars,1942-03-07,1942,0,0,0,0.148613
252981,Bride for Rent,2014-01-15,2014,0,0,0,1.01032
252983,Sly Cooper,2017-12-31,2017,0,0,0,1.531827
252990,Chariot,2013-07-15,2013,0,0,0,1.940882
253020,Road 47,2014-08-01,2014,0,0,0,0.823764
253046,Jailbait,2014-02-14,2014,0,0,0,2.133507
253065,Miss Granny,2014-01-22,2014,0,0,0,2.057505
253072,Dangerous Invitations,2002-11-19,2002,0,0,0,0.350865
253074,Mendy,2003-09-20,2003,0,0,0,0.002353
253077,Tomorrow Night,1998-01-23,1998,0,0,0,2.17195
253105,The Boys,1962-11-30,1962,0,0,0,0.804532
253112,Sheila Levine is Dead and Living in New York,1975-12-01,1975,0,0,0,0.483841
253116,Wrestling with Alligators,1998-01-18,1998,0,0,0,0.627698
253120,Almost You,1985-03-29,1985,0,0,0,0.989969
253150,Plastic Galaxy: The Story of Star Wars Toys,2014-01-15,2014,0,0,0,1.168756
253153,The Girl from Nagasaki,2013-11-11,2013,0,0,0,1.011966
253154,Imperial Dreams,2014-01-20,2014,0,0,0,3.002963
253155,We Come as Friends,2014-01-18,2014,0,0,0,0.225555
253161,Madame Bovary,2015-06-04,2015,0,0,0,6.885614
253192,Faster than Rabbits,2014-01-01,2014,3000000,5279982,2279982,1.14731
253232,Tora-san's Love Call,1971-12-29,1971,0,0,0,3.8e-05
253235,And So It Goes,2014-07-20,2014,18000000,25312387,7312387,7.69684
253239,Diplomacy,2014-03-05,2014,0,3946880,3946880,3.848346
253250,A Southern Yankee,1948-08-05,1948,0,0,0,0.275071
253251,"10,000 km",2014-05-16,2014,0,0,0,2.257993
253253,Animals,2014-05-15,2014,0,0,0,1.748668
253254,Before I Disappear,2014-10-11,2014,0,8251,8251,3.402261
253255,Fort Tilden,2014-03-08,2014,0,0,0,1.336467
253256,The Heart Machine,2014-10-24,2014,0,0,0,0.595003
253257,I Believe in Unicorns,2014-03-09,2014,0,0,0,1.001837
253258,The Mend,2014-03-09,2014,0,0,0,1.325731
253262,The Great Invisible,2014-03-09,2014,0,0,0,0.245866
253263,The Immortalists,2014-03-08,2014,0,0,0,1.046556
253266,Print the Legend,2014-03-09,2014,0,0,0,1.465349
253267,Vessel,2014-03-09,2014,0,0,0,0.711024
253270,Kelly & Cal,2014-03-07,2014,0,0,0,2.401406
253272,The Mule,2014-03-10,2014,0,0,0,5.481206
253273,Patrick's Day,2014-03-08,2014,0,0,0,0.29008
253277,Sequoia,2014-03-09,2014,0,0,0,1.415578
253279,The Trials of Cate McCall,2013-11-28,2013,7000000,0,-7000000,15.028038
253282,She's Lost Control,2014-02-09,2014,0,0,0,1.903051
253283,Take Care,2014-03-07,2014,0,0,0,2.216816
253284,Thank You a Lot,2014-03-07,2014,0,0,0,0.433744
253286,Two Step,2015-07-31,2015,0,0,0,0.750754
253287,We'll Never Have Paris,2014-10-01,2014,0,0,0,3.854754
253290,Butterfly Girl,2014-03-10,2014,0,0,0,0.014141
253291,DamNation,2014-03-10,2014,0,0,0,0.229704
253292,Harmontown,2014-03-08,2014,0,0,0,2.811629
253295,Manny,2014-12-31,2014,0,0,0,2.711057
253303,Buzzard,2015-03-06,2015,0,13684,13684,1.395727
253304,Evaporating Borders,2014-03-11,2014,0,0,0,0.168235
253306,Housebound,2014-09-04,2014,0,0,0,5.343018
253307,The Infinite Man,2014-09-18,2014,0,0,0,1.130017
253309,The Possibilities Are Endless,2014-03-04,2014,0,0,0,0.232301
253310,Premature,2014-07-02,2014,0,0,0,6.322381
253312,Space Station 76,2014-09-19,2014,0,0,0,15.884005
253315,All the Wilderness,2014-03-09,2014,0,0,0,1.026196
253331,Black or White,2014-09-06,2014,9000000,21571189,12571189,10.763583
253332,"Pulp: a Film About Life, Death & Supermarkets",2014-03-09,2014,0,0,0,1.009893
253333,Soul Boys of the Western World,2014-09-30,2014,0,0,0,0.53506
253336,Take Me to the River,2014-03-11,2014,0,0,0,0.256168
253337,The Winding Stream,2014-03-15,2014,0,0,0,0.59739
253339,All American High: Revisited,2014-03-09,2014,0,0,0,0.318884
253343,Dear Eleanor,2016-07-05,2016,0,0,0,2.626192
253344,Some Kind of Beautiful,2015-07-16,2015,0,0,0,8.410855
253353,Hannah Montana & Miley Cyrus: Best of Both Worlds Concert,2008-02-01,2008,0,0,0,1.949504
253376,In Darkness We Fall,2014-01-24,2014,0,0,0,1.522971
253377,The Distance,2014-01-25,2014,0,0,0,0.379726
253395,Above Dark Waters,2013-09-06,2013,2000000,0,-2000000,0.598521
253406,Ten Thousand Saints,2015-08-14,2015,0,0,0,9.036787
253412,Everest,2015-09-10,2015,55000000,203427584,148427584,10.758754
253414,Rock the Kasbah,2015-10-22,2015,15000000,3020664,-11979336,10.394389
253445,Eternal Flame of Gehenna,2011-01-01,2011,0,0,0,1.058506
253450,The Assassin,2015-08-27,2015,15000000,632542,-14367458,6.294815
253451,Crows Explode,2014-04-12,2014,0,0,0,2.121365
253454,The Snow White Murder Case,2014-03-29,2014,0,0,0,2.940222
253476,Landscape No. 2,2009-06-05,2009,0,0,0,0.114365
253484,1 Chance 2 Dance,2014-01-21,2014,0,0,0,1.212888
253533,Manam,2014-05-23,2014,0,0,0,1.218925
253578,"Tom, Dick And Harry",2006-05-25,2006,0,0,0,0.038824
253612,Live Forever as You Are Now with Alan Resnick,2013-12-24,2013,750000,0,-750000,0.018119
253622,That Demon Within,2014-02-08,2014,0,0,0,2.071283
253626,Good Kill,2015-04-09,2015,0,316472,316472,8.35399
253632,Baton Rouge,1988-10-08,1988,0,0,0,0.437895
253639,And the Oscar Goes To...,2014-02-02,2014,0,0,0,1.627151
253686,Darling Trap,2014-01-22,2014,0,0,0,1.988425
253687,Smart Ass,2014-04-02,2014,0,0,0,3.973512
253775,The Devil's Path,2013-09-21,2013,0,0,0,1.238348
253794,Haunting of the Innocent,2014-02-01,2014,0,0,0,1.020566
253808,3rd World Hero,2000-02-16,2000,0,0,0,0.147723
253817,Last Hijack,2014-04-24,2014,0,0,0,0.081242
253849,John Doe: Vigilante,2014-03-21,2014,0,0,0,2.538745
253851,Shirin in Love,2014-03-14,2014,0,0,0,0.48418
253876,The Greatest Ears in Town: The Arif Mardin Story,2010-06-15,2010,0,0,0,0.008663
253899,Danger Zone,1996-08-02,1996,0,0,0,1.0015
253944,"If You Don't, I Will",2014-03-05,2014,0,0,0,0.52037
253959,The Love of the Three Pomegranates,1979-03-10,1979,0,0,0,1.1e-05
253980,Marvel One-Shot: All Hail the King,2014-02-04,2014,0,0,0,5.708815
253988,Here Without Me,2011-03-12,2011,0,0,0,0.009087
254005,Land of Storms,2014-02-08,2014,0,0,0,0.993337
254007,The Samurai,2014-02-08,2014,0,0,0,1.74499
254011,The Huntresses,2014-01-29,2014,0,0,0,1.109891
254023,The Humbling,2014-03-26,2014,2000000,0,-2000000,5.27044
254024,The Face of an Angel,2014-09-06,2014,0,0,0,13.374827
254047,The Wedding Pact,2014-02-04,2014,0,0,0,6.305437
254065,The Gabby Douglas Story,2014-02-01,2014,0,0,0,2.069208
254123,The Most Beautiful Night In The World,2008-05-24,2008,0,0,0,1.383281
254126,Blood Shed,2014-02-05,2014,0,0,0,1.194683
254128,San Andreas,2015-05-27,2015,110000000,470490832,360490832,20.547925
254143,Healing,2014-04-03,2014,0,0,0,1.34155
254155,Sweet Alibis,2014-01-17,2014,0,0,0,0.397866
254166,Stratos,2014-02-11,2014,0,0,0,0.496835
254172,Fathers and Daughters,2015-10-01,2015,2240000,0,-2240000,6.758038
254188,At the Devil's Door,2014-03-09,2014,0,0,0,4.964202
254191,Honeymoon,2014-09-12,2014,1000000,9318,-990682,6.107378
254193,Late Phases,2014-11-21,2014,0,0,0,8.621852
254194,Starry Eyes,2014-07-29,2014,0,0,0,10.926642
254200,A Second Chance,2014-09-09,2014,4700000,0,-4700000,3.042462
254201,The Absent One,2014-10-02,2014,0,0,0,12.635996
254241,Piccadilly Incident,1946-08-24,1946,0,0,0,0.591084
254251,Our RoboCop Remake,2014-01-26,2014,0,0,0,0.553725
254258,As Dreamers Do,2014-05-02,2014,0,0,0,0.686423
254268,Club of the Laid Off,1989-01-01,1989,0,0,0,0.457028
254277,Pixadores,2014-02-01,2014,0,0,0,0.012964
254299,Die goldene Gans,2013-12-19,2013,0,0,0,0.091445
254302,High-Rise,2015-11-22,2015,0,346472,346472,18.947206
254309,"Ogaryova Street, Number 6",1980-12-01,1980,0,0,0,0.031359
254311,"Petrovka Street, Number 38",1980-07-28,1980,0,0,0,0.148508
254313,Swan Lake: The Zone,1990-09-12,1990,0,0,0,0.006091
254320,The Lobster,2015-10-08,2015,4000000,15656193,11656193,11.223033
254321,008: Operation Exterminate,1965-09-03,1965,0,0,0,0.181384
254323,Jack,2014-10-09,2014,0,0,0,0.879124
254375,Hector and the Search for Happiness,2014-08-14,2014,0,1124445,1124445,12.330898
254420,Gulaab Gang,2014-03-07,2014,0,0,0,1.936529
254435,The Boy in the Mirror,2014-06-19,2014,0,0,0,0.272608
254439,O Candidato Honesto,2014-09-05,2014,0,0,0,1.867297
254446,Who the F**K Is Arthur Fogel,2013-03-22,2013,0,0,0,0.071652
254464,Love Games,2013-02-10,2013,0,0,0,0.010708
254470,Pitch Perfect 2,2015-05-07,2015,29000000,287506194,258506194,15.862632
254472,Stung,2015-07-03,2015,2500000,0,-2500000,3.51172
254473,Brick Mansions,2014-04-22,2014,28000000,68896829,40896829,7.482959
254474,Zombeavers,2014-10-20,2014,0,14947,14947,5.599039
254479,Fish and Elephant,2001-09-01,2001,0,0,0,0.436679
254502,R20,2004-02-13,2004,0,0,0,0.176327
254526,The Midnight After,2014-02-07,2014,0,0,0,3.313939
254575,Memory Run,1995-06-16,1995,0,0,0,0.482713
254578,Phoenix,2014-09-25,2014,0,3184472,3184472,5.298121
254582,Oppressed Majority,2010-10-24,2010,340000,0,-340000,0.601191
254611,Podw√≥rka,2009-01-01,2009,0,0,0,0.004706
254661,O'er the Land,2009-01-01,2009,0,0,0,0.040056
254664,The Journey,2014-01-30,2014,1220000,0,-1220000,0.497461
254672,The Wrath Of Vajra,2013-09-24,2013,0,0,0,2.350929
254679,The Little House,2014-01-25,2014,0,0,0,1.212353
254689,Never Tear Us Apart: The Untold Story of INXS,2014-02-09,2014,0,0,0,0.132677
254719,History of Fear,2014-02-09,2014,0,0,0,0.483185
254721,Stations of the Cross,2014-03-20,2014,0,0,0,6.580186
254725,Time Please,2013-07-26,2013,0,0,0,0.09416
254736,"Arabian Nights: Volume 1, The Restless One",2015-06-24,2015,0,0,0,1.052262
254738,The Knot,2000-03-25,2000,0,0,0,0.00302
254772,Two Men in Town,2014-02-06,2014,0,0,0,2.065325
254775,The Codes of Gender,2010-10-13,2010,0,0,0,0.215909
254800,Breaking Through,2015-08-19,2015,0,0,0,1.911115
254869,Torrente 5: Operaci√≥n Eurovegas,2014-10-03,2014,9272437,11672363,2399926,4.207751
254902,A Story of the Forest: Mavka,1980-07-23,1980,0,0,0,0.239236
254904,The November Man,2014-08-27,2014,15000000,32556119,17556119,13.310556
254905,Manglehorn,2015-06-03,2015,4000000,143101,-3856899,4.69699
254918,Louder Than Words,2013-10-11,2013,0,0,0,2.100842
254936,Girltrash: All Night Long,2014-02-10,2014,0,0,0,1.058751
254952,Me Him Her,2016-03-11,2016,0,0,0,1.836611
254967,Between Two Wars,1978-11-05,1978,0,0,0,2.5e-05
255157,The Forger,2014-09-10,2014,0,0,0,7.490615
255160,On the Milky Road,2016-02-03,2016,0,0,0,4.339335
255253,The Face,2013-11-15,2013,0,0,0,0.096489
255268,Bad Ass 2: Bad Asses,2014-04-08,2014,5500000,0,-5500000,7.164554
255278,Way of the Wicked,2014-05-20,2014,3000000,0,-3000000,1.342395
255324,Party Plane,1991-01-02,1991,0,0,0,1.5e-05
255343,Escobar: Paradise Lost,2014-10-11,2014,17000000,3758328,-13241672,12.543659
255346,Bogart: The Untold Story,1997-01-05,1997,0,0,0,0.001723
255358,Don't Play the Fool...,1997-01-01,1997,0,0,0,0.444896
255384,"Don't Hug Me, I'm Scared II: Time",2014-01-08,2014,0,0,0,0.34628
255388,Man Alive,1945-11-16,1945,0,0,0,0.080368
255391,Pecoross' Mother and Her Days,2013-11-16,2013,0,0,0,0.287006
255396,Yardbird,2012-05-16,2012,0,0,0,0.407488
255456,Sotto una buona stella,2014-02-13,2014,0,0,0,3.469853
255476,Dakota's Summer,2014-04-17,2014,0,0,0,1.076293
255491,Authors Anonymous,2014-04-18,2014,0,0,0,8.936308
255496,And Then There Was You,2013-10-19,2013,0,0,0,2.686014
255497,This Thing with Sarah,2013-06-01,2013,0,0,0,0.169505
255511,Rue de l'Estrapade,1953-04-14,1953,0,0,0,0.568722
255528,Blank: A Vinylmation Love Story,2014-02-14,2014,0,0,0,0.084724
255533,The Kidnapping of Michel Houellebecq,2014-08-27,2014,0,0,0,0.701958
255546,Carmen Miranda: Bananas Is My Business,1995-04-13,1995,0,0,0,0.146287
255548,The Soul of the Bone,2004-01-22,2004,0,0,0,0.061216
255552,My Brother's Keeper,2014-02-07,2014,0,0,0,0.490325
255573,Murder: No Apparent Motive,1984-01-02,1984,0,0,0,5e-05
255575,Parviz,2012-09-23,2012,0,0,0,0.2405
255576,Yanco,1961-11-01,1961,0,0,0,0.149761
255577,Black Widow,2008-12-08,2008,2000000,0,-2000000,0.855427
255635,Are We Ok?,2013-11-29,2013,0,0,0,1.574675
255647,See You in Montevideo,2014-01-15,2014,5400000,0,-5400000,0.739684
255692,Ice Soldiers,2013-12-06,2013,0,0,0,5.113538
255709,Hope,2013-10-02,2013,0,0,0,2.57911
255718,Barbie: The Pearl Princess,2013-02-19,2013,0,0,0,2.935491
255733,Our Mr. Sun,1956-11-19,1956,0,0,0,0.58612
255746,The Reunion 2 - The Funeral,2014-02-06,2014,0,0,0,1.426212
255756,"Black Coal, Thin Ice",2014-06-11,2014,0,0,0,3.759315
255772,White Mountains,1964-01-01,1964,0,0,0,0.051215
255775,Spicy Love Soup,1997-01-01,1997,0,0,0,0.428107
255784,Times of Joy and Sorrow,1957-10-01,1957,0,0,0,0.00293
255798,Burying the Ex,2014-09-04,2014,0,0,0,5.702937
255802,Eu Maior,2013-11-21,2013,0,0,0,0.094541
255843,Slumber Party '57,1976-08-31,1976,0,0,0,0.306791
255869,Pleased to Meet Me,2013-10-10,2013,0,0,0,0.866074
255885,Breadcrumb Trail,2014-04-15,2014,0,0,0,1.026189
255890,The Circle,2014-09-18,2014,0,0,0,0.940121
255898,Another Year,2014-01-15,2014,0,0,0,0.187678
255906,Il figlio dello sceicco,1977-02-16,1977,0,0,0,0.09878
255913,Relationship Status: It's Complicated,2014-03-19,2014,0,0,0,4.273973
255940,In Order Not to Be Here,2003-01-01,2003,0,0,0,0.038024
255948,Nanayo,2008-11-01,2008,0,0,0,0.453058
255979,Balnearios,2002-04-23,2002,0,0,0,0.052877
256021,Macondo,2014-02-14,2014,0,0,0,0.069177
256030,Muck,2015-03-15,2015,0,0,0,1.649865
256040,Baahubali: The Beginning,2015-07-10,2015,40000000,100000000,60000000,11.80967
256044,Village People Radio Show,2007-01-01,2007,0,0,0,0.038824
256057,G√ºeros,2015-03-20,2015,0,0,0,2.159836
256092,Drive Hard,2014-05-26,2014,12000000,0,-12000000,6.004189
256102,To Singapore with Love,2013-07-10,2013,0,0,0,0.053838
256103,Night Flight,2014-02-09,2014,0,0,0,0.779126
256106,Blind Massage,2014-02-17,2014,0,0,0,0.597468
256108,Inbetween Worlds,2014-02-11,2014,0,0,0,1.046439
256109,Last Call,2012-04-12,2012,0,0,0,0.871584
256118,Bad Boy,1949-02-22,1949,0,0,0,0.315508
256122,Prata Palomares,1972-01-01,1972,0,0,0,0.002317
256166,Murder by Natural Causes,1979-02-17,1979,0,0,0,1.040928
256196,Burning Blue,2013-06-29,2013,0,0,0,4.630341
256222,Sleep,1963-01-01,1963,0,0,0,0.149295
256273,The Fluffy Movie,2014-07-25,2014,0,0,0,2.246494
256274,"As Above, So Below",2014-08-14,2014,5000000,40100000,35100000,10.846585
256283,Looking for Light: Jane Bown,2014-04-25,2014,0,0,0,0.071112
256306,Ice Poison,2014-02-07,2014,0,0,0,0.191301
256311,Stereo,2014-05-15,2014,0,0,0,3.93412
256314,Beltracchi - The Art of the Forgery,2014-03-06,2014,0,0,0,0.923673
256316,Tabloid Truth,2014-02-20,2014,0,0,0,0.618248
256328,The Water Front,2007-11-01,2007,0,0,0,0.00353
256347,Not Safe for Work,2014-05-09,2014,0,0,0,2.28311
256356,Speed Cross,1980-02-02,1980,0,0,0,0.465408
256375,If I Had Four Dromedaries,1966-01-01,1966,0,0,0,0.139913
256382,The Circus Tent,1978-01-18,1978,0,0,0,0.043701
256396,The Thrill of Brazil,1946-09-06,1946,0,0,0,0.917732
256421,Superman 75,2013-10-15,2013,0,0,0,1.22198
256474,In the Blood,2014-04-04,2014,10000000,0,-10000000,6.332859
256476,Walking with the Enemy,2014-04-25,2014,0,0,0,2.313749
256503,Nas: Time Is Illmatic,2014-04-04,2014,0,0,0,1.923351
256511,Cut!,2014-01-14,2014,0,0,0,1.177813
256520,When I Will Become a Giant,1978-01-01,1978,0,0,0,0.916141
256546,A Small September Affair,2014-02-14,2014,0,0,0,1.731338
256561,Free to Play,2014-03-19,2014,150000,0,-150000,3.453816
256562,Tar Creek,2009-08-13,2009,0,0,0,0.048424
256569,Trespass Against Us,2017-01-20,2017,0,0,0,11.480378
256591,Focus,2015-02-25,2015,50100000,153962963,103862963,10.035362
256593,Tillbaka till Bromma,2014-02-19,2014,0,0,0,0.194933
256608,Embassy,2013-10-18,2013,0,0,0,0.094228
256628,Takedown: The DNA of GSP,2014-02-20,2014,0,0,0,0.463995
256679,The Secret Country: The First Australians Fight Back,1986-01-01,1986,0,0,0,0.410375
256687,Swelter,2014-04-20,2014,8000000,0,-8000000,2.409569
256731,Bad Country,2014-09-26,2014,0,0,0,11.221265
256735,The Husband She Met Online,2013-10-26,2013,0,0,0,1.230587
256740,Wicked Blood,2014-03-04,2014,3500000,0,-3500000,3.188634
256750,The Rhythm of Crime,1981-01-01,1981,0,0,0,0.990878
256756,Purgatory,2014-03-28,2014,0,0,0,0.3475
256771,The Pool,2014-05-01,2014,0,0,0,0.551927
256779,The Princess of Egypt,2013-06-13,2013,0,0,0,0.082353
256835,Toy Story That Time Forgot,2014-12-02,2014,0,0,0,8.609555
256836,Next Goal Wins,2014-04-25,2014,0,0,0,1.747806
256876,Red Army,2014-08-13,2014,0,694600,694600,3.898604
256885,Symphony No. 42,2014-02-07,2014,0,0,0,0.365646
256907,Darr @ the Mall,2014-02-21,2014,0,0,0,1.283475
256912,Lasa & Zabala,2014-10-17,2014,0,0,0,1.323874
256913,Quantum Love,2014-04-23,2014,0,0,0,4.6887
256916,Sus ojos se cerraron y el mundo sigue andando,1998-01-23,1998,0,0,0,0.376985
256917,The Water Diviner,2014-12-25,2014,22500000,15520023,-6979977,9.615664
256921,A tiro limpio,1963-09-02,1963,0,0,0,0.037258
256922,In a Town This Size,2011-03-09,2011,0,0,0,0.007068
256924,Danny Collins,2015-03-19,2015,10000000,10835752,835752,16.903373
256930,Kano,2014-02-27,2014,7,0,-7,1.050606
256959,"White Out, Black In",2014-09-20,2014,0,0,0,1.236621
256961,Paul Blart: Mall Cop 2,2015-04-16,2015,38000000,107597242,69597242,17.02038
256962,Little Boy,2015-04-23,2015,20000000,6485961,-13514039,11.946728
256969,Boys of Abu Ghraib,2014-03-15,2014,0,0,0,2.597221
257004,The Stalker,2013-03-01,2013,300,0,-300,0.892921
257006,Encounters in the Deep,1979-04-04,1979,0,0,0,0.000132
257026,The Irish Pub,2013-10-04,2013,0,0,0,0.188489
257039,The Drunk,2014-02-16,2014,1000000,0,-1000000,0.014118
257044,Game For Vultures,1980-09-17,1980,0,0,0,0.810999
257059,The Hope Factory,2014-01-25,2014,0,0,0,1.153509
257081,Submarine Patrol,1938-11-25,1938,0,0,0,0.928714
257084,Tunisian Victory,1944-03-23,1944,0,0,0,0.009488
257087,The Veil,2016-04-21,2016,4000000,0,-4000000,10.087243
257088,Point Break,2015-12-03,2015,105000000,133718711,28718711,7.291872
257091,Get Hard,2015-03-26,2015,40000000,111811453,71811453,8.178015
257093,Dark House,2014-03-14,2014,0,0,0,2.85116
257095,Prince Bayaya,1950-01-26,1950,0,0,0,0.036841
257109,Bite Size,2014-03-07,2014,0,0,0,0.07953
257116,SlingShot,2014-03-14,2014,0,0,0,0.638842
257117,Blood Punch,2014-02-21,2014,0,0,0,2.880819
257134,Lawrence & Holloman,2014-08-29,2014,0,0,0,0.137186
257155,Threads of Destiny,2014-02-23,2014,0,0,0,0.738069
257160,Ohm Shanthi Oshaana,2014-02-07,2014,220000,1500000,1280000,0.633359
257176,Shadow People,2007-01-01,2007,0,0,0,0.038962
257200,The Conquerors,2013-09-25,2013,0,0,0,0.172239
257211,The Intern,2015-09-24,2015,35000000,194564672,159564672,15.651705
257214,Loaded,2014-03-08,2014,0,0,0,0.674434
257237,Il castello,2011-02-26,2011,0,0,0,0.41453
257238,As It Is in Heaven,2014-08-15,2014,0,0,0,0.068056
257245,East Side Sushi,2014-03-08,2014,0,0,0,1.020277
257249,The Human Experiment,2013-11-23,2013,0,0,0,1.108435
257253,Le Rossignol,2005-04-16,2005,0,0,0,0.0033
257258,Sold,2016-04-01,2016,0,0,0,1.933369
257291,Prater,2007-02-10,2007,0,0,0,0.038859
257296,The Righteous Thief,2009-11-26,2009,0,0,0,0.821182
257302,May Morning,1970-08-02,1970,0,0,0,1.9e-05
257331,Thread of Lies,2014-03-13,2014,0,0,0,0.623593
257343,Recep ƒ∞vedik 4,2014-02-20,2014,0,149521495,149521495,1.590383
257344,Pixels,2015-07-16,2015,88000000,243637091,155637091,21.14796
257345,The Darkness,2016-05-13,2016,4000000,10898293,6898293,12.187189
257346,Avengers Confidential: Black Widow & Punisher,2014-03-25,2014,0,0,0,9.945558
257347,Universal Soldier,1972-05-01,1972,0,0,0,0.060787
257377,A Circle of Deception,1960-11-01,1960,0,0,0,0.005029
257407,Actress,2014-11-07,2014,0,0,0,0.528734
257439,Bank$tas,2014-04-18,2014,0,0,0,0.78662
257440,Term Life,2016-04-29,2016,16500000,21256,-16478744,7.35578
257442,Almost Married,2014-03-28,2014,0,0,0,0.879915
257444,The Boy,2015-08-14,2015,0,0,0,5.345593
257445,Goosebumps,2015-08-05,2015,58000000,158162788,100162788,12.365292
257447,Tapped Out,2014-05-27,2014,0,0,0,1.849147
257450,Piranha Sharks,2015-08-06,2015,0,0,0,1.35227
257451,Trailer Park Boys: Don't Legalize It,2014-04-18,2014,0,0,0,1.335959
257454,Give Us the Moon,1944-09-18,1944,0,0,0,0.512585
257472,Rivers of Sand,1974-10-30,1974,0,0,0,0.0375
257487,Inevitable,2014-04-11,2014,0,0,0,0.277213
257521,Persecuted,2014-05-09,2014,0,1558836,1558836,11.153781
257534,The Shoe,1998-03-01,1998,0,0,0,0.078652
257537,Dream Land,2004-11-05,2004,0,0,0,0.002354
257561,Animated Motion: Part 5,1978-01-01,1978,0,0,0,1e-06
257563,Narcissus,1983-08-18,1983,0,0,0,0.085889
257568,Days of Wrath,2013-10-30,2013,0,0,0,1.105183
257574,My Sweet Charlie,1970-01-20,1970,0,0,0,0.25275
257578,The Miracle Worker,1979-10-14,1979,0,0,0,0.05556
257593,La mossa del pinguino,2014-03-01,2014,0,0,0,1.522658
257604,Kukuli,1961-01-01,1961,0,0,0,0.046175
257605,The Trial of Lee Harvey Oswald,1977-09-30,1977,0,0,0,0.431913
257608,Khanei ruye ab,,,0,0,0,0.0
257614,As the Palaces Burn,2014-01-27,2014,0,0,0,0.639113
257618,Ditirambo,1969-03-12,1969,0,0,0,0.04329
257623,The Magic City,1955-07-18,1955,0,0,0,0.174793
257648,The White Haired Witch of Lunar Kingdom,2014-02-14,2014,0,0,0,1.134239
257668,Kummeli V,2014-02-19,2014,0,0,0,0.768578
257698,Femmes femmes,1974-11-27,1974,0,0,0,0.015022
257716,Black and White,1968-03-15,1968,0,0,0,0.101017
257734,Benjamin Bl√ºmchen - Seine sch√∂nsten Abenteuer,2006-09-28,2006,0,0,0,0.013563
257831,Dream City,1973-11-15,1973,0,0,0,0.387376
257874,Beneath,2013-10-08,2013,89,0,-89,7.817221
257907,Spirit of Youth,1938-04-01,1938,0,0,0,0.068106
257912,Event 15,2013-03-05,2013,0,0,0,2.429872
257925,The Loyal 47 Ronin,1958-03-31,1958,0,0,0,0.668944
257932,Dragon Nest: Warriors' Dawn,2014-05-20,2014,40000000,0,-40000000,3.028163
257947,Mamay,2003-02-19,2003,0,0,0,0.123454
257974,Missing William,2014-03-07,2014,0,0,0,0.529802
257975,After Death,2012-10-05,2012,0,0,0,0.530841
258026,Idlers of the Fertile Valley,1978-10-01,1978,0,0,0,0.000603
258034,4 Moons,2014-03-21,2014,0,0,0,2.734851
258049,Mother Earth,1968-07-10,1968,0,0,0,0.002366
258070,The Broken Jug,1937-10-18,1937,0,0,0,0.662166
258075,Cruel & Unusual,2014-04-05,2014,0,0,0,0.517732
258086,The Damned,2013-10-17,2013,0,0,0,7.305699
258096,Alpha and Omega 3: The Great Wolf Games,2014-03-25,2014,0,0,0,2.455786
258099,Just Before I Go,2014-04-24,2014,0,0,0,6.528444
258100,Approaching the Elephant,2015-02-20,2015,0,0,0,0.186852
258113,Assepoester: Een Modern Sprookje,2014-01-01,2014,0,0,0,1.080523
258116,The Anatomy of Hate,2009-04-21,2009,0,0,0,0.110588
258126,HalloHallo,2014-02-07,2014,0,0,0,0.127643
258147,Highway of Tears,2014-03-06,2014,0,0,0,0.022031
258193,Alien Abduction,2014-04-04,2014,0,0,0,5.991675
258200,The Lone Ranger,1938-02-13,1938,0,0,0,0.001707
258210,Airplane vs Volcano,2014-03-28,2014,0,0,0,1.434665
258227,Lust for Gold,1974-10-27,1974,0,0,0,0.066819
258230,A Monster Calls,2016-10-07,2016,43000000,46652768,3652768,24.483893
258236,Skokie,1981-11-17,1981,0,0,0,1.322607
258251,Ironclad 2: Battle for Blood,2014-03-14,2014,0,0,0,1.002102
258253,Small Town of Anara,1978-03-06,1978,0,0,0,0.073328
258255,Mischief Night,2014-05-20,2014,0,0,0,0.824619
258284,Every Secret Thing,2014-04-20,2014,0,0,0,3.465405
258305,Hunt for the Labyrinth Killer,2013-08-03,2013,0,0,0,0.921705
258322,Fasten Your Seatbelts,2014-03-06,2014,0,5260000,5260000,2.973264
258353,The Good Mistress,2014-02-15,2014,0,0,0,1.076932
258358,Advanced Style,2014-05-09,2014,0,0,0,0.881511
258363,Desierto,2015-04-12,2015,0,0,0,6.073841
258369,Along the Sungari River,1947-03-06,1947,0,0,0,0.071483
258384,Flight into Darkness,1935-10-22,1935,0,0,0,0.114439
258435,Folies Berg√®re,2014-03-08,2014,0,0,0,1.11984
258450,Addictions and Subtractions,2004-09-22,2004,1500000,0,-1500000,0.66142
258476,"A Fragile Trust: Plagiarism, Power, and Jayson Blair at the New York Times",2014-03-07,2014,0,0,0,0.046415
258480,Carol,2015-11-20,2015,11800000,40272135,28472135,8.364201
258489,The Legend of Tarzan,2016-06-29,2016,180000000,356743061,176743061,45.38298
258509,Alvin and the Chipmunks: The Road Chip,2015-12-17,2015,0,233755553,233755553,14.307672
258514,Van Gogh: Painted with Words,2010-04-05,2010,0,0,0,2.071003
258521,The Deceased,1965-01-01,1965,0,0,0,0.436717
258550,"Lightning, the White Stallion",1986-10-17,1986,0,0,0,0.00043
258585,Arvon veli,2004-09-08,2004,0,0,0,0.003307
258614,Pantani: The Accidental Death of a Cyclist,2014-02-17,2014,0,0,0,0.522332
258630,Pelota,1983-09-09,1983,0,0,0,9.5e-05
258631,The Girl and The Echo,1964-06-06,1964,0,0,0,0.621657
258656,The Sixth Face of the Pentagon,1968-01-01,1968,0,0,0,0.173191
258665,A Prayer for Rain,2013-10-18,2013,0,0,0,2.4344
258673,The Trip to Bountiful,2014-03-08,2014,0,0,0,0.4494
258691,A Ring by Spring,2014-03-08,2014,0,0,0,0.486972
258749,They Are All Dead,2014-03-27,2014,0,0,0,0.73028
258750,Gun Woman,2014-02-28,2014,0,0,0,2.237762
258751,For a Handful of Kisses,2014-05-16,2014,0,0,0,1.792419
258755,Hidden Away,2014-10-03,2014,0,0,0,2.036082
258771,The Gambler,2013-09-25,2013,0,0,0,0.128131
258800,The Drunkard,1950-01-23,1950,0,0,0,0.402917
258805,Bad Johnson,2014-05-02,2014,0,0,0,2.53601
258809,Broadway Bad,1933-02-24,1933,0,0,0,0.674997
258893,Scooby-Doo! WrestleMania Mystery,2014-03-25,2014,0,0,0,7.400531
258907,Dyketactics,1974-01-01,1974,0,0,0,0.331254
258945,Anything Can Happen,1995-12-10,1995,0,0,0,0.172959
258947,Deadly Virtues: Love. Honour. Obey.,2015-09-28,2015,0,0,0,1.093554
259014,A Bit of Bad Luck,2014-04-17,2014,0,0,0,0.794622
259018,Behaving Badly,2014-04-14,2014,0,0,0,6.010463
259072,Wrong Turn 6: Last Resort,2014-08-22,2014,1200000,0,-1200000,7.445236
259074,Joy Ride 3,2014-06-03,2014,0,0,0,2.681592
259075,Cave of the Sharks,1978-06-28,1978,0,0,0,3.2e-05
259129,Monster,2014-03-13,2014,0,0,0,1.189852
259171,The Silent Mountain,2014-03-14,2014,0,0,0,1.82058
259180,The Impossible Hour,1974-03-08,1974,0,0,0,4.9e-05
259183,Home at Seven,1952-03-16,1952,0,0,0,1.02371
259209,Feast of July,1995-10-12,1995,0,0,0,0.523575
259231,Picture of Light,1994-12-15,1994,0,0,0,0.142515
259233,Ju-on: The Beginning of the End,2014-06-28,2014,0,0,0,1.235132
259246,Chasing the Devil,2014-03-07,2014,0,0,0,0.524786
259261,The Anonymous People,2013-08-15,2013,0,0,0,0.05148
259292,Honeymoon,1947-05-17,1947,0,0,0,0.117648
259300,009-1: The End of the Beginning,2013-09-07,2013,0,0,0,0.694855
259311,Opera Australia: The Pirates of Penzance,2006-01-01,2006,0,0,0,0.00353
259316,Fantastic Beasts and Where to Find Them,2016-11-16,2016,180000000,809342332,629342332,41.051421
259325,The Woman I Love,1937-04-15,1937,0,0,0,0.001321
259358,Sputnik,2013-10-24,2013,0,0,0,0.760585
259387,The Purse Snatcher,1995-04-06,1995,0,0,0,0.007424
259389,Dancing in September,2001-02-03,2001,850000,0,-850000,0.935221
259395,Tom Segura: Completely Normal,2014-03-15,2014,0,0,0,0.598777
259442,"Tough Guise: Violence, Media & the Crisis in Masculinity",1999-01-01,1999,0,0,0,0.48959
259453,I Am Soldier,2014-03-17,2014,0,0,0,3.330985
259460,Behavior,2014-01-16,2014,0,0,0,1.006481
259468,A Woman's Decision,1975-01-21,1975,0,0,0,0.122485
259550,Two Gentlemen Sharing,1969-09-17,1969,0,0,0,0.171405
259557,Running Scared,1980-11-01,1980,0,0,0,0.997875
259593,Where Do We Go from Here?,1945-05-23,1945,0,0,0,0.104985
259610,Bastards,2014-03-15,2014,0,0,0,0.121762
259611,Frontera,2014-07-31,2014,0,0,0,4.489185
259616,Die Weihnachtsklempner,1986-03-17,1986,0,0,0,1.1e-05
259634,Big Man - A Policy for Hell,1988-12-30,1988,0,0,0,0.029635
259645,"How Far, How Near",1972-05-04,1972,0,0,0,0.016318
259679,Requiem For The Big East,2014-03-16,2014,0,0,0,0.106924
259690,The Lika Cinema,2008-07-20,2008,0,0,0,0.067152
259693,The Conjuring 2,2016-05-13,2016,40000000,320170008,280170008,14.767317
259694,How to Be Single,2016-01-21,2016,38000000,112343513,74343513,8.898988
259695,Live by Night,2016-12-25,2016,108000000,22678555,-85321445,19.94393
259719,Getulio,2014-05-01,2014,0,0,0,0.732663
259720,2 States,2014-04-17,2014,0,0,0,2.196257
259728,Long Dark Night,2004-03-07,2004,0,0,0,0.80057
259761,Lights Out,2013-12-01,2013,0,0,0,4.08272
259808,Criminal Justice,1990-09-08,1990,0,0,0,1.460826
259830,Scintilla,2014-02-28,2014,0,0,0,1.919806
259835,Kindar the Invulnerable,1965-03-05,1965,0,0,0,0.01057
259838,Journey to the Safest Place on Earth,2013-10-10,2013,0,0,0,0.167894
259843,Natural Sciences,2014-03-10,2014,0,0,0,0.097556
259879,20 Ft Below: The Darkness Descending,2014-03-18,2014,0,0,0,1.74524
259894,A Sister's Revenge,2013-04-27,2013,0,0,0,0.731394
259910,Marvel Studios: Assembling a Universe,2014-03-18,2014,0,0,0,7.33781
259912,Memed My Hawk,1984-05-10,1984,0,0,0,0.008673
259943,Coming Home,2014-05-16,2014,0,0,0,5.262031
259954,5 to 7,2014-04-19,2014,0,0,0,6.852262
259956,About Alex,2014-08-08,2014,0,0,0,9.156825
259958,Alex of Venice,2015-04-17,2015,0,0,0,2.278837
259963,Boulevard,2014-04-20,2014,0,126150,126150,5.7396
259975,Belle Starr,1980-03-31,1980,0,0,0,0.120938
259985,Just Eat It: A Food Waste Story,2014-04-27,2014,0,0,0,0.202025
259997,Such Good People,2014-05-09,2014,0,0,0,0.417909
259999,Keep On Keepin‚Äô On,2014-08-08,2014,0,0,0,0.804915
260001,Life Partners,2014-12-05,2014,0,8265,8265,4.782116
260030,Nymph,2014-03-08,2014,0,0,0,2.207203
260063,Seal Team Eight: Behind Enemy Lines,2014-03-01,2014,0,0,0,6.775165
260064,My Man and I,1952-09-05,1952,0,0,0,0.440826
260094,Four of Us,2014-03-20,2014,0,0,0,0.427371
260156,Gitmo,2005-11-04,2005,0,0,0,0.110953
260163,Apocalyptic,2013-11-22,2013,0,0,0,0.589528
260176,Southern Baptist Sissies,2013-11-18,2013,0,0,0,0.142123
260182,Ochtendzwemmers,2001-04-08,2001,0,0,0,0.001873
260202,Turks & Caicos,2014-03-20,2014,0,0,0,5.750384
260211,Achmed Saves America,2014-03-18,2014,0,0,0,0.458095
260234,"Monster High: Frights, Camera, Action!",2014-03-25,2014,0,0,0,1.514793
260240,Catatan (Harian) Si Boy,2011-07-01,2011,0,0,0,0.324623
260310,Space Dogs 2,2014-02-06,2014,6000000,0,-6000000,0.622825
260312,The Yellow Eyes of Crocodiles,2014-04-09,2014,0,0,0,9.203353
260313,Flowers,2014-10-10,2014,0,0,0,1.138515
260339,Salting the Battlefield,2014-03-27,2014,0,0,0,5.628651
260346,Taken 3,2014-12-16,2014,48000000,325771424,277771424,18.081483
260352,Book of Days,1989-11-30,1989,0,0,0,0.04107
260372,Bermuda Tentacles,2014-04-04,2014,0,0,0,2.404717
260397,Buried in Light,1994-03-21,1994,0,0,0,0.001189
260399,Building a Broken Mousetrap,2006-03-21,2006,0,0,0,0.003563
260401,Evening's Civil Twilight in Empires of Tin,2008-03-21,2008,0,0,0,0.003584
260409,Barricade,1950-03-24,1950,0,0,0,0.240688
260500,Legion of the Black,2012-12-21,2012,150000,0,-150000,0.036631
260514,Cars 3,2017-06-15,2017,175000000,350170057,175170057,19.148182
260522,Easy on the Eyes,2014-02-27,2014,2153912,4864560,2710648,0.334881
260528,De f√ªke,2000-04-20,2000,0,0,0,0.00118
260535,The Little Rascals Save the Day,2014-03-25,2014,8000000,0,-8000000,3.868355
260583,The Substitute Husband,1936-12-20,1936,0,0,0,0.001197
260584,Peasants,1981-06-06,1981,0,0,0,0.038552
260646,Victor Young Perez,2013-11-20,2013,0,0,0,1.723131
260666,El Super,1979-04-28,1979,0,0,0,0.028571
260672,The First Time,1983-07-13,1983,0,0,0,0.014473
260677,Todd Barry: The Crowd Work Tour,2014-03-21,2014,0,0,0,0.947313
260817,The Seventh Bullet,1973-04-30,1973,0,0,0,0.035562
260826,Jesus Christ's Horoscope,1989-10-12,1989,0,0,0,0.064711
260839,Fear In The City,1981-01-01,1981,0,0,0,0.000672
260840,Casa dell'amore... la polizia interviene,1978-10-08,1978,0,0,0,0.000285
260848,Smiling Maniacs,1975-01-16,1975,0,0,0,0.001754
260857,Due Magnum .38 per una citt√† di carogne,1975-10-02,1975,0,0,0,0.5
260872,The New Godfathers,1979-08-24,1979,0,0,0,0.1907
260883,Silence the Witness,1974-05-15,1974,0,0,0,0.25
260884,Chronicle of a Homicide,1972-02-04,1972,0,0,0,1.150055
260886,Could It Happen Here?,1977-11-24,1977,0,0,0,0.0735
260888,L'avvertimento,1980-08-15,1980,0,0,0,2.3e-05
260891,The Climber,1975-02-18,1975,0,0,0,0.000248
260893,L'arma,1978-09-07,1978,0,0,0,0.01121
260899,La banda Vallanzasca,1977-12-15,1977,0,0,0,0.000176
260907,Lo sgarbo,1975-01-01,1975,0,0,0,1e-06
260912,The Police Serve the Citizens?,1973-01-01,1973,0,0,0,0.949698
260916,Invaders from the Deep,1981-01-01,1981,0,0,0,0.25
260928,Double Down,2005-01-01,2005,0,0,0,0.220443
260947,Something Wicked,2014-04-04,2014,3000000,0,-3000000,1.436789
260969,Kerosene Salesman's Wife,1988-01-01,1988,0,0,0,0.102196
260999,Processo per direttissima,1976-06-09,1976,0,0,0,0.207599
261005,Your Honor,1973-09-10,1973,0,0,0,0.25
261023,Black Mass,2015-09-04,2015,53000000,98837872,45837872,10.61072
261033,Manos sucias,2014-04-17,2014,0,0,0,0.732831
261035,Captain Midnight,1942-02-15,1942,0,0,0,0.011161
261036,Match,2014-04-18,2014,0,37285,37285,2.099788
261037,Miss Meadows,2014-09-12,2014,2000000,0,-2000000,2.934599
261038,The Newburgh Sting,2014-04-20,2014,0,0,0,0.535827
261039,"The Other One: The Long, Strange Trip of Bob Weir",2014-04-20,2014,0,0,0,0.266212
261041,The Search for General Tso,2014-04-20,2014,0,0,0,1.087791
261047,P-51 Dragon Fighter,2014-06-17,2014,0,0,0,0.750481
261101,Cantinflas,2014-08-29,2014,0,0,0,1.706992
261102,The Club of the Misunderstood,2014-12-25,2014,0,0,0,5.074475
261103,Maya the Bee Movie,2014-09-11,2014,0,0,0,6.287213
261112,Cairn,2008-06-12,2008,0,0,0,0.110657
261144,Impure Thoughts,1986-11-25,1986,0,0,0,0.254241
261157,Senn,2013-02-19,2013,0,0,0,0.187104
261192,Age of Cannibals,2014-02-10,2014,0,0,0,1.555531
261207,A Night at the Movies: The Suspenseful World of Thrillers,2009-10-02,2009,0,0,0,0.042765
261246,Century,1993-12-31,1993,0,0,0,1.461029
261249,Chubasco,1967-06-30,1967,0,0,0,0.639133
261273,Toxin,2014-02-25,2014,0,0,0,1.680483
261274,A Flower,1971-01-01,1971,0,0,0,0.480355
261375,Flying Home,2014-04-02,2014,0,0,0,7.958403
261392,American Ultra,2015-08-19,2015,28000000,27139524,-860476,9.534828
261409,VeggieTales: Josh and the Big Wall,1997-09-01,1997,0,0,0,0.07202
261410,VeggieTales: God Wants Me to Forgive Them!?!,1994-10-01,1994,0,0,0,0.130473
261414,Larry David: Curb Your Enthusiasm,1999-10-17,1999,0,0,0,0.534169
261419,No Trees in the Street,1959-01-01,1959,0,0,0,0.589774
261433,Pao's Story,2006-01-01,2006,0,0,0,0.366271
261439,Hamlet at Elsinore,1964-11-15,1964,0,0,0,0.342371
261461,Loucas pra Casar,2015-01-08,2015,3000000,0,-3000000,2.517939
261508,The Tiger from Tjampa,1953-01-01,1953,0,0,0,0.041724
261538,Tora-san's Rise and Fall,1975-08-19,1975,0,0,0,0.000589
261562,Blazing a Trail to the Stars,1958-06-04,1958,0,0,0,0.286
261581,Louis C.K.: One Night Stand,2005-08-19,2005,0,0,0,0.841152
261684,This Side of Heaven,1934-02-02,1934,0,0,0,0.122658
261768,Lullaby,2014-06-13,2014,0,0,0,1.679045
261770,Affluenza,2014-07-11,2014,0,0,0,0.374794
261810,Silenced,2014-11-19,2014,0,0,0,0.31926
261813,Slaying the Badger,2014-07-22,2014,0,0,0,0.050663
261814,Super Duper Alice Cooper,2014-04-17,2014,0,0,0,1.069667
261815,Five Star,2014-04-17,2014,0,0,0,1.24488
261817,Gabriel,2014-04-17,2014,0,0,0,0.877002
261818,Glass Chin,2014-04-19,2014,0,0,0,0.835154
261820,Goodbye to All That,2014-12-17,2014,0,0,0,2.489524
261823,Loitering with Intent,2014-04-18,2014,0,0,0,1.067448
261824,X/Y,2014-04-19,2014,0,0,0,0.988889
261825,Zero Motivation,2014-06-26,2014,0,0,0,0.99059
261830,Bj√∂rk: Biophilia Live,2014-10-10,2014,0,0,0,0.656176
261855,1971,2014-04-18,2014,0,0,0,0.388844
261857,Ballet 422,2014-04-19,2014,0,0,0,1.740687
261860,Dior and I,2015-03-27,2015,0,0,0,5.979181
261871,Polar Flight,2013-12-12,2013,0,0,0,0.036523
261872,Sunstruck,1972-12-22,1972,0,0,0,0.003242
261884,Memory Vague,2009-06-01,2009,0,0,0,0.005136
261899,Prospect,2014-03-26,2014,0,0,0,0.55705
261906,The Sheik,2014-04-26,2014,0,0,0,1.653319
261985,Cinderella,2011-10-30,2011,0,0,0,0.987462
262009,In the Crosswind,2014-03-28,2014,650000,0,-650000,1.164299
262088,Chocolate Strawberry Vanilla,2013-11-24,2013,0,0,0,1.209092
262113,Monk by Blood,,,0,0,0,0.0
262137,Overheard 3,2014-05-30,2014,0,0,0,1.292806
262165,The Unwanted,2014-03-31,2014,100000,0,-100000,0.571518
262169,Gravy,2015-10-02,2015,0,0,0,1.152146
262176,The Great Gatsby,1926-11-21,1926,0,0,0,0.001224
262199,Hannibal Buress: Live From Chicago,2014-03-24,2014,300000,0,-300000,1.092819
262227,Race Gurram,2014-04-11,2014,0,0,0,0.910767
262234,Don't Bet on Women,1931-02-15,1931,0,0,0,0.073332
262243,The John Garfield Story,2003-02-03,2003,0,0,0,0.072941
262260,The Desert Song,1929-04-08,1929,354000,0,-354000,0.005051
262267,Darkest Night,2012-10-20,2012,0,0,0,0.256166
262296,Acadia Acadia?!?,1971-01-01,1971,0,0,0,0.25
262311,Cherry Tobacco,2014-10-17,2014,0,0,0,0.655674
262338,Good People,2014-09-26,2014,0,0,0,6.965686
262340,Mrs. Brown's Boys D'Movie,2014-06-27,2014,5900000,23000000,17100000,1.840891
262357,Redwood Highway,2013-04-05,2013,0,0,0,1.263743
262390,112 Weddings,2014-06-13,2014,0,0,0,0.362159
262391,Serial (Bad) Weddings,2014-04-16,2014,13000000,0,-13000000,10.926965
262436,Champs,2015-03-13,2015,0,0,0,2.045686
262447,Postscript,1983-11-21,1983,0,0,0,0.001393
262454,The Cheat,1950-01-25,1950,0,0,0,0.00567
262474,Pro Wrestlers vs Zombies,2014-03-28,2014,230000,0,-230000,0.177258
262475,G.I. Joe: The Revenge of Cobra,1984-09-10,1984,0,0,0,0.000308
262481,An Honest Liar,2014-04-18,2014,0,0,0,2.400781
262500,Insurgent,2015-03-18,2015,110000000,295238201,185238201,27.887186
262504,Allegiant,2016-03-09,2016,110000000,179246868,69246868,18.386172
262514,The Bodyguard,1979-01-01,1979,0,0,0,0.138355
262517,Triptych,1977-12-31,1977,0,0,0,0.069819
262522,Poison,2000-04-04,2000,0,0,0,0.732388
262528,The Purple Gang,1959-12-18,1959,0,0,0,0.041885
262536,Draegerman Courage,1937-05-15,1937,0,0,0,0.672146
262542,51 Degrees North,2015-06-30,2015,0,0,0,0.33804
262543,Automata,2014-10-09,2014,7000000,0,-7000000,13.973689
262551,Babysitting,2014-04-16,2014,0,0,0,6.694707
262609,Astro-Zombies M3: Cloned,2010-06-19,2010,0,0,0,0.161226
262713,Godheten,2013-02-15,2013,0,0,0,0.147212
262755,The Edge,1968-03-26,1968,0,0,0,0.001179
262775,Lovely Man,2011-09-30,2011,0,0,0,0.060637
262782,Boys in Brazil,2014-05-15,2014,0,0,0,0.476078
262785,I corpi estranei,2013-11-12,2013,0,0,0,0.125804
262786,Il pretore,2014-04-03,2014,0,0,0,0.782061
262788,The Games Maker,2014-07-03,2014,6000000,0,-6000000,2.56817
262789,Ti ricordi di me?,2014-04-03,2014,0,0,0,2.193513
262806,The Forty-First,1927-04-01,1927,0,0,0,0.036472
262829,W.A.R.: Women Against Rape,1987-01-01,1987,0,0,0,0.329919
262831,Banana Paradise,1989-12-01,1989,0,0,0,0.313041
262840,WolfCop,2014-06-06,2014,0,0,0,3.903768
262841,Monster Trucks,2016-12-21,2016,125000000,64493915,-60506085,14.801195
262848,Phantasm: Ravager,2016-10-07,2016,0,0,0,2.203931
262866,In Security,2014-04-28,2014,0,0,0,1.761397
262871,The House of Exorcism,1975-04-02,1975,0,0,0,1.251434
262897,Another World,2014-03-15,2014,0,0,0,0.439457
262904,Kidnapped for Christ,2014-04-09,2014,0,0,0,1.043893
262945,"Am Tag, als der Regen kam",1959-11-24,1959,0,0,0,0.660252
262958,Jimmy's Hall,2014-05-30,2014,0,2606000,2606000,2.839854
262975,The Necktie,2008-08-28,2008,0,0,0,0.229713
262982,The Hollow Point,2016-12-16,2016,0,0,0,8.093488
262987,Filomena Marturano,1951-01-01,1951,0,0,0,0.017384
262988,The Men Who Made the Movies: Samuel Fuller,2002-07-02,2002,0,0,0,0.338325
263029,Late Night with Conan O'Brien: The Best of Triumph the Insult Comic Dog,2004-08-10,2004,0,0,0,0.764447
263032,Miss Rose White,1992-04-26,1992,0,0,0,0.840651
263065,The Elephant Man,1982-01-04,1982,0,0,0,0.092102
263105,Boy Meets Girl,2015-02-06,2015,0,0,0,2.171597
263109,Shaun the Sheep Movie,2015-02-05,2015,0,59700000,59700000,9.961184
263111,Jim Gaffigan: Obsessed,2014-04-27,2014,0,0,0,1.26846
263112,Current,1963-12-30,1963,0,0,0,0.159351
263115,Logan,2017-02-28,2017,97000000,616801808,519801808,54.581997
263260,Aschenputtel,1955-09-03,1955,0,0,0,0.071483
263281,Our Summer in Provence,2014-04-02,2014,0,0,0,4.39709
263314,Taryanche Bait,2011-04-11,2011,0,0,0,0.015176
263341,"Crouching Tiger, Hidden Dragon: Sword of Destiny",2016-02-18,2016,20000000,0,-20000000,8.796536
263412,Akelarre,1984-03-08,1984,0,0,0,0.080326
263416,Dead Sea,2014-04-15,2014,500000,0,-500000,0.966179
263471,I,2015-01-04,2015,16000000,0,-16000000,1.878496
263472,Knock Knock,2015-06-26,2015,2500000,6341684,3841684,11.898793
263510,The Hornet's Nest,2014-05-09,2014,0,0,0,1.592812
263524,Lewis Black: Old Yeller - Live at the Borgata,2013-08-24,2013,0,0,0,0.548512
263532,The Danube Exodus,1998-07-29,1998,0,0,0,0.036519
263570,The Comedian,1957-02-14,1957,0,0,0,0.621443
263579,Milka - A Film About Taboos,1980-12-19,1980,0,0,0,5.9e-05
263582,Vrijdag,1981-03-07,1981,0,0,0,0.0375
263600,Election Day,2007-03-10,2007,0,0,0,0.080013
263614,Virunga,2014-11-07,2014,0,0,0,5.410939
263627,Lucky in Love,2014-04-05,2014,0,0,0,0.603441
263794,Druid Peak,2014-03-28,2014,114000,0,-114000,0.690307
263823,Sentimentalnyy roman,,,0,0,0,0.034286
263855,Fort Bliss,2014-09-05,2014,0,0,0,2.244264
263873,The Undertaker's Wedding,1997-01-01,1997,0,0,0,1.187218
263913,Balls Out,2014-04-19,2014,0,0,0,1.289388
263915,The Emperor of California,1936-07-20,1936,0,0,0,1.231773
263937,Into the Middle of Nowhere,2010-06-01,2010,0,0,0,0.008236
263945,Curious George: A Very Monkey Christmas,2009-11-10,2009,0,0,0,0.361954
263946,Prime Suspect: The Final Act,2006-11-12,2006,0,0,0,0.678719
263947,Prime Suspect 6: The Last Witness,2004-04-18,2004,0,0,0,1.573895
263976,The Staple of News,2014-04-09,2014,0,0,0,0.128127
263986,The Drownsman,2014-08-22,2014,0,0,0,1.50184
264036,Heavenly Judgement,2012-05-31,2012,0,0,0,2.176924
264038,Kaaka Muttai,2015-06-05,2015,0,0,0,1.071588
264048,A Patriotic Man,2013-12-04,2013,2300000,0,-2300000,0.366128
264061,Ski Patrol,1940-05-09,1940,0,0,0,0.321072
264080,SST: Death Flight,1977-02-25,1977,0,0,0,0.123782
264081,Mighty Jack,1987-01-01,1987,0,0,0,0.035275
264085,Bhoothnath Returns,2014-04-11,2014,0,0,0,1.171748
264098,Superdome,1978-01-09,1978,0,0,0,0.390858
264113,The Man You Had in Mind,2008-06-10,2008,0,0,0,0.004706
264164,Mala Mala,2014-04-19,2014,0,0,0,0.971795
264166,Point and Shoot,2014-04-19,2014,0,0,0,1.025364
264170,Batman: Strange Days,2014-04-09,2014,0,0,0,3.138299
264206,Sulemani Keeda,2014-09-30,2014,0,0,0,0.10162
264241,Restless Blood,1946-01-01,1946,0,0,0,0.071782
264264,The Crossing,2014-12-02,2014,40000000,0,-40000000,1.321766
264269,Apartment 18,2014-03-13,2014,0,320395,320395,0.217441
264273,Broken,2014-04-10,2014,0,0,0,1.936956
264309,Navy Blues,1929-12-20,1929,0,0,0,0.094685
264321,A Rumor Of War,1980-09-24,1980,0,0,0,0.173342
264337,Spare Parts,2015-01-16,2015,0,0,0,6.856419
264356,Simon's Cat,2012-10-19,2012,0,0,0,0.588734
264389,Tropical Carmine,2014-10-16,2014,0,0,0,0.457331
264393,Flame and Women,1967-12-01,1967,0,0,0,0.183668
264397,The Incident,2014-05-17,2014,0,0,0,1.140772
264401,Gloria,2014-10-20,2014,0,0,0,1.138199
264418,You're Killing Me Susana,2016-08-25,2016,0,0,0,0.986199
264454,Nessuno mi pettina bene come il vento,2014-04-10,2014,0,0,0,0.097431
264471,Farmland,2014-04-06,2014,0,0,0,0.058976
264482,The Thirteen,1937-05-08,1937,0,0,0,0.197008
264525,La dictadura perfecta,2014-10-16,2014,0,0,0,3.631321
264530,I've Never Had an Hilda,2014-10-21,2014,0,0,0,0.214223
264553,The Life and Mind of Mark DeFriest,2014-04-30,2014,0,0,0,0.363846
264555,Death Clique,2014-04-12,2014,2000000,0,-2000000,1.753599
264560,When Friendship Kills,1996-02-19,1996,0,0,0,0.962282
264569,Dave Attell: Road Work,2014-04-13,2014,0,0,0,0.173142
264644,Room,2015-10-16,2015,6000000,35401758,29401758,12.443291
264646,LEGO Hero Factory: Savage Planet,2011-10-04,2011,0,0,0,3.120999
264656,The Homesman,2014-05-18,2014,16000000,3442853,-12557147,7.375146
264660,Ex Machina,2015-01-21,2015,15000000,36869414,21869414,14.14078
264723,Le p√©lican,1974-02-06,1974,0,0,0,0.000115
264729,Off Course,2015-03-03,2015,0,0,0,3.173875
264746,Tinker Ticker,2014-04-03,2014,0,0,0,0.361365
264760,Deadly Revenge,2013-12-15,2013,0,0,0,0.202736
264763,Regarding Susan Sontag,2014-04-20,2014,0,0,0,0.279157
264767,Misconception,2014-04-21,2014,0,0,0,0.014121
264978,Homeland,2014-02-11,2014,0,0,0,0.052259
264999,Magic Mike XXL,2015-07-01,2015,14800000,122513057,107713057,8.76993
265010,The Canal,2014-10-10,2014,0,0,0,12.352907
265016,Extraterrestrial,2014-10-17,2014,0,0,0,10.457657
265018,Indigenous,2014-04-20,2014,0,0,0,2.168519
265019,Preservation,2014-08-22,2014,0,0,0,5.092349
265111,Soundbreaker,2012-03-20,2012,0,0,0,0.328444
265169,Winter Sleep,2014-06-13,2014,0,0,0,11.32208
265177,Mommy,2014-05-22,2014,4900000,3494070,-1405930,14.876086
265178,Mauri,1988-01-01,1988,0,0,0,0.070606
265180,Leviathan,2014-09-24,2014,0,0,0,6.312412
265189,Force Majeure,2014-08-15,2014,0,1359497,1359497,12.165685
265189,Force Majeure,2014-08-15,2014,0,1359497,1359497,12.165685
265193,Still the Water,2014-06-01,2014,0,0,0,1.932287
265195,Wild Tales,2014-08-21,2014,0,27007072,27007072,8.764888
265208,Wild Card,2015-01-14,2015,30000000,0,-30000000,16.451228
265226,The Wonders,2014-05-22,2014,0,0,0,2.089044
265228,Timbuktu,2014-12-10,2014,0,1076075,1076075,5.091194
265297,The Salt of the Earth,2014-09-27,2014,0,1059804,1059804,5.154091
265314,Mexico's Most Wanted,2013-11-15,2013,0,0,0,0.055398
265330,Bad Boys,2014-04-17,2014,0,0,0,0.450876
265349,Charlie's Country,2013-10-12,2013,0,0,0,0.912033
265351,ƒ∞tirazƒ±m Var,2014-04-18,2014,0,0,0,0.465766
265394,Tracy Morgan: Bona Fide,2014-04-13,2014,0,0,0,0.503146
265432,Hunger auf Leben,2004-06-18,2004,0,0,0,0.060397
265449,Summer of Blood,2014-10-17,2014,0,0,0,1.543681
265497,One Last Hug,2014-04-14,2014,0,0,0,0.079895
265531,Hart to Hart: Till Death Do Us Hart,1996-08-25,1996,0,0,0,0.151739
265563,The Mystery of Happiness,2014-01-16,2014,0,0,0,0.76038
265579,Immensee,1943-12-26,1943,0,0,0,0.396582
265640,Nuts in May,1976-01-13,1976,0,0,0,0.934801
265712,Stand by Me Doraemon,2014-08-08,2014,35000000,83061158,48061158,6.493765
265717,Ti sposo ma non troppo,2014-04-20,2014,0,0,0,0.24263
265727,Les Formidables,2006-06-22,2006,0,0,0,0.007316
265741,Amelia Earhart: The Final Flight,1994-06-12,1994,0,0,0,0.56391
265758,Thief,2006-03-27,2006,0,0,0,0.908246
265760,Death of a Salesman,2000-01-09,2000,0,0,0,0.63332
265793,Nadia and Sarra,2004-10-28,2004,0,0,0,0.456747
265832,700 Sundays,2014-04-19,2014,0,0,0,1.735423
265845,Pink Ulysses,1990-02-13,1990,0,0,0,0.001393
265851,No Tears for the Dead,2014-06-01,2014,0,0,0,6.737604
265910,Yesterday,1988-01-25,1988,0,0,0,0.000844
265929,Art and Craft,2014-09-19,2014,0,0,0,0.305326
265934,"Tommy Cooper: Not Like That, Like This",2014-04-21,2014,0,0,0,0.443563
265966,Promise Her Anything,1999-06-11,1999,0,0,0,0.451412
265982,Holidaze: The Christmas That Almost Didn't Happen,2006-11-14,2006,0,0,0,0.127949
266022,I Shot a Man in Vegas,1996-10-18,1996,0,0,0,0.005055
266030,Party Girl,2014-08-27,2014,0,472370,472370,0.524215
266031,Jauja,2014-11-27,2014,0,0,0,3.605278
266034,The Blue Room,2014-05-16,2014,0,0,0,2.490899
266036,Misunderstood,2014-06-05,2014,0,0,0,1.606121
266038,Titli,2015-05-06,2015,0,0,0,0.304876
266040,Bird People,2014-06-04,2014,0,0,0,2.221776
266044,Amour fou,2014-05-16,2014,0,0,0,0.912793
266047,Snow in Paradise,2015-02-13,2015,0,0,0,1.217634
266058,A Girl at My Door,2014-05-22,2014,0,0,0,4.502793
266061,Xenia,2014-06-02,2014,0,0,0,2.916799
266080,National Gallery,2014-10-08,2014,0,0,0,1.09479
266082,Girlhood,2014-06-27,2014,0,60765,60765,4.220318
266102,Desert Dancer,2014-07-03,2014,0,0,0,1.538705
266108,Hand in Hand,1961-02-06,1961,0,0,0,0.007069
266135,Tail Gunner Joe,1977-02-06,1977,0,0,0,0.048761
266249,Das Lied einer Nacht,1932-11-06,1932,0,0,0,0.323312
266279,Night World,1932-05-04,1932,0,0,0,1.131643
266285,The Salvation,2014-05-22,2014,10500000,42070000,31570000,8.253705
266294,Sisters,2015-12-18,2015,30000000,105011053,75011053,13.799419
266314,Space,1985-04-13,1985,0,0,0,0.632363
266331,Table For Five,1983-02-18,1983,8000000,2439705,-5560295,0.406505
266333,The Ditchdigger's Daughters,1997-02-23,1997,0,0,0,0.001217
266353,In My Dreams,2014-04-20,2014,0,0,0,6.07112
266373,Bengazi,1955-09-14,1955,0,0,0,0.26675
266396,The Gunman,2015-02-16,2015,40000000,13644292,-26355708,11.429831
266400,Downhill,2014-05-30,2014,0,0,0,0.15738
266425,Sand Castles,2016-02-16,2016,0,0,0,1.089414
266433,Ejecta,2014-09-24,2014,0,0,0,1.860814
266442,Iverson,2014-04-27,2014,0,0,0,1.722125
266500,Dr. Cabbie,2014-09-19,2014,0,223003,223003,5.843804
266525,Alan & Naomi,1992-01-31,1992,0,259,259,0.904809
266537,Not My Type,2014-04-30,2014,0,0,0,3.196462
266540,Broken Side of Time,2013-06-01,2013,0,0,0,0.046076
266541,Parole Girl,1933-03-04,1933,0,0,0,0.076547
266549,"My Daughter, the Socialist",1966-10-12,1966,0,0,0,0.48322
266558,Casus Belli,2010-12-09,2010,0,0,0,0.132687
266563,The Mysterious House of Dr. C.,1976-01-09,1976,0,0,0,0.0315
266568,Aschenputtel,2011-12-05,2011,0,0,0,0.625869
266619,I Am Big Bird: The Caroll Spinney Story,2015-05-06,2015,0,0,0,1.257893
266621,Love Hotel,2014-04-26,2014,0,0,0,0.050868
266639,Jem and the Holograms,2015-10-22,2015,5000000,2333684,-2666316,5.394112
266647,Pan,2015-09-24,2015,150000000,128388320,-21611680,11.30428
266687,Games People Play,2004-03-12,2004,0,0,0,0.002353
266689,Vanishing Pearls: The Oystermen of Pointe √† la Hache,2014-04-18,2014,0,0,0,0.01412
266697,"God Respects Us When We Work, but Loves Us When We Dance",1968-01-01,1968,0,0,0,0.036471
266718,Murder of a Cat,2014-04-24,2014,0,0,0,8.32982
266723,Latitudes,2014-02-28,2014,670,0,-670,0.993994
266740,The Living Room of the Nation,2009-09-11,2009,0,0,0,0.07998
266741,Standard Time,2002-10-10,2002,0,0,0,0.00239
266764,Meet the Patels,2015-09-11,2015,0,0,0,1.405257
266782,The Improv: 50 Years Behind the Brick Wall,2013-12-06,2013,0,0,0,1.137949
266814,1939: Hollywood's Greatest Year,2009-07-02,2009,0,0,0,0.097805
266856,The Theory of Everything,2014-11-26,2014,15000000,123726688,108726688,11.85302
266874,Young Dragons: Kung Fu Kids II,1986-04-28,1986,0,0,0,0.001393
266880,Giuseppe Makes a Movie,2014-04-28,2014,0,0,0,0.231913
266882,Closer to God,2015-07-03,2015,0,0,0,2.225578
267035,Oh Jonathan ‚Äì oh Jonathan!,1973-05-09,1973,0,0,0,0.465158
267048,The Pyramid,2007-01-01,2007,0,0,0,0.404769
267091,A Year in Champagne,2014-02-01,2014,0,0,0,0.16725
267094,9-Man,2014-04-27,2014,0,0,0,0.024224
267178,Mad As Hell,2014-04-29,2014,0,0,0,0.027705
267188,Desert Winds,1997-12-31,1997,0,0,0,0.251223
267192,Genius,2016-06-10,2016,0,5681622,5681622,11.451354
267193,Grimsby,2016-02-24,2016,35000000,25182929,-9817071,13.912531
267197,Landscape with a Woman,1976-12-31,1976,0,0,0,8e-06
267219,Serrallonga,2008-01-01,2008,0,0,0,0.003749
267268,Darker Than Night,2014-09-05,2014,0,0,0,1.028514
267292,Super Juice Me!,2014-04-26,2014,0,0,0,0.212307
267310,The Decent One,2014-02-09,2014,0,0,0,1.084397
267319,Asian School Girls,2014-04-15,2014,0,0,0,0.747777
267333,Charlie Chan's Chance,1932-01-24,1932,0,0,0,0.007941
267336,Charlie Chan's Courage,1934-07-06,1934,0,0,0,0.119178
267345,The Diaries of Vaslav Nijinsky,2002-04-25,2002,0,0,0,0.321377
267355,Hotline,2014-04-28,2014,0,0,0,0.049412
267389,Der Rest ist Schweigen,1959-07-21,1959,0,0,0,0.097245
267415,Rot ist die Liebe,1957-01-17,1957,0,0,0,0.036636
267428,Buttwhistle,2014-04-25,2014,0,0,0,0.606567
267457,That Burning Feeling,2014-05-02,2014,0,0,0,2.010554
267463,The 10 Year Plan,2014-09-06,2014,0,0,0,2.957885
267466,Innocent Thing,2014-04-10,2014,0,0,0,1.224917
267467,The Target,2014-04-30,2014,0,0,0,2.84005
267480,The Look of Silence,2014-08-30,2014,0,332710,332710,4.943726
267481,Kitchen in Paris,2014-05-01,2014,0,0,0,1.402561
267483,Swing!,1938-04-29,1938,0,0,0,0.001346
267497,UFO... annientare S.H.A.D.O. stop. Uccidete Straker...,1972-05-23,1972,0,0,0,0.000167
267506,UFO - Distruggete base Luna!,1971-06-18,1971,0,0,0,0.000287
267522,Chhodo Kal Ki Baatein,2012-11-15,2012,0,0,0,0.019814
267523,Printed Rainbow,2006-05-20,2006,0,0,0,0.109412
267539,The New Rulers of the World,2001-07-18,2001,0,0,0,0.222197
267557,Un fidanzato per mia moglie,2014-04-30,2014,0,0,0,1.615822
267573,Man on High Heels,2014-06-01,2014,0,0,0,1.063154
267579,The Ardor,2014-05-14,2014,0,0,0,3.130743
267590,"Falkenau, the Impossible",1988-01-01,1988,0,0,0,0.000535
267623,Pas d'inqui√©tude,2014-04-09,2014,0,0,0,0.36666
267654,Quicker Than the Eye,1990-06-13,1990,0,0,0,0.000104
267752,#chicagoGirl,2013-11-21,2013,0,0,0,0.108531
267793,Petals on the Wind,2014-05-26,2014,0,0,0,3.873372
267795,Rosemary's Baby,2014-09-18,2014,0,0,0,3.578894
267800,Sundown,2016-05-16,2016,0,0,0,2.060918
267802,Cambio de Ruta,2014-05-23,2014,0,0,0,0.876897
267804,In the Courtyard,2014-05-02,2014,0,0,0,1.670098
267806,V/H/S: Viral,2014-10-23,2014,0,2756,2756,8.918611
267815,The Absent,2014-08-11,2014,0,0,0,0.055526
267831,A Dangerous Game,2014-05-01,2014,0,0,0,1.165251
267852,Black Mountain Side,2014-10-26,2014,0,0,0,1.732237
267860,London Has Fallen,2016-03-02,2016,60000000,205754447,145754447,15.037993
267863,Walking on Sunshine,2014-06-19,2014,0,0,0,4.747459
267872,Korengal,2014-05-30,2014,0,0,0,1.03755
267931,Hidden in the Woods,2014-12-12,2014,1,0,-1,0.805883
267935,The BFG,2016-06-01,2016,140000000,183345589,43345589,18.769476
267955,Nintendo Quest,2015-06-26,2015,0,0,0,1.334
267970,Miss Hokusai,2015-05-09,2015,0,0,0,2.915588
267977,Beautiful Mystery,1983-04-01,1983,0,0,0,0.190491
267999,White God,2014-06-12,2014,2200000,282358,-1917642,6.313465
268009,Days of Hope,1975-09-11,1975,0,0,0,0.629215
268015,Bukowski: The Last Straw,1980-03-30,1980,0,0,0,0.021389
268021,The Theory of Everything,2006-10-30,2006,0,0,0,0.289068
268060,Road to Paloma,2014-04-12,2014,0,0,0,3.764346
268092,Transformers Prime Beast Hunters: Predacons Rising,2013-10-04,2013,0,0,0,1.648427
268099,Sleepless In New York,2014-04-30,2014,0,0,0,0.049412
268100,Casa Grande,2014-01-28,2014,0,0,0,2.221013
268105,The Similars,2015-09-25,2015,0,0,0,1.386193
268159,We Could Be King,2014-04-23,2014,0,0,0,0.247665
268171,Elsa & Fred,2014-03-07,2014,10000000,0,-10000000,3.65758
268174,BFFs,2014-01-31,2014,0,0,0,0.451328
268212,Scarlet Eye,1963-05-30,1963,0,0,0,0.054546
268238,The Second Best Exotic Marigold Hotel,2015-02-26,2015,10000000,85978266,75978266,5.204474
268245,1000 To 1,2014-03-04,2014,0,0,0,0.722201
268271,The Battle of the Damned,1969-04-17,1969,0,0,0,0.161813
268272,Bronx Obama,2014-04-29,2014,0,0,0,0.308071
268297,The Film Critic,2013-04-11,2013,0,0,0,0.048818
268321,Squatters,2014-05-14,2014,0,0,0,7.613399
268350,Romance on the Run,1938-05-11,1938,0,0,0,0.563252
268380,Visions of Frank,2007-10-03,2007,0,0,0,0.004048
268386,Ragamuffin,2014-01-09,2014,0,0,0,0.495744
268413,Antidote,2014-05-08,2014,0,0,0,0.967731
268508,The Mummy Resurrected,2014-03-01,2014,0,0,0,2.287275
268522,Up in the Wind,2013-12-31,2013,0,0,0,0.196724
268523,Nice and Easy,2014-05-07,2014,0,0,0,2.935623
268531,Captain Underpants: The First Epic Movie,2017-06-01,2017,38000000,110824373,72824373,88.561239
268536,A Master Builder,2013-11-11,2013,0,0,0,0.862858
268539,The Builder,2010-04-10,2010,0,0,0,0.057648
268618,Life in a Fishbowl,2014-05-16,2014,2700000,0,-2700000,1.658231
268652,Honeycomb,1969-07-14,1969,0,0,0,0.018006
268660,Bangalore Days,2014-05-30,2014,7400000,1300000,-6100000,0.955596
268662,Il fischio al naso,1967-08-06,1967,0,0,0,0.001202
268666,Hafu,2013-04-05,2013,0,0,0,0.014958
268669,Victory in the Ukraine and the Expulsion of the Germans from the Boundaries of the Ukrainian Soviet Earth,1945-04-01,1945,0,0,0,0.001177
268674,Shadow Boxers,1999-06-02,1999,0,0,0,0.00168
268712,Allerleirauh,2012-12-26,2012,0,0,0,0.238522
268725,Nightlight,2015-03-27,2015,0,0,0,2.219537
268735,A Very Social Secretary,2005-10-10,2005,0,0,0,0.659644
268771,Superheroes: A Never-Ending Battle,2013-10-08,2013,0,0,0,1.25125
268788,Witch Hunt,1999-05-02,1999,0,0,0,0.760003
268823,April Rain,2014-06-04,2014,0,0,0,4.956361
268853,Paranoia,1967-04-19,1967,0,0,0,0.153761
268854,The Thin Yellow Line,2015-03-06,2015,0,0,0,1.266903
268875,All American Chump,1936-10-16,1936,0,0,0,0.037817
268893,VeggieTales: Where's God When I'm Scared,1993-12-21,1993,0,0,0,0.109141
268917,The Past Is a Grotesque Animal,2014-06-15,2014,100,0,-100,0.774471
268920,Hot Pursuit,2015-05-08,2015,35000000,51680201,16680201,6.90658
268956,Bubblegum and Broken Fingers,2011-01-01,2011,24000,0,-24000,0.514965
269043,National Geographic American Blackout,2013-08-27,2013,0,0,0,0.118315
269057,Bang Bang Baby,2014-09-08,2014,1000000,0,-1000000,0.910345
269070,Stop Train 349,1963-06-26,1963,0,0,0,0.016498
269100,Video Games: The Movie,2014-07-18,2014,0,0,0,11.564066
269148,Samba,2014-10-15,2014,20000000,151530,-19848470,11.024334
269149,Zootopia,2016-02-11,2016,150000000,1023784195,873784195,26.024868
269165,Die zw√∂lf Geschworenen,1963-10-25,1963,0,0,0,0.074898
269173,The Anomaly,2014-06-19,2014,0,0,0,13.860922
269198,Sarajevo,2014-04-23,2014,0,0,0,2.526922
269200,Plastic Paradise: The Great Pacific Garbage Patch,2013-04-22,2013,0,0,0,0.223348
269242,Alpha House,2014-03-11,2014,0,0,0,2.123441
269246,Batman Beyond Darwyn Cooke's Batman 75th Anniversary Short,2014-04-19,2014,0,0,0,0.850141
269258,Head Full of Honey,2014-12-25,2014,0,0,0,5.4192
269306,Last Pair Out,1956-11-12,1956,0,0,0,0.015284
269340,The Fatal Encounter,2014-04-30,2014,0,0,0,2.968776
269390,Skull,1927-05-10,1927,0,0,0,0.001223
269494,A Hard Day,2014-05-29,2014,0,0,0,10.154079
269495,No Thanks,2014-01-10,2014,1600000,0,-1600000,1.50671
269518,Some Photos in the City of Sylvia,2007-10-02,2007,0,0,0,0.203374
269572,Almost Thirty,2013-10-04,2013,0,0,0,0.163508
269576,From Zero to Hero,2014-04-09,2014,0,0,0,0.159785
269650,Appleseed Alpha,2014-05-28,2014,0,0,0,3.770032
269705,She's Beautiful When She's Angry,2014-12-05,2014,0,0,0,1.135336
269710,The Shamrock Handicap,1926-05-02,1926,0,0,0,0.039949
269711,JohnnyExpress,2014-05-08,2014,0,0,0,0.822262
269714,The Last Diamond,2014-04-30,2014,0,0,0,1.732667
269747,Catch Me Daddy,2015-02-27,2015,0,0,0,1.533354
269776,All√©luia,2014-05-14,2014,3673315,0,-3673315,1.730616
269795,2:22,2017-06-29,2017,0,422,422,37.484577
269797,"RKO Production 601: The Making of 'Kong, the Eighth Wonder of the World'",2005-10-23,2005,0,0,0,0.289677
269843,Fear,2009-05-14,2009,0,0,0,0.00492
269961,Pourquoi Isra√´l,1973-10-01,1973,0,0,0,0.14729
269963,The Way South,1981-01-01,1981,0,0,0,0.001393
269981,Twelve Angry Men,1954-09-20,1954,0,0,0,0.160214
269999,Fire!,1968-09-04,1968,0,0,0,0.001177
270002,Fuck Off! Images of Finland,1971-03-19,1971,0,0,0,0.018017
270005,By the Gun,2014-09-28,2014,0,0,0,3.660641
270007,Take Down,2016-05-05,2016,0,0,0,5.051764
270010,A Hologram for the King,2016-04-22,2016,30000000,4212494,-25787506,9.104543
270015,Domino Kid,1957-10-01,1957,0,0,0,0.908823
270024,I Know I'll See Your Face Again,2001-02-21,2001,0,0,0,0.007452
270025,Uncle Bob,2010-06-26,2010,0,0,0,0.378963
270045,Beck 04 - √ñga f√∂r √∂ga,1998-03-27,1998,0,0,0,0.563749
270047,Beck 06 - Monstret,1998-05-28,1998,0,0,0,0.494387
270081,Diane,1975-07-09,1975,0,0,0,0.000344
270173,Clutter,2013-06-07,2013,0,0,0,0.081353
270221,Neverlake,2013-12-13,2013,232000,0,-232000,7.022339
270251,Showman,1963-01-02,1963,0,0,0,0.002383
270302,The Riot Club,2014-09-19,2014,0,2146041,2146041,6.967835
270303,It Follows,2015-02-04,2015,2000000,14674076,12674076,20.359336
270306,Maryam,2002-02-22,2002,0,0,0,0.147295
270336,The Angel of Vengeance - The Female Hamlet,1977-01-01,1977,0,0,0,0.078659
270343,Love at First Fight,2014-08-20,2014,0,23598,23598,8.569586
270357,The Carboard Bernini,2012-10-12,2012,0,0,0,0.009412
270372,In Passing,2011-09-27,2011,0,0,0,0.007123
270383,A Daughter's Nightmare,2014-05-03,2014,0,0,0,1.471189
270393,–ü—Ä–∏–∫–ª—é—á–µ–Ω–∏—è –®–µ—Ä–ª–æ–∫–∞ –•–æ–ª–º—Å–∞ –∏ –¥–æ–∫—Ç–æ—Ä–∞ –í–∞—Ç—Å–æ–Ω–∞: –î–≤–∞–¥—Ü–∞—Ç—ã–π –≤–µ–∫ –Ω–∞—á–∏–Ω–∞–µ—Ç—Å—è,1986-05-18,1986,0,0,0,0.018017
270397,My Last Year With The Nuns,2014-05-21,2014,0,0,0,0.015294
270400,Breathe,2014-09-04,2014,0,0,0,4.832606
270403,Gett: The Trial of Viviane Amsalem,2014-06-25,2014,0,0,0,3.103506
270409,Su√ßlular aramizda,1964-12-07,1964,0,0,0,0.00294
270463,How I Learned to Love Women,1966-11-02,1966,0,0,0,0.919882
270469,Portrait,2002-10-19,2002,0,0,0,0.219241
270470,El Greco,1966-08-15,1966,0,0,0,0.177674
270479,Ammutta muddica al cinema,2013-10-16,2013,0,0,0,1.793601
270487,"Hail, Caesar!",2016-02-05,2016,22000000,63647656,41647656,11.241366
270529,The Sklar Brothers: What Are We Talking About?,2014-04-29,2014,0,0,0,0.051005
270585,Agente Logan - missione Ypotron,1966-08-28,1966,0,0,0,0.887984
270616,"Come On, Get Happy: The Partridge Family Story",1999-01-01,1999,0,0,0,0.004754
270646,The Kindergarten Teacher,2014-04-19,2014,0,0,0,1.146656
270650,Oy Vey! My Son Is Gay!,2009-01-01,2009,0,0,0,0.764982
270654,Parts Per Billion,2014-03-25,2014,500000,15000000,14500000,8.279917
270668,When Animals Dream,2014-06-12,2014,3000000,0,-3000000,2.783608
270672,The Formula,2014-04-15,2014,0,0,0,0.814013
270696,Tru Love,2013-10-04,2013,0,0,0,0.375722
270724,The Breakup Guru,2014-06-27,2014,0,106640000,106640000,0.651512
270759,One on One,2014-05-22,2014,0,0,0,0.8505
270762,What a Fuck Am I Doing on This Battlefield,2013-04-22,2013,0,0,0,0.020752
270766,Jigarthanda,2014-08-01,2014,1600000,0,-1600000,0.46122
270771,The Last Survivors,2014-06-12,2014,0,0,0,3.336934
270774,Skiptrace,2016-07-21,2016,32000000,58500000,26500000,10.912208
270822,Junior,2011-01-01,2011,0,0,0,0.008232
270842,Tiny Times 3,2014-07-17,2014,0,0,0,1.977485
270851,Blood Lake,2014-05-25,2014,0,0,0,1.790149
270886,You're Sleeping Nicole,2014-08-22,2014,0,0,0,1.600198
270899,In the Name of My Daughter,2014-05-21,2014,0,0,0,1.756452
270908,–°–æ–≤–µ—Ä—à–µ–Ω–Ω–æ —Å–µ—Ä—å–µ–∑–Ω–æ,1961-10-17,1961,0,0,0,0.38171
270909,Refugiado,2014-05-18,2014,0,0,0,0.146336
270919,Number One Fan,2014-06-18,2014,0,0,0,4.159516
270926,Maidan,2014-05-21,2014,0,0,0,0.16355
270936,Ellen ten Damme: As I Was Wondering Where This Mixed-up Little Life of Mine Was Leading To,2007-04-19,2007,0,0,0,0.003571
270938,Falcon Rising,2014-09-05,2014,0,0,0,4.738017
270946,Penguins of Madagascar,2014-11-22,2014,132000000,373552094,241552094,22.201607
270952,The Life and Times of Allen Ginsberg,2008-01-01,2008,0,0,0,0.007134
271007,Appointment in Tokyo,1945-01-01,1945,0,0,0,0.002307
271009,BBOY for LIFE,2012-12-30,2012,0,0,0,0.009438
271033,Siringo,1995-05-16,1995,0,0,0,0.318503
271039,"Something, Anything",2015-01-09,2015,0,0,0,0.382781
271110,Captain America: Civil War,2016-04-27,2016,250000000,1153304495,903304495,145.882135
271120,Singapore GaGa,2005-08-24,2005,100,0,-100,0.003025
271124,Woodenhead,2003-07-18,2003,27000,0,-27000,0.151836
271164,The Song,2014-09-26,2014,0,1009620,1009620,1.69425
271185,Ask Me Anything,2014-04-19,2014,950000,0,-950000,4.977232
271200,Heropanti,2014-05-23,2014,4200000,10000000,5800000,2.031919
271234,22 Minutes,2014-05-08,2014,6500000,0,-6500000,3.662477
271304,Paperback Romance,1994-10-20,1994,0,0,0,0.122025
271327,Mr Reliable,1996-11-22,1996,0,0,0,0.39183
271331,United Passions,2014-06-19,2014,27000000,0,-27000000,4.766716
271388,Velociraptor,2014-06-07,2014,0,0,0,0.800358
271397,The Tribe,2014-09-11,2014,0,0,0,5.278578
271404,Beyond Skyline,2017-10-20,2017,0,0,0,6.416249
271433,Wir sind die Neuen,2014-07-17,2014,0,0,0,2.280715
271462,Russian Doll,2001-06-14,2001,0,0,0,0.390652
271467,School Dance,2014-07-02,2014,0,0,0,2.603625
271484,Beti No. 1,2000-11-10,2000,0,0,0,0.071487
271495,Dialogues,2014-04-24,2014,0,0,0,0.262591
271504,2 Become 1,2006-01-01,2006,0,0,0,0.936104
271550,"Little Girl, Big Tease",1976-07-01,1976,0,0,0,0.590412
271664,Alex: The Life of a Child,1986-04-23,1986,0,0,0,1.028263
271665,Deep in the Darkness,2014-04-29,2014,0,0,0,5.577636
271667,Landscape,2000-04-01,2000,0,0,0,0.204367
271674,Suite Fran√ßaise,2014-11-05,2014,15000000,9104716,-5895284,5.02124
271677,The Hero: Love Story of a Spy,2003-04-10,2003,0,0,0,0.735283
271706,Big Fish & Begonia,2016-07-08,2016,4531653,84552250,80020597,2.238595
271714,Love & Mercy,2015-05-29,2015,0,28641776,28641776,10.444048
271717,I Am Femen,2014-05-22,2014,0,0,0,0.053702
271718,Trainwreck,2015-07-17,2015,35000000,140795793,105795793,17.310647
271724,Hippocrates,2014-09-03,2014,0,0,0,5.647722
271736,The Program,2015-09-16,2015,0,3286448,3286448,5.607543
271826,An Eye for Beauty,2014-05-15,2014,0,40000,40000,3.408264
271919,The Cage,1975-06-10,1975,0,0,0,0.574132
271954,Water and Fire,2013-11-15,2013,0,0,0,0.392463
271969,Ben-Hur,2016-08-17,2016,100000000,94061311,-5938689,11.51021
271983,Entre Abelhas,2015-04-30,2015,0,0,0,1.80368
272072,Leather,2013-07-21,2013,0,0,0,0.066398
272075,Silvered Water,2014-12-17,2014,0,0,0,0.13276
272095,Forgotten,2014-07-31,2014,0,0,0,0.138964
272160,My Man is a Loser,2014-07-25,2014,0,0,0,2.262251
272162,A Dream of Kings,1969-01-01,1969,0,0,0,0.879663
272165,Solomon Northup's Odyssey,1984-01-02,1984,0,0,0,0.361012
272220,Karam,2005-01-01,2005,0,0,0,0.953813
272255,The Dude Goes West,1948-05-30,1948,0,0,0,0.590349
272261,The Last Blitzkrieg,1959-01-01,1959,0,0,0,0.636188
272264,The Owners,2014-05-17,2014,0,0,0,0.053831
272414,Echo Park,2014-06-14,2014,0,0,0,0.769613
272418,Man from Reno,2015-03-27,2015,0,0,0,0.883092
272426,H3 - Halloween Horror Hostel,2008-03-18,2008,0,0,0,0.045829
272435,Gemma Bovery,2014-09-10,2014,9700000,154701,-9545299,5.105914
272525,Henry Kissinger: Secrets of a Superpower,2008-10-15,2008,0,0,0,0.009603
272543,Die Fischerin,2014-05-23,2014,0,0,0,0.345628
272548,Moonwalkers,2015-03-14,2015,0,0,0,15.041341
272602,Amira & Sam,2014-05-30,2014,0,0,0,7.175939
272610,Black Rose,2014-04-17,2014,7000000,855450,-6144550,2.482771
272634,The Circle,2015-02-18,2015,0,0,0,3.695288
272663,Fort Vengeance,1953-03-28,1953,0,0,0,0.021966
272691,Haemoo,2014-08-13,2014,0,0,0,6.01763
272692,The Possession of Michael King,2014-08-22,2014,0,0,0,3.964299
272693,The DUFF,2015-02-20,2015,8500000,43528634,35028634,8.592449
272720,You're Human Like the Rest of Them,1967-05-29,1967,2,0,-2,0.003245
272772,How 2 Build A Rapper,2008-01-01,2008,0,0,0,0.00353
272820,Mr. Pig,2016-07-22,2016,0,0,0,1.65619
272875,The Continent,2014-07-24,2014,0,0,0,2.137091
272878,Max,2015-06-26,2015,20000000,43967255,23967255,7.987747
272892,In Lieu of Flowers,2013-04-28,2013,0,0,0,0.125098
273029,Tank on the Moon,2007-01-01,2007,0,0,0,0.004942
273059,Starving in Suburbia,2014-04-26,2014,0,0,0,0.780125
273080,Fools on the Hill,2012-03-08,2012,0,0,0,0.008273
273084,Bipolar,2014-05-30,2014,0,0,0,0.543602
273085,David Bowie: Best Of Bowie,2002-06-30,2002,0,0,0,0.431531
273096,My Man,2014-06-14,2014,0,0,0,1.026315
273106,Peter Pan,2000-10-10,2000,0,0,0,0.315904
273122,VeggieTales: Are You My Neighbor?,1995-02-01,1995,0,0,0,0.036519
273126,How the Lion Cub and the Turtle Sang a Song,1974-01-01,1974,0,0,0,0.020248
273127,VeggieTales: Dave and the Giant Pickle,1996-03-01,1996,0,0,0,0.11674
273128,"Myq Kaplan: Small, Dork and Handsome",2014-05-15,2014,0,0,0,0.114815
273149,VeggieTales: Duke and the Great Pie War,2005-06-01,2005,0,0,0,0.055719
273153,Summertime,2015-08-19,2015,0,0,0,4.425995
273160,Four Eyes and Six-Guns,1992-12-07,1992,0,0,0,0.190428
273167,The Spy with a Cold Nose,1966-12-19,1966,0,0,0,0.470347
273169,French Women,2014-06-04,2014,5000000,12058187,7058187,6.976069
273197,The Great Hypnotist,2014-04-29,2014,0,0,0,1.723131
273202,Mother For Baby Mammoth,1981-06-01,1981,0,0,0,0.67668
273205,VeggieTales: Tomato Sawyer & Huckleberry Larry's Big River Rescue,2008-03-06,2008,0,0,0,0.081523
273248,The Hateful Eight,2015-12-25,2015,44000000,155760117,111760117,20.328822
273261,Red Knot,2014-05-31,2014,80,0,-80,0.847311
273271,Time Lapse,2014-05-24,2014,0,0,0,9.646738
273279,The Skin of Sorrow,2010-09-22,2010,0,0,0,1.235341
273296,VeggieTales: Esther...The Girl Who Became Queen,2000-06-01,2000,0,0,0,0.116419
273302,VeggieTales: King George and the Ducky,2000-06-01,2000,0,0,0,0.101284
273309,VeggieTales: Lord of the Beans,2005-06-01,2005,0,0,0,0.109677
273310,"VeggieTales: Lyle, the Kindly Viking",2001-06-01,2001,0,0,0,0.100019
273311,A Long Walk,2006-04-01,2006,0,0,0,0.543246
273312,VeggieTales: Madame Blueberry,1998-06-01,1998,0,0,0,0.149785
273315,VeggieTales: Minnesota Cuke and the Search for Samson's Hairbrush,2005-06-01,2005,0,0,0,0.188101
273318,"VeggieTales: Rack, Shack & Benny",1995-06-01,1995,0,0,0,0.112761
273334,United States of Secrets (Part One): The Program,2014-05-13,2014,0,0,0,0.062823
273341,The Unknown Cyclist,1998-10-10,1998,2000000,0,-2000000,0.375762
273404,I'll Follow You Down,2013-07-28,2013,0,0,0,4.968243
273477,Scouts Guide to the Zombie Apocalypse,2015-10-23,2015,15000000,14860766,-139234,20.683405
273481,Sicario,2015-09-17,2015,30000000,84025816,54025816,19.511221
273509,Blood Widow,2014-06-03,2014,0,0,0,2.094547
273510,Madame Bovary,2000-06-02,2000,0,0,0,0.697519
273511,Ghost of Goodnight Lane,2014-06-10,2014,0,0,0,0.459575
273578,VeggieTales: The Ballad of Little Joe,2003-08-17,2003,0,0,0,0.110577
273598,Road to Your Heart,2014-02-14,2014,0,0,0,0.501787
273599,The Suicide Theory,2015-07-10,2015,0,0,0,2.629085
273610,Helicopter Mom,2015-04-24,2015,0,0,0,2.4129
273621,Cat Run 2,2014-08-19,2014,0,0,0,2.246531
273632,La petite reine,2014-06-13,2014,0,0,0,1.036076
273641,Bad Grandpa .5,2014-06-03,2014,0,0,0,9.911275
273645,Manhole,2014-10-08,2014,0,0,0,1.093521
273651,America's Most Haunted,2013-05-08,2013,0,0,0,0.460032
273656,Never Make It Home,2011-06-24,2011,0,0,0,0.007059
273707,Beach Pillows,2013-01-01,2013,0,0,0,0.076481
273743,The Last Light,2014-06-01,2014,400000,0,-400000,1.074476
273745,A Year in Burgundy,2013-12-03,2013,0,0,0,0.202767
273807,Last Exit,2003-10-11,2003,0,0,0,0.002353
273848,The Amorous Prawn,1962-11-26,1962,0,0,0,0.013822
273856,Cruel Will,2013-12-30,2013,80000,0,-80000,0.417469
273868,Scipione detto anche l'africano,1971-09-09,1971,0,0,0,0.237537
273879,Black Angel,1980-05-21,1980,25000,0,-25000,0.044464
273883,The Circle,1985-03-02,1985,0,0,0,3.5e-05
273886,Holiday,2014-06-06,2014,0,0,0,1.971482
273890,Twelve Chairs,2004-07-15,2004,0,0,0,0.002354
273895,Selma,2014-12-25,2014,20000000,66787908,46787908,7.107071
273896,Losing Ground,1982-01-02,1982,0,0,0,0.051916
273899,Stonewall,2015-09-18,2015,13500000,187674,-13312326,3.531089
273912,The Young Kieslowski,2015-07-24,2015,0,0,0,0.255766
273922,Deadline,2013-05-16,2013,500000,0,-500000,0.058838
273926,Shelter Island,2011-01-01,2011,0,0,0,0.00713
273973,Carpet Racers,2009-01-01,2009,0,0,0,0.004706
273997,Stop at Nothing: The Lance Armstrong Story,2014-05-27,2014,0,0,0,0.936567
274007,The Color of Rain,2014-05-31,2014,0,0,0,0.727583
274060,John Loves Mary,1949-01-01,1949,0,0,0,0.294897
274109,Palm Trees in the Snow,2015-12-25,2015,10000000,0,-10000000,6.818031
274110,Ciudad Delirio,2014-09-19,2014,0,0,0,0.145248
274127,A Star for Two,1991-08-10,1991,0,0,0,0.092722
274131,Forbidden,1954-04-01,1954,0,0,0,0.001382
274167,Daddy's Home,2015-12-25,2015,50000000,242786137,192786137,8.009226
274202,Perpetrators of the Crime,2000-01-17,2000,0,0,0,0.001178
274253,Belizaire the Cajun,1986-06-13,1986,0,1,1,0.063442
274266,Time Again,2011-07-26,2011,0,0,0,0.009883
274325,Keeping the Promise,1997-01-05,1997,0,0,0,0.342396
274326,Trailer Park Boys - Live in F**kin' Dublin,2014-05-01,2014,0,0,0,1.063387
274388,Express 'Moscow-Russia',2014-04-17,2014,0,0,0,0.87609
274415,The Pasta Detectives,2014-07-10,2014,0,0,0,2.343945
274478,Freedom Strike,1998-09-26,1998,0,0,0,0.495828
274479,Joy,2015-12-24,2015,60000000,101134059,41134059,12.975936
274483,Fool Circle,2014-06-04,2014,0,0,0,1.160712
274504,The Adderall Diaries,2016-04-15,2016,0,13191,13191,4.14228
274626,Animal,2014-06-17,2014,0,0,0,2.883361
274669,Century of the Dragon,1999-10-15,1999,0,0,0,0.794382
274805,Our Curse,2013-05-28,2013,0,0,0,0.086112
274815,Uzumasa Limelight,2014-06-14,2014,0,0,0,0.846959
274817,Wood Job!,2014-05-10,2014,0,0,0,2.564491
274820,4 Minute Mile,2014-06-05,2014,0,0,0,2.131265
274854,The Last Witch Hunter,2015-10-21,2015,90000000,146936910,56936910,13.412445
274857,King Arthur: Legend of the Sword,2017-04-27,2017,175000000,146175066,-28824934,44.251369
274868,The Tic Code,2000-06-01,2000,0,0,0,0.938948
274870,Passengers,2016-12-21,2016,110000000,303144152,193144152,20.303632
274899,Inner Demons,2014-06-13,2014,0,0,0,2.405315
274902,Keeping Rosy,2014-06-08,2014,0,0,0,1.00038
274906,The 50 Year Argument,2014-06-29,2014,0,0,0,1.3485
274985,How Hitler Lost the War,1989-01-01,1989,0,0,0,3e-06
274990,Sofie,1992-09-25,1992,0,0,0,0.544704
274991,Mister Designer,1988-12-01,1988,0,0,0,1e-06
275054,The Bonus,1974-01-01,1974,0,0,0,0.691569
275060,The Disappearance of Eleanor Rigby: Her,2014-10-10,2014,0,0,0,8.396969
275065,VeggieTales: LarryBoy & The Bad Apple,2006-07-29,2006,0,0,0,0.337621
275074,VeggieTales: The Wonderful Wizard of Ha's,2007-10-09,2007,0,0,0,0.056535
275096,The Jar,1994-04-01,1994,0,0,0,0.401531
275130,VeggieTales: Sheerluck Holmes and the Golden Ruler,2006-03-11,2006,0,0,0,0.094013
275136,VeggieTales: The Ultimate Silly Song Countdown,2001-09-15,2001,0,0,0,0.286689
275210,The Violent Kind,2008-01-01,2008,0,0,0,0.883589
275239,The Fishmen and Their Queen,1995-01-01,1995,0,0,0,0.003708
275244,Cheburashka,2010-12-18,2010,0,0,0,0.062199
275269,Wazir,2016-01-07,2016,5200000,9200000,4000000,3.571376
275272,Je hais les enfants!,2003-11-12,2003,0,0,0,0.040481
275287,LEGO Hero Factory: Rise of the Rookies,2010-11-16,2010,0,0,0,1.427992
275318,Sleeping Beauty,2014-05-13,2014,0,0,0,3.846559
275331,The Hunters,1957-01-01,1957,0,0,0,0.141547
275355,Memphis: The Broadway Musical,2011-04-28,2011,0,0,0,0.077753
275468,"Back to the Garden, Flower Power Comes Full Circle",2009-06-01,2009,0,0,0,0.04
275477,China Cry: A True Story,1990-11-02,1990,0,0,0,0.150438
275573,Bitter Creek,1954-02-21,1954,0,0,0,0.001218
275601,Ricki and the Flash,2015-07-10,2015,18000000,41325328,23325328,16.778946
275603,The Portal,2014-03-22,2014,0,0,0,0.721434
275619,Age of Tomorrow,2014-06-10,2014,0,0,0,4.909894
275647,Life May Be,2014-06-21,2014,0,0,0,0.016241
275657,All This Mayhem,2014-06-05,2014,0,0,0,1.471582
275696,3 Nights in the Desert,2015-02-06,2015,0,0,0,1.787325
275771,Comedy Central Roast of Denis Leary,2003-08-10,2003,0,0,0,0.371787
275905,Bells of Capistrano,1942-09-15,1942,0,0,0,0.188199
275932,Boy! What a Girl!,1947-01-01,1947,0,0,0,0.038915
275985,The Coed and the Zombie Stoner,2014-04-18,2014,0,0,0,1.904582
276120,The (Dead Mothers) Club,2014-05-12,2014,0,0,0,0.363873
276122,A Brony Tale,2014-07-08,2014,0,0,0,0.762451
276123,A Tale from the Past,1987-01-01,1987,0,0,0,1.250959
276137,Road,2014-06-11,2014,0,0,0,1.403263
276155,The Mill on the Po,1949-09-28,1949,0,0,0,0.039762
276157,What Is Left,2014-06-12,2014,0,0,0,0.015294
276165,The Adventures of Mary-Kate & Ashley: The Case of the United States Navy Adventure,1997-01-01,1997,0,0,0,0.042841
276220,The Price of Forgiveness,2001-09-12,2001,0,0,0,0.003508
276387,Shikhar,2005-01-01,2005,0,0,0,0.039977
276401,The Disappearance of Eleanor Rigby: Him,2014-10-10,2014,0,0,0,6.490949
276486,The Work of Director Chris Cunningham,2003-10-22,2003,0,0,0,0.719482
276488,Let Us Prey,2014-04-17,2014,0,0,0,4.931539
276496,The Dark Horse,2014-07-17,2014,0,0,0,3.664848
276518,The Beach,1954-06-12,1954,0,0,0,0.984672
276536,We Are Many,2014-06-08,2014,0,0,0,0.534794
276537,The Last Man on the Moon,2016-02-26,2016,0,0,0,1.117829
276550,Susie's Hope,2013-01-01,2013,0,0,0,0.162924
276562,One Rogue Reporter,2014-06-08,2014,0,0,0,0.109031
276578,The Good Sister,2014-05-10,2014,0,0,0,0.511356
276608,Suspect,2005-11-16,2005,0,0,0,1.183295
276621,The Girl Who Talked to Dolphins,2014-06-17,2014,0,0,0,0.077813
276624,I Am a Hero,2015-03-23,2015,0,0,0,5.440884
276635,Experience Preferred...But Not Essential,1982-12-22,1982,0,822,822,0.122181
276678,Agent F.O.X.,2014-06-01,2014,0,0,0,0.450671
276702,Arvo P√§rt: 24 Preludes for a Fugue,2002-11-15,2002,0,0,0,0.003527
276729,Heaven Adores You,2014-05-14,2014,0,0,0,1.082197
276770,The Work of Director Jonathan Glazer,2005-09-13,2005,0,0,0,0.114708
276808,The Last Time You Had Fun,2015-04-07,2015,0,0,0,1.225925
276819,Dot and the Whale,1986-11-10,1986,0,0,0,8e-06
276828,Wind,2013-06-15,2013,0,0,0,0.118706
276833,"Quiet Riot: Well Now You're Here, There's No Way Back",2014-04-29,2014,0,0,0,0.085212
276839,Home Sweet Hell,2015-03-13,2015,3000000,0,-3000000,8.504655
276843,What We Did on Our Holiday,2014-09-26,2014,0,1289998,1289998,11.576578
276844,The Little Death,2014-06-13,2014,0,0,0,5.593682
276846,Badal,2000-02-11,2000,0,0,0,0.091809
276883,The Homestretch,2014-06-19,2014,0,0,0,0.078313
276895,Deep Hearts,1981-01-01,1981,0,0,0,0.011025
276898,Spanish Lake,2014-06-13,2014,0,0,0,0.330074
276901,Mall,2014-06-18,2014,0,0,0,2.351591
276902,Cut Bank,2014-09-10,2014,5000000,0,-5000000,8.901282
276904,Underwater Dreams,2014-07-11,2014,0,0,0,0.099231
276905,Norm of the North,2016-01-14,2016,18000000,17062499,-937501,7.008103
276906,Apartment Troubles,2014-06-15,2014,0,0,0,0.638504
276907,Legend,2015-09-09,2015,25000000,42972994,17972994,11.187833
276908,Comet,2014-12-05,2014,0,0,0,6.93232
276909,Deepsea Challenge 3D,2014-08-08,2014,0,0,0,2.463666
276918,America: Imagine the World Without Her,2014-07-02,2014,0,0,0,1.313952
276922,Come Back to Me,2014-07-25,2014,0,0,0,3.821899
276935,Ek Villain,2014-06-27,2014,0,0,0,2.424208
277069,No Tomorrow,2010-01-01,2010,0,0,0,0.005882
277073,North Beach,2000-06-07,2000,0,0,0,0.210088
277098,Battle Fairy Yukikaze,2002-05-12,2002,0,0,0,0.004729
277153,The Surprise,2015-05-21,2015,0,0,0,2.750275
277154,Admiral,2015-01-29,2015,10000000,0,-10000000,9.92595
277167,The Children of Sanchez,1978-06-16,1978,0,0,0,0.009192
277190,Secrets of War,2014-07-03,2014,0,0,0,2.075151
277216,Straight Outta Compton,2015-08-13,2015,28000000,201634991,173634991,21.183077
277217,Descendants,2015-07-31,2015,0,0,0,12.603719
277229,Taarzan: The Wonder Car,2004-08-06,2004,0,0,0,0.072964
277237,Hyena,2014-06-18,2014,0,0,0,2.673658
277261,The Fossil,1975-10-04,1975,0,0,0,0.037234
277270,To Cross the Rubicon,1991-01-01,1991,0,0,0,0.006854
277296,Vice and Virtue,1963-03-01,1963,0,0,0,0.771942
277355,Everly,2015-01-23,2015,0,0,0,13.145621
277368,Nicholas on Holiday,2014-07-09,2014,0,0,0,6.339846
277388,The Good Old Boys,1995-03-05,1995,0,0,0,1.097667
277396,Three Sisters,1970-04-01,1970,0,0,0,0.464209
277399,2047: Sights of Death,2014-06-13,2014,0,0,0,7.576182
277415,Besotted,2001-05-21,2001,0,0,0,0.001177
277416,The Adventure of Faustus Bidgood,1986-01-02,1986,0,0,0,0.046792
277432,Happy New Year,2014-10-23,2014,25000000,0,-25000000,4.631534
277435,Stray Dog,2014-06-13,2014,0,0,0,0.088117
277459,Ludwig van,1970-06-01,1970,0,0,0,0.001736
277464,The Spike Jones Story,1988-01-01,1988,0,0,0,0.0
277528,Live and let Live,2013-11-03,2013,0,0,0,1.048548
277541,Foodies,2014-05-23,2014,0,0,0,0.200882
277546,The Runner,2015-08-07,2015,6000000,0,-6000000,5.159939
277547,Playing It Cool,2014-09-26,2014,0,0,0,9.689284
277558,Final Girl,2015-04-14,2015,0,0,0,6.082415
277582,Monk With a Camera,2014-03-24,2014,0,0,0,0.200404
277594,Hercules Reborn,2014-07-08,2014,0,0,0,0.959275
277597,Mercenaries,2014-08-05,2014,0,0,0,3.094354
277610,Eat,2014-07-06,2014,0,0,0,0.980003
277622,The 27 Club,2008-04-26,2008,0,0,0,0.040054
277631,Birch Interval,1976-05-02,1976,0,0,0,0.320041
277662,Nightingale,2015-05-29,2015,0,0,0,7.930328
277685,Unfriended,2015-04-17,2015,1000000,62882090,61882090,10.07817
277686,The Man in the Orange Jacket,2015-02-27,2015,0,0,0,1.76713
277687,The Midnight Swim,2015-06-26,2015,0,0,0,1.892877
277688,Suburban Gothic,2014-07-19,2014,0,0,0,3.251693
277690,Yasmine,2014-07-09,2014,0,0,0,0.479662
277702,Supremacy,2014-06-12,2014,0,0,0,6.849918
277710,Anesthesia,2016-01-08,2016,0,0,0,4.440982
277713,Sunset Song,2015-12-04,2015,0,0,0,2.710586
277724,Better Housekeeping,2000-11-11,2000,0,0,0,0.003312
277726,Better Living,1998-11-02,1998,0,0,0,1.283178
277751,Maine Dil Tujhko Diya,2002-08-23,2002,0,0,0,0.0558
277778,Starship Rising,2014-08-08,2014,3000000,0,-3000000,1.511242
277796,Hide and Seek,2014-06-20,2014,0,0,0,1.173596
277806,Say 'I Love You',2014-07-12,2014,0,0,0,0.859095
277809,Massacre Canyon,1954-05-01,1954,0,0,0,0.869256
277819,Factory,2004-01-01,2004,0,0,0,0.245512
277834,Moana,2016-11-23,2016,150000000,643034466,493034466,9.143457
277839,"Good Guys Go to Heaven, Bad Guys Go to Pattaya",2016-02-24,2016,5402000,0,-5402000,5.613875
277846,Castles in the Sky,2014-06-23,2014,0,0,0,1.682416
277847,Set Fire to the Stars,2014-11-07,2014,0,0,0,1.633124
277934,Sadece Sen,2014-03-14,2014,0,0,0,1.463353
277967,Life Eternal,2015-03-05,2015,0,0,0,5.339649
277968,Me and Kaminski,2015-09-17,2015,0,0,0,2.919553
278041,Iyer the Great,1990-08-31,1990,0,0,0,0.378501
278051,Death Driver,1977-09-01,1977,0,0,0,0.000681
278086,Altman,2014-08-01,2014,0,0,0,3.031063
278095,A Gift with a Character,2014-05-22,2014,0,0,0,0.246799
278111,Angels Don't Sleep Here,2002-04-02,2002,3500000,0,-3500000,0.524742
278122,A Garibaldian in the Convent,1942-03-10,1942,0,0,0,0.148435
278154,Ice Age: Collision Course,2016-06-23,2016,105000000,408579038,303579038,20.151037
278236,X+Y,2015-03-13,2015,0,0,0,12.714642
278247,Walt Before Mickey,2015-04-03,2015,0,0,0,4.398708
278262,"Life, Autumn",1999-12-20,1999,0,0,0,0.071779
278269,The Settlement,2001-10-31,2001,0,0,0,0.17833
278283,The Great Man Votes,1939-01-13,1939,0,0,0,0.605472
278316,Da Sweet Blood of Jesus,2014-06-22,2014,0,0,0,4.967015
278329,Korso,2014-02-28,2014,0,0,0,0.190927
278334,Heatstroke,2013-12-19,2013,0,0,0,5.707479
278348,The Maid's Room,2014-08-08,2014,0,0,0,0.8185
278388,The Iceman and the Psychiatrist,2004-06-01,2004,0,0,0,0.160322
278393,Varsham,2014-11-06,2014,0,0,0,0.654724
278458,The Artist,2008-10-28,2008,0,0,0,0.123867
278468,Family Guy Presents: Blue Harvest,2007-09-23,2007,0,0,0,5.658089
278475,≈ûevkat Yerimdar,2013-10-25,2013,0,0,0,0.098004
278514,Hungry,2014-01-01,2014,0,0,0,0.012941
278544,Always Faithful,,,0,0,0,4.2e-05
278604,"Family Guy Presents: Something, Something, Something, Dark Side",2009-10-17,2009,0,0,0,8.266563
278621,Everything Relative,1996-09-13,1996,0,0,0,0.104276
278632,Julia,2014-10-14,2014,0,2710,2710,2.333511
278660,Tony Benn: Will and Testament,2014-06-26,2014,0,0,0,0.094209
278677,A Grain of Truth,2015-01-09,2015,0,0,0,0.803469
278706,Chrysalis,2014-04-24,2014,0,0,0,0.537234
278717,Test,2014-09-18,2014,0,0,0,0.297445
278718,Star,2014-06-18,2014,0,0,0,1.324441
278730,Nobody Wanted to Die,1965-09-04,1965,0,0,0,0.924553
278738,The Greggs,2014-06-26,2014,0,0,0,0.034825
278758,San Francisco International,1970-09-29,1970,0,0,0,0.214473
278771,Infliction,2012-01-01,2012,0,0,0,0.101246
278772,Serial Killer Culture,2014-02-04,2014,50,0,-50,0.299481
278774,Zapped,2014-06-27,2014,0,0,0,4.269081
278778,Dancing Ninja,2013-10-08,2013,0,0,0,0.205246
278813,Esmeraldero,2003-11-17,2003,0,0,0,0.002353
278822,Evidence of Blood,1998-04-13,1998,0,0,0,0.287605
278837,I Am Steve McQueen,2014-06-24,2014,0,0,0,0.853402
278851,Slums: Cities of Tomorrow,2014-04-25,2014,0,0,0,0.058183
278867,Hardkor Disko,2014-04-04,2014,0,0,0,0.296873
278878,The Gunfighter,2014-03-21,2014,0,0,0,1.812848
278901,Korgoth of Barbaria,2006-06-03,2006,0,0,0,0.765373
278924,Mechanic: Resurrection,2016-08-25,2016,40000000,125729635,85729635,14.288577
278927,The Jungle Book,2016-04-07,2016,175000000,966550600,791550600,17.432758
278935,Barrela: Escola de Crimes,1990-02-06,1990,0,0,0,0.008848
278939,Girl in the Cadillac,1995-10-24,1995,0,0,0,0.405392
278978,Und keiner weint mir nach,1996-02-29,1996,0,0,0,0.439989
278990,Seve,2014-06-27,2014,0,0,0,0.625265
279006,Kent State,1981-02-08,1981,0,0,0,0.000308
279049,Mission Impossible: Samurai,2014-06-21,2014,0,0,0,0.399967
279068,L'assedio dell'Alcazar,1940-01-02,1940,0,0,0,0.321393
279086,Shoot the Messenger,2006-08-30,2006,0,0,0,1.052916
279090,"Ich Chef, Du Turnschuh",1998-09-26,1998,0,0,0,0.039214
279096,Lazer Team,2016-01-27,2016,2480421,0,-2480421,5.121756
279144,"The Death of ""Superman Lives"": What Happened?",2015-05-01,2015,0,0,0,2.72378
279159,Physical Promise,1975-07-26,1975,0,0,0,0.037375
279179,Wir tun es f√ºr Geld,2014-06-27,2014,0,0,0,0.05459
279229,Sapphire Blue,2014-08-14,2014,0,0,0,9.11794
279254,Ghost in the Shell Arise - Border 4: Ghost Stands Alone,2014-09-06,2014,0,0,0,3.783372
279332,Mom's Day Away,2014-05-11,2014,0,0,0,0.422787
279371,When Sparks Fly,2014-06-28,2014,0,0,0,0.35033
279414,Once My Mother,2014-07-24,2014,0,0,0,0.016301
279444,Soft Toilet Seats,1999-12-03,1999,0,0,0,0.002341
279543,Elder Sister,1966-12-01,1966,0,0,0,0.176865
279558,Der Teufel mit den drei goldenen Haaren,2013-12-26,2013,0,0,0,0.534425
279568,"Paolo Barca, maestro elementare, praticamente nudista",1975-01-01,1975,0,0,0,5.7e-05
279570,10%: What Makes a Hero?,2013-07-16,2013,0,0,0,0.018845
279588,Cool As Hell,2013-02-19,2013,0,0,0,0.129193
279598,The Cat Who Walked by Herself,1988-01-01,1988,0,0,0,1.129734
279606,Radio Inside,1994-03-15,1994,0,0,0,0.686178
279608,Thunder,1982-07-11,1982,0,0,0,0.00022
279634,Vortex,2009-09-04,2009,0,0,0,0.149484
279641,Whiskey Tango Foxtrot,2016-03-04,2016,35000000,23083334,-11916666,8.155604
279661,Killer Legends,2014-07-01,2014,0,0,0,2.243927
279687,Futurama: The Lost Adventure,2008-06-24,2008,0,0,0,0.988667
279690,He Never Died,2015-03-17,2015,0,0,0,6.78295
279692,Murder Without Motive: The Edmund Perry Story,1992-01-06,1992,0,0,0,0.360935
279698,Never Met Picasso,1996-01-01,1996,0,0,0,0.001746
279714,OT: Our Town,2002-01-01,2002,0,0,0,0.052777
279784,Soap Girl,2002-09-01,2002,0,0,0,0.003438
279828,Delirium,2014-06-20,2014,0,0,0,7.181428
279842,Un attore contro - Gian Maria Volont√©,2005-10-29,2005,0,0,0,0.002357
279852,Federico Fellini's Autobiography,2000-09-05,2000,0,0,0,0.691717
279914,The Identical,2014-09-05,2014,12000000,0,-12000000,1.721715
279960,I Am Road Comic,2014-04-14,2014,0,0,0,0.401567
279965,Shockwave Darkside,2014-08-22,2014,0,0,0,0.364068
279966,The Forgotten,2014-08-22,2014,1446950,0,-1446950,0.808207
279967,Dead Within,2014-08-23,2014,0,0,0,0.722644
279968,White Settlers,2014-09-05,2014,0,0,0,1.827629
279972,Digging Up the Marrow,2015-02-20,2015,0,0,0,3.940514
279973,Nowhere Safe,2014-10-05,2014,0,0,0,1.901873
279977,The Mirror,2015-08-23,2015,0,0,0,1.420161
279979,The Court-Martial of Jackie Robinson,1990-10-15,1990,0,0,0,0.081817
279984,The Defiant Ones,1986-01-05,1986,0,0,0,0.321674
279988,Extinction: Nature Has Evolved,2017-03-10,2017,3400000,0,-3400000,1.862426
279992,Lost Soul: The Doomed Journey of Richard Stanley's Island of Dr. Moreau,2014-08-24,2014,0,0,0,1.835973
279997,I Survived a Zombie Holocaust,2014-08-25,2014,0,0,0,1.859992
279998,Altergeist,2014-08-25,2014,0,0,0,0.322574
280000,Lemon Tree Passage,2014-08-25,2014,0,0,0,2.254561
280002,The Remaining,2014-08-25,2014,0,1169603,1169603,14.788837
280004,The Great Waltz,1972-11-11,1972,0,0,0,0.421882
280005,Blood Moon,2014-08-25,2014,0,0,0,0.591218
280019,For the Emperor,2014-06-11,2014,0,0,0,2.045005
280030,Farewell Baghdad,2014-04-10,2014,0,0,0,0.357603
280045,El gafe,1959-12-07,1959,0,0,0,0.269518
280092,Insidious: Chapter 3,2015-06-04,2015,10000000,104303851,94303851,10.098792
280134,The Sweet Ride,1968-06-12,1968,0,0,0,0.49706
280165,Thani Oruvan,2015-08-28,2015,0,0,0,0.940349
280178,Freedom,1982-01-01,1982,0,0,0,0.003013
280182,H2S,1969-09-05,1969,0,0,0,0.08202
280218,1987,2014-08-06,2014,4000000,0,-4000000,0.854327
280276,Turtle Power: The Definitive History of the Teenage Mutant Ninja Turtles,2014-08-12,2014,0,0,0,0.519473
280416,Gun Hill,2014-07-02,2014,0,0,0,0.897531
280422,All at Once,2014-06-05,2014,750000,3,-749997,0.201582
280437,Eline Vere,1991-03-01,1991,0,0,0,0.378043
280459,Bad Behavior,2013-10-22,2013,0,0,0,1.069262
280477,The House of Fools,1985-09-10,1985,0,0,0,0.02541
280495,Deceit,1992-08-21,1992,0,0,0,1.108734
280509,Common,2014-07-06,2014,0,0,0,1.113581
280512,Christian Finnegan: The Fun Part,2014-04-15,2014,0,0,0,0.453289
280583,Violent,2014-07-06,2014,0,0,0,0.056694
280612,Genome Hazard,2014-01-24,2014,0,0,0,0.8585
280617,Space Cop,2016-01-13,2016,80000,0,-80000,1.103486
280640,Geronimo,2014-10-15,2014,0,0,0,0.621014
280668,Don't Think I've Forgotten: Cambodia's Lost Rock and Roll,2014-01-01,2014,0,0,0,0.166893
280674,Bigfoot's Reflection,2007-05-23,2007,0,0,0,0.075144
280690,Kick,2014-07-25,2014,22000000,55000000,33000000,7.366331
280723,Nena,2014-09-11,2014,0,0,0,0.416859
280755,Drops of Joy,2014-07-19,2014,0,0,0,0.050728
280795,Haider,2014-10-02,2014,0,0,0,6.024652
280840,Ma Ma,2015-09-11,2015,0,1137421,1137421,2.54364
280874,Killing Daddy,2014-07-05,2014,0,0,0,1.103423
280901,Shakespeare and Victor Hugo's Intimacies,2009-11-13,2009,0,0,0,0.223269
280913,The Teacher's Diary,2014-03-20,2014,0,0,0,0.919978
280922,Asthma,2015-10-23,2015,0,0,0,2.404878
280957,"Teodora, Slave Empress",1954-07-02,1954,0,0,0,0.195923
280996,Mr. Holmes,2015-06-19,2015,0,29355203,29355203,19.256859
281007,The Summer I Turned 15,1976-03-04,1976,0,0,0,9.95301
281085,A Boy Called Hate,1996-05-22,1996,0,0,0,1.56604
281122,Ere erera baleibu icik subua aruaren,1970-01-01,1970,0,0,0,0.021428
281124,Screen Directors Playhouse:  Meet the Governor,1955-10-05,1955,0,0,0,0.001243
281180,First to Fight,1967-01-25,1967,0,0,0,0.757753
281189,Gory Gory Hallelujah,2003-11-05,2003,0,0,0,0.078652
281215,Memorial Day,1983-11-23,1983,0,0,0,0.014455
281230,Fort McCoy,2014-01-01,2014,0,0,0,0.711099
281238,Master Stroke,1967-02-23,1967,0,0,0,0.23707
281287,Dead Ahead: The Exxon Valdez Disaster,,,0,0,0,0.035294
281289,Tainted,1998-05-18,1998,0,0,0,0.076396
281291,Bethune: The Making of a Hero,1993-09-17,1993,0,0,0,0.099122
281298,The Divine Move,2014-07-03,2014,0,0,0,1.71351
281338,War for the Planet of the Apes,2017-07-11,2017,152000000,369907963,217907963,146.161786
281418,The Lookalike,2014-07-11,2014,0,0,0,3.602005
281468,Killing Us Softly 4: Advertising's Image Of Women,2010-01-01,2010,0,0,0,0.063515
281506,Isabelle Dances Into the Spotlight,2014-01-01,2014,0,0,0,1.308219
281524,The Hooligan Factory,2014-06-13,2014,1000000,0,-1000000,3.856935
281556,Sink or Swim,1997-09-19,1997,0,0,0,0.003965
281583,The Substitute,1993-09-22,1993,0,0,0,0.680068
281590,Kurt Metzger: White Precious,2014-07-11,2014,0,0,0,0.07805
281600,Breaking with Old Ideas,1976-01-02,1976,0,0,0,0.0
281615,Santa's Pocket Watch,1980-12-20,1980,0,0,0,0.000263
281713,Rebel Beat: The story of LA Rockabilly,2007-02-06,2007,0,0,0,0.003534
281730,Fugly,2014-06-13,2014,0,0,0,0.924931
281778,Survivor,2014-07-22,2014,0,0,0,2.788535
281780,Kundo: Age of the Rampant,2014-07-23,2014,0,0,0,9.240619
281783,Satyricon,1969-03-27,1969,0,0,0,1.220012
281826,Algorithm,2014-07-19,2014,0,0,0,1.216647
281908,Train On The Brain,2000-01-14,2000,0,0,0,0.036488
281957,The Revenant,2015-12-25,2015,135000000,532950503,397950503,23.501228
281968,La Sapienza,2014-08-01,2014,0,0,0,0.242981
281979,Doctor Who: The Waters of Mars,2009-12-19,2009,0,0,0,2.66804
281987,Desperado's Duel,2014-07-18,2014,0,0,0,0.0859
282009,The Sea Vultures,1915-06-16,1915,0,0,0,0.00265
282024,The Iron Ivan,2014-07-10,2014,12000000,0,-12000000,1.685233
282035,The Mummy,2017-06-06,2017,125000000,407778013,282778013,33.704935
282040,The Alamo: Thirteen Days to Glory,1987-11-11,1987,0,0,0,1.518506
282041,"Electric Boogaloo: The Wild, Untold Story of Cannon Films",2014-10-06,2014,0,0,0,3.057828
282042,The Gold Spinners,2013-11-29,2013,0,0,0,0.210561
282069,Parasyte: Part 1,2014-11-29,2014,0,0,0,3.346011
282070,Parasyte: Part 2,2015-04-25,2015,0,0,0,2.240411
282078,Tale of the Siberian Land,1947-09-09,1947,0,0,0,0.001307
282084,There's No Place Like Utopia,2014-07-18,2014,0,0,0,0.083811
282086,Shark in the Head,2004-06-01,2004,0,0,0,0.005914
282116,Braban√ßonne,2014-12-10,2014,0,0,0,0.419784
282225,The Choice,1970-01-02,1970,0,0,0,0.074246
282247,Clerks: The Lost Scene,2004-09-07,2004,0,0,0,1.353701
282248,The Living,2014-06-26,2014,500000,0,-500000,1.293257
282266,The Adventures of Robinson Crusoe,1922-03-27,1922,0,0,0,0.008978
282268,Monty Python Live (Mostly),2014-07-20,2014,0,0,0,1.315493
282296,My Old Lady,2014-09-09,2014,5000000,7527232,2527232,11.127162
282297,Cowspiracy: The Sustainability Secret,2014-07-01,2014,117,0,-117,6.213797
282298,Surfacing,1981-07-25,1981,2250000,0,-2250000,0.093933
282308,"Whiffles, Cubic Artist",1912-01-01,1912,0,0,0,0.003732
282313,The Reconstruction of William Zero,2015-04-11,2015,0,0,0,4.741389
282346,Hate Story 2,2014-07-18,2014,0,0,0,1.383588
282374,Cure: The Life of Another,2014-08-16,2014,0,0,0,0.169939
282376,Corn Island,2014-09-17,2014,0,0,0,3.303655
282502,Dancing Arabs,2014-07-10,2014,0,0,0,1.815821
282553,The Muse,2007-09-30,2007,0,0,0,0.110908
282624,Little Sister,1992-09-16,1992,0,0,0,0.206364
282631,The Admiral: Roaring Currents,2014-07-30,2014,9500000,112156811,102656811,5.062756
282672,My Mistress,2014-08-14,2014,0,0,0,1.264539
282758,Doctor Who: The Runaway Bride,2007-07-06,2007,0,0,0,2.88026
282762,Committed,2014-04-06,2014,0,0,0,0.205891
282768,Maicol Jecson,2014-07-19,2014,0,0,0,0.390501
282813,The Pyramid,2014-12-04,2014,6500000,13865435,7365435,9.312354
282848,Doctor Who: The Time of the Doctor,2013-12-25,2013,0,0,0,3.331914
282879,The Work of Director Spike Jonze,2003-10-20,2003,0,0,0,0.771091
282919,Diebinnen,1996-06-20,1996,0,0,0,0.106345
282963,Doctor Who: Planet of the Dead,2009-07-26,2009,0,0,0,3.214699
282983,Magical Girl,2014-09-07,2014,0,0,0,2.341779
282984,Irrational Man,2015-07-17,2015,11000000,27391084,16391084,6.862812
282996,Erebus: Operation Overdue,2014-07-13,2014,0,0,0,0.074004
283101,Shadowing the Third Man,2004-10-11,2004,0,0,0,0.017007
283105,Expecting Amish,2014-07-19,2014,0,0,0,1.031839
283127,Yakuza Apocalypse,2015-05-21,2015,0,12756,12756,3.052285
283146,This Land Is Mine,2012-07-22,2012,0,0,0,0.194273
283161,The Prophet,2014-09-06,2014,0,0,0,3.996894
283201,Finding Fanny,2014-09-12,2014,2489400,0,-2489400,1.310166
283227,A Little Chaos,2014-09-13,2014,0,0,0,7.579751
283235,99 Homes,2014-10-09,2014,8000000,1411927,-6588073,6.60913
283281,The Scapegoat,1963-08-23,1963,0,0,0,0.739498
283302,Lost for Life,2013-06-22,2013,0,0,0,0.577301
283317,Messi,2014-09-06,2014,0,0,0,2.254378
283322,The Dead Lands,2014-09-04,2014,0,5240,5240,10.001517
283330,Eden,2014-11-19,2014,0,65460,65460,10.919636
283350,Before We Go,2014-09-11,2014,0,37151,37151,9.526911
283366,Miss Peregrine's Home for Peculiar Children,2016-09-28,2016,110000000,296485719,186485719,36.262655
283378,Fallen,2016-11-10,2016,0,0,0,6.603389
283384,The Calling,2014-08-05,2014,0,0,0,4.99324
283424,The Eternity Man,2008-09-18,2008,0,0,0,0.119274
283445,Sinister 2,2015-08-19,2015,10000000,52882018,42882018,17.602928
283489,Ascendant,,,0,0,0,8.518516
283521,Falsely Accused,2016-06-24,2016,0,0,0,0.169443
283536,Ned Rifle,2014-09-07,2014,0,0,0,4.235107
283552,The Light Between Oceans,2016-09-02,2016,20000000,25956113,5956113,8.483245
283587,Beasts of No Nation,2015-09-11,2015,6000000,9077700,3077700,11.732546
283589,Bang Bang!,2014-10-02,2014,0,0,0,5.558673
283591,The Secret Scripture,2016-11-04,2016,0,152761,152761,13.177741
283596,The Legend of Barney Thomson,2015-07-24,2015,0,0,0,3.861768
283686,Out of the Dark,2014-08-27,2014,0,0,0,3.290095
283691,Halo: Nightfall,2014-11-11,2014,0,0,0,5.112049
283698,Hungry Hearts,2015-01-15,2015,0,6921,6921,4.543452
283700,Pasolini,2014-09-25,2014,0,0,0,3.238304
283701,3 Hearts,2014-09-09,2014,0,0,0,1.77278
283703,The Postman's White Nights,2014-10-14,2014,0,0,0,1.658212
283704,Leopardi,2014-10-16,2014,0,0,0,4.735656
283707,Black Souls,2014-09-18,2014,0,0,0,2.460348
283708,Far from Men,2014-08-30,2014,7700000,0,-7700000,3.790687
283710,Fires on the Plain,2014-08-30,2014,0,0,0,1.196373
283711,Red Amnesia,2014-08-30,2014,0,0,0,0.488603
283712,Boats,2013-09-20,2013,0,0,0,0.104465
283726,The New Girlfriend,2014-09-06,2014,0,0,0,5.518654
283792,Œü ŒòŒ±ŒΩŒ¨œÉŒ∑œÇ œÉœÑŒ∑ œáœéœÅŒ± œÑŒ∑œÇ œÉœÜŒ±ŒªŒπŒ¨œÅŒ±œÇ,1976-07-25,1976,0,0,0,0.001641
283827,Singh is Bling,2015-10-02,2015,0,0,0,1.017176
283959,Diary of a Lover,1977-09-13,1977,0,0,0,0.000431
283995,Guardians of the Galaxy Vol. 2,2017-04-19,2017,200000000,863416141,663416141,185.330992
284013,Popsy Pop,1971-03-10,1971,0,0,0,0.320955
284048,Los tontos y los est√∫pidos,2014-10-03,2014,0,0,0,0.078877
284050,Mr. Kaplan,2014-11-21,2014,0,0,0,0.968647
284052,Doctor Strange,2016-10-25,2016,165000000,677718395,512718395,43.847654
284053,Thor: Ragnarok,2017-10-25,2017,0,0,0,57.283628
284063,Mourning Grave,2014-07-03,2014,0,0,0,1.720618
284096,Cet Amour-l√†,2001-09-11,2001,0,0,0,0.060572
284117,Fitna,2008-03-27,2008,0,0,0,0.040068
284135,Hill of Freedom,2014-09-04,2014,0,0,0,1.249293
284152,Confession,2014-07-10,2014,0,0,0,0.455081
284154,Premeditated Murder,1995-11-15,1995,0,0,0,0.152705
284189,Les mauvaises t√™tes,2013-09-11,2013,0,0,0,0.292226
284231,Tinpis Run,1991-09-06,1991,0,0,0,0.350449
284246,The Yes Men Are Revolting,2014-09-04,2014,0,0,0,0.595005
284250,Halam Geldi,2014-01-15,2014,0,0,0,0.361116
284258,Zeitoun,,,0,0,0,0.036084
284270,Cub,2014-10-29,2014,0,0,0,4.676897
284274,Iron Man & Captain America: Heroes United,2014-07-29,2014,0,0,0,3.838554
284276,Cake,2014-09-07,2014,7000000,2360281,-4639719,10.197503
284279,Burnout,2014-08-24,2014,4000000,0,-4000000,1.109389
284284,The Keeping Room,2014-09-25,2014,0,0,0,5.654989
284286,Learning to Drive,2014-08-21,2014,0,3447633,3447633,10.405088
284288,Mary Kom,2014-09-05,2014,224056,15536328,15312272,1.416035
284289,Beyond the Reach,2014-09-06,2014,0,45895,45895,10.072918
284290,Return to Ithaca,2014-10-30,2014,0,0,0,1.15553
284293,Still Alice,2014-12-05,2014,5000000,43884652,38884652,8.823253
284294,Time Out of Mind,2014-09-07,2014,0,166775,166775,4.248105
284296,Top Five,2014-12-12,2014,0,25434291,25434291,7.355355
284303,Goodnight Mommy,2014-08-29,2014,0,1178196,1178196,5.399896
284305,Shrew's Nest,2014-09-26,2014,0,0,0,6.319326
284306,They Have Escaped,2014-08-01,2014,1400000,0,-1400000,0.75959
284343,Self Made,2014-06-16,2014,0,0,0,0.328318
284362,El vals de los in√∫tiles,2014-05-08,2014,0,0,0,0.120001
284427,Who Am I,2014-09-25,2014,0,0,0,13.001155
284457,Twin Peaks: Fire Walk with Me - The Missing Pieces,2014-07-29,2014,0,0,0,3.027874
284460,Samurai Cop 2: Deadly Vengeance,2015-10-09,2015,1500000,0,-1500000,3.3756
284467,Jigsaw,1968-06-05,1968,0,0,0,0.321421
284470,Atari: Game Over,2014-11-19,2014,0,0,0,4.574669
284514,Spy Time,2015-09-04,2015,0,0,0,4.03651
284536,The Gambler,2014-12-25,2014,25000000,39171130,14171130,8.728556
284537,Welcome to Me,2014-09-05,2014,0,0,0,7.143088
284564,31,2016-09-15,2016,1500000,779820,-720180,6.636625
284568,Closure,2013-12-01,2013,0,0,0,0.069426
284581,Back Issues: The Hustler Magazine Story,2014-02-14,2014,0,0,0,0.53084
284620,M√©moire de glace,2007-01-17,2007,0,0,0,0.038878
284674,Air,2015-08-14,2015,0,0,0,9.698415
284682,"Jinxy Jenkins, Lucky Lou",2014-03-19,2014,0,0,0,0.386604
284689,Testament of Youth,2014-10-14,2014,0,1822250,1822250,7.046825
284694,The Scarlet Letter,1979-04-02,1979,0,0,0,0.193441
284711,Sharktopus vs Pteracuda,2014-08-02,2014,0,0,0,1.887713
284729,Killa,2014-02-11,2014,0,0,0,0.41221
284785,My Brother the Terrorist,2014-04-28,2014,0,0,0,0.040214
284793,The Land,1942-01-02,1942,0,0,0,0.021544
284841,E-clip-se,1999-09-01,1999,0,0,0,0.148486
284870,The Princess of France,2014-08-07,2014,0,0,0,0.099722
284875,Cut Snake,2015-09-24,2015,0,0,0,1.659599
284995,Scooby-Doo! Frankencreepy,2014-08-19,2014,0,0,0,4.934518
285011,Broken Strings,1940-01-01,1940,0,0,0,0.329203
285020,"Christmas, Again",2014-08-13,2014,0,0,0,1.339057
285024,Heaven Knows What,2015-05-29,2015,0,0,0,2.351893
285025,Tour de Force,2014-08-09,2014,4000000,0,-4000000,1.609661
285026,The Last Season,2014-04-25,2014,0,0,0,0.014245
285135,Zodiac,2014-08-16,2014,0,0,0,3.29973
285165,Beatles,2014-08-29,2014,0,0,0,0.435339
285176,Out of Nature,2014-09-19,2014,950000,0,-950000,2.335565
285181,1001 Grams,2014-09-07,2014,0,0,0,0.994875
285213,The Pirates,2014-08-06,2014,0,0,0,2.352706
285245,10 000 timmar,2014-04-04,2014,0,0,0,0.803128
285270,Believe Me,2014-09-26,2014,0,0,0,1.734576
285307,My Bromance,2014-02-20,2014,0,0,0,1.255406
285387,Colt 45,2014-08-06,2014,0,0,0,2.963954
285398,The Hour Before the Dawn,1944-05-10,1944,0,0,0,0.224832
285400,Out of This World,1945-07-13,1945,0,0,0,0.180517
285423,Jarhead 2: Field of Fire,2014-08-14,2014,0,0,0,2.095438
285460,Limited Partnership,2014-06-14,2014,0,0,0,0.01552
285463,Two Shots Fired,2014-09-05,2014,0,0,0,0.139648
285532,Bolidi sull'asfalto a tutta birra!,1970-08-08,1970,0,0,0,0.013602
285549,Horsehead,2014-09-07,2014,0,0,0,2.528537
285581,August Winds,2014-08-08,2014,0,0,0,1.347489
285594,Making 'The New World',2006-01-01,2006,0,0,0,0.004985
285595,My Own Man,2014-03-06,2014,0,0,0,0.129014
285597,Nixon by Nixon: In His Own Words,2014-08-04,2014,0,0,0,0.442069
285598,Call Girl of Cthulhu,2014-05-08,2014,0,0,0,1.340703
285649,L'erba proibita,2002-12-13,2002,0,0,0,0.072941
285685,El cimarr√≥n,2006-10-01,2006,0,0,0,0.041651
285689,Glen Campbell: I'll Be Me,2014-04-24,2014,0,365522,365522,1.380258
285692,A Blast,2014-08-12,2014,0,0,0,0.444405
285697,Horse Money,2014-08-13,2014,0,0,0,0.780997
285700,The Fool,2014-08-09,2014,0,0,0,2.382734
285733,Barbie and the Secret Door,2014-08-30,2014,0,0,0,2.973442
285755,Forgiveness,2006-08-08,2006,0,0,0,0.007524
285783,The Walk,2015-09-30,2015,35000000,61181942,26181942,9.425787
285803,Singham Returns,2014-08-15,2014,0,0,0,2.108695
285814,The Butterfly Ball,1977-04-01,1977,0,0,0,0.556668
285838,Teen Lust,2014-09-04,2014,0,0,0,2.126283
285840,The Editor,2014-09-11,2014,0,0,0,1.716268
285841,Elephant Song,2014-09-04,2014,0,0,0,3.521503
285843,October Gale,2014-09-11,2014,0,0,0,8.967028
285844,Preggoland,2014-09-04,2014,0,0,0,1.788104
285848,Felix and Meira,2015-01-11,2015,0,0,0,0.776885
285851,Love in the Time of Civil War,2014-09-04,2014,0,0,0,0.786654
285856,Big Muddy,2014-09-04,2014,0,0,0,0.752178
285858,Corbo,2014-04-17,2014,0,0,0,0.597897
285860,Guidance,2014-09-04,2014,0,0,0,1.186123
285863,Songs She Wrote About People She Knows,2014-09-04,2014,0,0,0,0.102578
285869,Wet Bum,2014-09-07,2014,0,0,0,0.017768
285908,The Last Breath,1999-03-25,1999,3800000,559298,-3240702,0.072704
285935,Aksuat,1997-08-09,1997,0,0,0,0.001191
285946,Blazing Guns,1943-10-08,1943,0,0,0,0.020745
285953,The Time of Your Life,1976-03-10,1976,0,0,0,0.05165
285959,Valentino,1951-03-08,1951,1300000,1550000,250000,0.328342
286007,LoveHotels,2006-06-03,2006,0,0,0,0.011113
286120,The Legend of the Red Lantern,1970-01-02,1970,0,0,0,0.009192
286192,Lava,2015-06-21,2015,0,0,0,5.761878
286217,The Martian,2015-09-30,2015,108000000,630161890,522161890,25.62993
286239,Arisan! 2,2011-12-01,2011,0,0,0,0.18744
286256,Tim Maia,2014-10-30,2014,0,0,0,1.113421
286267,One Man's Fate,1940-09-01,1940,0,0,0,0.001908
286301,The Dinner,2014-09-05,2014,0,0,0,2.351135
286313,Free Fall,2014-09-25,2014,0,0,0,0.446869
286367,Classroom 6,2014-04-08,2014,0,0,0,1.348183
286369,Gabriel & Me,2001-11-01,2001,0,0,0,0.298577
286372,Treehouse,2014-10-20,2014,3250000,3250000,0,1.574542
286402,Cardinal Richelieu,1935-04-18,1935,0,0,0,0.387212
286407,Mission Blue,2014-01-30,2014,0,0,0,0.658563
286437,The Secret Game,1917-12-03,1917,0,0,0,0.010377
286452,Varsity Blood,2014-08-19,2014,0,0,0,0.310607
286512,Les amants du bagne,2005-01-31,2005,0,0,0,0.144614
286519,Boychoir,2014-09-04,2014,0,0,0,10.765313
286521,5 Flights Up,2014-09-05,2014,6000000,1020921,-4979079,9.383088
286532,A Merry Friggin' Christmas,2014-11-07,2014,0,0,0,14.921478
286538,Bokeh,2017-03-24,2017,0,0,0,6.165126
286545,Troublemaker,1988-01-01,1988,0,0,0,0.000917
286548,TEKKEN: Kazuya's Revenge,2014-08-12,2014,0,0,0,7.415328
286554,Two Night Stand,2014-09-26,2014,0,18612,18612,6.788822
286565,Paper Towns,2015-06-18,2015,12000000,85512300,73512300,9.662731
286567,Max Steel,2016-10-14,2016,10000000,6272403,-3727597,6.703892
286595,Marie's Story,2014-08-10,2014,0,0,0,1.64304
286654,Reclaim,2014-09-19,2014,0,0,0,3.78824
286657,Crawl or Die,2014-08-13,2014,0,0,0,1.584846
286668,A Good Man,2014-08-19,2014,7000000,0,-7000000,2.83412
286687,Love Lesson,2013-12-05,2013,0,0,0,3.02542
286697,Songs From the North,2014-08-08,2014,0,0,0,0.380374
286709,Revenge of the Green Dragons,2014-03-15,2014,5000000,0,-5000000,2.820466
286789,The Warrior Empress,1960-08-24,1960,0,0,0,0.386799
286805,Dark Dungeons,2014-08-15,2014,1000,0,-1000,0.055526
286817,Anatomy of a Love Seen,2014-07-28,2014,0,0,0,2.134277
286873,Northmen: A Viking Saga,2014-09-27,2014,0,0,0,16.388563
286875,Paper Planes,2014-09-07,2014,0,0,0,7.78915
286940,The Boxcar Children,2014-08-05,2014,5,0,-5,0.929799
286971,Innocence,2014-09-05,2014,0,0,0,5.304305
286987,How to Build a Better Boy,2014-08-17,2014,0,0,0,5.954022
287084,The Town that Dreaded Sundown,2014-10-16,2014,0,0,0,8.494374
287169,The Studio Murder Mystery,1932-02-17,1932,0,0,0,0.001312
287170,Love's Coming,2014-02-27,2014,0,0,0,1.512438
287179,The Iron Ministry,2014-08-15,2014,0,0,0,0.376129
287233,Tom and Jerry: The Lost Dragon,2014-07-27,2014,0,0,0,1.35961
287241,The Unauthorized Saved by the Bell Story,2014-09-01,2014,0,0,0,0.948724
287281,The Gamers: Natural One,2014-08-14,2014,0,0,0,0.142142
287284,Swung,2015-06-19,2015,0,0,0,1.671062
287299,Katt Williams: Priceless: Afterlife,2014-08-16,2014,0,0,0,0.476007
287301,Summertime,2014-08-01,2014,0,0,0,0.358817
287305,Peanuts ‚Äì Die Bank zahlt alles,1996-03-21,1996,0,0,0,0.066123
287322,Blackbird,2014-02-16,2014,0,0,0,0.934827
287344,Gaston's War,1997-10-23,1997,0,0,0,0.01804
287391,Un milliard dans un billard,1965-10-07,1965,0,0,0,0.002612
287422,Gentlemen,2014-12-05,2014,0,0,0,0.461721
287424,Maggie,2015-05-08,2015,4000000,187112,-3812888,12.020933
287426,Shelter,2014-09-12,2014,0,0,0,5.675752
287483,The Farewell Party,2014-08-29,2014,0,0,0,1.457375
287484,Sons of Liberty,2013-07-06,2013,0,0,0,0.457657
287486,The Grump,2014-09-05,2014,0,0,0,2.681279
287493,Kabukicho Love Hotel,2014-09-07,2014,0,0,0,1.31479
287495,Labyrinth of Lies,2014-09-06,2014,0,794452,794452,9.046751
287497,The Lesson,2014-09-04,2014,0,0,0,1.051211
287499,"Margarita, with a Straw",2014-10-04,2014,0,0,0,0.600391
287504,Modris,2014-10-24,2014,0,0,0,0.056398
287509,Tokyo Fianc√©e,2014-09-07,2014,0,0,0,1.833529
287524,Fear Clinic,2014-10-31,2014,1,0,-1,2.508452
287581,Foreign Body,2014-10-17,2014,1500000,0,-1500000,0.374007
287587,Adult Beginners,2014-09-08,2014,0,108808,108808,5.764184
287590,Saint Seiya: Legend of Sanctuary,2014-06-21,2014,0,0,0,6.751603
287594,Dukhtar,2014-09-18,2014,0,0,0,0.539258
287603,Eddie Pepitone: In Ruins,2014-08-07,2014,0,0,0,0.024104
287623,Second Coming,2014-09-02,2014,0,0,0,1.046576
287628,Theeb‚Äé‚Äé,2014-09-04,2014,0,0,0,2.469425
287636,The Sound And The Fury,2015-10-23,2015,0,0,0,1.166012
287647,Cart,2014-11-13,2014,0,0,0,1.467059
287689,7 Days in Hell,2015-07-11,2015,0,0,0,8.323292
287703,Caf√©. Waiting. Love,2014-08-15,2014,0,0,0,1.273364
287717,Edgar G. Ulmer: The Man Off-screen,2004-09-04,2004,0,0,0,0.304351
287719,Vinodentro,2013-12-12,2013,0,0,0,0.392381
287767,Mardaani,2014-08-22,2014,0,0,0,1.139847
287790,"Bailout at 43,000",1957-05-01,1957,0,0,0,0.590307
287793,Cam2Cam,2014-08-22,2014,0,0,0,1.120312
287811,Boys Life 4: Four Play,2003-08-01,2003,0,0,0,0.066548
287815,Call + Response,2008-10-10,2008,0,0,0,0.04002
287816,Camera Obscura,2000-02-06,2000,0,0,0,0.037259
287821,Catfish in Black Bean Sauce,2000-06-09,2000,0,0,0,0.003552
287831,External Affairs,,,0,0,0,0.0
287859,Raja Natwarlal,2014-08-29,2014,5,4,-1,1.109545
287877,"First Case, Second Case",1979-01-01,1979,0,0,0,0.001655
287903,Krampus,2015-11-26,2015,15000000,61548707,46548707,15.553313
287935,Midnight Sun,2014-09-01,2014,18000000,0,-18000000,2.355806
287940,Night Sights,2011-12-31,2011,250000,0,-250000,2.124093
287948,The Transporter Refueled,2015-09-03,2015,25000000,72629670,47629670,11.007319
287982,VHS Massacre: Cult Films and the Decline of Physical Media,2016-06-20,2016,0,0,0,1.39872
287991,Dog Run,2001-04-04,2001,0,0,0,0.001648
288035,"Kids in the Hall: Same Guys, New Dresses",2001-03-02,2001,0,0,0,0.001262
288036,Sleeping with Other People,2015-06-26,2015,0,3214116,3214116,8.844452
288037,Step Up Love Story,2000-01-01,2000,0,0,0,0.318238
288094,Casual Relations,1974-03-22,1974,0,0,0,0.0
288098,Skies Above the Landscape,2006-03-15,2006,0,0,0,0.044619
288101,"All Blossoms Again: Pedro Costa, Director",2006-07-10,2006,0,0,0,0.003534
288105,Eastwood on Eastwood,1997-11-01,1997,0,0,0,0.071704
288108,Film ist. 7-12,2002-10-10,2002,0,0,0,0.002353
288109,Jean Renoir: Part One - From La Belle √âpoque to World War II,1993-11-17,1993,0,0,0,0.0
288111,"Moral Tales, Filmic Issues",2006-08-15,2006,0,0,0,0.003783
288117,Living with the Fosters,2002-03-23,2002,0,0,0,0.002361
288121,Fearful Symmetry,1998-01-01,1998,0,0,0,0.089356
288122,Budd Boetticher: A Man Can Do That,2005-12-02,2005,0,0,0,0.074118
288126,Comrades in Arms,1992-09-30,1992,0,0,0,0.649618
288128,Great Escape: The Untold Story,2001-01-01,2001,0,0,0,0.001177
288129,Liz in September,2014-10-02,2014,0,0,0,0.787551
288130,A Good Job: Stories of the FDNY,2014-09-08,2014,600000,0,-600000,0.862513
288146,97 Percent True,2008-01-01,2008,0,0,0,0.003534
288151,The Act in Question,1993-05-01,1993,0,0,0,0.082589
288153,Killing Auntie,1985-09-20,1985,0,0,0,1.3e-05
288154,Jersey Shore Massacre,2014-08-22,2014,1400000,0,-1400000,2.466441
288158,The Woman in Black 2: Angel of Death,2014-12-30,2014,1000000,26501323,25501323,6.942139
288162,Happy Birthday to a Beautiful Woman,2012-09-08,2012,0,0,0,0.009437
288165,Safrana or Freedom of Speech,1978-02-08,1978,0,0,0,0.0375
288168,The time and patience,1994-01-01,1994,0,0,0,0.001178
288171,Blue Mountain State: The Rise of Thadland,2016-02-02,2016,0,0,0,5.008234
288173,Hostile Intentions,1995-01-01,1995,0,0,0,0.062388
288183,A Hole in the Soul,1994-01-01,1994,0,0,0,0.132825
288186,Passing Glory,1999-02-21,1999,0,0,0,1.250784
288193,Warren Oates: Across the Border,1993-01-01,1993,0,0,0,0.091812
288201,A Season on the Brink,2002-03-10,2002,0,0,0,0.002361
288259,No Flesh Shall Be Spared,2009-01-01,2009,0,0,0,0.009451
288281,A Good Marriage,2014-10-03,2014,0,0,0,9.30854
288284,Making the Earth Stand Still,1995-01-01,1995,0,0,0,0.001177
288286,The History of Eternity,2014-07-26,2014,0,0,0,0.172293
288288,I am Von H√∂fler Variation on Werther,2008-01-01,2008,0,0,0,0.00353
288290,Mon Paradis - Der Winterpalast,2001-01-01,2001,0,0,0,0.002582
288291,What Is to Be Done?,1970-01-01,1970,0,0,0,0.076219
288292,Budd Boetticher: An American Original,2005-12-13,2005,0,0,0,0.003786
288293,Jungle de Ikou,1997-03-26,1997,0,0,0,0.076206
288295,Lana Turner... a Daughter's Memoir,2001-01-01,2001,0,0,0,0.036478
288296,The Footprints of a Spirit,1998-10-10,1998,0,0,0,0.00152
288298,Victor Seastrom,1981-01-01,1981,0,0,0,3.8e-05
288301,Do I Sound Gay?,2014-07-10,2014,0,0,0,1.635063
288312,The Gold Bug,2014-08-15,2014,0,0,0,0.19059
288313,Perez.,2014-10-02,2014,0,0,0,1.187722
288413,The Ernest Film Festival,1986-01-01,1986,0,0,0,2.1e-05
288421,Making 'Do the Right Thing',1989-11-03,1989,0,0,0,0.548066
288424,Shock Value,2014-08-01,2014,0,0,0,0.704106
288427,How the Myth Was Made: A Study of Robert Flaherty's Man of Aran,1984-11-08,1984,0,0,0,0.0525
288430,In the Edges: The 'Grizzly Man' Session,2005-12-26,2005,0,0,0,0.005173
288438,Gable: The King Remembered,1975-01-01,1975,0,0,0,3e-06
288463,The Guvnors,2014-06-24,2014,0,0,0,2.562863
288503,Killjoy,1981-08-24,1981,0,0,0,0.15623
288504,Bridge and Tunnel,2014-04-30,2014,0,0,0,0.019792
288521,Why Be Good?,1929-02-28,1929,0,0,0,0.374038
288526,The Auntie from Chicago,1957-12-16,1957,0,0,0,0.11368
288581,Rocks in my Pockets,2014-08-21,2014,0,0,0,0.829203
288585,Silent Heart,2014-11-13,2014,0,0,0,1.872988
288587,Wild Life,2014-10-29,2014,0,0,0,2.144842
288618,Atl√°ntida,2014-02-11,2014,0,0,0,0.014118
288668,Tainted Blood,1993-08-24,1993,0,0,0,2.1e-05
288691,Last Weekend,2014-08-29,2014,0,0,0,3.131421
288694,La trattativa,2014-10-02,2014,0,0,0,0.527368
288708,In the Basement,2014-09-26,2014,0,0,0,2.246861
288710,The Frontier,2016-11-08,2016,0,0,0,1.672854
288772,"Five Wives, Three Secretaries and Me",1999-10-08,1999,0,0,0,0.001648
288778,Runoff,2015-06-26,2015,0,0,0,0.4807
288788,But Always,2014-09-04,2014,0,0,0,0.630429
288789,Merchants of Doubt,2014-11-08,2014,0,192400,192400,1.743751
288916,Pay 2 Play: Democracy's High Stakes,2014-09-05,2014,0,0,0,0.051932
288931,Pump,2014-09-19,2014,0,0,0,0.499251
288952,Evergreen,2004-01-01,2004,0,0,0,0.876271
288953,Forget Baghdad: Jews and Arabs - The Iraqi Connection,2002-01-01,2002,0,0,0,0.002374
288977,The Dovekeepers,2015-03-31,2015,0,0,0,1.313421
288980,Freedom,2014-08-21,2014,14500000,0,-14500000,5.3991
289010,Die Frau des Fris√∂rs,2008-10-27,2008,0,0,0,0.043028
289039,Factory Girl,2013-12-08,2013,0,0,0,0.477975
289097,Cell 213,2011-06-10,2011,0,0,0,2.68548
289126,Hiver rouge,2011-09-08,2011,0,0,0,0.007094
289153,"Sex, Love & Therapy",2014-10-01,2014,0,0,0,6.837575
289159,The Invisible Front,2014-03-20,2014,0,0,0,0.137328
289171,The Secret of Arkandias,2014-10-22,2014,0,0,0,3.87515
289174,The President,2014-08-30,2014,0,0,0,0.334111
289180,H.,2014-08-28,2014,0,0,0,0.730281
289183,Boy Upside Down,2014-08-29,2014,0,0,0,0.023784
289190,Felt,2014-09-18,2014,0,0,0,0.643327
289191,I Am Here,2014-09-30,2014,0,0,0,1.948792
289198,Redeemer,2014-09-18,2014,0,0,0,1.586498
289207,Catastrophe,1978-02-07,1978,0,0,0,0.049321
289222,The Zookeeper's Wife,2017-03-31,2017,20000000,13162475,-6837525,13.655178
289225,Love Finds You In Sugarcreek,2014-06-01,2014,0,0,0,0.712788
289232,The Goob,2014-09-25,2014,0,0,0,1.310577
289239,Mostly Ghostly: Have You Met My Ghoulfriend?,2014-09-02,2014,0,0,0,5.308946
289269,Lady Bloodfight,2016-11-11,2016,0,0,0,5.226483
289278,My So-Called Father,2014-09-19,2014,0,0,0,1.035811
289314,Olive Kitteridge,2014-11-02,2014,0,0,0,6.029457
289318,Mars,1968-01-01,1968,0,0,0,0.052164
289333,Jim Jefferies: BARE,2014-08-29,2014,0,0,0,1.62502
289336,Dagmamman,2013-09-11,2013,0,0,0,0.030036
289339,Chelsea Peretti: One of the Greats,2014-11-14,2014,0,0,0,1.91832
289390,Women Aren't Funny,2014-08-29,2014,0,0,0,0.388231
289394,Houdini,2014-09-01,2014,0,0,0,3.988645
289416,Grace,2014-10-28,2014,0,0,0,4.550875
289510,The Blue Elephant,2014-07-28,2014,3500000,0,-3500000,0.945722
289519,Blues Story,2003-11-01,2003,200000,0,-200000,0.111754
289520,Perfect on Paper,2014-09-20,2014,0,0,0,0.192214
289523,Midnight Masquerade,2014-09-27,2014,0,0,0,0.804969
289575,Tales of the Grim Sleeper,2014-08-29,2014,0,0,0,1.026813
289673,Cinderella,2000-01-01,2000,0,0,0,1.085134
289679,I Married You For Fun,1967-08-30,1967,0,0,0,0.001332
289712,Mockingbird,2014-10-07,2014,0,0,0,10.895623
289716,The World Made Straight,2015-01-09,2015,0,0,0,2.20851
289720,Outcast,2014-09-26,2014,25000000,0,-25000000,9.029641
289723,An Act of War,2015-03-10,2015,0,0,0,1.662556
289727,The Rewrite,2014-06-15,2014,0,4453524,4453524,6.253843
289728,Jingle All the Way 2,2014-12-02,2014,5000000,0,-5000000,2.448724
289781,Poshter Boyz,2014-08-01,2014,0,0,0,0.02424
289820,N: The Madness Of Reason,2014-11-08,2014,0,0,0,0.103679
289891,Jackie & Ryan,2014-09-01,2014,0,0,0,3.104679
289923,The Burkittsville 7,2000-10-03,2000,0,0,0,0.38645
289933,The Truth About Webcam Girls,2014-02-24,2014,0,0,0,1.316376
289960,Blondie's New York and the Making of Parallel Lines,2014-08-29,2014,0,0,0,0.633345
290043,M√∂rderische Erpressung,2006-11-03,2006,0,0,0,0.003565
290075,Modern Boy,2008-10-02,2008,0,0,0,0.006784
290098,The Handmaiden,2016-06-01,2016,8575000,1983204,-6591796,16.727405
290100,Plan Bart,2014-09-17,2014,0,0,0,0.579576
290157,Jupiter's Wife,1995-01-01,1995,0,0,0,0.001178
290188,The Brittany Murphy Story,2014-09-06,2014,0,0,0,1.328486
290217,My Old Classmate,2014-04-25,2014,0,76000000,76000000,0.504
290235,Find Me,2014-09-01,2014,0,0,0,0.147431
290250,The Nice Guys,2016-05-15,2016,50000000,62788218,12788218,16.075615
290274,The Man Who Couldn't Say No,1975-11-21,1975,0,0,0,0.000578
290283,Honeytrap,2015-05-08,2015,0,0,0,0.309684
290290,War Book,2014-10-13,2014,0,0,0,1.860646
290300,Peter Pan Live!,2014-12-04,2014,0,0,0,1.882141
290304,21 Years: Richard Linklater,2014-11-07,2014,0,0,0,1.287567
290316,My Friend Victoria,2014-12-31,2014,0,0,0,0.696188
290365,Project-M,2014-09-20,2014,0,0,0,0.976485
290370,Mutant World,2014-09-27,2014,0,1500000,1500000,1.044936
290379,Looking Forward,1933-04-28,1933,0,0,0,0.572083
290382,Roger Waters: The Wall,2014-09-29,2014,0,0,0,3.343723
290504,Awake: The Life of Yogananda,2014-10-10,2014,0,0,0,0.321054
290542,You're Not You,2014-10-10,2014,0,11486,11486,6.800456
290555,Wolves,2014-08-28,2014,18000000,0,-18000000,11.481479
290556,Viktor,2014-09-04,2014,10000000,0,-10000000,1.35921
290595,The Huntsman: Winter's War,2016-04-06,2016,115000000,164602163,49602163,17.260203
290637,Pay the Ghost,2015-09-16,2015,0,2160298,2160298,7.935683
290656,Raised by Wolves,2014-08-18,2014,0,0,0,0.931028
290672,Detour,1998-10-05,1998,0,0,0,0.616132
290695,Melbourne,2014-02-07,2014,0,0,0,0.732605
290714,The Surface,2014-10-09,2014,0,0,0,0.834443
290727,Monster High: Freaky Fusion,2014-10-06,2014,0,0,0,2.742513
290729,Sniper: Legacy,2014-09-29,2014,0,0,0,3.544629
290739,Land,2010-05-02,2010,415000,0,-415000,0.076579
290751,Secret in Their Eyes,2015-10-14,2015,19500000,34854990,15354990,6.79115
290762,Miss You Already,2015-09-12,2015,0,0,0,7.634145
290764,Tracers,2015-01-15,2015,11000000,593683,-10406317,9.056173
290773,The Connection,2014-09-01,2014,0,0,0,0.262563
290789,Breaking at the Edge,2013-01-01,2013,0,0,0,1.598702
290802,Night Will Fall,2014-06-07,2014,0,0,0,1.742732
290815,Court,2015-03-26,2015,0,0,0,0.725267
290825,Yoga Hosers,2016-07-08,2016,5000000,0,-5000000,7.550395
290862,Man for a Day,2012-07-19,2012,0,0,0,0.414603
290864,Kung Fu Jungle,2014-10-31,2014,25000000,129115,-24870885,6.636514
290865,Tazza: The Hidden Card,2014-09-03,2014,0,0,0,1.745604
290911,Paradies 505. Ein Niederbayernkrimi,2013-10-19,2013,0,0,0,0.048331
290916,7.2,2014-10-16,2014,0,0,0,0.016798
290930,Image,2014-11-05,2014,0,0,0,0.569464
290999,Wyrmwood: Road Of The Dead,2014-09-19,2014,0,0,0,6.635569
291006,The Price We Pay,2014-09-05,2014,0,0,0,0.194929
291122,Long Gone,2003-01-20,2003,0,0,0,0.002353
291146,Yalom's Cure,2014-05-20,2014,0,0,0,0.563739
291151,The Stranger,2015-06-12,2015,0,0,0,4.250043
291154,Daawat-e-Ishq,2014-09-05,2014,0,0,0,1.141957
291155,"Fat, Sick & Nearly Dead 2",2014-09-18,2014,0,0,0,0.943537
291156,No One's Child,2014-09-01,2014,0,0,0,0.442652
291157,Khoobsurat,2014-09-19,2014,0,0,0,1.61641
291162,Slow Southern Steel,2011-10-20,2011,0,0,0,0.00968
291164,Hand Gun,1994-10-01,1994,0,0,0,0.662077
291189,The Driftless Area,2015-04-18,2015,0,0,0,11.875146
291224,How A Sausage Dog Works,1971-01-01,1971,0,0,0,0.003921
291264,The Family Fang,2016-04-16,2016,0,262921,262921,5.121894
291270,Anomalisa,2015-12-30,2015,8000000,5659286,-2340714,10.428421
291272,We Are Still Here,2015-06-05,2015,0,0,0,8.100029
291276,Unlocked,2017-04-27,2017,0,0,0,13.371144
291290,Submerged,2015-11-27,2015,0,0,0,2.232507
291325,Heads,1994-01-29,1994,0,0,0,0.733197
291328,Rules Don't Apply,2016-11-23,2016,25000000,3885342,-21114658,8.167673
291336,Honeyspider,2014-10-18,2014,0,0,0,0.0845
291343,Nowitzki: The Perfect Shot,2014-09-18,2014,0,0,0,0.981528
291348,A Matter of Faith,2014-10-17,2014,0,0,0,1.860893
291351,The Sea of Trees,2016-04-27,2016,0,0,0,8.316558
291356,In a Valley of Violence,2016-10-21,2016,0,53647,53647,7.723801
291362,Road Hard,2015-03-06,2015,1500000,0,-1500000,1.906036
291375,Sleeping with the Fishes,2013-08-10,2013,0,0,0,0.388701
291413,Within,2016-10-18,2016,0,0,0,9.449891
291495,American Burger,2014-10-17,2014,0,0,0,0.679229
291537,Winning: The Racing Life of Paul Newman,2015-05-08,2015,0,0,0,1.700266
291540,Why Horror?,2014-10-03,2014,0,0,0,0.778909
291549,Assassination,2015-07-22,2015,0,0,0,6.346176
291554,Twogether,1994-01-01,1994,0,0,0,0.047019
291558,Vagabond Lady,1935-05-03,1935,0,0,0,0.10071
291577,Miguel San Miguel,2012-11-15,2012,0,0,0,0.062805
291613,Mistrial,1996-11-02,1996,0,0,0,1.223689
291634,The Next Step,1997-06-13,1997,0,0,0,0.001247
291675,Gabriela,2001-02-14,2001,0,0,0,0.001187
291680,Sioux City,1994-04-01,1994,0,0,0,0.369474
291692,Brotherhood of Blades,2014-08-07,2014,0,0,0,4.259327
291731,Homage,1995-05-03,1995,0,0,0,0.014925
291805,Now You See Me 2,2016-06-02,2016,90000000,334901337,244901337,39.540653
291817,Seymour: An Introduction,2015-03-13,2015,0,0,0,0.932758
291851,Field of Lost Shoes,2015-03-30,2015,0,0,0,2.899439
291854,Meet the Mormons,2014-10-10,2014,0,0,0,0.431374
291861,The Wild McCullochs,1975-05-21,1975,0,0,0,0.594758
291863,Future Shock! The Story of 2000AD,2014-09-19,2014,0,0,0,0.353387
291865,From the Dark,2014-04-14,2014,0,0,0,2.916224
291866,The Hive,2015-09-14,2015,0,0,0,11.693912
291868,My Life Directed by Nicolas Winding Refn,2014-09-18,2014,0,0,0,1.43713
291869,I Am Michael,2015-01-29,2015,0,0,0,9.565297
291870,Dirty Grandpa,2016-01-21,2016,11500000,94073028,82573028,16.290586
291871,Yosemite,2016-01-01,2016,0,0,0,2.076048
291907,Jealousy,1953-01-13,1953,0,0,0,0.118581
291976,All Souls' Day,1961-12-05,1961,0,0,0,0.028504
292010,The Daughter,2015-10-09,2015,0,0,0,3.71029
292014,The Snow Queen 2: Refreeze,2014-12-12,2014,0,0,0,3.107696
292022,After Midnight,2014-01-01,2014,0,0,0,1.091991
292033,Alexander Graham Bell: The Sound and the Silence,1993-07-18,1993,0,0,0,0.240517
292035,Aanmodderfakker,2014-09-30,2014,0,0,0,0.454109
292040,Spooks: The Greater Good,2015-04-11,2015,0,1473809,1473809,10.199449
292062,Caught,1987-11-09,1987,0,0,0,0.000172
292063,Raiders from Beneath the Sea,1964-01-01,1964,0,0,0,0.001283
292081,Sunshine Superman,2015-05-22,2015,400000,88097,-311903,0.984906
292090,Face,2002-01-01,2002,0,0,0,0.003027
292133,Battle of the Stars,1978-02-17,1978,0,0,0,0.357165
292177,My Little Pony: Equestria Girls - Rainbow Rocks,2014-09-27,2014,0,0,0,1.340019
292191,Bachelor Night,2014-08-12,2014,0,0,0,0.722405
292214,Killer Cop,2002-10-15,2002,0,0,0,0.004889
292262,Graffiti Wars,2011-08-14,2011,0,0,0,0.430964
292264,I Just Wanna Hug You,2014-02-01,2014,0,0,0,0.560196
292277,Living in the Age of Airplanes,2015-04-25,2015,0,0,0,0.205058
292280,The Bye Bye Man,2017-01-12,2017,7400000,26667197,19267197,19.225832
292294,The Phantom Stagecoach,1957-03-31,1957,0,0,0,0.094121
292298,Meeting David Wilson,2010-06-01,2010,0,0,0,0.066282
292342,Bill Maher: Live From DC,2014-09-12,2014,0,0,0,0.162976
292387,Summer Nights,2014-08-29,2014,0,0,0,0.274176
292396,Deliverance Creek,2014-09-13,2014,0,0,0,1.08147
292431,Love,2015-07-06,2015,3000000,249083,-2750917,2.328321
292445,(Absolutions) Pipilotti's Mistakes,1988-01-13,1988,0,0,0,0.0735
292483,Not Cool,2014-09-23,2014,0,0,0,1.406589
292498,Confidentially Connie,1953-03-12,1953,0,0,0,0.092012
292510,The Vagabond King,1956-08-28,1956,0,0,0,1.605152
292523,Whistle and I'll Come to You,1968-05-07,1968,0,0,0,0.226607
292533,Women's Prison,2002-10-06,2002,0,0,0,0.037647
292538,Wisdom of Changes - Richard Wilhelm and the I Ching,2011-11-19,2011,0,0,0,0.008235
292539,Food Chains,2014-04-26,2014,913000,0,-913000,1.254662
292547,The Young and the Dead,2000-04-22,2000,0,0,0,0.001177
292607,The Rise and Rise of Bitcoin,2014-10-03,2014,0,0,0,0.880642
292610,Ladies' Doctor,1977-09-13,1977,0,0,0,1.177053
292625,The Swimmers,2014-08-07,2014,0,0,0,0.704442
292631,Negociador,2014-09-22,2014,0,0,0,0.57353
292640,"White, White Storks",1966-01-02,1966,0,0,0,0.013045
292656,Tractor Drivers,1939-07-03,1939,0,0,0,0.366948
292795,Yellowbird,2014-11-06,2014,0,0,0,2.308762
292830,Creature,2014-09-12,2014,0,0,0,0.129933
292834,Brother Nature,2016-09-09,2016,0,0,0,1.006543
292893,Snake River Desperadoes,1951-05-30,1951,0,0,0,0.332574
292917,Some Body,2001-01-19,2001,0,0,0,0.166855
292947,Won't Anybody Listen,2001-09-28,2001,0,0,0,0.078017
292948,Writer of O,2005-04-01,2005,0,0,0,0.0449
292974,Just an American Boy,2003-06-07,2003,0,0,0,0.002353
292975,King Leopold's Ghost,2006-05-28,2006,0,0,0,0.003534
292988,Dark Mountain,2013-10-27,2013,0,0,0,0.742753
293006,Aliens on the Moon: The Truth Exposed,2014-01-01,2014,0,0,0,0.633369
293028,Death of a Nation - The Timor Conspiracy,1994-03-18,1994,0,0,0,0.081766
293082,"10,000 Days",2014-11-23,2014,0,0,0,1.807454
293085,Juurakon Hulda,1937-10-17,1937,0,0,0,0.058968
293089,The Prodigal Son,1992-10-30,1992,0,0,0,0.000431
293091,When the Heavens Fell,1972-03-10,1972,0,0,0,0.036243
293092,Back to the USSR,1992-03-27,1992,0,0,0,0.037475
293093,Dark Haul,2014-10-04,2014,0,0,0,1.151262
293094,Aliisa,1970-11-18,1970,0,0,0,0.026681
293097,Harmagedon - Er√§√§n maailman loppu,1986-03-28,1986,0,0,0,0.014956
293109,Onnenpeli,1965-10-01,1965,0,0,0,0.036478
293114,The Painting Sellers,2010-09-03,2010,0,0,0,0.005936
293122,The Guide,2014-11-12,2014,722083,499168,-222915,0.817488
293126,Terror at the Mall,2014-09-15,2014,0,0,0,0.054871
293167,Kong: Skull Island,2017-03-08,2017,185000000,566652812,381652812,29.429112
293189,Algorithms,2013-06-06,2013,0,0,0,0.011525
293198,The Road to Brown,1989-01-01,1989,0,0,0,0.0
293205,Recipe for Love,2014-10-11,2014,0,0,0,1.691508
293238,Labyrinth,2012-11-24,2012,20000000,0,-20000000,2.062354
293262,I Am Ali,2014-10-10,2014,0,7205,7205,3.191386
293264,A Golden Boy,2014-09-18,2014,0,0,0,0.783186
293270,Sistemo l'America e torno,1974-09-16,1974,0,0,0,0.305299
293271,Moomins on the Riviera,2014-10-10,2014,4700000,0,-4700000,1.160542
293299,Feast,2014-11-07,2014,0,0,0,7.365663
293310,Citizenfour,2014-10-10,2014,0,3003169,3003169,6.584217
293313,Risto R√§pp√§√§j√§ ja liukas Lennart,2014-02-07,2014,1300000,0,-1300000,0.020492
293380,The Nativity,1978-12-17,1978,0,0,0,0.887877
293395,Three Nights of Love,1964-10-08,1964,0,0,0,0.912961
293412,Running Wild,1995-01-01,1995,0,0,0,0.465559
293413,Inside Men,2015-11-19,2015,0,62000000,62000000,3.527119
293444,Garden Lovers,2014-03-07,2014,460000,0,-460000,0.093541
293450,Flow,2014-05-08,2014,0,0,0,0.317829
293452,The Disappointments Room,2016-09-09,2016,15000000,0,-15000000,13.288704
293456,For Some Inexplicable Reason,2014-10-30,2014,0,0,0,0.630332
293461,Monsterman,2014-09-26,2014,0,0,0,0.016499
293471,Jill and Joy,2014-01-17,2014,2100000,0,-2100000,0.017998
293476,La buca,2014-09-25,2014,0,0,0,0.60367
293487,Tolonen,2014-05-01,2014,0,0,0,0.018059
293491,Raspberry Boat Refugee,2014-08-19,2014,3200000,0,-3200000,1.035143
293516,La nostra terra,2014-09-18,2014,0,0,0,0.200371
293552,At the River I Stand,1993-01-01,1993,0,0,0,0.0
293553,Bloody Knuckles,2014-07-27,2014,0,0,0,0.708993
293570,Enemy of the Reich: The Noor Inayat Khan Story,2014-02-15,2014,0,0,0,0.592531
293572,The Houses October Built,2014-10-10,2014,0,0,0,6.034967
293603,The Roosevelts: An Intimate History,2014-09-15,2014,0,0,0,0.824032
293625,The Ritual,2009-08-15,2009,0,0,0,0.042204
293633,Catch Hell,2014-10-10,2014,2500000,0,-2500000,7.115612
293646,The 33,2015-08-06,2015,25000000,24902723,-97277,8.383246
293654,Corporate Event,2014-09-18,2014,2000000,0,-2000000,0.52437
293660,Deadpool,2016-02-09,2016,58000000,783112979,725112979,187.860492
293670,The Wailing,2016-05-12,2016,0,0,0,8.141819
293721,Failure of Engineer Garin,1973-10-15,1973,0,0,0,0.194489
293767,Billy Lynn's Long Halftime Walk,2016-11-10,2016,40000000,30930984,-9069016,8.009568
293768,Kidnap,2017-08-04,2017,21000000,24527158,3527158,20.214579
293771,Dead Rising: Watchtower,2015-03-27,2015,0,0,0,9.559969
293796,Wet and Reckless,2014-04-08,2014,10000,0,-10000,0.049443
293820,Tar,1997-11-26,1997,0,0,0,0.001177
293828,Starve,2014-10-03,2014,0,0,0,1.228646
293830,Terminal,1996-02-12,1996,0,0,0,1.524545
293850,The Magic of Heineken,2014-09-19,2014,0,0,0,0.329432
293861,Imagine I'm Beautiful,2014-01-01,2014,0,0,0,0.705234
293863,The Age of Adaline,2015-04-16,2015,25000000,65663276,40663276,10.542026
293880,Hollidaysburg,2014-09-19,2014,600000,0,-600000,0.966348
293901,Haunting of Cellblock 11,2014-07-01,2014,0,0,0,0.955792
293941,The Quiet Hour,2014-09-07,2014,0,0,0,2.066559
293946,The Great Stone Face,1968-01-01,1968,0,0,0,0.052171
293970,The Final Girls,2015-10-09,2015,0,0,0,6.679341
293982,Warsaw 44,2014-09-19,2014,6700000,0,-6700000,4.277554
294016,Trumbo,2015-10-27,2015,15000000,8235661,-6764339,7.358726
294047,The Levenger Tapes,2013-09-01,2013,0,0,0,0.422781
294083,Dead Girls,2014-09-21,2014,0,0,0,0.380439
294085,Valerie Inside Outside,1972-05-30,1972,0,0,0,0.087326
294086,Tiger Orange,2014-07-26,2014,0,0,0,0.459083
294093,Dinosaur Island,2014-09-01,2014,0,0,0,4.668314
294098,Gooische Vrouwen 2,2014-12-04,2014,0,0,0,1.101141
294132,Results,2015-05-29,2015,0,104507,104507,3.967229
294161,Tain√°: An Amazon Adventure,2001-01-12,2001,0,0,0,0.113347
294221,Hockney,2014-11-25,2014,0,0,0,0.179841
294222,Mantervention,2014-07-15,2014,0,0,0,1.104738
294254,Maze Runner: The Scorch Trials,2015-09-09,2015,61000000,311256926,250256926,41.225769
294261,Fever,1991-05-11,1991,0,0,0,0.325096
294272,Pete's Dragon,2016-08-10,2016,65000000,143695338,78695338,12.189941
294308,Don't Blink,2014-09-18,2014,0,0,0,3.065359
294368,An Open Secret,2015-06-05,2015,0,0,0,1.088139
294409,Hollywood Without Make-Up,1963-07-01,1963,0,0,0,0.347774
294463,Lou!,2014-10-08,2014,0,0,0,3.149547
294483,Wir waren K√∂nige,2014-11-13,2014,0,0,0,1.305476
294517,Aging Out,2004-03-12,2004,0,0,0,0.002353
294538,Hit by Lightning,2014-10-31,2014,0,0,0,1.416907
294543,Pelican Dreams,2014-11-07,2014,0,0,0,0.274778
294544,"On Any Sunday, The Next Chapter",2014-01-01,2014,0,0,0,0.737708
294550,The Outrageous Sophie Tucker,2014-05-02,2014,0,0,0,0.014118
294562,Lavalantula,2015-08-08,2015,0,0,0,6.901559
294574,Ruin Explorers,1995-06-25,1995,0,0,0,0.038722
294600,Last I Heard,2013-01-01,2013,0,0,0,0.139138
294608,The Light of Freedom,2013-10-01,2013,0,0,0,0.011765
294640,Afterlife,2014-09-11,2014,0,0,0,0.123551
294651,Pale Moon,2014-11-15,2014,0,0,0,0.859012
294652,Son of a Gun,2014-10-16,2014,0,0,0,12.756464
294682,Little Forest: Summer/Autumn,2014-08-30,2014,0,0,0,1.252833
294690,Saints and Soldiers: The Void,2014-08-15,2014,0,0,0,3.351527
294709,Satan's Sword,1960-10-18,1960,0,0,0,0.152012
294741,The Falling,2014-10-11,2014,750000,0,-750000,3.669491
294795,The 9th Life of Louis Drax,2016-09-01,2016,0,0,0,8.602488
294819,"Colpo grosso, grossissimo...anzi probabile",1972-03-31,1972,0,0,0,0.01541
294825,Rumors of Wars,2014-05-02,2014,0,0,0,0.128762
294826,The Runner from Ravenshead,2010-07-23,2010,0,0,0,0.005882
294862,Magical Universe,2014-10-31,2014,0,0,0,0.171424
294959,Valley Uprising,2014-09-01,2014,0,0,0,1.779918
294963,Bone Tomahawk,2015-10-23,2015,1800000,0,-1800000,10.480166
294991,Gangster Payday,2014-10-11,2014,0,0,0,1.581698
294992,The Taking of Tiger Mountain,2014-12-24,2014,0,228984,228984,10.475435
294993,Rise of the Legend,2014-11-20,2014,0,0,0,4.068355
295011,Patient Zero,,,0,0,0,1.083454
295045,Little Ninjas,1990-08-17,1990,0,0,0,0.049521
295049,"Nativity 3: Dude, Where's My Donkey?!",2014-11-14,2014,0,0,0,1.048552
295058,The Tree,2014-07-07,2014,0,0,0,0.087385
295069,Saturday Night,2010-05-02,2010,0,0,0,0.786341
295087,"Bangkok, We Have A Problem!",2014-10-22,2014,0,0,0,3.000275
295111,War,2014-09-21,2014,0,0,0,0.731356
295144,Marvellous,2015-02-19,2015,0,0,0,3.448294
295273,The Crossing II,2015-07-30,2015,0,0,0,1.834833
295279,"Back to Back, Face to Face",1994-11-17,1994,0,0,0,0.438368
295314,L'Oranais,2014-11-19,2014,0,0,0,0.742137
295315,Sex Ed,2014-11-07,2014,0,0,0,2.924166
295317,Dark Star: HR Giger‚Äôs World,2014-10-23,2014,0,0,0,1.04773
295355,Satan's Sword: The Dragon God,1960-12-27,1960,0,0,0,0.009566
295368,Elon Gold: Chosen and Taken,2014-04-15,2014,0,0,0,0.138257
295389,Decameron proibitissimo (Boccaccio mio statte zitto),1972-08-03,1972,0,0,0,0.059956
295401,Underdog,2014-09-26,2014,0,0,0,0.746802
295469,Made in Bangkok,2015-03-09,2015,0,0,0,0.020002
295490,Digging for Fire,2015-08-21,2015,0,0,0,4.335659
295507,Barbary Coast Gent,1944-09-01,1944,0,0,0,0.114375
295508,Calcutta Mail,2003-06-30,2003,0,0,0,0.00972
295538,The Culture High,2014-09-18,2014,0,0,0,0.740742
295560,Clint Eastwood: Out of the Shadows,2000-09-27,2000,0,0,0,1.036699
295581,If I Had Wings,2013-12-01,2013,0,0,0,0.742863
295588,23 Blast,2014-10-24,2014,0,0,0,1.6757
295592,Monkey Kingdom,2015-04-17,2015,0,16661077,16661077,3.367592
295595,Soaked in Bleach,2015-06-09,2015,0,0,0,3.539209
295602,Becoming Me,2014-09-24,2014,0,0,0,0.024587
295621,Eyes of a Thief,2014-10-01,2014,0,0,0,0.120442
295627,Spawn: The Recall,2014-09-13,2014,0,0,0,0.377926
295656,Along Came a Nanny,2014-10-12,2014,0,0,0,0.713069
295689,Goofy Movies Number One,1933-12-23,1933,0,0,0,0.14163
295693,The Boss Baby,2017-03-23,2017,125000000,498814908,373814908,13.392824
295698,Free the Nipple,2014-12-12,2014,937000,0,-937000,1.405665
295699,Everybody Wants Some!!,2016-03-30,2016,10000000,3400278,-6599722,6.737797
295715,Snow on The Blades,2014-09-20,2014,0,0,0,0.74993
295723,Kingdom Come,2014-08-20,2014,3000000,0,-3000000,1.911022
295748,Pek Yakƒ±nda,2014-10-02,2014,0,0,0,2.088729
295782,"Die Frau, die im Wald verschwand",2009-04-29,2009,0,0,0,0.006667
295799,Iris,2014-10-09,2014,0,0,0,2.644281
295823,Mixed Feelings,2014-10-02,2014,2000000,0,-2000000,0.631308
295830,Attack on Titan,2015-08-12,2015,0,0,0,8.118506
295832,Unique Brothers,2014-10-02,2014,0,0,0,2.969323
295841,Killer Instinct,1988-01-01,1988,0,0,0,0.40977
295884,Saving Christmas,2014-11-14,2014,0,0,0,1.231644
295886,Brotherly Love,2015-04-24,2015,1900000,0,-1900000,1.483826
295887,Beethoven's Treasure Tail,2014-10-02,2014,0,0,0,1.206403
295891,Jerrod Carmichael: Love at the Store,2014-10-04,2014,0,0,0,0.736452
295914,Queen of the Mountains,2014-08-22,2014,0,0,0,0.340106
295958,Sound of Redemption: The Frank Morgan Story,2016-07-15,2016,0,0,0,0.043929
295964,Burnt,2015-10-02,2015,20000000,36606743,16606743,8.066726
296025,Safelight,2015-04-17,2015,0,0,0,8.64958
296029,Matt Shepard Is a Friend of Mine,2014-10-07,2014,0,0,0,1.185564
296065,Last Shift,2014-10-25,2014,0,0,0,5.347371
296071,Princess Jellyfish,2014-12-27,2014,0,0,0,0.920347
296082,Austin to Boston,2015-06-12,2015,0,0,0,0.370551
296095,Little White Lie,2014-07-29,2014,0,0,0,0.432039
296096,Me Before You,2016-06-02,2016,20000000,207945075,187945075,34.34759
296098,Bridge of Spies,2015-10-15,2015,40000000,165478348,125478348,13.707888
296099,Vacation,2015-07-28,2015,31000000,104384188,73384188,11.33038
296100,The Night Before,2015-11-20,2015,25000000,52395996,27395996,10.516094
296104,I Was an Adventuress,1940-05-10,1940,0,0,0,0.075077
296121,Trophy Heads,2014-06-04,2014,0,0,0,0.508162
296130,Harbinger Down,2015-08-07,2015,0,0,0,3.979592
296136,Oko Wykol,1960-01-01,1960,0,0,0,0.41351
296178,Posthumous,2014-10-04,2014,0,0,0,8.082888
296192,Comedy Central Roast of Charlie Sheen,2011-09-19,2011,0,0,0,4.272554
296193,Comedy Central Roast of David Hasselhoff,2010-08-15,2010,0,0,0,2.1604
296194,Comedy Central Roast of William Shatner,2006-08-20,2006,0,0,0,1.142292
296206,Comedy Central Roast of Pamela Anderson,2005-08-14,2005,0,0,0,4.407922
296225,Drei wei√üe Birken,1961-09-27,1961,0,0,0,0.037098
296244,Plague,2014-10-30,2014,200000,0,-200000,1.125723
296288,Tamo Junto,2016-12-08,2016,0,0,0,0.227697
296313,Men & Chicken,2015-02-05,2015,0,0,0,11.369559
296344,Politexnitis and Erimospitis,1963-09-30,1963,0,0,0,0.154738
296360,Love & Friendship,2016-05-27,2016,3000000,14016568,11016568,12.822085
296367,Morning Star,2014-04-14,2014,3000000,0,-3000000,0.570639
296370,Platinum the Dance Movie,2014-01-01,2014,0,0,0,2.030962
296449,Francofonia,2015-11-11,2015,0,0,0,1.656862
296456,Christian Mingle,2014-10-10,2014,0,0,0,1.585224
296472,Wedding Day,2012-06-15,2012,350000,0,-350000,0.755105
296491,3 Avengers,1964-11-26,1964,0,0,0,0.002054
296503,Dude Bro Party Massacre III,2015-06-13,2015,0,0,0,1.933788
296523,Man Down,2016-12-02,2016,0,454516,454516,13.95291
296524,Deepwater Horizon,2016-09-29,2016,110000000,121790373,11790373,13.1984
296543,Tinseltown,1997-01-01,1997,0,0,0,0.036471
296557,The Roommate,2008-07-15,2008,0,0,0,0.320305
296626,Finders Keepers,2014-10-18,2014,0,0,0,2.814458
296633,The Whistleblower,2014-10-02,2014,0,0,0,0.635799
296750,The Furthest End Awaits,2014-09-29,2014,0,0,0,0.164005
296778,Death in Buenos Aires,2014-05-05,2014,500000,0,-500000,1.427255
296779,The Waiting Room,1996-10-09,1996,0,0,0,0.563832
296820,Pillars of Society,1935-12-21,1935,0,0,0,0.001293
296834,An Alternative Reality: The Football Manager Documentary,2014-10-07,2014,0,0,0,0.29281
296855,The Thing on the Doorstep,2014-01-01,2014,0,0,0,0.229551
296865,A Monster with a Thousand Heads,2016-03-30,2016,0,0,0,1.016876
296867,Jeremy,2016-10-21,2016,0,0,0,0.844263
296879,Of Mind and Music,2016-02-12,2016,0,0,0,0.261945
296901,Firefly,1975-09-16,1975,0,0,0,0.957019
296917,Psycho-Pass: The Movie,2015-01-09,2015,0,0,0,4.299518
296941,The Hacker Wars,2014-10-17,2014,0,0,0,0.631502
297018,Simshar,2014-04-27,2014,0,0,0,0.345032
297023,The Lies of the Victors,2014-10-17,2014,0,0,0,0.43251
297063,Sven's Secret,1995-09-26,1995,0,0,0,0.026497
297098,Chelsea Handler Uganda Be Kidding Me Live,2014-10-10,2014,0,0,0,0.888914
297160,XX,2017-02-17,2017,0,30911,30911,8.106953
297167,2AM: The Smiling Man,2013-07-23,2013,0,0,0,0.43588
297173,The Expedition,,,0,0,0,0.049412
297186,Fatal Frame,2014-09-26,2014,0,0,0,0.274385
297207,La pazza della porta accanto: conversazione con Alda Merini,2013-11-12,2013,0,0,0,0.084644
297222,PK,2014-12-18,2014,13000000,120000000,107000000,12.58752
297239,Boy 7,2015-02-19,2015,0,0,0,6.631736
297263,It's My Mother's Birthday Today,2008-01-01,2008,0,0,0,0.00353
297265,Northern Soul,2014-10-17,2014,0,0,0,2.174854
297270,Tinker Bell and the Legend of the NeverBeast,2014-12-12,2014,0,0,0,8.106333
297288,Good for Nothing,2014-10-23,2014,0,0,0,1.109136
297291,The Scorpion King: Quest for Power,2015-01-09,2015,0,0,0,10.907809
297298,Mandƒ±ra Filozofu,2014-04-04,2014,0,0,0,0.765972
297308,1989,2014-11-05,2014,0,0,0,0.081008
297342,Œ•œÄŒ¨œÅœáŒµŒπ ŒöŒ±Œπ Œ¶ŒπŒªœåœÑŒπŒºŒø,1965-12-06,1965,0,0,0,0.038719
297362,Teacher of the Year,2015-05-19,2015,0,0,0,1.650458
297393,Dark Horse,2015-04-17,2015,0,0,0,1.92024
297399,Artie Lange: The Stench of Failure,2014-10-18,2014,0,0,0,0.14776
297400,Socialphobia,2015-03-12,2015,0,0,0,0.866055
297421,Of Men and War,2014-10-22,2014,0,0,0,0.088236
297462,Old Fashioned,2014-10-18,2014,0,0,0,0.68064
297466,A Reunion,2014-06-01,2014,0,0,0,0.079878
297482,Sebastian Maniscalco: Aren't You Embarrassed?,2014-11-14,2014,0,0,0,0.061909
297505,The Black Sheep,1968-11-09,1968,0,0,0,0.620422
297544,Age of Ice,2014-12-09,2014,0,0,0,1.725587
297556,Justice League: Throne of Atlantis,2015-01-27,2015,3500000,0,-3500000,6.012379
297560,Œ§Œø ŒûœçŒªŒø ŒíŒ≥ŒÆŒ∫Œµ ŒëœÄœå Œ§ŒøŒΩ Œ†Œ±œÅŒ¨Œ¥ŒµŒπœÉŒø,1959-11-16,1959,0,0,0,0.142537
297596,Dying of the Light,2014-12-04,2014,15000000,0,-15000000,14.059259
297603,Mr. Dynamite: The Rise of James Brown,2014-04-27,2014,0,0,0,1.286655
297608,The Taking of Deborah Logan,2014-10-21,2014,0,0,0,5.418357
297621,There's Always Woodstock,2014-11-14,2014,0,0,0,1.109909
297631,Spark of Being,2010-11-19,2010,0,0,0,0.005882
297633,Bordering on Bad Behavior,2014-07-01,2014,0,0,0,0.466899
297641,Holiday,2014-05-01,2014,0,0,0,0.123029
297645,The Story of Xinghua,1994-03-30,1994,0,0,0,0.001652
297668,Terrible Joe Moran,1984-03-26,1984,0,0,0,0.097665
297677,The Effect of Love,2007-08-16,2007,0,0,0,0.327148
297680,Hangar 10,2014-10-22,2014,0,0,0,1.948145
297702,Gutshot Straight,2014-10-11,2014,0,0,0,1.712432
297721,Gangnam Blues,2015-01-31,2015,0,0,0,2.368227
297736,Radiator,2014-10-15,2014,0,0,0,0.782889
297745,...E fuori nevica!,2014-10-16,2014,0,0,0,1.557067
297755,L‚ô°DK,2014-04-12,2014,0,0,0,0.923746
297761,Suicide Squad,2016-08-02,2016,175000000,745600054,570600054,42.965027
297762,Wonder Woman,2017-05-30,2017,149000000,820580447,671580447,294.337037
297784,Barolo Boys,2014-10-16,2014,0,0,0,0.346869
297789,Angels of Revolution,2014-11-05,2014,0,0,0,0.290199
297806,I Saw the Light,2016-02-05,2016,13000000,1646788,-11353212,4.654312
297814,Jasper Redd: Jazz Talk,2014-03-15,2014,0,0,0,0.029434
297835,The Loretta Claiborne Story,2000-01-16,2000,0,0,0,0.00118
297850,Heat Wave,1990-08-13,1990,0,0,0,0.07614
297853,Turn of Faith,2002-06-05,2002,0,0,0,0.012656
297859,Drone,2014-04-10,2014,0,0,0,1.35076
297865,La Santa Muerte,2007-09-28,2007,0,0,0,0.074158
297948,Bienvenido Paisano,2006-04-28,2006,0,0,0,0.00353
297956,Dansen op de vulkaan,2014-10-30,2014,0,0,0,0.274267
297961,Big Driver,2014-10-18,2014,0,0,0,9.403638
297983,On the Rumba River,2007-09-01,2007,0,0,0,0.005674
298026,Reaper,2015-06-05,2015,0,0,0,1.753718
298028,The Prey,2016-12-25,2016,0,0,0,0.693029
298032,VANish,2015-02-24,2015,0,0,0,7.862361
298040,Gods,2014-10-10,2014,2000000,0,-2000000,2.445081
298077,Ambition,2014-10-24,2014,0,0,0,1.92006
298078,Ruined Heart: Another Love Story Between A Criminal & A Whore,2014-10-24,2014,0,0,0,0.782841
298093,Poker Night,2014-12-20,2014,0,0,0,3.672557
298158,By Dawn's Early Light,2001-04-15,2001,0,0,0,0.062423
298165,He Took His Skin Off for Me,2014-10-18,2014,0,0,0,1.03593
298207,Der kleine Nazi,2010-11-18,2010,0,0,0,0.182403
298228,Peter Rottentail,2004-06-29,2004,0,0,0,0.040075
298296,Heidi,2014-09-08,2014,0,0,0,0.784375
298312,The Visit,2015-09-10,2015,5000000,98450062,93450062,15.021058
298317,My Boyfriends' Dogs,2014-10-18,2014,0,0,0,1.628644
298382,The Dressmaker,2015-10-01,2015,11930000,18340000,6410000,7.95686
298396,Los Flamencos,2013-09-07,2013,0,0,0,0.693155
298432,Freeway: Crack in the System,2014-10-24,2014,0,0,0,0.135776
298445,I Am Santa Claus,2014-11-04,2014,0,0,0,1.734826
298459,Next Time I'll Aim for the Heart,2014-11-12,2014,5100000,0,-5100000,8.323292
298522,Wyatt Cenac: Brooklyn,2014-10-21,2014,0,0,0,0.461053
298533,Corner Gas: The Movie,2014-12-03,2014,8500000,0,-8500000,0.994222
298538,Disaster L.A.: The Last Zombie Apocalypse Begins Here,2014-09-16,2014,0,0,0,1.320585
298540,Cru,2014-06-21,2014,0,0,0,1.276517
298582,Full Out,2015-09-11,2015,1500000,0,-1500000,2.607667
298583,All Roads Lead to Rome,2016-01-14,2016,0,0,0,9.57783
298584,Cabin Fever,2016-02-12,2016,0,0,0,4.931373
298609,Hollows Grove,2014-10-21,2014,0,0,0,0.800372
298614,Do Not Disturb,2014-12-31,2014,0,0,0,5.756279
298634,One Little Pill,2014-10-01,2014,0,0,0,0.415124
298653,Berkshire County,2014-10-05,2014,0,0,0,2.620536
298662,A Visit with Truman Capote,1966-01-01,1966,0,0,0,0.084996
298664,Magician: The Astonishing Life and Work of Orson Welles,2014-12-12,2014,0,0,0,0.995184
298695,Act of God,2009-01-01,2009,0,0,0,0.077309
298721,Cemetery of Splendour,2015-09-02,2015,980000,0,-980000,2.535419
298721,Cemetery of Splendour,2015-09-02,2015,980000,0,-980000,2.535419
298722,Soap Opera,2014-10-23,2014,0,0,0,2.012232
298729,Do You See Me?,2014-11-20,2014,0,0,0,4.265142
298751,Growing Up and Other Lies,2014-04-26,2014,0,0,0,0.521774
298787,3 A.M,2014-09-26,2014,0,0,0,0.353854
298830,The Dorm,2014-10-26,2014,0,0,0,0.451724
298844,Alone With People,2014-07-18,2014,0,0,0,0.050589
298865,Lost After Dark,2014-09-19,2014,0,0,0,2.173072
298869,Bag Man,2014-09-10,2014,0,0,0,0.49763
298920,Ghost Planes and the Mysteries of Flight 370,2014-08-09,2014,0,0,0,0.06329
298923,Roar,2014-10-31,2014,0,0,0,1.046235
298931,Billy Elliot: The Musical,2014-09-28,2014,0,0,0,1.956774
298935,All Relative,2014-11-21,2014,0,0,0,0.760099
298986,Greenery Will Bloom Again,2014-11-06,2014,0,0,0,0.549559
299001,Lucifer,2014-10-22,2014,0,0,0,0.440012
299049,Bey Yaar,2014-08-29,2014,0,0,0,0.333635
299104,Port of Flowers,1943-07-29,1943,0,0,0,0.12133
299121,Train Ride to Hollywood,1975-10-01,1975,0,0,0,0.004393
299143,The Gate of Heaven,1945-02-16,1945,0,0,0,0.04013
299145,Stranded,2015-06-05,2015,0,0,0,5.18104
299165,Nunca en horas de clase,1978-11-03,1978,0,495861,495861,0.2815
299203,Judgement Day,1983-01-01,1983,0,0,0,1e-06
299221,Phantom Halo,2015-06-19,2015,0,0,0,1.366876
299245,The Gallows,2015-07-10,2015,100000,42664410,42564410,7.51505
299269,Androids Dream,2014-11-08,2014,0,0,0,0.32864
299309,The Last Patrol,2014-10-23,2014,0,0,0,0.056837
299313,Building the Inferno: Nobuo Nakagawa and the Making of 'Jigoku',2006-09-19,2006,0,0,0,0.004942
299353,About a Girl,2015-08-06,2015,0,0,0,1.159873
299359,The Cabining,2014-05-03,2014,0,0,0,0.232337
299400,Santa Claws,2014-11-04,2014,0,0,0,0.500485
299511,Steak (R)√©volution,2014-11-05,2014,0,0,0,0.473593
299513,Drumline: A New Beat,2014-10-27,2014,0,0,0,1.439209
299551,The Atticus Institute,2015-01-20,2015,0,0,0,4.551561
299553,Shark Lake,2015-10-02,2015,2000000,0,-2000000,1.699695
299574,One Starry Christmas,2014-11-01,2014,0,0,0,0.423509
299576,The Nine Lives of Christmas,2014-11-08,2014,0,0,0,2.821398
299578,A Cookie Cutter Christmas,2014-11-09,2014,0,0,0,0.819949
299579,Northpole,2014-11-15,2014,0,0,0,1.65579
299582,A Royal Christmas,2014-11-21,2014,0,0,0,2.236319
299585,Mr. Miracle,2014-12-06,2014,0,0,0,0.432326
299588,Christmas at Cartwright's,2014-12-07,2014,0,0,0,7.295144
299590,Best Christmas Party Ever,2014-12-13,2014,0,0,0,0.995562
299618,Fugly!,2014-11-05,2014,0,0,0,4.149553
299641,Jimmy Vestvood: Amerikan Hero,2016-03-13,2016,2500000,230069,-2269931,1.216497
299687,The 5th Wave,2016-01-14,2016,38000000,109906372,71906372,10.788263
299715,All About Them,2015-03-25,2015,0,0,0,7.994028
299729,Banksy Does New York,2014-11-17,2014,0,0,0,1.729753
299730,The Dead the Damned and the Darkness,2014-10-07,2014,0,0,0,0.599813
299751,"Jia Zhangke, A Guy from Fenyang",2014-10-20,2014,0,0,0,0.157448
299780,Dough,2015-04-14,2015,0,0,0,1.688982
299782,The Other Side of the Wind,2018-12-31,2018,12000000,0,-12000000,0.238154
299796,The Photographer,2014-09-17,2014,0,0,0,0.229246
299822,Zhongkui: Snow Girl and the Dark Crystal,2015-02-19,2015,32000000,0,-32000000,2.269432
299824,Mojin: The Lost Legend,2015-12-18,2015,37000000,278300000,241300000,4.209701
299828,Women Who Flirt,2014-11-28,2014,0,0,0,0.612352
299851,Sem Pena,2014-10-02,2014,0,0,0,0.073123
299856,The Ball,1999-10-14,1999,0,0,0,0.001683
299909,Bella Vita,2014-09-16,2014,0,0,0,0.052588
299939,Debug,2014-11-03,2014,0,0,0,2.30671
299969,"Marvel: 75 Years, From Pulp to Pop!",2014-11-04,2014,0,0,0,6.729792
300090,White Rabbit,2013-09-20,2013,2000000,0,-2000000,1.947005
300153,Life,2015-07-24,2015,12000000,0,-12000000,11.256619
300155,A Royal Night Out,2015-05-14,2015,0,228136,228136,4.060966
300168,Dragon Blade,2015-02-19,2015,65000000,121545703,56545703,5.462048
300176,Joanna,2013-06-28,2013,0,0,0,0.095886
300179,The Lion‚Äôs Mouth Opens,2014-01-18,2014,0,0,0,1.242084
300187,One Christmas Eve,2014-11-30,2014,0,0,0,1.091679
300210,Route 181: Fragments of a Journey in Palestine-Israel,2004-05-06,2004,0,0,0,0.040498
300302,Comedy Central Roast of James Franco,2013-09-02,2013,0,0,0,4.58277
300321,RWD,2015-09-26,2015,0,0,0,0.344337
300364,Sailing to Paradise,2014-09-01,2014,0,0,0,0.086036
300402,Road to Kabul,2012-04-05,2012,0,0,0,0.049862
300403,Shana: The Wolf's Music,2014-08-17,2014,0,0,0,0.654077
300424,LEGO DC Comics Super Heroes: Batman: Be-Leaguered,2014-10-27,2014,0,0,0,1.774731
300433,The Con Artists,2014-12-24,2014,0,0,0,2.200564
300438,All My Lenins,1997-10-02,1997,0,0,0,0.33279
300441,Grumpy Cat's Worst Christmas Ever,2014-11-29,2014,0,0,0,9.565376
300455,Absent Minded,2013-01-01,2013,0,0,0,0.173264
300467,Dark Was the Night,2014-10-17,2014,0,0,0,5.168382
300487,The Swedish Moment,2014-11-07,2014,495000,0,-495000,0.055159
300490,Unutursam Fƒ±sƒ±lda,2014-10-29,2014,0,0,0,1.012721
300532,Unabomber: The True Story,1996-09-11,1996,0,0,0,0.41938
300542,Queen of Earth,2015-08-26,2015,0,0,0,3.634485
300544,Thru the Wire,1987-01-01,1987,0,0,0,0.012236
300596,Sidetracked,2015-01-30,2015,0,0,0,1.235675
300600,RISE,2014-11-06,2014,446000,0,-446000,0.701289
300601,It's Now or Never,2015-06-19,2015,0,0,0,5.104004
300602,Capture the Flag,2015-08-28,2015,14000000,8306690,-5693310,6.345679
300605,City of God ‚Äì 10 Years Later,2013-10-05,2013,0,0,0,1.270588
300654,Wildlike,2014-09-25,2014,0,0,0,10.754914
300665,Leatherface,2017-09-14,2017,0,0,0,9.742082
300666,Bravetown,2015-05-08,2015,0,0,0,8.378022
300667,3 Generations,2016-02-11,2016,5000000,443962,-4556038,4.626438
300669,Don't Breathe,2016-08-25,2016,9900000,157100845,147200845,25.869883
300671,13 Hours: The Secret Soldiers of Benghazi,2016-01-13,2016,50000000,69411370,19411370,18.022579
300672,Vincent N Roxxy,2016-04-18,2016,5000000,0,-5000000,6.871869
300673,The Finest Hours,2016-01-25,2016,80000000,52099090,-27900910,10.385757
300685,Jeff Dunham: All Over the Map,2014-11-18,2014,0,0,0,0.832848
300686,Chloe and Theo,2015-04-15,2015,0,0,0,2.775514
300690,Lily & Kat,2015-03-20,2015,0,0,0,0.606691
300693,Truth,2015-09-12,2015,9600000,2541554,-7058446,6.133745
300706,Let's Kill Ward's Wife,2014-12-23,2014,5000000,0,-5000000,10.224446
300761,Kobe Bryant's Muse,2015-02-28,2015,0,0,0,0.505821
300762,Red Dot on the Ocean,2014-10-24,2014,0,0,0,0.018431
300769,Enchantment,1921-10-29,1921,0,0,0,0.095193
300792,Racing Extinction,2015-01-24,2015,0,0,0,3.003456
300803,Dragonheart 3: The Sorcerer's Curse,2015-02-24,2015,0,0,0,11.633592
300816,Mama's Dirty Girls,1974-08-17,1974,0,0,0,0.036152
300839,Nobody from Nowhere,2014-11-19,2014,0,0,0,3.836441
300900,Ardennes Fury,2014-11-11,2014,0,0,0,1.574415
300940,Tungsten,2011-11-24,2011,0,0,0,0.156187
300945,ŒùœåŒºŒøœÇ 4000,1962-05-05,1962,0,0,0,0.051855
300949,The Man with the Carnation,1980-11-23,1980,0,0,0,0.000177
300983,Yennai Arindhaal,2015-02-06,2015,7900000,16000000,8100000,0.86433
301016,Sunstroke,2014-10-04,2014,21000000,0,-21000000,0.528909
301056,Enchanted Kingdom,2014-03-25,2014,18,0,-18,1.145184
301224,54 Days,2014-11-16,2014,0,0,0,0.068147
301225,Standby,2014-11-14,2014,0,0,0,5.136007
301228,Narcopolis,2015-09-25,2015,1500000,0,-1500000,3.256531
301229,Muffin Top: A Love Story,2014-10-18,2014,1100000,0,-1100000,0.652875
301233,Terrified,1995-01-13,1995,0,0,0,1.011702
301270,Œ§Œø Œ≥Œ¨ŒªŒ±,2012-10-10,2012,0,0,0,0.062588
301272,Andiamo a quel paese,2014-11-06,2014,0,0,0,3.786727
301304,Doug Benson: Doug Dynasty,2014-11-06,2014,0,0,0,0.054358
301325,#Horror,2015-11-20,2015,1500000,0,-1500000,2.451342
301334,Una,2016-09-14,2016,0,23275,23275,8.312298
301339,Coming Through The Rye,2016-10-13,2016,0,0,0,0.568526
301348,Elvis & Nixon,2016-04-22,2016,0,1055287,1055287,5.966121
301351,We Are Your Friends,2015-08-26,2015,6000000,11122090,5122090,9.023686
301365,The Neon Demon,2016-06-08,2016,7000000,1333124,-5666876,13.410522
301368,Spilt Milk,2011-04-10,2011,0,0,0,0.217393
301372,Voice from the Stone,2017-04-28,2017,0,0,0,5.91121
301491,The Hurdy-Gurdy,1955-11-12,1955,0,0,0,0.212727
301494,I arhontissa ki o alitis,1968-11-07,1968,0,0,0,0.07707
301566,Too Many Cooks,2014-10-27,2014,0,0,0,1.272698
301608,The Trust,2016-04-29,2016,9000000,0,-9000000,7.55939
301629,Addicted to Fresno,2015-09-01,2015,0,0,0,1.732968
301671,Devil's Domain,1990-04-13,1990,0,0,0,7.3e-05
301687,Tango Charlie,2005-03-25,2005,0,0,0,0.079571
301728,Infini,2015-05-08,2015,0,0,0,12.592801
301729,Terminus,2015-01-30,2015,0,0,0,3.377218
301730,Turkey Shoot,2014-12-04,2014,3200000,0,-3200000,1.660383
301744,Bloodsuckers,1991-01-01,1991,0,0,0,0.002723
301748,The Opposite Sex,2014-11-08,2014,3300000,45000,-3255000,3.436499
301804,Before I Wake,2016-04-07,2016,0,3295624,3295624,9.449103
301816,Christmas Icetastrophe,2014-12-20,2014,0,0,0,2.008878
301846,Howl,2015-10-01,2015,0,0,0,6.844863
301849,Blowfly Park,2014-11-28,2014,0,0,0,0.774073
301875,Equals,2015-07-15,2015,16000000,2084628,-13915372,19.803969
301876,30 Years to Life,1998-01-01,1998,0,0,0,0.039591
301883,The Trans-Atlantic Mystery,1932-08-31,1932,0,0,0,0.012305
302026,Garm Wars: The Last Druid,2014-10-24,2014,0,0,0,2.299266
302036,Beyond,2014-04-25,2014,0,0,0,0.415365
302042,Dead on Campus,2014-11-10,2014,1500000,0,-1500000,1.682861
302104,That Thing Called Tadhana,2014-11-09,2014,0,0,0,0.453131
302118,Quatsch und die Nasenb√§rbande,2014-10-13,2014,0,0,0,0.067739
302150,The Hunter's Prayer,2017-06-08,2017,17000000,0,-17000000,12.396344
302156,Criminal,2016-04-14,2016,31500000,14708696,-16791304,10.038581
302161,A Field Full of Secrets,2014-12-02,2014,0,0,0,0.074358
302323,Manhattan Romance,2015-10-02,2015,0,0,0,2.017695
302348,Allies,2014-11-01,2014,0,0,0,5.069033
302349,Iron Sky: The Coming Race,2018-03-01,2018,18000000,0,-18000000,1.917649
302376,We Are Young. We Are Strong.,2014-10-21,2014,0,0,0,1.345495
302401,Snowden,2016-09-15,2016,40000000,37279439,-2720561,14.384554
302429,Strange Magic,2015-01-23,2015,0,13603453,13603453,10.192407
302435,Ashi Hi Banwa Banwi,1988-01-01,1988,0,0,0,0.124208
302436,The Snow Maiden,1968-10-12,1968,0,0,0,0.595183
302465,Brothers on the Line,2012-03-08,2012,0,0,0,0.010453
302472,Dhadakebaaz,1990-01-01,1990,0,0,0,1.1e-05
302496,Beautiful Girl,2014-11-25,2014,3000000,0,-3000000,0.708378
302502,Pervert Park,2014-11-06,2014,0,0,0,0.739378
302508,Emmanuelle 2000: Emmanuelle's Intimate Encounters,2000-11-11,2000,0,0,0,0.19188
302528,Remember,2015-10-23,2015,0,1986615,1986615,10.200553
302579,Naturally Native,1999-10-08,1999,700000,10508,-689492,0.101618
302666,10.0 Earthquake,2014-10-15,2014,0,0,0,1.581577
302688,My Big Fat Greek Wedding 2,2016-03-23,2016,18000000,88923251,70923251,6.344961
302699,Central Intelligence,2016-06-15,2016,50000000,216972543,166972543,11.374041
302721,Operation Dalmatian: The Big Adventure,1997-01-01,1997,0,0,0,0.101382
302797,Encounters,2015-10-30,2015,0,0,0,1.711247
302802,Tre tocchi,2014-11-13,2014,0,0,0,0.38436
302818,"Poverty, Inc.",2014-07-10,2014,0,0,0,0.106243
302828,Against the Sun,2014-11-22,2014,0,0,0,7.937835
302946,The Accountant,2016-10-14,2016,44000000,155160045,111160045,13.465656
302960,Scooby-Doo! Moon Monster Madness,2015-02-17,2015,0,0,0,1.437302
303281,Happy Ending,2014-11-21,2014,0,0,0,1.02066
303296,M for Mother,2006-10-24,2006,0,0,0,0.041642
303360,Queen of Carthage,2015-09-01,2015,0,0,0,0.104978
303398,Jaal: The Trap,2003-07-18,2003,0,0,0,0.359771
303457,Chaar Sahibzaade,2014-11-06,2014,0,0,0,0.222695
303483,Les H√©ritiers,2014-12-03,2014,0,0,0,4.465918
303484,Paradigm,1969-11-15,1969,0,0,0,0.00273
303497,Unfair!,1970-11-15,1970,0,0,0,0.087186
303542,The Invisible Boy,2014-12-18,2014,8000000,0,-8000000,4.349915
303623,Hello Ladies: The Movie,2014-11-22,2014,0,0,0,2.957017
303636,Young Sophie Bell,2015-01-23,2015,0,0,0,0.128815
303665,Journey to Le Mans,2014-10-23,2014,0,0,0,3.423001
303680,No Touching At All,2014-05-31,2014,0,0,0,0.456456
303693,Inside,1996-08-25,1996,0,0,0,0.064513
303742,Trailer Park Boys: Live at the North Pole,2014-11-15,2014,0,0,0,1.43617
303835,Sex and Broadcasting,2014-11-15,2014,0,0,0,0.0568
303856,The Presence,2014-10-31,2014,40000,0,-40000,0.67191
303857,Dragon Ball Z: Resurrection 'F',2015-04-18,2015,5000000,61768190,56768190,11.350372
303858,Money Monster,2016-05-12,2016,27000000,93282604,66282604,11.953822
303867,World of Tomorrow,2015-03-31,2015,0,0,0,5.223297
303903,Pok√©mon the Movie: Diancie and the Cocoon of Destruction,2014-07-19,2014,24720400,0,-24720400,3.662458
303966,Black Magic,1977-01-01,1977,0,0,0,6e-05
303982,Vai Que Cola - O Filme,2015-10-01,2015,0,0,0,2.792306
303991,Demolition,2016-04-06,2016,10000000,1978592,-8021408,6.925667
304023,Rakuen Tsuihou - Expelled from Paradise,2014-11-15,2014,0,0,0,1.755072
304030,Olmo & the Seagull,2015-11-05,2015,0,0,0,0.509817
304126,My Internship in Canada,2015-10-02,2015,0,0,0,0.440445
304134,Zapatlela 2,2013-06-07,2013,0,0,0,0.011057
304274,Lai Bhaari,2014-07-11,2014,0,0,0,0.375197
304336,Lap Dance,2014-12-05,2014,0,0,0,3.66256
304357,Woman in Gold,2015-04-10,2015,11000000,61619773,50619773,11.61
304372,The Perfect Guy,2015-09-11,2015,12000000,60273173,48273173,7.607052
304375,"Good-bye, My Lady",1956-05-12,1956,0,0,0,1.037593
304410,The B√©lier Family,2014-12-17,2014,11000000,0,-11000000,7.943506
304613,Charlie's Farm,2014-12-04,2014,3000000,0,-3000000,4.262502
304640,Das Ende der Geduld,2014-11-19,2014,0,0,0,0.459386
304701,Haathi Mere Saathi,1971-05-01,1971,0,0,0,0.074215
304755,Khiladi 420,2000-12-29,2000,0,0,0,0.149783
304850,Hard Sun,2014-11-21,2014,0,0,0,0.056186
304869,Emergency Exit,2014-07-15,2014,0,0,0,0.015625
304878,From Caligari to Hitler: German Cinema in the Age of the Masses,2015-05-28,2015,0,0,0,1.306323
305019,Campaign of Hate: Russia and Gay Propaganda,2014-06-22,2014,0,0,0,0.050591
305022,Exile Nation: The Plastic People,2014-10-31,2014,0,0,0,0.060879
305044,Freetown,2015-04-08,2015,0,0,0,0.749717
305088,For Love or Money,2014-11-07,2014,0,5600000,5600000,0.383008
305091,That Sugar Film,2014-07-31,2014,0,0,0,3.676626
305127,The Frame,2014-11-21,2014,0,0,0,1.199515
305147,A Wolf from Vesyegonsk,2004-08-26,2004,0,0,0,0.061158
305198,Al Capone: Icon,2014-07-22,2014,0,0,0,0.071084
305276,Tell,2014-12-04,2014,0,0,0,1.924119
305309,Redemption Trail,2013-10-06,2013,0,0,0,0.0633
305310,Mr. Civil Rights: Thurgood Marshall and the NAACP,2014-10-01,2014,0,0,0,0.016471
305337,Pyaar Koi Khel Nahin,1999-07-23,1999,0,0,0,0.036541
305342,Dean,2017-06-02,2017,0,0,0,1.807007
305450,A Fight for,2014-09-16,2014,0,0,0,0.093386
305455,Santa Claus,2014-12-04,2014,0,0,0,2.803446
305470,Power Rangers,2017-03-23,2017,100000000,142337240,42337240,23.247298
305594,Elizabeth Ekadashi,2014-11-14,2014,0,0,0,0.031261
305638,The Shamer's Daughter,2015-03-26,2015,7500000,0,-7500000,7.169599
305642,Ithaca,2015-10-29,2015,5000000,0,-5000000,3.820453
305656,Lakota Woman: Siege at Wounded Knee,1994-10-16,1994,0,0,0,0.821303
305747,Hoovey,2015-01-31,2015,2,0,-2,1.259813
305815,Fe,1994-01-01,1994,0,0,0,0.03725
305819,Yeh Raaste Hain Pyaar Ke,2001-08-10,2001,0,0,0,0.039454
305899,Sapoot,1996-11-08,1996,0,0,0,0.052297
305932,Expelled,2014-12-12,2014,0,0,0,9.323591
305943,A Kind of Murder,2016-12-16,2016,0,0,0,9.453
305956,Lost Songs: The Basement Tapes Continued,2014-11-21,2014,0,0,0,0.682102
305969,Forever's End,2013-06-07,2013,0,0,0,0.446525
306060,Richard Pryor: Icon,2014-11-23,2014,0,0,0,0.931437
306197,Unexpected,2015-07-24,2015,0,0,0,4.135614
306199,Joe Rogan: Rocky Mountain High,2014-11-21,2014,0,0,0,0.085771
306207,Christmas on Salvation Street,2014-11-11,2014,0,0,0,0.088235
306218,Keith Lowell Jensen: Atheist Christmas,2014-11-25,2014,0,0,0,0.024143
306293,Zero,2012-06-01,2012,0,0,0,0.046416
306323,Homesick,2005-09-12,2005,0,0,0,0.113661
306383,Gajakessari,2014-05-23,2014,0,0,0,0.072047
306391,Be Dune Saade Char,2009-01-01,2009,0,0,0,0.064459
306406,Gaiir,2009-11-06,2009,0,0,0,0.005882
306411,Hee Porgi Kunachi,2006-04-14,2006,0,0,0,0.00353
306464,Family Guy Presents: Seth and Alex's almost live comedy show,2009-11-08,2009,0,0,0,0.285174
306482,Partisan,2015-01-25,2015,0,0,0,3.239485
306523,Ogni maledetto Natale,2014-11-27,2014,0,0,0,2.328465
306543,Homies,2015-01-22,2015,0,0,0,0.487434
306547,Son of Mine,2015-01-29,2015,0,0,0,0.686589
306555,Mio pap√†,2014-11-27,2014,0,0,0,0.676182
306598,"My Love, Don't Cross That River",2014-11-27,2014,0,0,0,0.444564
306650,Kajaki,2014-11-12,2014,0,0,0,5.557227
306745,Freeheld,2015-10-02,2015,7000000,573335,-6426665,4.955317
306758,Somewhere Only We Know,2015-02-14,2015,0,0,0,1.330643
306819,The Danish Girl,2015-11-27,2015,15000000,64191523,49191523,11.245661
306825,Deadly Daycare,2014-10-24,2014,0,0,0,0.334359
306838,Magallanes,2015-08-20,2015,0,0,0,0.398179
306943,The Outcasts,2017-04-14,2017,0,0,0,10.591249
306947,The Invitation,2015-08-05,2015,0,231737,231737,9.248388
306952,Naomi and Ely's No Kiss List,2015-09-18,2015,0,0,0,6.347034
306963,Wanderers,2014-10-11,2014,0,0,0,1.621875
306964,Tales of Halloween,2015-10-16,2015,0,0,0,5.784778
306966,Summer Camp,2016-05-13,2016,0,0,0,2.171869
306969,Dark Summer,2015-01-09,2015,0,0,0,1.393417
307020,Tarzan Rƒ±fkƒ±,1986-03-12,1986,0,0,0,0.00022
307081,Southpaw,2015-06-15,2015,30000000,91709827,61709827,12.370126
307087,The Ghost and the Whale,2016-05-17,2016,0,0,0,0.055054
307103,Serial Killer 1,2015-01-07,2015,5290000,0,-5290000,5.127658
307113,Presidentintekij√§t,2014-03-14,2014,200000,0,-200000,0.014121
307114,To Encourage the Others,1972-03-27,1972,0,0,0,0.311614
307127,Daughters of Dolma,2013-11-21,2013,0,0,0,0.018143
307256,Jon Richardson Live: Nidiot,2014-12-01,2014,0,0,0,0.040376
307261,Cowboy in Sweden,1970-01-01,1970,0,0,0,2e-06
307276,2,2007-12-11,2007,0,0,0,0.003748
307293,G√∂tz von Berlichingen,2014-12-04,2014,0,0,0,1.071695
307318,Stephen Fry Live: More Fool Me,2014-11-01,2014,0,0,0,0.088605
307479,88,2015-01-06,2015,0,0,0,7.073602
307510,Children of God: Lost and Found,2007-01-01,2007,0,0,0,0.038824
307649,Likes or Dislikes,2014-12-04,2014,0,0,0,0.640962
307663,Vice,2015-01-16,2015,10000000,0,-10000000,19.236571
307696,Coda,2013-07-13,2013,0,0,0,1.377141
307930,The Paedophile Hunter,2014-10-01,2014,0,0,0,0.122378
307931,The Wolfpack,2015-06-12,2015,0,1301696,1301696,5.416273
307946,I Smile Back,2015-10-23,2015,0,0,0,4.680849
308017,Silent Retreat,2016-01-12,2016,0,0,0,0.61582
308024,The Overnight,2015-06-19,2015,0,1100000,1100000,7.834161
308027,"People, Places, Things",2015-08-14,2015,0,0,0,3.094082
308032,The Stanford Prison Experiment,2015-07-17,2015,0,643557,643557,4.833182
308063,The Visit: An Alien Encounter,2015-01-26,2015,0,0,0,0.56447
308077,Nasty Baby,2015-02-08,2015,0,0,0,2.422713
308084,Tangerine,2015-07-10,2015,100000,702354,602354,4.832631
308160,The Master Plan,2015-01-16,2015,3500000,0,-3500000,1.849762
308165,Action Jackson,2014-12-05,2014,0,0,0,0.914507
308174,3 T√ºrken und ein Baby,2015-01-22,2015,0,0,0,1.497333
308266,War Dogs,2016-08-17,2016,40000000,86234523,46234523,16.453573
308269,"Gore, Quebec",2014-10-14,2014,7000,0,-7000,0.032138
308361,"Stockholm, Pennsylvania",2015-01-22,2015,0,0,0,6.173635
308369,Me and Earl and the Dying Girl,2015-06-12,2015,0,0,0,12.503333
308409,The Commune,2016-01-14,2016,0,0,0,5.566138
308418,Eat with Me,2014-12-05,2014,0,0,0,1.432327
308423,Bonobo,2014-12-05,2014,0,0,0,0.42662
308447,The Flintstones & WWE: Stone Age Smackdown,2015-03-17,2015,0,0,0,2.590491
308453,The Bronze,2016-01-22,2016,3500000,615816,-2884184,5.353826
308457,Advantageous,2015-06-23,2015,0,0,0,3.436595
308504,Last Knights,2015-04-03,2015,0,3643591,3643591,14.619519
308529,Kickboxer: Vengeance,2016-07-14,2016,17000000,0,-17000000,6.966654
308531,Teenage Mutant Ninja Turtles: Out of the Shadows,2016-06-01,2016,135000000,245623848,110623848,13.047776
308557,SEVILLA ‚Üí (‚àû) 06,2006-01-01,2006,0,0,0,0.00353
308571,Bill Burr: I'm Sorry You Feel That Way,2014-12-05,2014,0,0,0,1.123035
308638,The D Train,2015-05-08,2015,447524,771317,323793,3.993759
308639,Dope,2015-06-19,2015,700000,17986781,17286781,7.948581
308640,Songs My Brothers Taught Me,2015-01-27,2015,0,0,0,0.924161
308671,"Meine Frau, meine Freunde und ich",2004-06-27,2004,0,0,0,0.004957
308674,Superpai,2015-02-27,2015,0,0,0,0.419322
308686,"Signed, Sealed, Delivered for Christmas",2014-11-23,2014,0,0,0,0.621576
308704,The Mysterious Death of P√©rola,2014-10-27,2014,0,0,0,0.363993
308715,Away and Back,2015-01-25,2015,0,0,0,1.690373
308792,A Justified Life: Sam Peckinpah and the High Country,2006-01-10,2006,0,0,0,0.00353
308794,The Christmas Tree,1991-02-02,1991,0,0,0,0.020664
308823,Uitgesloten,2001-03-12,2001,0,0,0,0.003275
308919,Wishin' and Hopin',2014-11-23,2014,0,0,0,0.937615
309018,Life Inside Out,2014-10-17,2014,0,0,0,0.238238
309024,Take Me to the River,2016-03-18,2016,0,0,0,1.327809
309028,Midnight Diner,2014-11-10,2014,0,0,0,2.094312
309049,We Still Kill the Old Way,2014-12-12,2014,0,0,0,3.135108
309063,The Ouija Experiment 2: Theatre of Death,2015-01-13,2015,0,0,0,1.642247
309242,Mississippi Grind,2015-07-04,2015,0,130541,130541,6.054981
309245,Mistress America,2015-08-14,2015,0,2500431,2500431,6.969947
309298,Don Verdean,2015-12-01,2015,0,31309,31309,2.789838
309299,Experimenter,2015-10-16,2015,0,0,0,5.112935
309302,Wolf Totem,2015-02-19,2015,38000000,123205624,85205624,6.542647
309304,Grandma,2015-06-04,2015,600000,7087452,6487452,4.565414
309410,Malta G.C.,1942-01-01,1942,0,0,0,0.001319
309425,Do You Believe?,2015-03-20,2015,0,0,0,3.722756
309503,Zipper,2015-08-28,2015,0,0,0,4.711535
309579,Prince Among Slaves,2008-02-04,2008,800000,0,-800000,0.010448
309581,Lila & Eve,2015-07-31,2015,0,0,0,7.283158
309739,8 New Dates,2015-01-01,2015,0,0,0,1.341288
309809,The Little Prince,2015-07-29,2015,64000000,97571250,33571250,11.376954
309811,Shadows on the Wall,2014-12-10,2014,0,0,0,0.463261
309820,Wild Rose,1932-04-11,1932,0,0,0,0.00181
309875,Micke & Veronica,2014-12-25,2014,0,0,0,0.401121
309879,Dark Signal,2016-05-30,2016,0,0,0,1.725255
309882,Patterns of Evidence: The Exodus,2015-01-14,2015,0,0,0,0.261811
309886,Blood Father,2016-08-11,2016,13000000,0,-13000000,7.146017
309887,Bad Asses on the Bayou,2015-03-06,2015,5300000,0,-5300000,4.743997
309889,The Culling,2015-03-15,2015,0,0,0,1.639984
309898,Breakfast on the Grass,1979-06-06,1979,0,0,0,0.33789
309919,The Curse of Downers Grove,2015-08-21,2015,2000000,0,-2000000,1.043799
309924,After the Ball,2015-02-27,2015,0,161820,161820,4.257785
309929,Soldat blanc,2014-09-08,2014,0,0,0,0.720986
309968,Twisted Seduction,2010-01-01,2010,0,0,0,0.01167
310001,Seoul Searching,2015-01-30,2015,0,0,0,0.339331
310119,Last Days in the Desert,2016-05-13,2016,0,0,0,6.641951
310121,I'll See You in My Dreams,2015-05-15,2015,0,7449681,7449681,4.958676
310123,Zid,2014-11-28,2014,1556288,1268395,-287893,0.195677
310126,"Il ricco, il povero e il maggiordomo",2014-12-11,2014,0,0,0,4.213349
310131,The Witch,2016-02-19,2016,3500000,40423945,36923945,11.840138
310133,Cop Car,2015-08-07,2015,0,134552,134552,11.070889
310135,Turbo Kid,2015-08-14,2015,0,0,0,16.304654
310137,Bound to Vengeance,2015-06-26,2015,0,0,0,4.393241
310307,The Founder,2016-11-24,2016,25000000,23964782,-1035218,17.523343
310319,Deli Man,2015-02-27,2015,0,0,0,0.277736
310417,Mending Fences,2009-06-18,2009,0,0,0,0.630262
310431,Stacy's Knights,1983-06-01,1983,0,0,0,1.7e-05
310442,The Lost Honour of Christopher Jefferies,2014-12-10,2014,0,0,0,1.13233
310458,Zabardast,2007-05-18,2007,0,0,0,0.00353
310491,Glassland,2015-04-17,2015,0,0,0,2.796273
310567,Umrika,2015-07-29,2015,0,0,0,1.392034
310568,The Summer of Sangaile,2015-03-29,2015,0,0,0,1.351097
310569,The Second Mother,2015-02-08,2015,0,0,0,5.458754
310589,Beyond the Fear,2014-12-02,2014,0,0,0,0.048432
310593,Youth,2015-05-20,2015,13360000,2000000,-11360000,8.717661
310602,Klown Forever,2015-09-24,2015,0,0,0,1.783179
310814,Julie & Jack,2003-01-01,2003,0,0,0,0.081995
310888,Southside with You,2016-08-26,2016,0,0,0,5.379834
310933,Bleeding Hearts,2013-06-01,2013,0,0,0,0.181289
310952,A Little Game,2014-04-26,2014,0,0,0,1.425007
310972,The Christmas Secret,2014-11-23,2014,0,0,0,1.468411
311021,The Uncommon Making of Petulia,2006-01-01,2006,0,0,0,0.003786
311093,A Christmas Kiss II,2014-12-13,2014,0,0,0,1.896928
311146,The Golden Cane Warrior,2014-12-18,2014,2000000,0,-2000000,0.947278
311181,A Novel Romance,2015-01-10,2015,0,0,0,2.597629
311215,Roles in the Wind,2015-01-08,2015,0,0,0,0.469509
311282,I Know a Woman Like That,2009-10-13,2009,0,0,0,0.025577
311291,45 Years,2015-08-28,2015,0,4250507,4250507,6.645078
311301,As We Were Dreaming,2015-02-10,2015,0,0,0,0.696905
311324,The Great Wall,2016-12-16,2016,150000000,331957105,181957105,15.884744
311417,Funny Farm,1975-02-27,1975,0,0,0,0.0002
311539,A Christmas Horror Story,2015-07-20,2015,0,0,0,6.848664
311585,Make Your Own Damn Movie,2005-01-01,2005,0,0,0,0.349976
311600,Questions for Crazy Horse,2010-01-01,2010,0,0,0,0.005882
311615,Smosh: The Movie,2015-07-24,2015,0,0,0,4.197684
311627,Pilot Error,2014-11-13,2014,0,0,0,0.023186
311667,Manhattan Night,2016-05-20,2016,0,0,0,11.139734
311764,Opening Night,2016-06-03,2016,0,0,0,2.917208
311770,My Skinny Sister,2015-01-25,2015,0,0,0,3.145054
311998,Film Noir: Bringing Darkness to Light,2006-07-18,2006,0,0,0,0.208295
312100,Elf: Buddy's Musical Christmas,2014-12-16,2014,0,0,0,2.05959
312101,Used Parts,2007-04-18,2007,0,0,0,0.276641
312113,Black November,2012-12-07,2012,12500000,0,-12500000,2.107069
312131,The Phoenix Project,2015-01-16,2015,0,0,0,0.525556
312137,Has the Film Already Started?,1951-01-01,1951,0,0,0,0.036798
312138,Les R√©volt√©s,2014-08-29,2014,0,0,0,0.230447
312149,Russell Brand: End the Drugs War,2014-12-17,2014,0,0,0,0.141361
312152,Chuck Norris vs Communism,2015-11-12,2015,0,0,0,0.957362
312167,Merry Ex-Mas,2014-12-05,2014,0,0,0,0.94378
312174,Unedited Footage of a Bear,2014-12-16,2014,0,0,0,0.202749
312221,Creed,2015-11-25,2015,37000000,173567581,136567581,33.449723
312316,The Elevator: Three Minutes Can Change Your Life,2013-01-30,2013,0,0,0,0.938642
312399,Toy Reanimator,2002-01-01,2002,60,0,-60,0.002385
312433,Children in the Surf at Coney Island,1904-12-18,1904,0,0,0,0.001247
312452,La Vague,1891-11-15,1891,0,0,0,0.173584
312497,Ascension,2014-12-15,2014,0,0,0,2.097331
312526,Alien Outpost,2014-09-19,2014,0,0,0,4.904615
312597,Jatra: Hyalagaad Re Tyalagaad,2006-01-01,2006,0,0,0,0.004957
312623,Living on Love,1937-11-12,1937,0,0,0,0.005656
312669,Maggie's Plan,2016-04-27,2016,0,3351735,3351735,6.068689
312791,GirlHouse,2014-10-16,2014,3150000,0,-3150000,14.386348
312793,The Walking Deceased,2015-03-20,2015,0,0,0,1.76195
312796,The Squeeze,2015-04-17,2015,0,0,0,0.816541
312797,The Barber,2015-03-27,2015,0,0,0,3.293362
312804,James White,2015-01-23,2015,0,0,0,3.227613
312813,6 Desires,2014-10-16,2014,0,0,0,0.123697
312827,The Nightmare,2015-06-05,2015,0,28281,28281,4.601867
312831,The Hallow,2015-11-06,2015,0,0,0,8.613908
312849,Ivy,2015-01-26,2015,0,0,0,1.092242
312940,The Mole at the Sea,2012-09-01,2012,0,0,0,0.011879
312963,Macropolis,2012-07-05,2012,0,0,0,0.025827
312993,The Masters of Suspense,2014-12-19,2014,0,0,0,0.094963
313074,Sword of Vengeance,2014-10-03,2014,0,0,0,3.146204
313108,Ode to My Father,2014-12-17,2014,0,0,0,1.005648
313179,American Justice,2015-06-16,2015,0,0,0,1.168247
313297,Kubo and the Two Strings,2016-08-18,2016,60000000,69929545,9929545,12.321832
313369,La La Land,2016-11-29,2016,30000000,445435700,415435700,19.681686
313371,All She Wishes,2015-01-15,2015,0,0,0,0.0962
313511,Largo,2008-02-01,2008,0,0,0,1.042338
313556,Six Degrees of Celebration 1914,2014-12-25,2014,0,0,0,1.361724
313628,Love Forecast,2015-01-15,2015,0,0,0,1.473808
313646,Mumbai Pune Mumbai,2010-06-11,2010,0,0,0,0.081157
313653,Rege,2014-08-15,2014,0,0,0,0.108772
313676,Waiting for Good News,2009-02-28,2009,0,0,0,0.310096
313788,Firequake,2014-12-22,2014,0,0,0,2.304605
313867,Roald Dahl's Esio Trot,2015-01-02,2015,0,0,0,2.485569
313896,"Von einem, der auszog, das F√ºrchten zu lernen",2014-11-13,2014,0,0,0,0.405308
313922,Green Room,2016-04-15,2016,5000000,3220371,-1779629,8.4702
313943,Revolt,2017-07-01,2017,0,0,0,8.442584
313972,"East, West, East: The Final Sprint",2009-11-14,2009,0,0,0,0.126566
313985,The West,1996-09-15,1996,0,0,0,0.001189
314011,The Beat Beneath My Feet,2014-09-25,2014,0,0,0,5.187104
314029,Neon Bull,2016-01-14,2016,1500000,0,-1500000,1.720755
314065,Altar,2014-12-27,2014,0,0,0,2.68043
314070,"Captain Video, Master of the Stratosphere",1951-12-27,1951,0,0,0,0.007987
314076,Short Fuse,2016-04-21,2016,0,0,0,0.141
314095,The Lost City of Z,2016-10-15,2016,30000000,8574339,-21425661,21.791111
314220,Chevalier,2015-11-26,2015,0,0,0,1.691618
314238,Plug,2014-10-25,2014,0,0,0,0.495194
314283,A Perfect Christmas List,2014-12-14,2014,0,0,0,0.605492
314285,Antboy: Revenge of the Red Fury,2014-12-25,2014,0,0,0,1.734211
314327,The Royal Tailor,2014-12-24,2014,0,0,0,0.476617
314352,Honeymoon,1996-04-11,1996,0,0,0,0.652621
314365,Spotlight,2015-11-06,2015,20000000,88346473,68346473,14.63239
314371,11 Minutes,2015-09-02,2015,2023012,0,-2023012,1.519861
314385,By the Sea,2015-11-12,2015,10000000,3727746,-6272254,12.61223
314388,Mountains May Depart,2015-12-23,2015,0,0,0,3.595572
314389,Baby,2015-01-23,2015,0,0,0,2.822923
314400,Blood of My Blood,2015-09-09,2015,0,0,0,1.10941
314402,Dheepan,2015-08-26,2015,0,248392,248392,5.752416
314404,Wondrous Boccaccio,2015-02-26,2015,0,0,0,2.689328
314405,Tale of Tales,2015-05-14,2015,12000000,0,-12000000,10.95023
314407,Cocaine Cowboys: Reloaded,2014-04-08,2014,0,0,0,0.871688
314420,Body,2015-01-25,2015,0,0,0,6.236714
314443,The Crow's Nest,2014-10-04,2014,0,0,0,0.016486
314462,Silsile,2014-03-07,2014,0,0,0,0.305421
314555,Melody,2014-08-23,2014,0,0,0,0.706014
314570,I Touched All Your Stuff,2014-07-04,2014,0,0,0,0.121863
314580,VeggieTales: Very Silly Songs,1997-01-01,1997,0,0,0,0.324885
314601,VeggieTales: The End of Silliness? More Really Silly Songs!,1998-01-01,1998,0,0,0,0.001829
314635,Schmitke,2014-10-05,2014,0,0,0,0.04335
314837,The Emperor in August,2015-08-08,2015,0,0,0,1.388744
314946,Three Heroes and Julius Caesar,2015-01-01,2015,0,0,0,0.922398
314952,What Men Do! 2,2015-01-01,2015,2000000,0,-2000000,1.48559
314996,Nanny Cam,2014-12-28,2014,0,0,0,1.789112
315010,Sense and Sensibility,2008-01-01,2008,0,0,0,1.724436
315011,Shin Godzilla,2016-07-29,2016,15000000,77000000,62000000,9.285519
315024,Jurassic City,2014-12-31,2014,0,0,0,1.606009
315044,"Eila, Rampe ja Likka",2014-12-26,2014,0,0,0,0.239708
315049,Adult Camp,2015-01-23,2015,0,0,0,0.143037
315055,Absolution,2015-02-27,2015,2000000,0,-2000000,0.648791
315057,Headfirst,2014-12-26,2014,0,0,0,0.071156
315112,Bright Night,2015-05-01,2015,0,0,0,0.725889
315134,Surprised by Love,2015-01-03,2015,0,0,0,0.912916
315196,Sanctuary,2015-06-18,2015,0,0,0,1.588444
315226,Lokmanya: Ek Yug Purush,2015-01-02,2015,0,0,0,0.101391
315252,Sneeuwwitje En De Zeven Kleine Mensen: Een Modern Sprookje,2015-01-01,2015,0,0,0,0.175813
315256,Terror,1981-06-19,1981,0,0,0,0.0
315319,We Accept Miracles,2015-01-02,2015,0,0,0,4.833239
315335,Frau M√ºller muss weg!,2015-01-15,2015,0,9127383,9127383,2.14431
315360,Beck 27 - Rum 302,2015-01-01,2015,0,0,0,0.566619
315362,Beck 28 - Familjen,2015-01-10,2015,0,0,0,0.956873
315367,Beck 30 - Sjukhusmorden,2015-03-28,2015,0,0,0,0.649984
315371,Human Target,1990-06-06,1990,0,0,0,0.000431
315417,Paradh,2010-08-17,2010,0,0,0,0.09182
315439,The Throne,2015-09-16,2015,0,0,0,1.122048
315465,The Boy and the Beast,2015-07-11,2015,0,490643,490643,6.900285
315467,Kubrick Remembered,2014-11-04,2014,0,0,0,0.23941
315509,Helios,2015-04-30,2015,25784494,0,-25784494,1.596675
315534,Amarillo By Morning,1998-01-16,1998,0,0,0,0.014839
315575,My Golden Days,2015-05-20,2015,0,269144,269144,2.64619
315620,Doctor Who: A Christmas Carol,2010-12-25,2010,0,0,0,2.906731
315623,"Doctor Who: The Doctor, the Widow and the Wardrobe",2011-12-25,2011,0,0,0,0.773867
315664,Florence Foster Jenkins,2016-05-06,2016,29000000,48902953,19902953,10.829116
315669,My Beloved Bodyguard,2016-04-01,2016,0,0,0,1.941475
315723,The Nostalgist,2014-06-19,2014,0,0,0,0.470585
315837,Ghost in the Shell,2017-03-29,2017,110000000,169801921,59801921,68.726676
315841,Ryuzo and the Seven Henchmen,2015-04-25,2015,0,0,0,0.823797
315846,Our Little Sister,2015-06-13,2015,0,346485,346485,4.7685
315850,Comedy Central Roast of Flavor Flav,2007-08-12,2007,0,0,0,1.491024
315855,The Forbidden Room,2015-10-07,2015,0,0,0,3.092455
315859,Muhammad: The Messenger of God,2015-02-09,2015,0,0,0,1.173732
315865,In the Shadow of Women,2015-05-14,2015,0,0,0,1.831295
315868,Cosmos,2015-12-03,2015,0,0,0,1.26037
315872,Mia Madre,2015-04-16,2015,0,0,0,8.120076
315880,The Correspondence,2016-01-14,2016,10000000,0,-10000000,5.004038
315882,Beaver Trilogy Part IV,2015-01-23,2015,0,0,0,0.132716
315893,Bitter Dream,2004-05-14,2004,0,0,0,0.073301
315946,Passage of Venus,1874-12-09,1874,0,0,0,0.480371
315955,Crazy Horse,1996-07-07,1996,0,0,0,0.290244
316000,Miles Ahead,2016-03-20,2016,0,3460466,3460466,3.989771
316002,Accidental Love,2015-02-10,2015,26000000,0,-26000000,5.213733
316003,After the Wall: A World United,2011-01-17,2011,0,0,0,0.007059
316015,My Life as a Dead Girl,2015-01-01,2015,0,0,0,0.767827
316021,Frank & Lola,2016-12-09,2016,0,9188,9188,3.805811
316023,Mike and Dave Need Wedding Dates,2016-07-07,2016,33000000,77068246,44068246,12.237571
316042,Hyena Road,2015-10-09,2015,0,0,0,5.620274
316067,Misery Loves Comedy,2015-01-23,2015,0,0,0,0.819352
316074,What's Between Us,2015-01-07,2015,0,0,0,0.19332
316098,Brother Minister: The Assassination of Malcolm X,1995-03-01,1995,0,0,0,0.0368
316111,Riuscir√† l'avvocato Franco Benenato a sconfiggere il suo acerrimo nemico il pretore Ciccio De Ingras?,1971-08-18,1971,0,0,0,0.000559
316152,Free State of Jones,2016-06-24,2016,50000000,25035950,-24964050,10.223582
316154,The Bad Batch,2017-06-23,2017,6000000,0,-6000000,78.8072
316170,Uomo e galantuomo,1975-12-26,1975,0,0,0,5.3e-05
316179,Tired Moonlight,2015-01-22,2015,0,0,0,0.409933
316183,What Other Couples Do,2013-01-01,2013,0,0,0,0.567979
316268,Lake Eerie,2016-01-15,2016,0,0,0,3.264722
316269,Calculator,2014-12-18,2014,2200000,0,-2200000,2.781177
316310,The Sky Above Us,2015-01-28,2015,0,0,0,0.117331
316322,Barbie in Princess Power,2015-01-29,2015,0,0,0,11.796151
316347,A Horse for Summer,2015-01-06,2015,0,0,0,0.453126
316410,Bound,2015-01-09,2015,0,0,0,1.75416
316437,Pairon Talle,2011-01-15,2011,0,0,0,0.059486
316491,Kiuleandra,1985-01-14,1985,0,0,0,0.403077
316603,Funeral Ceremonies,1969-01-01,1969,0,0,0,0.213909
316637,Atrocity,2014-01-01,2014,0,0,0,0.048302
316654,Bombay Velvet,2015-05-15,2015,18000000,1500000,-16500000,1.377993
316715,The Eichmann Show,2015-01-20,2015,0,0,0,3.785532
316727,The Purge: Election Year,2016-06-29,2016,10000000,118587880,108587880,13.1789
316761,Call Me Lucky,2015-08-07,2015,0,0,0,1.640786
316776,Who Killed Captain Alex?,2010-01-01,2010,200,0,-200,0.157292
316784,The Black Hole,2015-05-26,2015,800000,0,-800000,0.772555
316840,Bhoot Unkle,2006-10-06,2006,0,0,0,0.005157
316883,Above and Below,2015-01-22,2015,0,0,0,0.304429
316885,Bridgend,2015-01-22,2015,0,0,0,1.442316
317114,Bridal Wave,2015-01-24,2015,0,0,0,1.657305
317120,Cloudy With a Chance of Love,2015-02-14,2015,0,0,0,0.183365
317121,All of My Heart,2015-02-14,2015,0,0,0,3.911933
317144,Cyberbully,2015-01-15,2015,0,0,0,9.079974
317168,Santo vs. the She-Wolves,1976-05-13,1976,0,0,0,0.052935
317182,Doctor Who: Last Christmas,2014-12-25,2014,0,0,0,4.964132
317190,Doctor Who: The Next Doctor,2008-12-25,2008,0,0,0,3.229702
317198,Bad Hair Day,2015-02-13,2015,0,0,0,2.344304
317213,The Twin Girls of Sunset Street,2010-02-10,2010,0,0,0,0.214997
317214,From A to B,2015-01-08,2015,0,0,0,0.769127
317246,Bandidos,1991-08-09,1991,0,0,0,0.000578
317247,Confessor Caressor,1989-01-01,1989,0,0,0,0.000592
317260,For Singles Only,1968-06-05,1968,0,0,0,0.002866
317384,Li'l Quinquin,2014-09-18,2014,0,0,0,2.044591
317389,Simbad e il califfo di Bagdad,1973-07-22,1973,0,0,0,0.006352
317442,The Last: Naruto the Movie,2014-12-06,2014,0,0,0,5.294086
317557,Queen of Katwe,2016-09-23,2016,15000000,10367161,-4632839,6.164561
317560,Carrie Pilby,2017-03-31,2017,0,0,0,5.041182
317655,Being Evel,2015-01-23,2015,0,0,0,1.197099
317683,Password: Uccidete agente Gordon,1966-03-29,1966,0,0,0,0.006665
317720,"English, August",1994-09-16,1994,0,0,0,0.141795
317723,Transylvanian Garlic,2014-06-27,2014,0,0,0,0.355922
317736,Pani z przedszkola,2014-12-25,2014,0,0,0,0.171539
317744,Careful What You Wish For,2015-05-06,2015,8000000,0,-8000000,6.88876
317903,Archive 253,2015-02-05,2015,0,0,0,0.996435
317925,A la mala,2015-02-27,2015,0,0,0,1.854081
317930,Compadres,2016-03-31,2016,3000000,0,-3000000,0.968473
317938,You Will Know What to Do With Me,2016-05-27,2016,0,0,0,0.207
317952,Cartel Land,2015-07-03,2015,0,0,0,4.889765
317953,Spud 3: Learning to Fly,2014-12-16,2014,0,0,0,1.187815
317954,City of Gold,2016-03-11,2016,0,0,0,1.043523
317965,La Bionda,1993-03-12,1993,0,0,0,0.0
317981,Bloodsucking Bastards,2015-09-04,2015,0,0,0,2.730363
317988,Banana Pancakes and the Children of Sticky Rice,2015-01-22,2015,0,0,0,0.077118
318007,The Veil of Twilight,2014-10-10,2014,1131974,0,-1131974,0.698991
318033,Dreamcatcher,2015-03-27,2015,0,0,0,0.097257
318040,Bizarre,2015-02-07,2015,0,0,0,1.038659
318042,B-Movie: Lust & Sound in West-Berlin,2015-02-05,2015,0,0,0,1.22249
318044,"What Happened, Miss Simone?",2015-01-22,2015,0,0,0,4.507082
318052,The Man in the Wall,2015-01-22,2015,0,0,0,0.066944
318053,natural history,2014-09-26,2014,0,0,0,0.110399
318054,No Men Beyond This Point,2015-01-27,2015,0,0,0,0.602784
318121,The Fundamentals of Caring,2016-06-16,2016,0,0,0,6.138199
318177,Tarantella,1996-03-15,1996,0,0,0,0.001662
318184,Umbkotid,2012-01-11,2012,0,0,0,0.04752
318224,Going Clear: Scientology and the Prison of Belief,2015-01-25,2015,0,0,0,5.887113
318225,Tig,2015-04-23,2015,0,0,0,2.932138
318256,Hot Girls Wanted,2015-05-29,2015,0,0,0,5.352415
318277,Larry Kramer In Love & Anger,2015-06-29,2015,0,0,0,0.426831
318279,Meru,2015-01-25,2015,0,2334228,2334228,3.457153
318348,Reverse Runner,2013-02-21,2013,0,0,0,0.152742
318359,In Our Garden,2002-03-08,2002,0,0,0,0.002713
318373,Young Tiger,2015-01-14,2015,0,0,0,0.579716
318484,Qayamat: City Under Threat,2003-07-11,2003,0,0,0,0.055968
318535,The Mesmerist,2002-03-11,2002,0,0,0,0.006517
318553,Sugar Daddies,2014-12-23,2014,0,0,0,1.798216
318562,Gopi Kishan,1994-01-01,1994,0,0,0,0.036471
318781,Colonia,2016-02-18,2016,14000000,3621046,-10378954,10.156891
318794,Vehshi Jatt,1975-08-08,1975,0,0,0,0.0
318832,e-motion,2013-01-01,2013,0,0,0,0.345755
318846,The Big Short,2015-12-11,2015,28000000,133346506,105346506,13.143061
318850,The Young Messiah,2016-03-10,2016,18500000,6490401,-12009599,1.729199
318851,Confessions of Loving Couples,1967-02-16,1967,0,0,0,0.001346
318868,Out of Reach,2013-07-01,2013,0,0,0,0.476022
318914,The Grief of Others,2015-08-26,2015,0,0,0,0.495947
318917,Look Who's Back,2015-10-08,2015,3196621,25513752,22317131,6.704659
318922,Kill Your Friends,2015-11-06,2015,0,0,0,5.846711
318954,Beyond the Mask,2015-04-06,2015,0,1236094,1236094,2.43519
318972,(T)ERROR,2015-01-24,2015,0,0,0,0.990819
318973,Welcome to Leith,2015-09-09,2015,0,0,0,2.072847
319017,The Last Straight Man,2014-05-06,2014,0,0,0,1.263359
319067,Best of Enemies,2015-07-31,2015,1000000,0,-1000000,3.141893
319070,Drunk Stoned Brilliant Dead: The Story of the National Lampoon,2015-01-25,2015,0,0,0,1.61917
319071,Fresh Dressed,2015-06-26,2015,0,0,0,1.485347
319073,How To Change The World,2015-09-09,2015,0,0,0,1.127377
319074,In Football We Trust,2015-01-23,2015,0,0,0,0.079336
319075,Cobain: Montage of Heck,2015-03-23,2015,0,0,0,6.516131
319076,Listen to Me Marlon,2015-07-29,2015,0,0,0,2.554756
319078,Most Likely to Succeed,2015-01-01,2015,0,0,0,0.18307
319079,Prophet's Prey,2015-08-01,2015,0,0,0,1.348402
319089,The Black Panthers: Vanguard of the Revolution,2015-01-23,2015,0,0,0,0.778443
319090,The Chinese Mayor,2015-03-06,2015,0,0,0,0.292345
319091,The Hunting Ground,2015-02-27,2015,0,411115,411115,2.408677
319092,The Russian Woodpecker,2015-01-31,2015,0,0,0,0.681702
319093,Western,2015-09-25,2015,0,0,0,0.450096
319096,Whitney,2015-01-17,2015,0,0,0,8.048503
319152,Finders Keepers,2015-06-22,2015,0,0,0,1.001538
319167,Station to Station,2014-12-31,2014,0,0,0,0.54223
319179,Man van staal,1999-10-13,1999,0,0,0,0.036524
319188,Frankenstein vs. The Mummy,2015-02-10,2015,0,0,0,1.413782
319337,13 Minutes,2015-04-09,2015,0,147315,147315,4.969851
319340,I Kissed a Girl,2015-01-28,2015,0,0,0,10.415724
319341,Daddy or Mommy,2015-02-04,2015,0,0,0,8.307255
319352,The Birth of the Tramp,2013-12-29,2013,0,0,0,0.769287
319373,Sweet Bean,2015-05-30,2015,0,124518,124518,4.419952
319389,Lovesick,2014-04-24,2014,0,0,0,3.651781
319396,Zombieworld,2015-02-24,2015,0,0,0,1.64962
319513,Zurich,2015-02-19,2015,0,0,0,0.907234
319632,What Is a Man without a Moustache?,2005-07-23,2005,0,0,0,0.086354
319656,Don't Eat the Pictures: Sesame Street at the Metropolitan Museum of Art,1983-11-16,1983,0,0,0,0.000559
319669,Joker Game,2015-01-31,2015,0,0,0,0.987496
319851,Pictures from Life's Other Side,1971-01-01,1971,0,0,0,8e-06
319888,Eddie the Eagle,2016-02-26,2016,23000000,46152411,23152411,7.528276
319910,Broken Horses,2015-03-15,2015,0,0,0,12.971415
319920,Kartoos,1999-05-07,1999,0,0,0,0.160076
319924,Russell Madness,2015-02-21,2015,0,0,0,0.65691
319964,Famous Nathan,2015-07-17,2015,0,0,0,0.09425
319966,Compared To What: The Improbable Journey Of Barney Frank,2014-04-27,2014,0,0,0,0.15905
319971,Gary Owen: I Agree With Myself,2015-01-16,2015,0,0,0,0.038396
319975,The Drop Box,2014-04-05,2014,0,0,0,0.217522
319986,Grace,2014-04-18,2014,0,0,0,1.296285
319993,Aferim!,2015-01-22,2015,1379375,105097,-1274278,2.214179
319994,The Pearl Button,2015-10-15,2015,0,0,0,0.881308
319995,The Club,2015-05-28,2015,0,52761,52761,3.534068
319996,Chasuke's Journey,2015-02-13,2015,0,0,0,0.749972
319998,Sworn Virgin,2015-03-19,2015,0,0,0,2.187639
319999,Body,2015-01-20,2015,0,0,0,2.633612
320001,Volcano,2015-01-20,2015,0,0,0,1.211958
320003,Diary of a Chambermaid,2015-02-07,2015,0,0,0,2.967943
320004,Endless Night,2015-11-27,2015,0,0,0,2.486485
320005,Under Electric Clouds,2015-02-10,2015,0,80551,80551,0.66989
320006,Taxi,2015-04-15,2015,0,0,0,4.440102
320007,Victoria,2015-06-11,2015,0,3191998,3191998,8.247275
320011,Men with Guns,1998-03-06,1998,0,0,0,0.004075
320028,Il nome del figlio,2015-01-22,2015,0,0,0,4.679687
320037,Funci√≥n de noche,1981-09-26,1981,0,0,0,0.093167
320048,Ratter,2015-01-24,2015,500000,0,-500000,5.78016
320061,Batkid Begins,2015-06-26,2015,0,0,0,2.061863
320132,Triumph in the Skies,2015-02-19,2015,0,0,0,0.436934
320146,Creative Control,2016-03-11,2016,1000000,0,-1000000,2.125933
320150,Big Match,2014-11-26,2014,500,0,-500,1.472591
320169,Ninjas vs. Monsters,2012-10-14,2012,0,0,0,0.358804
320179,Resistance,2015-01-01,2015,0,0,0,0.241235
320181,The Perfect 46,2014-10-28,2014,0,0,0,0.035948
320293,The Howling Miller,1982-11-05,1982,0,0,0,0.070588
320295,Detective Byomkesh Bakshy!,2015-04-03,2015,0,0,0,1.478116
320299,Bleu catacombes,2014-01-21,2014,0,0,0,0.056765
320302,Ever Been to the Moon?,2015-01-22,2015,0,0,0,4.123075
320311,Wolf Hall,2015-01-21,2015,0,0,0,1.018691
320316,Italiano medio,2015-01-29,2015,1816720,4541800,2725080,3.782108
320318,The Clearstream Affair,2015-02-11,2015,0,0,0,1.957983
320343,Hacker's Game,2015-03-06,2015,0,0,0,0.941795
320349,"3 ¬Ω Minutes, 10 Bullets",2015-10-02,2015,0,0,0,1.381594
320385,The Widowmaker,2015-02-27,2015,0,0,0,0.215188
320412,Camp Massacre,2014-04-12,2014,0,0,0,0.209126
320413,The Greasy Strangler,2016-10-07,2016,0,0,0,3.638676
320420,Love Me,2014-04-06,2014,0,0,0,0.993372
320430,Senior Project,2015-01-07,2015,0,0,0,0.124922
320433,The Ninja Immovable Heart,2014-02-27,2014,0,0,0,0.68636
320453,Life Can Be So Wonderful,2007-09-15,2007,0,0,0,0.04975
320586,Brand: A Second Coming,2015-03-13,2015,0,0,0,0.988652
320587,A Brave Heart: The Lizzie Velasquez Story,2015-03-14,2015,0,0,0,0.161354
320588,"Hello, My Name Is Doris",2015-11-27,2015,1000000,14444999,13444999,14.992311
320589,Mavis!,2015-03-15,2015,0,0,0,1.13476
320639,All About E,2015-02-21,2015,0,0,0,1.373247
320643,Stand,2014-06-20,2014,0,0,0,0.015297
320703,The Dramatics: A Comedy,2015-02-10,2015,0,0,0,1.54267
320736,Virgin Mountain,2015-03-20,2015,0,0,0,1.633149
320849,Ice Age Columbus: Who Were the First Americans?,2005-01-01,2005,0,0,0,0.043244
320853,Sealed Verdict,1948-11-05,1948,0,0,0,0.003641
320873,Dhanak,2015-02-02,2015,0,0,0,0.381319
320882,The Seven Five,2014-11-14,2014,0,0,0,1.749022
320892,Kyle Kinane: I Liked His Old Stuff Better,2015-01-23,2015,0,0,0,0.229202
320910,Naanum Rowdydhaan,2015-10-21,2015,0,0,0,0.761788
320917,Oranges,2004-03-13,2004,0,0,0,0.52322
320996,Iliza Shlesinger: Freezing Hot,2015-01-23,2015,0,0,0,0.965884
321030,One More Time,2016-04-08,2016,0,0,0,1.070554
321039,The Phoenix Incident,2015-06-16,2015,1300000,0,-1300000,1.352518
321068,Mythica: A Quest for Heroes,2014-12-08,2014,0,0,0,6.550033
321109,Bitter Lake,2015-01-24,2015,0,0,0,1.464736
321130,Solyaris,1968-10-08,1968,0,0,0,0.250398
321142,That Summer of White Roses,1989-01-01,1989,0,0,0,0.723459
321160,With This Ring,2015-01-24,2015,0,0,0,6.592284
321191,Chronicle of a Blood Merchant,2015-01-14,2015,0,0,0,0.505002
321224,Boy,2014-06-19,2014,0,0,0,0.121374
321228,"Remake, Remix, Rip-Off: About Copy Culture & Turkish Pop Cinema",2014-08-13,2014,0,0,0,0.254341
321258,The Boy,2016-01-22,2016,10000000,64188367,54188367,17.028854
321283,Flogsta Heaven,2015-10-16,2015,0,0,0,0.028198
321303,1944,2015-02-20,2015,2000000,0,-2000000,6.95773
321315,Forever,2014-11-14,2014,0,0,0,0.056341
321377,Plan 9,2015-02-18,2015,0,0,0,1.224136
321494,The Man with the Iron Fists 2,2015-03-10,2015,0,0,0,3.98978
321497,The Debt,2015-04-24,2015,0,0,0,1.251677
321528,Batman vs. Robin,2015-04-14,2015,0,0,0,5.48942
321530,Caffeinated,2015-01-31,2015,200000,0,-200000,0.020813
321594,Louis C.K.: Live at The Comedy Store,2015-01-27,2015,0,0,0,2.515629
321612,Beauty and the Beast,2017-03-16,2017,160000000,1262886337,1102886337,287.253654
321621,The Throwaways,2015-01-30,2015,0,0,0,2.877374
321640,The Jinx: The Life and Deaths of Robert Durst,2015-02-08,2015,0,0,0,5.403881
321644,Enquiring Minds: The Untold Story of the Man Behind the National Enquirer,2014-10-16,2014,750000,0,-750000,0.104105
321645,This Is Normal,2013-04-09,2013,0,0,0,0.086079
321662,LA Apocalypse,2014-06-20,2014,0,0,0,0.584916
321666,600 Miles,2016-07-15,2016,0,0,0,3.733787
321678,PMMP ‚Äì Life is Right Here,2015-01-31,2015,0,0,0,0.020195
321697,Steve Jobs,2015-10-09,2015,30000000,34441873,4441873,16.224866
321741,Concussion,2015-11-12,2015,35000000,50363790,15363790,7.739783
321751,A Perfect Day,2015-08-28,2015,0,1702433,1702433,9.786662
321757,Punching Henry,2017-02-24,2017,0,0,0,1.797552
321769,Deep Web,2015-03-15,2015,0,0,0,4.615203
321779,Lost in Munich,2015-10-22,2015,1509896,0,-1509896,0.504189
321974,Janis: Little Girl Blue,2015-09-09,2015,0,0,0,2.726411
322039,Classmates,2015-01-16,2015,0,0,0,0.026397
322125,A Perfect Man,2015-03-18,2015,0,0,0,7.500331
322148,Caedes,2015-10-15,2015,0,0,0,0.791988
322240,Nine Lives,2016-08-03,2016,30000000,57814445,27814445,10.000208
322260,Crockdale,2011-01-01,2011,0,0,0,0.007059
322266,Buddy Hutchins,2015-01-01,2015,1200000,0,-1200000,1.77499
322270,Talvivaaran miehet,2015-01-27,2015,0,0,0,0.018824
322317,Christ lives in Siberia,2015-01-28,2015,0,0,0,0.026716
322378,Nice People,2015-01-28,2015,0,0,0,0.255966
322400,Faces of November,1964-01-01,1964,0,0,0,0.07211
322434,The Ceremony,2014-11-08,2014,0,0,0,0.621568
322443,The Timber,2015-02-27,2015,0,0,0,2.395158
322453,Assassini dei giorni di festa,2002-04-17,2002,0,0,0,0.002524
322455,The Burgos Trial,1979-08-31,1979,0,0,0,0.001744
322456,LEGO DC Comics Super Heroes: Justice League vs. Bizarro League,2015-02-10,2015,0,0,0,4.020885
322460,Crooks and Coronets,1969-04-02,1969,0,0,0,0.279551
322476,Demons,2012-11-09,2012,0,0,0,0.013177
322487,Spark: A Space Tail,2017-04-14,2017,0,116873,116873,10.348612
322488,The Fencer,2015-03-13,2015,0,0,0,1.731591
322506,Elstree 1976,2015-10-09,2015,370000,0,-370000,0.667803
322518,The Intruders,2015-02-24,2015,0,0,0,3.139941
322548,Shangri-La Suite,2017-01-11,2017,0,0,0,3.073417
322614,Crumbs,2015-01-27,2015,200000,0,-200000,0.230976
322740,Seashore,2015-06-21,2015,0,0,0,1.544971
322745,Counting,2015-02-09,2015,50000,0,-50000,0.125118
322746,Sweet Micky for President,2015-01-23,2015,0,0,0,0.036361
322766,Beautiful & Twisted,2015-01-31,2015,0,0,0,2.873763
322785,Mel Brooks: Live at the Geffen,2015-01-31,2015,0,0,0,0.061709
322799,Cooperstown,1993-01-26,1993,0,0,0,1.181628
322850,Badge of Honor,2015-10-19,2015,5000000,0,-5000000,2.177661
322903,Naz & Maalik,2014-01-01,2014,0,0,0,0.051256
322922,Awaken,2015-07-07,2015,0,0,0,3.621457
323016,Armi Alive!,2015-03-20,2015,0,0,0,0.145548
323027,Justice League: Gods and Monsters,2015-07-28,2015,0,0,0,5.778906
323111,Semper Fi,2001-04-01,2001,0,0,0,0.370146
323132,Altar of Fire,1976-01-01,1976,0,0,0,0.0
323149,Darkness on the Edge of Town,2015-01-25,2015,0,0,0,0.205807
323214,Alexia,2013-11-04,2013,0,0,0,0.163732
323262,Holidays,2016-04-22,2016,0,0,0,7.19726
323272,War Room,2015-08-28,2015,3000000,67790117,64790117,5.384163
323315,You're Ugly Too,2015-02-07,2015,0,0,0,1.043122
323366,Pod,2015-03-16,2015,0,0,0,2.202593
323370,The Diabolical,2015-03-16,2015,0,0,0,4.822018
323372,The Corpse of Anna Fritz,2015-03-15,2015,0,0,0,7.043286
323373,Deathgasm,2015-08-28,2015,0,0,0,7.391953
323383,Wuthering High,2015-03-07,2015,0,0,0,1.286626
323384,A Gift of Miracles,2015-02-15,2015,0,0,0,0.929781
323396,Wednesday 04:45,2015-03-12,2015,0,0,0,0.445141
323426,Shamitabh,2015-02-06,2015,3700000,0,-3700000,1.244056
323428,There Should Be Rules,2015-10-23,2015,0,0,0,0.628542
323431,Petting Zoo,2015-02-10,2015,0,0,0,0.653838
323435,One & Two,2015-08-01,2015,0,0,0,2.233208
323517,Badlapur,2015-02-20,2015,3700000,11480000,7780000,1.493061
323552,Jay Mohr: Happy. And A Lot.,2015-03-14,2015,0,0,0,0.102784
323555,That Gal...Who Was in That Thing: That Guy 2,2015-03-07,2015,0,0,0,0.059585
323573,Daughter... Father... Daughter,2011-10-07,2011,0,0,0,0.007059
323656,Just Jim,2015-09-25,2015,400000,0,-400000,1.03027
323660,Avengers Grimm,2015-03-17,2015,0,0,0,10.277117
323661,Mune: Guardian of the Moon,2015-02-05,2015,0,15730665,15730665,8.657935
323665,Ava's Possessions,2015-03-16,2015,0,0,0,2.769526
323673,Just the Way You Are,2015-05-09,2015,0,0,0,0.91541
323674,6 Years,2015-08-18,2015,0,0,0,4.075159
323675,Ride Along 2,2016-01-14,2016,40000000,124827316,84827316,9.420931
323676,The Boss,2016-04-07,2016,29000000,78636257,49636257,7.533146
323677,Race,2016-02-19,2016,5000000,24804129,19804129,7.979302
323679,Manson Family Vacation,2015-03-16,2015,0,0,0,1.608143
323688,Brian Gaar: Jokes I Wrote At Work,2015-02-05,2015,0,0,0,0.022506
323690,Matt Braunger: Big Dumb Animal,2015-02-06,2015,0,0,0,0.173589
323694,Nina Forever,2015-03-14,2015,0,0,0,3.149665
323695,Devo: Hardcore Live!,2015-02-24,2015,0,0,0,0.055294
323788,The Man in 3B,2015-11-06,2015,0,0,0,0.671717
323792,L.A. Slasher,2015-06-12,2015,0,0,0,1.208879
323925,Florida Man,2015-02-04,2015,0,0,0,0.132196
323929,Krisha,2016-03-18,2016,0,140779,140779,3.438362
323967,Walter,2015-03-13,2015,700000,0,-700000,1.950065
323968,OzLand,2015-02-08,2015,0,0,0,0.486995
324011,The Yearling,1994-04-24,1994,0,0,0,0.437619
324013,Tanner '88,1988-02-15,1988,0,0,0,0.04122
324017,The Master,2017-01-01,2017,0,0,0,0.414474
324083,Life Lesson,1995-04-11,1995,0,0,0,0.001648
324150,Uncle John,2015-03-16,2015,0,0,0,1.304515
324173,Comedy Central Roast of Bob Saget,2008-08-17,2008,0,0,0,1.676586
324174,The Automatic Hate,2015-03-15,2015,0,0,0,0.503064
324178,Panic Button,1964-04-10,1964,0,0,0,0.201067
324181,The Resurrection of Jake the Snake,2015-01-23,2015,0,0,0,1.271146
324194,7 Golden Monks,1966-02-08,1966,0,0,0,0.138865
324230,Diet of Sex,2014-02-14,2014,0,0,0,6.889832
324245,7 Chinese Brothers,2015-08-14,2015,0,0,0,1.630684
324251,A Space Program,2015-03-18,2015,0,0,0,0.162792
324253,All Things Must Pass,2015-10-16,2015,0,0,0,2.792944
324259,Prince,2015-02-06,2015,0,0,0,0.99881
324260,Bikes vs Cars,2015-03-15,2015,90,0,-90,0.141087
324263,Breaking a Monster,2015-03-14,2015,0,0,0,0.253071
324264,Danny Says,2015-03-18,2015,0,0,0,0.708313
324266,Disaster Playground,,,0,0,0,0.001405
324269,For Grace,2015-03-13,2015,0,0,0,0.253959
324271,Frame by Frame,2015-03-14,2015,0,0,0,0.029063
324277,Jaco,2014-10-06,2014,0,0,0,0.641846
324279,Kingdom of Shadows,2015-01-01,2015,0,0,0,0.14908
324281,"Knock Knock, It's Tig Notaro",2015-03-16,2015,0,0,0,0.162188
324284,Lamb,2016-01-08,2016,0,0,0,1.252328
324289,Touched with Fire,2016-02-12,2016,0,0,0,2.348892
324291,Night Owls,2015-03-15,2015,0,0,0,1.660851
324293,Peace Officer,2015-09-16,2015,0,26632,26632,0.208919
324300,Rolling Papers,2015-03-15,2015,0,0,0,0.125909
324307,Sneakerheadz,2015-03-16,2015,0,0,0,0.979311
324308,Steve Jobs: The Man in the Machine,2015-08-07,2015,0,494506,494506,5.019486
324314,Tab Hunter Confidential,2015-03-15,2015,0,0,0,0.864349
324317,The Ecstasy of Wilko Johnson,2015-03-17,2015,0,0,0,0.420739
324320,Theory of Obscurity: A Film About the Residents,2015-03-14,2015,0,0,0,0.214932
324322,They Will Have to Kill Us First,2015-10-13,2015,522360,0,-522360,0.074027
324325,Twinsters,2015-07-17,2015,0,0,0,2.867932
324326,Uncle Kent 2,2016-08-26,2016,0,0,0,0.418824
324333,Wild Horses,2015-06-05,2015,0,0,0,3.940336
324340,Summers Downstairs,2015-02-07,2015,0,0,0,0.868407
324345,The Seventh Fire,2015-02-07,2015,0,0,0,0.469971
324408,Der Kronzeuge,2007-12-12,2007,0,0,0,0.145349
324421,We are Twisted Fucking Sister!,2016-02-19,2016,0,0,0,0.859521
324436,Dyke Hard,2015-02-08,2015,30000,0,-30000,0.175255
324440,The Bunker,2015-02-07,2015,0,0,0,1.606356
324542,Sleepless,2017-01-12,2017,30000000,32540674,2540674,12.240817
324552,John Wick: Chapter 2,2017-02-08,2017,40000000,171539887,131539887,49.247505
324560,Brimstone,2017-01-12,2017,0,0,0,18.473022
324572,Escape,2015-04-30,2015,0,0,0,1.061068
324573,Love is All: 100 Years of Love & Courtship,2014-12-07,2014,0,0,0,0.202543
324578,Butterfly,2015-02-07,2015,0,0,0,0.35236
324631,Photographer,2015-01-08,2015,0,0,0,1.060042
324668,Jason Bourne,2016-07-27,2016,120000000,415484914,295484914,19.133256
324670,Spectral,2016-12-09,2016,0,0,0,9.117924
324764,Flocking,2015-02-01,2015,0,0,0,0.859004
324786,Hacksaw Ridge,2016-10-07,2016,40000000,175302354,135302354,21.037699
324794,The Blue Hour,2015-02-09,2015,0,0,0,0.454353
324803,Hangman,2015-03-14,2015,0,0,0,2.055173
324807,A Bigger Splash,2015-11-26,2015,0,1982505,1982505,12.945544
324819,Daniel's World,2015-02-19,2015,0,0,0,0.056855
324820,The Snake Brothers,2015-02-20,2015,0,0,0,0.750401
324849,The Lego Batman Movie,2017-02-08,2017,80000000,311950384,231950384,17.070748
324852,Despicable Me 3,2017-06-15,2017,80000000,1020063384,940063384,36.631519
324930,Proof of the Devil,2015-02-10,2015,0,0,0,0.439368
324963,Monster High: Haunted,2015-03-02,2015,0,0,0,2.468501
324978,Pirate's Passage,2015-01-04,2015,0,0,0,0.935899
324986,The Last House on Cemetery Lane,2015-02-17,2015,0,0,0,1.340182
325039,Lady of Csejte,2015-02-26,2015,2000000,0,-2000000,1.574378
325111,Wingman Inc.,2015-04-21,2015,0,0,0,0.54143
325113,A Girl Like Her,2015-03-27,2015,0,0,0,3.766743
325133,Neighbors 2: Sorority Rising,2016-05-04,2016,35000000,108758521,73758521,9.914008
325134,Cute and Dangerous,2015-02-06,2015,0,0,0,2.212227
325138,Dum Laga Ke Haisha,2015-02-27,2015,0,0,0,2.721314
325140,Hum To Mohabbat Karega,2000-05-26,2000,0,0,0,0.001177
325173,Close Range,2015-12-11,2015,0,0,0,5.419602
325186,Smothered,2016-03-29,2016,0,0,0,0.581794
325189,Teen Beach 2,2015-06-26,2015,0,0,0,4.405129
325205,Other Girls,2015-03-27,2015,0,0,0,0.021594
325240,Something for a Lonely Man,1968-01-01,1968,0,0,0,0.368082
325263,Journey to Space,2015-02-13,2015,0,0,0,0.801267
325302,They Look Like People,2016-02-26,2016,0,0,0,3.781344
325346,The Hollars,2016-08-25,2016,3800000,1016985,-2783015,5.723985
325348,Hardcore Henry,2015-09-12,2015,10000000,14333790,4333790,14.544852
325358,Superfast!,2015-03-05,2015,20000000,0,-20000000,5.885213
325365,Dawg Fight,2015-03-13,2015,0,0,0,1.309117
325373,Two Lovers and a Bear,2016-10-02,2016,0,0,0,3.18198
325382,Nuntius,2014-10-28,2014,0,0,0,0.017806
325385,Endless Poetry,2016-03-23,2016,0,0,0,2.522699
325428,Out of My Hand,2015-02-14,2015,0,0,0,0.226631
325439,The Wonders of Aladdin,1961-10-31,1961,0,0,0,0.093498
325555,Loafer,1996-06-09,1996,0,0,0,0.633962
325592,Camp Belvidere,2014-01-01,2014,15000,0,-15000,0.679885
325645,"Senza famiglia, nullatenenti cercano affetto",1972-03-30,1972,0,0,0,0.011064
325690,The Legendary Giulia and Other Miracles,2015-02-19,2015,0,0,0,4.206606
325712,Cool Cat Saves the Kids,2015-02-01,2015,50000,0,-50000,0.847277
325758,I Am Thor,2015-11-20,2015,0,0,0,0.306142
325780,Sottozero,1987-01-01,1987,0,0,0,0.185157
325789,The Infiltrator,2016-07-13,2016,25000000,15436808,-9563192,11.504398
325803,October 1,2014-10-01,2014,2,0,-2,0.402422
325848,"Connasse, Princesse des c≈ìurs",2015-04-29,2015,0,0,0,4.476741
325892,Hunterrr,2015-03-20,2015,0,0,0,0.576446
326011,The Battalion,2015-02-20,2015,10000000,7547762,-2452238,1.557671
326013,I Remember You,1986-09-08,1986,0,0,0,0.201286
326029,Delivery,2005-04-09,2005,10000,0,-10000,0.003043
326038,Mariya,1975-09-03,1975,0,0,0,0.001393
326045,Lonesome Dove Church,2014-08-04,2014,0,0,0,0.676407
326057,Assassin,2015-03-09,2015,0,0,0,1.781163
326058,Housekeeping,2015-03-31,2015,0,0,0,0.287974
326094,Wiener-Dog,2016-06-24,2016,0,0,0,5.933337
326119,Danny and the Wild Bunch,2014-02-18,2014,0,0,0,0.092765
326139,Eadweard,2015-02-28,2015,0,0,0,1.008265
326198,Nothing in Return,2015-05-08,2015,0,0,0,1.474889
326215,Ooops! Noah is Gone...,2015-04-09,2015,6000000,0,-6000000,6.845062
326228,Brains Repaired,1911-01-01,1911,0,0,0,0.001837
326241,For Here or to Go?,2017-03-31,2017,0,0,0,0.579564
326247,The House on Pine Street,2015-02-28,2015,0,0,0,1.593227
326250,Killswitch,2015-03-01,2015,0,0,0,0.442896
326253,Marry Me,2015-01-28,2015,0,0,0,0.109654
326255,Meet the Hitlers,2014-10-17,2014,0,0,0,0.06394
326256,Miss India America,2016-03-24,2016,0,0,0,0.805939
326262,Biology 101,2011-04-01,2011,0,0,0,0.232607
326284,Pound of Flesh,2015-05-07,2015,7500000,0,-7500000,5.135262
326285,American Pastoral,2016-10-20,2016,0,0,0,19.953565
326305,Aung San Suu Kyi - Lady of No Fear,2010-11-05,2010,0,0,0,0.005882
326333,"Liza, the Fox-Fairy",2015-02-19,2015,0,0,0,2.631047
326359,Frozen Fever,2015-03-09,2015,0,0,0,9.509334
326415,Headless,2015-02-28,2015,0,0,0,0.853425
326420,Dig Two Graves,2014-10-17,2014,0,0,0,1.380905
326423,Barbershop: The Next Cut,2016-04-15,2016,20000000,55030051,35030051,8.468401
326425,Extraction,2015-12-18,2015,0,16775,16775,8.075504
326441,Pernicious,2015-06-15,2015,0,0,0,1.378801
326446,Savageland,2017-02-24,2017,0,0,0,0.376757
326536,The Coven,2015-02-16,2015,0,0,0,0.214465
326553,Keith Robinson: Back of the Bus Funny,2015-02-21,2015,0,0,0,0.026029
326591,Hollywood between Paranoia and Sci-Fi. The Power of Myth,2011-05-06,2011,118399,0,-118399,0.050593
326649,Life Is Sacred,2014-11-08,2014,0,0,0,0.040096
326665,Aziz Ansari: Live at Madison Square Garden,2015-03-06,2015,0,0,0,1.980386
326723,Snowden‚Äôs Great Escape,2015-01-12,2015,0,0,0,0.712004
326755,Dirty Weekend,1973-03-08,1973,0,0,0,0.034457
326874,L'Art de la fugue,2015-03-04,2015,0,0,0,0.422533
326890,Revolution #9,2002-11-15,2002,0,0,0,0.203356
326923,Babysitter's Black Book,2015-02-21,2015,0,0,0,2.030937
327016,Weekend of a Champion,2013-10-09,2013,0,0,0,0.490537
327029,Power Rangers,2015-02-24,2015,0,0,0,5.04399
327040,Bang Gang (A Modern Love Story),2015-08-26,2015,0,0,0,2.793311
327083,The Victoria's Secret Fashion Show 2001,2001-11-15,2001,0,0,0,0.01268
327175,Not Angels but Angels,1994-01-01,1994,0,0,0,0.14255
327225,Crazy Beautiful You,2015-02-25,2015,0,0,0,0.690123
327231,For Better and Worse,2015-03-06,2015,0,0,0,0.436144
327237,"Blood, Sweat and Tears",2015-04-02,2015,0,0,0,0.590087
327253,The Gracefield Incident,2017-07-21,2017,0,0,0,4.184306
327352,Christopher Titus: Angry Pursuit of Happiness,2014-09-27,2014,0,0,0,0.671568
327383,Happy 140,2015-04-10,2015,0,0,0,1.390382
327389,Cigarette Burns,2005-12-16,2005,0,0,0,1.59474
327418,Batman Unlimited: Animal Instincts,2015-05-12,2015,0,0,0,8.059946
327476,Reunion,2015-02-25,2015,1432960,0,-1432960,1.1503
327528,Born to Be Blue,2015-09-13,2015,0,830129,830129,4.470369
327536,Bakuman,2015-10-01,2015,0,0,0,1.362149
327655,Nina,1978-10-17,1978,0,0,0,0.2875
327674,The Invited,2010-01-01,2010,0,0,0,0.780846
327685,White Cop,2014-11-06,2014,0,0,0,0.017647
327749,Wish You Well,2013-10-19,2013,0,0,0,1.634835
327833,Skin Trade,2014-11-07,2014,9000000,0,-9000000,4.261152
327909,No Man's Island,2014-10-16,2014,0,0,0,0.017349
327924,The Confessions of Bernhard Goetz,1987-11-10,1987,0,0,0,0.043125
327935,≈ûabaniye,1984-06-02,1984,0,0,0,0.1222
327953,Ralphie May: Unruly,2015-02-27,2015,0,0,0,0.036387
327982,Soulless 2,2015-03-05,2015,0,0,0,1.369751
328032,Mara and the Firebringer,2015-04-02,2015,0,0,0,0.960229
328069,The Glass Agency,1999-01-02,1999,0,0,0,0.268492
328111,The Secret Life of Pets,2016-06-18,2016,75000000,875457937,800457937,11.01395
328132,Earth's Golden Playground,2015-03-13,2015,0,0,0,0.05488
328212,The Last Man on Earth,2014-03-07,2014,0,0,0,0.330445
328216,Be My Cat: A Film for Anne,2015-03-01,2015,10000,0,-10000,0.339659
328233,India's Daughter,2015-03-08,2015,0,0,0,1.079777
328246,Salad Days,2015-04-11,2015,0,0,0,0.679427
328252,Sweet Home,2015-05-08,2015,0,0,0,2.421888
328327,Nick Di Paolo: Another Senseless Killing,2015-02-17,2015,0,0,0,0.039208
328387,Nerve,2016-07-27,2016,19000000,85241496,66241496,14.9837
328407,Metalocalypse: The Doomstar Requiem,2013-10-27,2013,0,0,0,1.586754
328416,Hard Choices,1986-05-16,1986,0,0,0,0.43218
328425,The Gift,2015-07-30,2015,5000000,58978653,53978653,8.585856
328429,Approaching the Unknown,2016-06-03,2016,0,0,0,4.957424
328448,Dial a Prayer,2015-01-01,2015,0,0,0,1.964488
328480,Kept Woman,2015-02-28,2015,0,0,0,3.016183
328483,London Road,2015-06-12,2015,0,0,0,2.58432
328589,The Lady in the Van,2015-11-13,2015,6000000,41387687,35387687,5.799373
328594,The Birth of Sak√©,2016-03-18,2016,0,0,0,0.522941
328595,Parallels,2015-03-01,2015,0,0,0,4.081263
328631,Not Bad for a Human,1977-10-07,1977,0,0,0,0.037321
328692,Ventoux,2015-05-14,2015,0,0,0,0.27894
328712,Tarda estate,2010-09-04,2010,0,0,0,0.005935
328714,Assassin,1969-01-16,1969,0,0,0,0.001185
328716,Detective K: Secret of the Lost Island,2015-02-11,2015,0,0,0,1.231733
328720,Ma che bella sorpresa,2015-03-11,2015,0,0,0,4.369253
328739,David and Goliath,2015-03-13,2015,0,0,0,0.272295
328763,Echoes,2014-07-05,2014,0,0,0,8.460369
328796,Burn Country,2016-04-16,2016,0,0,0,1.235151
328799,"It's Me, Hilary: The Man Who Drew Eloise",2015-01-24,2015,0,0,0,0.112852
328820,Unknown Caller,2015-06-10,2015,0,0,0,2.439977
328840,The Primary Instinct,2015-05-29,2015,50234,0,-50234,0.545911
328844,Eloquent Nude: The Love and Legacy of Edward Weston & Charis Wilson,2007-10-27,2007,0,0,0,0.003741
328848,"Murder, She Baked: A Chocolate Chip Cookie Mystery",2015-05-02,2015,0,0,0,2.997835
328869,Meadowland,2015-10-16,2015,0,0,0,2.407351
328901,The Benefactor,2015-04-17,2015,0,0,0,9.013856
328918,Slim Carter,1957-11-01,1957,0,0,0,0.001346
328930,Sunrise,2014-10-03,2014,0,0,0,0.278628
329004,The Survivalist,2015-04-15,2015,0,0,0,8.126324
329005,Autism in Love,2015-04-15,2015,0,0,0,0.341701
329010,Emelie,2016-03-04,2016,0,0,0,5.543789
329013,III,2015-03-02,2015,0,0,0,0.541651
329020,Extraordinary Tales,2015-10-23,2015,0,0,0,2.101326
329024,TransFatty Lives,2015-04-05,2015,0,0,0,0.055353
329063,We Can't Live Without Cosmos,2014-08-21,2014,0,0,0,0.696244
329066,Those Who Feel the Fire Burning,2014-11-22,2014,0,0,0,0.063082
329134,Massu Engira Maasilamani,2015-05-29,2015,0,0,0,0.793723
329135,O Kadhal Kanmani,2015-04-17,2015,940000,5100000,4160000,0.739665
329137,My Italian Secret: The Forgotten Heroes,2014-10-12,2014,0,0,0,0.122358
329205,Ghoul,2015-02-26,2015,0,0,0,2.577826
329206,Lost and Love,2015-03-20,2015,0,0,0,1.15327
329216,The Foot Shooting Party,1994-01-01,1994,0,0,0,0.610254
329227,Mi Amigo Hugo,2014-03-05,2014,0,0,0,0.191531
329241,Sinatra: All or Nothing at All,2015-04-05,2015,0,0,0,0.669469
329243,Comedy Central Roast of Donald Trump,2011-03-15,2011,0,0,0,1.456319
329255,The Thoughts That Once We Had,2015-03-06,2015,0,0,0,0.090618
329263,Fuck You Goethe 2,2015-09-10,2015,0,83027924,83027924,9.221178
329286,Trevor Moore: High In Church,2015-03-02,2015,0,0,0,0.189606
329289,Always Watching: A Marble Hornets Story,2015-04-07,2015,0,0,0,2.094087
329407,Kansas: Miracles Out Of Nowhere,2015-03-24,2015,0,0,0,0.202117
329440,The Forest,2016-01-07,2016,10000000,40055439,30055439,7.384688
329540,The Marine 4: Moving Target,2015-04-10,2015,1950000,0,-1950000,3.633327
329550,"Dzie≈Ñ dobry, kocham ciƒô!",2014-11-07,2014,0,0,0,0.487328
329556,Landmine Goes Click,2015-03-03,2015,1000000,0,-1000000,4.432702
329637,Star Trek: Renegades,2015-08-01,2015,0,0,0,3.02229
329639,Love Stories,2016-09-15,2016,0,0,0,0.356588
329682,The Anarchists,2015-11-11,2015,0,0,0,1.968115
329690,Comedy Central Roast of Roseanne,2012-08-12,2012,0,0,0,0.744095
329697,Raiders!: The Story of the Greatest Fan Film Ever Made,2015-03-14,2015,0,0,0,2.245922
329712,The Measure of a Man,2015-03-16,2015,0,106498,106498,4.778045
329718,Finding Altamira,2016-04-01,2016,9500000,0,-9500000,2.002313
329724,In Harmony,2015-04-15,2015,0,0,0,2.527577
329740,Satan's Sword III: The Final Chapter,1961-05-17,1961,0,0,0,0.001807
329750,(Dis)Honesty: The Truth About Lies,2015-05-22,2015,0,0,0,1.226256
329802,White People,2015-10-30,2015,0,0,0,0.681617
329805,My King,2015-10-21,2015,0,282000,282000,5.88082
329809,Courted,2015-11-18,2015,0,0,0,3.139448
329815,Disorder,2015-09-30,2015,0,39687,39687,4.165542
329819,Standing Tall,2015-05-13,2015,5000000,26144,-4973856,4.206655
329829,The Girl King,2015-12-11,2015,0,0,0,9.227292
329833,Zoolander 2,2016-02-06,2016,50000000,55969000,5969000,10.155109
329865,Arrival,2016-11-10,2016,47000000,203388186,156388186,30.83786
329868,Six Days a Week,1965-03-22,1965,0,0,0,0.002006
329981,Shut In,2016-11-11,2016,10000000,13082071,3082071,6.944457
330007,In the Grayscale,2015-03-06,2015,0,0,0,1.275006
330011,The Millennials,2015-03-10,2015,0,0,0,0.024568
330037,Brothers,2015-08-14,2015,0,0,0,1.74416
330068,Fastball,2016-03-25,2016,0,0,0,1.178657
330070,Terra Formars,2016-04-29,2016,0,0,0,3.786856
330112,Ashby,2015-04-19,2015,0,4631,4631,5.159349
330115,Ride,2014-11-08,2014,0,0,0,4.14587
330127,Back in Time,2015-10-20,2015,190000,0,-190000,4.8954
330152,A Lamp In The Dark: The Untold History of the Bible,2009-11-10,2009,0,0,0,0.076471
330161,Gourmet Detective,2015-05-16,2015,0,0,0,2.851343
330171,Latin Lover,2015-03-19,2015,0,0,0,2.774803
330206,Anti-Social,2015-01-01,2015,0,0,0,0.915218
330275,Des roses en hiver,2014-09-12,2014,0,0,0,0.260316
330294,Marguerite & Julien,2015-09-30,2015,0,0,0,2.184684
330298,The Lady in the Car with Glasses and a Gun,2015-08-05,2015,0,0,0,3.13016
330333,The Boss's Daughter,2016-01-06,2016,0,0,0,2.348352
330348,The Wait,2015-09-17,2015,0,0,0,2.03853
330381,Lily Lane,2016-05-19,2016,0,0,0,0.632632
330399,Rajathandhiram,2015-03-13,2015,0,0,0,0.351634
330418,Indru Netru Naalai,2015-06-26,2015,620000,1400000,780000,0.326862
330421,Papanasam,2015-07-03,2015,0,14000000,14000000,0.569463
330430,C√≥mo pasan las horas,2005-03-18,2005,0,0,0,0.053203
330431,NH10,2015-03-13,2015,0,0,0,1.306922
330459,Rogue One: A Star Wars Story,2016-12-14,2016,200000000,1056057273,856057273,36.567575
330483,The Choice,2016-02-04,2016,10000000,18730891,8730891,8.28378
330544,Bessie,2015-05-16,2015,0,0,0,2.129215
330588,Monsoon Baby,2014-09-17,2014,0,0,0,0.284122
330628,The Answer,2015-04-11,2015,0,0,0,1.863127
330629,Kaakha Kaakha,2003-08-01,2003,0,0,0,0.7343
330697,Belgica,2016-03-02,2016,0,0,0,3.708558
330711,One Kill,2000-01-01,2000,0,0,0,0.008218
330764,The Brand New Testament,2015-09-02,2015,8555500,0,-8555500,6.488451
330770,Evolution,2015-09-14,2015,0,0,0,3.191394
330878,"Kidnapping, Caucasian Style",2014-08-21,2014,3500000,179000,-3321000,0.524653
330916,King Jack,2015-04-01,2015,0,0,0,1.709289
330947,Song to Song,2017-03-17,2017,10000000,443684,-9556316,12.928712
330982,The Childhood of a Leader,2016-07-22,2016,3000000,0,-3000000,10.753568
331075,Twilight Online,2014-09-04,2014,0,496000,496000,0.424794
331110,Sicarivs: The Night and the Silence,2015-05-15,2015,0,0,0,0.649496
331161,See You In Valhalla,2015-04-24,2015,0,0,0,2.506371
331190,Captive,2015-09-17,2015,2000000,2801508,801508,5.396271
331214,Band of Brothers,2001-09-09,2001,125000000,0,-125000000,7.903731
331251,Twenty,2015-03-25,2015,0,0,0,1.786845
331313,Keeping Up with the Joneses,2016-10-20,2016,40000000,29918745,-10081255,9.48515
331351,Innocent Killers,2015-03-10,2015,0,0,0,0.694197
331354,Requisitos para ser una persona normal,2015-06-04,2015,0,0,0,2.016359
331367,Kids of Survival,1996-09-05,1996,0,0,0,0.001178
331392,Eloise,2017-02-03,2017,0,0,0,5.271207
331393,Undrafted,2016-07-15,2016,0,0,0,1.198056
331446,Sharknado 3: Oh Hell No!,2015-07-22,2015,0,0,0,4.354938
331485,Streit's: Matzo and the American Dream,2015-03-20,2015,0,0,0,0.020034
331501,Residue,2015-03-20,2015,0,0,0,6.201362
331576,SPL 2: A Time for Consequences,2015-06-18,2015,0,0,0,3.34086
331583,The Whole Truth,2016-03-25,2016,0,0,0,12.664893
331588,The Great Gilly Hopkins,2015-10-05,2015,5000000,0,-5000000,3.206636
331592,Listening,2015-09-11,2015,0,0,0,1.957695
331641,Food and Shelter,2015-12-04,2015,0,0,0,0.751451
331642,Born to Win,2016-05-06,2016,0,0,0,0.719873
331737,All Eyes And Ears,2015-04-20,2015,0,0,0,0.021407
331745,Top Spin,2014-11-15,2014,0,0,0,0.567031
331781,Amy,2015-07-03,2015,0,8413144,8413144,11.12024
331836,Babysitting 2,2015-12-02,2015,0,0,0,5.901413
331958,"ŒõŒ±œÑŒ≠œÅŒΩŒ±, Œ¶œÑœéœáŒµŒπŒ± Œ∫Œ±Œπ ŒìŒ±œÅœçœÜŒ±ŒªŒªŒø",1954-03-31,1954,0,0,0,0.149811
331962,Exposed,2016-01-22,2016,0,1787926,1787926,6.402939
331985,Sundays,2015-03-23,2015,51237,0,-51237,1.714401
332079,The Judge Steps Out,1947-12-15,1947,0,0,0,0.322313
332168,Tonight It's Me,2014-03-22,2014,25000,0,-25000,0.233897
332177,Vendetta,2015-06-12,2015,0,0,0,2.033272
332179,April 9th,2015-03-09,2015,0,0,0,2.091185
332210,Storks,2016-09-22,2016,70000000,182379278,112379278,12.687521
332212,Robo-Dog,2015-01-01,2015,0,0,0,0.729468
332270,Battle for Sevastopol,2015-04-02,2015,5000000,0,-5000000,5.603565
332280,Shark Killer,2015-03-23,2015,0,0,0,0.649879
332283,Mary Shelley,2018-04-25,2018,0,0,0,3.328261
332285,Antibirth,2016-09-02,2016,35000000,0,-35000000,10.629806
332286,1915,2015-04-17,2015,0,0,0,0.954477
332288,Bigfootville,2002-09-20,2002,0,0,0,0.003294
332340,Man Up,2015-05-29,2015,0,0,0,11.879205
332354,Rey gitano,2015-07-17,2015,0,0,0,0.772191
332356,Killing Jesus,2015-04-05,2015,0,0,0,1.758075
332411,I Am Wrath,2016-04-14,2016,18000000,0,-18000000,6.2319
332488,Zombie Resurrection,2014-10-25,2014,0,0,0,0.848918
332491,Journey,2015-03-12,2015,0,0,0,0.312315
332502,400 Days,2015-10-29,2015,0,0,0,6.133899
332512,Ghost,2015-03-26,2015,0,3300000,3300000,1.041195
332534,Bana Masal Anlatma,2015-01-09,2015,0,0,0,1.095345
332543,A Genius Leaves the Hood - The Unauthorized Story of Jay Z,2014-03-21,2014,0,0,0,0.325405
332567,The Shallows,2016-06-24,2016,17000000,119100758,102100758,13.689175
332662,The Scopia Effect,2014-11-01,2014,0,0,0,0.494527
332665,Men Go to Battle,2016-07-08,2016,0,0,0,0.1908
332704,Backtrack,2015-07-25,2015,0,0,0,6.727871
332706,Bleeding Heart,2015-04-16,2015,0,0,0,2.802814
332709,I Killed Napoleon,2015-03-26,2015,0,0,0,2.114265
332721,Dad's Army,2016-02-05,2016,0,0,0,6.558944
332739,In Transit,2015-04-16,2015,0,0,0,0.022031
332741,Palio,2015-04-18,2015,0,0,0,0.504591
332742,Song of Lahore,2015-11-13,2015,0,0,0,0.373688
332745,Sweet Lorraine,2015-04-23,2015,0,0,0,0.027989
332746,Thank You for Playing,2015-04-17,2015,0,0,0,0.193109
332748,Very Semi-Serious,2015-04-19,2015,0,0,0,0.192604
332749,The Forecaster,2014-11-24,2014,0,0,0,0.938255
332757,A Virgin in the Family,1975-10-11,1975,0,0,0,0.091036
332759,Einstein,2015-03-26,2015,0,0,0,0.119505
332788,Husband Factor,2015-03-20,2015,0,0,0,0.656589
332794,The Odyssey,2016-10-12,2016,21363000,0,-21363000,4.875172
332806,I Am Belfast,2016-04-08,2016,0,0,0,0.51468
332827,Ennum Eppozhum,2015-03-27,2015,0,0,0,0.535343
332835,Piku,2015-05-08,2015,5500000,22159216,16659216,2.942711
332839,Big Sky,2015-08-14,2015,0,0,0,1.431897
332872,Julieta,2016-04-08,2016,1490000,0,-1490000,6.768165
332880,Les oiseaux de passage,2015-04-02,2015,0,0,0,0.083143
332936,Any Day,2015-03-27,2015,0,0,0,5.415548
332976,Absolution,2015-05-04,2015,0,0,0,3.476891
332979,Bleed for This,2016-11-04,2016,6000000,6174491,174491,7.873407
332980,Little Big Master,2015-03-19,2015,0,0,0,1.320364
333072,Deadman Inferno,2015-05-16,2015,0,0,0,0.260544
333088,Applesauce,2015-11-24,2015,0,0,0,0.871957
333089,Bad Hurt,2016-02-12,2016,0,0,0,0.892602
333091,Bare,2015-10-30,2015,0,0,0,1.779635
333092,Come Down Molly,2015-04-16,2015,0,0,0,0.333745
333097,Almost Holy,2015-04-16,2015,0,0,0,0.492842
333099,Dream/Killer,2015-04-19,2015,0,0,0,0.178468
333103,Comedy Central Roast of Justin Bieber,2015-03-30,2015,0,0,0,2.531139
333106,Back to the Well: 'Clerks II',2006-11-28,2006,0,0,0,0.569257
333123,Jackrabbit,2015-04-18,2015,0,0,0,0.206222
333126,Comedy Central Roast of Larry the Cable Guy,2009-03-15,2009,0,0,0,0.832763
333127,Comedy Central Roast of Jeff Foxworthy,2005-03-20,2005,0,0,0,0.62502
333164,Beperkt houdbaar,2007-03-05,2007,0,0,0,0.00353
333165,Unforgotten: Twenty-Five Years After Willowbrook,1997-02-14,1997,0,0,0,0.14057
333287,Slow Learners,2015-08-19,2015,0,0,0,1.452617
333295,Uncertain,2017-03-09,2017,0,0,0,0.415139
333318,Scherzo Diabolico,2015-04-16,2015,0,0,0,0.378619
333324,A House of Secrets: Exploring 'Dragonwyck',2008-09-09,2008,0,0,0,0.004707
333344,Dirty Weekend,2015-09-04,2015,0,0,0,2.963863
333346,The Emperor's New Clothes,2015-04-24,2015,0,0,0,1.026667
333348,Love the Coopers,2015-11-12,2015,17000000,42426912,25426912,5.660649
333350,A Faster Horse,2015-10-08,2015,0,0,0,0.740328
333352,Eye in the Sky,2015-09-11,2015,13000000,18704595,5704595,10.564701
333354,Extortion,2017-01-02,2017,0,0,0,12.593368
333356,What Our Fathers Did: A Nazi Legacy,2015-04-19,2015,0,0,0,0.590079
333358,Better Off Single,2016-10-07,2016,0,0,0,1.044526
333360,Peggy Guggenheim: Art Addict,2015-11-06,2015,0,0,0,0.387788
333367,Sky,2015-09-16,2015,0,0,0,1.563618
333371,10 Cloverfield Lane,2016-03-10,2016,15000000,108286421,93286421,14.421528
333372,"Wings, Legs and Tails",1986-01-01,1986,0,0,0,0.304628
333375,Prescription Thugs,2016-01-22,2016,0,0,0,0.60305
333377,Requiem for the American Dream,2015-04-18,2015,0,44695,44695,2.203671
333381,Return to Sender,2015-05-31,2015,0,0,0,5.814583
333382,Thought Crimes,2015-05-11,2015,0,0,0,0.516172
333384,Lowriders,2017-04-28,2017,916000,2403885,1487885,4.612622
333385,Mr. Right,2016-02-29,2016,8000000,34694,-7965306,7.317816
333386,The Duel,2016-06-24,2016,10000000,4500,-9995500,5.927867
333387,The Wannabe,2015-12-04,2015,0,0,0,2.881769
333484,The Magnificent Seven,2016-09-14,2016,90000000,162360636,72360636,13.809622
333516,S√§√§list√§j√§t,2014-11-22,2014,0,0,0,0.017672
333545,Road Wars,2015-05-05,2015,0,0,0,1.24917
333555,Schneider vs. Bax,2015-05-28,2015,3000000,0,-3000000,2.076154
333590,My Beautiful Dacia,2009-01-01,2009,0,0,0,0.004706
333594,Echoes Of War,2015-05-15,2015,0,0,0,1.522946
333596,Woodlawn,2015-10-15,2015,12000000,14394097,2394097,3.216606
333658,Seeds of Yesterday,2015-04-12,2015,0,0,0,2.867162
333663,War on Everyone,2016-10-07,2016,0,0,0,9.215388
333665,Consumed,2015-06-01,2015,0,0,0,1.596732
333667,Rock Dog,2016-07-08,2016,60000000,9420546,-50579454,6.55207
333669,Bastille Day,2016-04-22,2016,20000000,14397593,-5602407,12.119295
333674,Intruders,2016-01-15,2016,0,0,0,5.428567
333675,Band of Robbers,2016-01-15,2016,0,0,0,2.914586
333678,Fan Girl,2015-12-31,2015,0,0,0,2.292561
333696,Naked Among Wolves,2015-04-01,2015,0,0,0,4.885995
333846,Enclave,2015-03-03,2015,0,0,0,0.663021
333847,Isabella Rossellini's Green Porno Live,2015-05-17,2015,0,0,0,0.135513
333884,La scelta,2015-04-02,2015,0,0,0,1.71044
333886,Lemonade,2015-04-24,2015,0,0,0,0.736792
333888,Tempo instabile con probabili schiarite,2015-04-02,2015,0,0,0,1.008409
333953,Dumpling Brothers,2013-08-29,2013,0,0,0,0.050476
333968,How to Win at Checkers (Every Time),2015-04-03,2015,0,0,0,0.275362
334026,Sun Choke,2015-10-01,2015,0,0,0,1.885819
334028,Some Kind Of Hate,2015-05-02,2015,0,0,0,1.624956
334057,Louis Theroux: By Reason of Insanity,2015-03-22,2015,0,0,0,0.261593
334074,Survivor,2015-05-21,2015,20000000,0,-20000000,15.033568
334088,Curse of the Witching Tree,2015-05-18,2015,0,0,0,0.674552
334130,Open Secret,2013-11-03,2013,0,0,0,0.013061
334132,You Are My Sunshine,2015-04-30,2015,0,0,0,0.983058
334146,Genetic Me,2014-11-06,2014,0,0,0,0.017649
334175,Sicc√Æn,2014-09-26,2014,0,0,0,0.460433
334298,Monster Hunt,2015-07-16,2015,40000000,385284817,345284817,5.361771
334299,Caprice,2015-02-27,2015,0,0,0,2.237834
334304,Belle and Sebastian: The Adventure Continues,2015-12-07,2015,0,0,0,3.245243
334307,Through the Air,2015-06-17,2015,0,0,0,0.999402
334312,The Tournament,2015-04-29,2015,0,0,0,0.747649
334317,D√©sir√©,1993-04-05,1993,0,0,0,0.581963
334328,Live from New York!,2015-04-15,2015,0,0,0,1.983722
334362,Highway to Hellas,2015-08-06,2015,0,0,0,1.30421
334376,Ghost in the Shell: The New Movie,2015-06-20,2015,0,101203,101203,5.518129
334394,Baskin,2015-12-31,2015,0,0,0,4.173011
334440,The Judgement,2014-10-16,2014,0,0,0,0.181335
334449,The Village Had No Walls,1995-04-01,1995,0,0,0,0.003445
334461,Comedy Central Roast of Joan Rivers,2009-08-09,2009,0,0,0,0.843221
334495,The Barkley Marathons: The Race That Eats Its Young,2014-10-26,2014,0,0,0,2.276543
334517,The Siege of Jadotville,2016-09-19,2016,0,0,0,6.042021
334521,Free Fire,2017-03-31,2017,10000000,3565109,-6434891,10.403003
334522,Alone in Berlin,2016-09-29,2016,0,33125,33125,4.647236
334524,Gold,2016-12-22,2016,20000000,7227038,-12772962,16.01076
334527,Criminal Activities,2015-11-20,2015,7000000,0,-7000000,12.579261
334531,My All American,2015-11-13,2015,20000000,0,-20000000,2.664286
334532,100 Streets,2016-11-11,2016,0,0,0,6.195956
334533,Captain Fantastic,2016-07-02,2016,5000000,5879736,879736,16.519276
334534,Louis Theroux: Transgender Kids,2015-04-05,2015,0,0,0,0.217053
334535,The Ticket,2017-04-07,2017,0,0,0,5.803266
334536,The Blackcoat's Daughter,2015-11-20,2015,0,19980,19980,4.950329
334538,Into the Forest,2016-06-03,2016,0,0,0,7.54965
334541,Manchester by the Sea,2016-11-18,2016,9000000,75026965,66026965,12.821257
334543,Lion,2016-11-24,2016,12000000,140302754,128302754,17.085145
334557,Port of Call,2015-11-13,2015,5000000,0,-5000000,2.226677
334629,The Wonderful Wizard of Oz: 50 Years of Magic,1990-02-20,1990,0,0,0,0.009036
334651,De feu et de glace,2008-11-08,2008,0,0,0,0.669449
334670,Gayby Baby,2015-04-29,2015,0,0,0,0.527187
334679,All Work All Play: The Pursuit of eSports Glory Live,2015-04-20,2015,0,0,0,0.382638
334681,Among the Believers,2015-04-16,2015,0,0,0,0.487041
334682,A Ballerina's Tale,2015-10-14,2015,0,0,0,1.345929
334742,Fractured,2015-04-17,2015,0,0,0,0.482626
334795,The End of a Vacation,1986-01-01,1986,0,0,0,0.0
334878,Blind Date,2015-05-06,2015,0,0,0,4.848466
334889,The Break-In,2016-02-05,2016,0,0,0,0.06616
334890,The Schoolboy,2015-04-11,2015,0,0,0,1.358252
334894,Nightmare Code,2014-01-01,2014,0,0,0,0.243615
334918,The White Knights,2016-01-20,2016,0,0,0,1.148314
334922,Sparrows,2015-05-13,2015,0,0,0,0.504563
334924,The Treasure,2015-06-02,2015,0,33508,33508,1.534354
334930,Insanity,2014-11-19,2014,0,0,0,1.177078
334939,Sword of D'Artagnan,2015-06-24,2015,0,0,0,0.906563
334991,Journey to the Shore,2015-09-30,2015,0,0,0,1.081604
335026,Day One,2015-04-16,2015,0,0,0,0.280555
335031,¬°Asu Mare! 2,2015-04-09,2015,0,0,0,0.200219
335051,God Willing,2015-04-09,2015,0,0,0,3.599743
335053,My Big Night,2015-10-23,2015,4000000,0,-4000000,3.502256
335077,Battle For SkyArk,2015-05-18,2015,0,0,0,7.795204
335138,Radical Grace,2015-04-28,2015,0,0,0,0.022724
335141,Bob le magnifique,1998-01-01,1998,0,0,0,0.001648
335145,Let It Be Me,1995-11-17,1995,0,0,0,0.755295
335201,Signer's Suitcase,1995-04-10,1995,0,0,0,0.001177
335205,Sorry I Love You,2013-11-01,2013,0,0,0,0.083546
335209,Doctor Who: Voyage of the Damned,2007-12-25,2007,0,0,0,1.654309
335251,The Land Where the Blues Began,,,0,0,0,0.0
335310,Being Canadian,2015-09-18,2015,0,0,0,5.010009
335340,Le Rebelle,1980-11-12,1980,0,0,0,0.065675
335392,Religion In Crisis,2015-04-10,2015,0,0,0,0.237711
335409,Sharkansas Women's Prison Massacre,2015-11-04,2015,600000,0,-600000,3.812053
335430,Makeup Room,2015-02-20,2015,0,0,0,0.05488
335450,Life of the Party,1920-11-21,1920,0,0,0,0.001179
335462,Wolf Warrior,2015-04-02,2015,12000000,80000000,68000000,2.162781
335490,The Idealist,2015-04-09,2015,2907868,0,-2907868,1.756551
335498,The Penalty,1941-03-13,1941,0,0,0,0.001694
335509,Below the Sea,1933-03-28,1933,0,0,0,0.023666
335578,Land of Mine,2015-12-03,2015,5070773,0,-5070773,8.121072
335582,A God Without a Universe,2015-05-28,2015,0,0,0,0.159817
335640,The Deal,2015-03-12,2015,0,0,0,0.996272
335676,Aurora,2016-06-10,2016,0,0,0,0.453891
335683,Miraklet i Viskan,2015-04-17,2015,0,0,0,0.079065
335724,Territory,2015-04-16,2015,0,0,0,1.30755
335753,The Amityville Playhouse,2015-06-23,2015,0,0,0,0.712917
335778,Risen,2016-02-19,2016,20000000,46069568,26069568,8.759801
335791,When the Bough Breaks,2016-09-09,2016,10000000,30658387,20658387,17.046052
335796,Ouija: Origin of Evil,2016-10-20,2016,9000000,81705746,72705746,10.182974
335797,Sing,2016-11-23,2016,75000000,632443719,557443719,20.045673
335805,Faith of Our Fathers,2015-07-01,2015,0,0,0,0.547615
335819,B/W,2015-03-19,2015,0,358590,358590,1.078148
335837,Therapy for a Vampire,2014-12-19,2014,0,0,0,1.08423
335866,Circle,2015-10-02,2015,0,0,0,6.735649
335869,This Isn't Funny,2015-11-06,2015,0,0,0,0.417405
335872,Killer Crush,2015-04-04,2015,0,0,0,0.964223
335874,Childless,2015-04-03,2015,0,0,0,0.428473
335897,The Unemployment Club,2003-08-15,2003,0,0,0,0.007449
335970,Joe Dirt 2: Beautiful Loser,2015-07-16,2015,0,0,0,4.625603
335988,Transformers: The Last Knight,2017-06-21,2017,260000000,604942143,344942143,39.186819
336000,The Glass Castle,2017-08-10,2017,0,9705840,9705840,7.892689
336004,Heist,2015-11-13,2015,8900000,4100000,-4800000,8.476315
336011,White Girl,2016-09-02,2016,700000,200242,-499758,6.021721
336018,Finding Gast√≥n,2014-03-20,2014,0,0,0,0.01533
336026,Little Forest: Winter/Spring,2015-01-28,2015,0,0,0,2.210696
336029,A Tale of Love and Darkness,2015-09-03,2015,4000000,0,-4000000,3.212952
336033,Break Free,2014-07-14,2014,0,0,0,0.377272
336050,Son of Saul,2015-06-11,2015,1000000,1777043,777043,6.403937
336055,Office,2015-09-03,2015,0,0,0,0.967907
336118,Down Here,2014-01-01,2014,0,0,0,0.372993
336121,Girl on the Edge,2015-02-23,2015,0,0,0,3.24433
336149,Arthur & Merlin,2015-04-17,2015,3000000,0,-3000000,0.868019
336167,Private Number,2015-05-01,2015,0,0,0,1.692988
336199,Macadam Stories,2015-05-17,2015,0,0,0,3.041967
336203,Masaan,2015-05-19,2015,0,0,0,3.042652
336206,The High Sun,2015-05-12,2015,0,0,0,1.129184
336211,Tanu Weds Manu Returns,2015-05-22,2015,0,0,0,1.055322
336212,Nahid,2016-01-07,2016,0,0,0,1.446837
336216,One Floor Below,2015-10-07,2015,0,0,0,0.271885
336220,The Other Side,2015-11-25,2015,0,0,0,0.528407
336222,Rams,2015-05-28,2015,0,0,0,3.148711
336251,California City,2014-10-24,2014,0,0,0,0.104996
336265,The Mind's Eye,2015-08-05,2015,0,0,0,1.703803
336268,Rosenwald,2015-04-19,2015,0,0,0,0.023087
336271,The Dark Stranger,2016-07-15,2016,0,0,0,0.807172
336307,Love Me!,2014-10-22,2014,0,0,0,0.453372
336313,Hell & Back,2015-10-02,2015,0,157768,157768,5.571253
336380,Je Vous Aime,1891-01-01,1891,0,0,0,0.212894
336445,Army of One,2016-11-04,2016,0,0,0,5.274165
336455,Viral,2016-02-18,2016,0,551760,551760,6.944764
336484,–ö–∞–º–µ–Ω–Ω–∞—è –±–∞—à–∫–∞,2008-09-18,2008,0,0,0,0.114133
336544,Princes of the Yen,2014-11-05,2014,0,0,0,0.337719
336549,Choice of Purpose,1975-01-01,1975,0,0,0,1.163124
336560,Lake Placid vs. Anaconda,2015-04-25,2015,0,0,0,2.123698
336652,Two Friends,2015-09-23,2015,0,0,0,2.591979
336655,D√©grad√©,2015-05-17,2015,0,0,0,0.144933
336660,Mediterranea,2015-09-02,2015,0,0,0,1.299649
336663,Neither Heaven Nor Earth,2015-09-30,2015,0,0,0,0.917331
336664,Paulina,2015-06-18,2015,0,0,0,1.046181
336666,Sleeping Giant,2015-05-14,2015,0,0,0,0.437906
336669,Land and Shade,2015-05-18,2015,0,0,0,1.347626
336681,Amor Imposs√≠vel,2015-12-24,2015,0,0,0,0.559961
336691,Paternity Leave,2015-11-24,2015,0,0,0,0.448056
336735,Lakeer - Forbidden Lines,2004-05-14,2004,0,0,0,0.087731
336736,Chris D'Elia: Incorrigible,2015-04-17,2015,0,0,0,0.684656
336744,Coin Locker Girl,2015-04-29,2015,0,0,0,2.43313
336775,All-Stars,2014-10-15,2014,608000,0,-608000,0.610104
336776,Love & Peace,2015-06-26,2015,0,0,0,0.390047
336804,Mustang,2015-06-17,2015,1300000,250000,-1050000,6.49255
336805,Much Loved,2015-09-16,2015,0,0,0,3.319995
336806,The Here After,2015-01-20,2015,0,0,0,1.416633
336807,Fatima,2015-10-07,2015,0,0,0,1.986733
336808,Embrace of the Serpent,2015-05-25,2015,1400000,1320005,-79995,5.061041
336811,Les Cowboys,2015-05-21,2015,0,0,0,2.985745
336845,Cleveland Abduction,2015-05-02,2015,0,0,0,7.60305
336850,The Encounter,2015-05-05,2015,0,0,0,1.285409
336882,The Wave,2015-08-28,2015,5904067,12975143,7071076,6.982302
336884,Dark Woods II,2015-10-09,2015,0,0,0,1.395306
336885,Returning Home,2015-02-27,2015,0,0,0,0.181902
336890,Goon: Last of the Enforcers,2017-03-17,2017,0,0,0,6.365691
336956,A.D. The Bible Continues,2015-04-05,2015,0,0,0,0.023268
336970,True Siblings,2000-09-13,2000,0,0,0,2.364355
336972,A Sinner in Mecca,2015-04-29,2015,0,0,0,0.249371
337012,The Legend of Longwood,2014-11-16,2014,0,0,0,0.118119
337014,I bambini sanno,2015-04-23,2015,0,0,0,0.426314
337029,Frankenstein,2015-10-30,2015,0,0,0,10.168119
337073,Almost Mercy,2015-01-01,2015,0,0,0,0.533634
337075,The Alchemist's Letter,2015-04-21,2015,0,0,0,0.436531
337085,Estranged,2015-08-28,2015,0,0,0,1.908936
337101,El bosque de Karadima,2015-04-23,2015,0,0,0,0.279202
337104,Chronic,2015-10-21,2015,0,0,0,2.858077
337107,Valley of Love,2015-06-17,2015,0,0,0,1.6833
337115,Alias Maria,2015-04-03,2015,0,0,0,0.308206
337154,The Meddler,2016-04-05,2016,3200000,4267218,1067218,5.510288
337208,Cowboys vs. Dinosaurs,2015-05-19,2015,0,0,0,1.121188
337210,Just About Famous,2015-04-21,2015,0,0,0,0.092631
337218,Wild in Blue,2014-05-05,2014,0,0,0,0.494769
337339,The Fate of the Furious,2017-04-12,2017,250000000,1238764765,988764765,48.573287
337405,Jim Norton: Contextually Inadequate,2015-04-24,2015,0,0,0,0.282009
337412,John Apple Jack,2013-11-29,2013,0,0,0,0.057986
337435,Cuckoo in a Dark Forest,1986-05-09,1986,0,0,0,0.163995
337456,Agadbam,2010-10-08,2010,0,0,0,0.006053
337473,Sugar Coated,2015-04-25,2015,0,0,0,0.346089
337549,The C-Word,2015-05-03,2015,0,0,0,0.490042
337550,Flatland,2007-01-01,2007,0,0,0,0.343896
337641,Naked,2014-11-07,2014,0,0,0,0.026183
337663,Tooken,2015-05-26,2015,0,0,0,1.357121
337674,Elle,2016-05-25,2016,9804690,2341534,-7463156,8.226065
337677,Microbe and Gasoline,2015-07-08,2015,0,63802,63802,2.388952
337703,The Red Turtle,2016-06-29,2016,0,921974,921974,12.874084
337730,French Blood,2015-06-10,2015,0,0,0,1.593745
337747,Texas Rising,2015-05-25,2015,0,0,0,0.895272
337751,The Secret Life of Marilyn Monroe,2015-05-30,2015,0,0,0,0.882126
337758,Honey Night,2015-04-17,2015,0,0,0,0.601453
337789,"C'mon, Let's Live a Little",1967-03-03,1967,0,0,0,0.00118
337844,In Dubious Battle,2017-02-17,2017,15000000,0,-15000000,12.514865
337874,Goat,2016-09-23,2016,0,23020,23020,2.523707
337876,Gabbar Is Back,2015-05-01,2015,11000000,41000000,30000000,1.812728
337879,Sorrow,2015-04-21,2015,0,0,0,0.122062
337944,Southern Rites,2015-05-18,2015,0,0,0,0.383368
337958,Last Cab to Darwin,2015-08-06,2015,0,0,0,2.303824
337960,Holding the Man,2015-08-27,2015,0,0,0,4.766482
337965,The Great Alone,2015-04-25,2015,0,0,0,0.097444
338063,Drag Becomes Him,2015-04-29,2015,0,0,0,0.069603
338065,Dil Dhadakne Do,2015-06-05,2015,13000000,22000000,9000000,2.337434
338072,A Bell for Ursli,2015-10-15,2015,0,0,0,0.764131
338079,Basta Poco,2015-04-29,2015,0,0,0,0.129853
338100,Grace Stirs Up Success,2015-06-23,2015,0,0,0,0.752735
338107,Chocolate City,2015-05-22,2015,0,0,0,1.32701
338189,It's Only the End of the World,2016-08-26,2016,0,0,0,11.864584
338227,Women vs. Men,2015-04-01,2015,0,0,0,1.393948
338234,The Livingston Gardener,2015-05-15,2015,0,0,0,0.184075
338273,Antarctica: Ice & Sky,2015-10-21,2015,0,0,0,0.649671
338309,The Spin Kid,2011-11-11,2011,0,0,0,0.048028
338312,Argo 2,2015-04-30,2015,0,0,0,0.4994
338353,Dennis Rodman's Big Bang in PyongYang,2015-01-25,2015,0,0,0,0.597879
338381,10 Billion: What's On Your Plate,2015-04-16,2015,0,0,0,0.097288
338387,Youth in Oregon,2017-02-03,2017,0,0,0,2.640601
338421,Wild City,2015-07-25,2015,0,0,0,0.439886
338438,The Invincible Masked Rider,1963-03-29,1963,0,0,0,0.014994
338485,"Signed, Sealed, Delivered: From Paris With Love",2015-06-06,2015,0,0,0,1.082366
338517,The Dawns Here Are Quiet,2015-04-30,2015,3300000,5249225,1949225,4.445867
338518,Age Of Kill,2015-06-15,2015,0,0,0,0.227199
338544,For the Love of Spock,2016-09-09,2016,0,0,0,3.087962
338546,The Enfield Haunting,2015-05-03,2015,0,0,0,0.965857
338614,Unbranded,2015-04-25,2015,0,0,0,0.141191
338676,Extinction,2015-08-07,2015,0,0,0,6.171657
338679,Beep: A Documentary History of Game Sound,2016-04-04,2016,0,0,0,0.115946
338689,Nate Bargatze: Full Time Magic,2015-04-28,2015,0,0,0,0.192167
338729,The Beauty Inside,2015-08-20,2015,0,108083,108083,2.978534
338766,Hell or High Water,2016-08-12,2016,12000000,37589296,25589296,12.565896
338767,From The Depths of My Heart,2015-05-08,2015,0,0,0,0.286933
338803,The Treacherous,2015-05-21,2015,0,0,0,4.015952
338853,Tokio Baby,2010-01-01,2010,0,0,0,0.041176
338913,Bill,2015-08-21,2015,0,0,0,1.400383
338928,He Named Me Malala,2015-09-12,2015,0,2642899,2642899,2.20137
338930,Loham,2015-08-20,2015,1050255,2250547,1200292,0.633653
338964,Bad Santa 2,2016-11-23,2016,26000000,17782178,-8217822,7.459161
339060,The Cokeville Miracle,2015-06-05,2015,0,0,0,1.352889
339065,The True Cost,2015-05-29,2015,0,0,0,2.796878
339077,Lovemilla,2015-02-06,2015,0,0,0,1.230719
339079,A Country Called Home,2015-06-13,2015,0,0,0,2.09366
339116,Maximum Ride,2016-09-30,2016,0,0,0,4.055025
339145,The Girl in the Book,2015-06-13,2015,0,0,0,3.28083
339148,Already Tomorrow in Hong Kong,2015-06-12,2015,0,0,0,2.326132
339152,The Babushkas of Chernobyl,2015-06-14,2015,0,0,0,0.751381
339161,Catching the Sun,2015-06-12,2015,0,0,0,0.03158
339274,Tamasha,2015-11-27,2015,0,0,0,1.653733
339312,A Nightingale Falling,2014-09-12,2014,0,0,0,0.312981
339320,Red Passport,2003-09-20,2003,0,0,0,0.003375
339327,Industrial Soundtrack for the Urban Decay,2015-05-08,2015,0,0,0,0.091919
339339,A Tale of Two Thieves,2014-04-12,2014,0,0,0,0.086024
339342,Anarchy Parlor,2015-01-01,2015,0,0,0,3.257999
339350,By Our Selves,2015-10-01,2015,0,0,0,0.061269
339355,Larry Gaye: Renegade Male Flight Attendant,2015-06-05,2015,0,0,0,0.69891
339362,SuperBob,2015-10-16,2015,0,0,0,1.680426
339367,Hamari Adhuri Kahani,2015-06-12,2015,0,0,0,0.489781
339396,True Memoirs of an International Assassin,2016-11-11,2016,40000000,0,-40000000,5.830839
339397,Caf√© Society,2016-05-11,2016,30000000,43763247,13763247,9.2467
339403,Baby Driver,2017-06-28,2017,34000000,224511319,190511319,228.032744
339405,Christine,2016-10-14,2016,0,0,0,8.403532
339408,The Birth of a Nation,2016-09-09,2016,8500000,15861566,7361566,5.933047
339419,Loving,2016-11-04,2016,9000000,8996802,-3198,7.977391
339428,Happy Weekend,1996-03-14,1996,0,65335,65335,0.002229
339445,Henry Miller Asleep & Awake,1975-02-14,1975,0,0,0,2.2e-05
339526,The Land Before Time XIV: Journey of the Brave,2016-02-02,2016,0,0,0,1.987829
339527,Solace,2015-09-03,2015,0,22586863,22586863,12.642675
339530,Tremors 5: Bloodlines,2015-10-06,2015,0,0,0,12.95779
339533,San Andreas Quake,2015-05-19,2015,0,0,0,4.260681
339547,Jeruzalem,2016-01-22,2016,0,0,0,7.410228
339562,To the Fore,2015-08-06,2015,0,0,0,1.268551
339669,Blinky Bill the Movie,2015-08-21,2015,12796917,0,-12796917,2.042545
339692,Shot Caller,2017-07-13,2017,0,0,0,15.786854
339739,Henry Gamble's Birthday Party,2015-12-20,2015,0,0,0,2.169304
339749,Saber Marionette R,1995-05-21,1995,0,0,0,0.001258
339751,Hitchcock/Truffaut,2015-09-04,2015,0,0,0,3.178725
339790,Burroughs: The Movie,1983-10-08,1983,0,0,0,0.401106
339792,David Brent: Life on the Road,2016-08-19,2016,0,0,0,4.341522
339846,Baywatch,2017-05-12,2017,69000000,177856751,108856751,35.637691
339888,Tyke Elephant Outlaw,2015-06-04,2015,0,0,0,0.248179
339894,The Burrow,2015-07-09,2015,0,0,0,0.394109
339927,Kevin Hart: What Now ?,2016-10-14,2016,0,0,0,5.59613
339928,Once I Was a Beehive,2015-08-14,2015,0,732655,732655,0.987209
339934,Steve McQueen: The Man & Le Mans,2015-05-16,2015,0,0,0,0.673276
339944,Secret Society of Souptown,2015-05-15,2015,1,0,-1,1.278335
339964,Valerian and the City of a Thousand Planets,2017-07-20,2017,197471676,90024292,-107447384,15.262706
339967,Colossal,2017-04-06,2017,0,3021345,3021345,25.373662
339984,Miracles from Heaven,2016-03-17,2016,16000000,73883359,57883359,7.528099
339987,The Exception,2017-06-02,2017,0,0,0,6.472434
339988,The Circle,2017-04-27,2017,18000000,20497844,2497844,88.439243
339992,The Redwood Massacre,2014-09-28,2014,156660,0,-156660,1.128292
339994,The Good Neighbor,2016-09-16,2016,0,0,0,6.049596
340027,Brain on Fire,2017-02-22,2017,0,0,0,4.341687
340053,Orson Welles: Shadows & Light,2015-05-09,2015,0,0,0,0.0656
340101,Their Finest,2017-04-06,2017,32745300,12173470,-20571830,17.958512
340103,The Monster,2016-11-11,2016,2700000,0,-2700000,6.533171
340119,Nomi e cognomi,2015-05-14,2015,0,0,0,0.107041
340155,–ò–≥—Ä–∞ –Ω–∞ –≤—ã–±—ã–≤–∞–Ω–∏–µ,,,0,0,0,0.035294
340176,Tag,2015-07-11,2015,0,0,0,2.913197
340187,Uncaged,2016-02-06,2016,0,0,0,2.018219
340190,Drunk Wedding,2015-05-22,2015,0,0,0,0.683918
340194,A Year and Change,2015-11-24,2015,0,0,0,0.286902
340210,Condition Red,1995-12-08,1995,0,0,0,0.793932
340213,Darkest Day,2015-05-15,2015,0,0,0,1.239071
340215,Dusk,2016-05-24,2016,0,0,0,1.753419
340223,Harry & Snowman,2015-01-01,2015,0,0,0,0.198311
340224,"Hello, My Name Is Frank",2014-01-01,2014,0,0,0,0.035052
340230,Legacy,2015-06-19,2015,0,0,0,1.075807
340243,All Mistakes Buried,2015-05-14,2015,0,0,0,0.244223
340255,Welcome to Happiness,2015-04-27,2015,0,0,0,1.580786
340275,Chi-Raq,2015-12-04,2015,0,0,0,12.023704
340357,April and the Extraordinary World,2015-11-04,2015,0,0,0,5.73874
340382,Attack on Titan II: End of the World,2015-09-01,2015,0,0,0,4.300416
340401,Potato Salad: Don't Ask!,2015-07-23,2015,0,0,0,2.51729
340402,Almost Christmas,2016-11-11,2016,17000000,42487325,25487325,7.288877
340481,The Unknown Girl,2016-10-05,2016,0,0,0,4.707286
340484,Kate Plays Christine,2016-01-24,2016,0,0,0,0.624857
340485,American Honey,2016-09-30,2016,0,1751330,1751330,7.78179
340487,Certain Women,2016-09-25,2016,0,1130466,1130466,11.684425
340488,Salt and Fire,2016-11-17,2016,0,0,0,2.264631
340543,Vivien Leigh: Scarlett And Beyond,1990-05-17,1990,0,0,0,0.001359
340584,Lavender,2017-03-03,2017,0,0,0,3.528884
340611,Indignation,2016-07-29,2016,0,0,0,4.971211
340616,Baden Baden,2016-11-25,2016,0,0,0,1.241971
340627,Ayanda,2015-06-13,2015,0,0,0,0.183751
340666,Nocturnal Animals,2016-11-04,2016,22500000,29252978,6752978,18.908782
340676,Personal Shopper,2016-10-19,2016,6000000,1305195,-4694805,11.186981
340677,I.T.,2016-09-09,2016,13000000,0,-13000000,21.815354
340684,Those People,2015-05-16,2015,0,0,0,3.077948
340712,Gabo: The Creation of Gabriel Garcia Marquez,2015-04-12,2015,0,19337,19337,0.057737
340746,The Chronicles of Evil,2015-05-14,2015,0,0,0,1.070169
340753,Sunset Edge,2015-05-29,2015,0,0,0,0.066636
340785,Jim Breuer: Comic Frenzy,2015-05-29,2015,0,0,0,0.073011
340816,Christmas Eve,2015-12-04,2015,0,0,0,2.36446
340837,A Cure for Wellness,2017-02-15,2017,40000000,26559557,-13440443,13.28436
340856,Seinfeld: How It Began,2004-11-23,2004,0,0,0,0.334085
340881,About Scout,2015-04-25,2015,0,0,0,0.515234
340937,The Father's Love,2014-08-20,2014,0,0,0,0.07104
340945,USS Indianapolis: Men of Courage,2016-09-22,2016,40000000,0,-40000000,13.417585
340961,Copacabana Palace,1962-11-03,1962,0,0,0,0.385288
341006,The Belko Experiment,2016-03-17,2016,5000000,0,-5000000,15.352467
341007,3 Braves,2015-05-21,2015,143149,645135,501986,0.091951
341012,Popstar: Never Stop Never Stopping,2016-06-03,2016,0,9496130,9496130,5.28542
341013,Atomic Blonde,2017-07-26,2017,30000000,90007945,60007945,14.455104
341045,Bolshoi Babylon,2015-01-01,2015,0,0,0,1.39876
341050,Convergence,2015-01-01,2015,0,0,0,2.743509
341051,Deep Dark,2015-01-01,2015,0,0,0,1.154928
341077,Tiger House,2015-08-24,2015,0,0,0,4.563906
341106,Ingrid Bergman: In Her Own Words,2015-05-19,2015,0,0,0,1.847581
341174,Fifty Shades Darker,2017-02-08,2017,55000000,378827494,323827494,29.130443
341176,Jen Kirkman: I'm Gonna Die Alone (And I Feel Fine),2015-05-22,2015,0,0,0,0.528489
341178,Dangerous Company,2015-08-15,2015,0,0,0,0.395692
341201,Great Transport,1983-07-04,1983,0,0,0,0.165915
341366,Sherpa,2015-06-07,2015,0,0,0,2.590546
341392,Lolo,2015-09-03,2015,0,24134,24134,6.117335
341420,Demonte Colony,2015-05-22,2015,0,0,0,0.918321
341443,Vampire in Love,2015-04-17,2015,0,0,0,1.185717
341445,One Hundredth of a Second,2006-08-21,2006,0,0,0,0.1779
341490,As in Heaven,1992-08-29,1992,0,0,0,0.035294
341491,Tears of Stone,1995-09-15,1995,0,0,0,0.07586
341517,Seven Songs from the Tundra,2000-02-18,2000,0,0,0,0.635972
341559,Red Dust,1999-10-14,1999,0,0,0,0.494935
341689,How to Talk to Girls at Parties,2017-12-27,2017,0,0,0,2.068008
341744,Truman,2015-10-30,2015,0,9027600,9027600,4.778359
341745,Aus Liebe zu Dir,2012-11-09,2012,0,0,0,0.009467
341886,June,2015-08-01,2015,0,0,0,2.285686
341895,Premam,2015-05-29,2015,6200000,11000000,4800000,0.81609
341957,21 Days,2014-01-01,2014,0,0,0,0.173695
341962,Stavitel chr√°mu,1920-03-05,1920,0,0,0,0.038658
341984,Back to the Jurassic,2015-06-09,2015,0,0,0,0.98268
342003,Eli,2015-06-19,2015,0,0,0,0.143823
342011,C√°rcel de Mujeres,1951-09-28,1951,0,0,0,0.063012
342021,Perfect Proposal,2015-06-04,2015,0,0,0,1.053136
342052,"Return to the Philippines, the Leon Cooper Story",2015-05-25,2015,0,0,0,0.049112
342163,Sin hijos,2015-05-14,2015,0,0,0,1.7125
342165,Too Late,2016-03-25,2016,0,7000,7000,1.714795
342213,La caliente ni√±a Julietta,1981-03-20,1981,0,591696,591696,0.000464
342218,The Eighth Day,1979-01-13,1979,0,0,0,0.350666
342281,Family For Rent,2015-08-19,2015,0,0,0,6.618931
342381,Bad,1987-08-31,1987,2000000,0,-2000000,1.925278
342464,Jack of the Red Hearts,2015-05-06,2015,0,0,0,1.416942
342472,1 Mile to You,2017-04-07,2017,0,0,0,1.668699
342473,Ballerina,2016-12-14,2016,30000000,2351359,-27648641,16.53732
342474,Jenny's Wedding,2015-07-31,2015,0,0,0,4.886524
342502,AWOL-72,2015-08-07,2015,3000000,0,-3000000,1.264454
342521,Keanu,2016-04-21,2016,15000000,20566327,5566327,7.942084
342546,Nick Swardson: Taste It,2015-05-25,2015,0,0,0,0.098582
342550,You Carry Me,2015-05-25,2015,0,0,0,0.198948
342562,Tiny Giants 3D,2014-05-24,2014,0,0,0,0.597164
342588,Empire of Corpses,2015-10-02,2015,0,0,0,0.933088
342657,The Silenced,2015-06-18,2015,0,0,0,2.065367
342672,4th Man Out,2016-02-05,2016,0,0,0,3.843861
342684,Vulcania,2015-10-16,2015,0,0,0,0.157839
342686,Killed by Lightning,2002-06-27,2002,0,0,0,0.118265
342695,Cannibal Fog,2015-04-11,2015,0,0,0,0.029662
342737,20th Century Women,2016-12-25,2016,7000000,5816211,-1183789,9.855927
342765,Carte Blanche,2015-01-23,2015,0,0,0,0.314174
342786,Rubble Kings,2015-06-19,2015,0,0,0,1.750743
342831,Sherlock Holmes,1916-06-30,1916,0,0,0,0.096912
342850,The Prince of Chess,2005-03-19,2005,0,0,0,0.002353
342878,One Wild Moment,2015-06-24,2015,0,0,0,7.862844
342896,I-Lived,2015-07-03,2015,0,0,0,0.509913
342917,Batman Unlimited: Monster Mayhem,2015-08-18,2015,0,0,0,2.772324
342925,Everything Before Us,2015-06-03,2015,0,0,0,0.644057
342927,3-Headed Shark Attack,2015-07-20,2015,0,0,0,3.677281
343010,The American Side,2016-04-14,2016,0,0,0,2.03344
343018,American Sharia,2015-02-01,2015,0,0,0,0.057365
343042,Embassy,1972-10-06,1972,0,0,0,0.000813
343043,Odyssey in Rome,2005-09-30,2005,0,0,0,0.11153
343059,Hollywood Adventures,2015-06-26,2015,0,0,0,0.29912
343070,Flight World War II,2015-06-02,2015,0,0,0,0.537919
343112,Man Vs.,2015-06-02,2015,1500000,0,-1500000,0.494847
343140,Office,2015-09-24,2015,0,0,0,1.618777
343173,The ReZort,2016-04-22,2016,0,0,0,4.399489
343227,El pejesapo,,,0,0,0,0.0
343283,I Am Maria,1979-12-15,1979,0,0,0,2.621798
343284,Night Of The Living Deb,2015-08-29,2015,2000000,0,-2000000,4.69124
343289,I Am Evel Knievel,2014-09-10,2014,0,0,0,1.16603
343295,Jeff Ross Roasts Criminals: Live at Brazos County Jail,2015-06-13,2015,0,0,0,0.2281
343304,Sex in the Comix,2012-01-02,2012,0,0,0,0.601682
343369,Love Finds You in Charm,2015-06-06,2015,0,0,0,0.276956
343371,No Way Jose,2015-06-06,2015,0,0,0,1.771705
343426,The Murder Pact,2015-10-09,2015,0,0,0,0.355751
343435,Tukkijoella,1928-11-05,1928,0,0,0,0.039118
343611,Jack Reacher: Never Go Back,2016-10-19,2016,60000000,162146076,102146076,15.60562
343693,Aladin,2008-08-12,2008,0,0,0,0.961941
343702,The Sweet Escape,2015-06-10,2015,0,0,0,2.84509
343724,Identicals,2015-06-20,2015,2004384,0,-2004384,1.090345
343795,90 Minutes in Heaven,2015-09-11,2015,5000000,4842699,-157301,4.222496
343809,That's Not Us,2015-06-21,2015,0,0,0,0.390489
343825,Het is een schone dag geweest,1993-11-04,1993,0,0,0,3.6e-05
343843,Northern Limit Line,2015-06-24,2015,0,0,0,1.258682
343858,Sweet Surrender,2014-07-01,2014,0,0,0,0.613339
343878,An Afternoon,2014-10-06,2014,0,0,0,0.345031
343880,A Murder in the Park,2015-06-26,2015,0,0,0,0.202059
343887,The Last Laugh,2016-04-18,2016,0,0,0,0.315939
343921,A Deadly Adoption,2015-06-20,2015,0,0,0,2.065217
343934,Staten Island Summer,2015-06-30,2015,0,0,0,6.277157
343972,Pecos River,1951-12-15,1951,0,0,0,0.049843
343977,Tom and Jerry Spy Quest,2015-06-09,2015,0,0,0,0.917742
343981,Gascoigne,2015-06-08,2015,0,0,0,1.341622
344039,Len and Company,2015-09-11,2015,0,0,0,0.489224
344041,Standoff,2016-01-04,2016,8000000,0,-8000000,4.662079
344043,Hole,2014-08-14,2014,0,0,0,0.023059
344120,Rabid Dogs,2015-09-30,2015,0,0,0,2.645913
344123,Perfect Match,2015-06-21,2015,0,0,0,0.826013
344147,Sharktopus vs. Whalewolf,2015-07-19,2015,6000000,0,-6000000,2.266007
344170,Only the Dead See The End of War,2015-06-11,2015,0,0,0,0.855416
344255,The Wrong Girl,2015-05-16,2015,0,0,0,0.50045
344277,Caught,2015-06-12,2015,0,0,0,0.48592
344339,'49-'17,1917-10-14,1917,0,0,0,0.281624
344476,The Classified File,2015-06-18,2015,0,0,0,1.178156
344560,Stonemouth,2015-06-08,2015,0,0,0,0.233509
344591,Spiderwebhouse,2015-02-08,2015,0,0,0,0.905246
344593,Cherry Tree,2015-08-04,2015,0,0,0,1.372693
344656,Enemy Empire,2013-12-27,2013,0,0,0,0.411958
344741,Pajƒôczarki,,,0,0,0,0.0
344854,The Pack,2015-08-05,2015,0,0,0,2.169787
344900,Oriented,2015-06-06,2015,0,0,0,0.149029
344906,The Last Heist,2016-06-17,2016,0,0,0,1.888444
345003,10 Days in a Madhouse,2015-11-20,2015,1200000,0,-1200000,1.034954
345009,Mine,2016-10-06,2016,0,0,0,17.029573
345054,Double Daddy,2015-06-06,2015,0,0,0,1.650978
345069,Crush the Skull,2015-06-11,2015,0,0,0,0.88979
345139,Homeland (Iraq Year Zero),2016-02-10,2016,0,0,0,0.247332
345176,Susan Calman: Lady Like,2015-06-17,2015,0,0,0,0.025645
345235,Monk Comes Down the Mountain,2015-07-03,2015,0,0,0,4.371861
345306,The Bartender,2015-06-18,2015,2600000,0,-2600000,0.889558
345323,Unity,2015-08-12,2015,0,0,0,2.500114
345426,Khushi,2003-02-07,2003,0,0,0,0.712619
345438,"Ja, Ik Wil!",2015-10-15,2015,0,0,0,0.529403
345468,Contracted: Phase II,2015-07-05,2015,0,0,0,2.478457
345470,Hector,2015-12-11,2015,0,0,0,1.535347
345489,Meet Me in Venice,2015-07-02,2015,0,0,0,0.410722
345519,The Day the '60s Died,2015-04-28,2015,0,0,0,0.097444
345575,The Saboteurs,2015-01-04,2015,0,0,0,1.064188
345637,Sanjay's Super Team,2015-11-25,2015,0,0,0,4.33573
345661,Salam Neighbor,2015-06-20,2015,0,0,0,0.096894
345664,Mr. Right,2015-07-28,2015,0,0,0,0.723257
345725,A Fool,2015-05-01,2015,0,0,0,0.313224
345727,Pentatonix: On My Way Home,2015-06-18,2015,0,0,0,0.598304
345735,Robbery,2015-07-05,2015,0,0,0,1.005211
345775,Long Way North,2015-12-10,2015,0,0,0,2.528348
345874,Stealing Cars,2016-04-05,2016,0,0,0,1.922711
345875,The Abandoned,2016-01-08,2016,0,0,0,2.932801
345888,The Piper,2015-07-09,2015,0,0,0,0.929163
345896,The American Film Institute Salute to Frank Capra,1982-04-03,1982,0,0,0,3e-06
345906,Panamerican Machinery,2016-02-14,2016,0,0,0,0.03209
345909,Wolves,2016-10-25,2016,0,0,0,4.233209
345911,Lights Out,2016-07-21,2016,4900000,148868835,143968835,11.494907
345913,The Cutting Room,2015-06-01,2015,0,0,0,0.273861
345914,The House,2017-06-29,2017,40000000,0,-40000000,30.146847
345915,Once Upon a Time in Venice,2017-06-08,2017,0,0,0,18.699821
345916,Do You Take This Man,2017-07-07,2017,0,0,0,0.814903
345918,Come and Find Me,2016-11-11,2016,0,0,0,6.435238
345920,Collateral Beauty,2016-12-06,2016,36000000,87416021,51416021,14.575883
345922,Fist Fight,2017-02-16,2017,20000000,0,-20000000,22.831649
345924,The Night Stalker,2016-07-01,2016,0,0,0,1.035997
345925,Rupture,2016-11-04,2016,0,0,0,4.970237
345931,American Poltergeist,2015-05-29,2015,0,0,0,1.370522
345938,The Shack,2017-03-03,2017,20000000,57330873,37330873,16.392712
345944,I Am Chris Farley,2015-07-27,2015,0,0,0,1.919671
346034,3 Idiotas,2017-04-02,2017,0,0,0,0.959942
346079,6 Ways to Die,2015-07-31,2015,0,0,0,1.346481
346093,KillerSaurus,2015-09-06,2015,0,0,0,0.060371
346106,Jeff Ross Roasts America,2012-08-11,2012,0,0,0,0.367808
346134,Miss Stevens,2016-03-12,2016,0,0,0,1.427353
346170,The Chosen,2015-07-23,2015,0,0,0,2.600651
346225,Bleak Street,2015-09-17,2015,0,0,0,0.553966
346239,Heil,2015-07-16,2015,0,0,0,2.236804
346347,"End of Days, Inc.",2015-04-24,2015,0,0,0,0.412805
346384,Chicken,2016-05-20,2016,0,0,0,0.945876
346388,Black Mountain Poets,2016-04-01,2016,0,0,0,1.116962
346401,Daft Punk Unchained,2015-06-24,2015,0,0,0,3.352455
346443,Disco Polo,2015-02-27,2015,0,0,0,0.492468
346469,Eternal Summer,2015-08-21,2015,0,0,0,0.962963
346472,The Zohar Secret,2015-01-01,2015,0,0,0,0.448018
346473,Lisa Lampanelli: Back to the Drawing Board,2015-06-26,2015,0,0,0,0.126769
346489,A Country Wedding,2015-06-27,2015,0,0,0,0.566128
346490,Babai,2015-06-28,2015,2137000,0,-2137000,0.431364
346494,Coconut Hero,2015-08-13,2015,0,0,0,1.889834
346564,In Search of the Ultra-Sex,2015-09-28,2015,0,0,0,0.262111
346570,Perfect High,2015-07-05,2015,0,0,0,1.500092
346592,10 Cent Pistol,2015-07-24,2015,0,0,0,0.778499
346641,The Nightmare,2015-07-01,2015,85876,0,-85876,2.647094
346646,Veteran,2015-08-05,2015,0,1200627,1200627,3.631863
346650,Girlfriend's Day,2017-02-14,2017,0,0,0,5.931844
346651,Pandemic,2016-02-26,2016,0,0,0,6.253285
346672,Underworld: Blood Wars,2016-11-28,2016,35000000,81093313,46093313,20.02976
346681,Wilson,2017-03-24,2017,0,653951,653951,8.984386
346685,The Girl on the Train,2016-10-05,2016,45000000,173185859,128185859,10.217291
346723,Home Care,2015-07-16,2015,0,0,0,0.309123
346755,The Red Spider,2015-07-06,2015,0,0,0,0.482449
346758,The Magic Mountain,2015-07-08,2015,0,0,0,0.40376
346763,Gold Coast,2015-07-02,2015,0,0,0,1.297468
346808,Momentum,2015-08-01,2015,20000000,133332,-19866668,7.895442
346838,The Four Warriors,2015-07-13,2015,0,0,0,0.357815
346873,Marching to Zion,2015-03-26,2015,0,0,0,0.204891
347026,A United Kingdom,2016-11-25,2016,14000000,13819139,-180861,6.249112
347031,Swiss Army Man,2016-06-24,2016,3000000,4210454,1210454,9.196678
347033,Equity,2016-07-29,2016,0,1605463,1605463,2.656999
347035,Swallows and Amazons,2016-08-19,2016,0,0,0,1.935094
347064,Jurassic Prey,2015-06-23,2015,0,0,0,0.687557
347096,Mythica: The Darkspore,2015-06-24,2015,0,0,0,4.680888
347097,Observance,2016-04-03,2016,0,0,0,1.009579
347105,The Best of Insomniac with Dave Attell Volume 1,2003-02-04,2003,0,0,0,0.102172
347106,Best Wishes from Missangertrask,2015-09-25,2015,0,0,0,0.130267
347123,All the Way,2016-05-23,2016,0,0,0,7.631206
347126,God's Not Dead 2,2016-04-01,2016,5000000,23507567,18507567,5.957998
347127,The Charnel House,2016-11-04,2016,0,0,0,0.965521
347155,Las aventuras de Oliver Twist,1987-09-06,1987,0,0,0,0.000117
347157,Syksyll√§ kaikki on toisin,1978-10-05,1978,0,0,0,0.00068
347184,Sharunas Bartas: An Army of One,2010-04-20,2010,0,0,0,0.006052
347201,Boruto: Naruto the Movie,2015-08-07,2015,0,0,0,7.245984
347258,The Subjects,2015-10-08,2015,0,0,0,1.519297
347264,Ralphie May: Imperfectly Yours,2013-02-23,2013,0,0,0,0.338061
347317,Princess,1969-01-01,1969,0,0,0,0.006464
347328,"OMG, I'm a Robot!",2015-08-06,2015,0,0,0,0.091121
347331,Baji,2015-02-06,2015,0,0,0,0.023871
347344,Alena,2016-08-19,2016,0,0,0,1.334644
347382,The One,2015-06-11,2015,1500000,0,-1500000,0.461835
347413,Little Witch Academia: The Enchanted Parade,2015-07-03,2015,625,0,-625,1.464431
347465,ŒöŒªŒ≠œÜœÑŒµœÇ,2007-12-13,2007,0,0,0,0.080801
347495,Inside The Dark Web,2014-09-03,2014,0,0,0,0.092499
347497,Chaos on the Bridge,2015-08-25,2015,0,0,0,1.16084
347528,"Chronic-Con, Episode 420: A New Dope",2015-07-03,2015,0,0,0,0.20562
347548,Containment,2015-07-09,2015,0,0,0,1.498709
347627,I Love You Both,2017-06-09,2017,0,0,0,1.158989
347630,Laid in America,2016-09-26,2016,0,0,0,1.595163
347642,Bite,2015-08-15,2015,0,0,0,2.259175
347647,Traders,2016-03-11,2016,0,0,0,2.144094
347666,We Need to Talk,2016-02-26,2016,0,0,0,1.154832
347669,Stranded,2015-12-31,2015,0,0,0,1.071291
347688,Scooby-Doo! And Kiss: Rock and Roll Mystery,2015-07-10,2015,0,0,0,1.335477
347689,Pee-wee's Big Holiday,2016-03-18,2016,0,0,0,3.64791
347697,Alice in Earnestland,2015-08-13,2015,0,0,0,0.919349
347702,Packed In A Trunk: The Lost Art of Edith Lake Wilkinson,2015-07-20,2015,0,0,0,0.054776
347751,13 Cameras,2015-08-30,2015,0,0,0,3.005423
347752,Road Games,2016-03-04,2016,0,0,0,2.824548
347754,Curve,2015-08-31,2015,0,0,0,4.957058
347757,Worry Dolls,2016-06-27,2016,0,0,0,10.810706
347760,Aaaaaaaah!,2015-08-28,2015,0,0,0,0.743119
347762,Most Likely to Die,2015-08-30,2015,0,0,0,3.443724
347763,The Lesson,2015-08-31,2015,0,0,0,2.63201
347764,Goddess of Love,2015-08-31,2015,0,0,0,1.202176
347767,The Entity,2015-01-22,2015,0,0,0,1.600885
347786,Pioneer Heroes,2015-06-18,2015,500000,0,-500000,0.081696
347807,Fight Club: Members Only,2006-02-17,2006,0,0,0,0.109991
347835,The Real Miyagi,2015-02-20,2015,0,0,0,0.482773
347847,The Sand,2015-08-28,2015,0,0,0,3.035252
347848,Last Girl Standing,2015-08-31,2015,0,0,0,2.411218
347850,The Unfolding,2016-03-14,2016,0,0,0,1.449125
347855,Curtain,2015-11-19,2015,0,0,0,0.936197
347870,Slash,2016-03-13,2016,0,0,0,0.957564
347881,The Confirmation,2016-03-18,2016,0,0,0,5.025097
347882,Sleight,2017-04-28,2017,0,0,0,24.91169
347938,11.22.63,2016-02-15,2016,30000000,0,-30000000,5.791978
347944,Anguish,2015-07-21,2015,0,0,0,1.57501
347945,Synchronicity,2015-07-22,2015,0,4505,4505,7.37661
347968,One Minute Time Machine,2014-03-29,2014,1000,0,-1000,1.783273
347969,The Ridiculous 6,2015-12-11,2015,60000000,0,-60000000,6.287086
347979,Horoscope for Good Luck,2015-07-16,2015,2800000,964206,-1835794,0.502326
347981,Winds,2013-06-21,2013,0,0,0,0.236659
348025,Families,2015-10-14,2015,0,0,0,3.052225
348035,Chris Tucker Live,2015-07-10,2015,0,0,0,1.424643
348060,Antigang,2015-08-19,2015,0,0,0,5.748885
348069,Capital C,2015-09-24,2015,0,0,0,0.105402
348089,Grease Live,2016-01-31,2016,0,0,0,4.456394
348090,The Black Kung Fu Experience,2012-09-22,2012,0,0,0,0.080002
348138,Breathing Room,1996-11-08,1996,0,0,0,0.028988
348150,Jim Henson‚Äôs Turkey Hollow,2015-11-21,2015,0,0,0,0.625631
348191,Leviathan: The Story of Hellraiser and Hellbound: Hellraiser II,2015-06-18,2015,0,0,0,1.30706
348273,Finale,2007-07-17,2007,0,0,0,0.703549
348295,The Laundryman,2015-08-20,2015,0,0,0,0.063953
348296,The Bad Education Movie,2015-08-21,2015,0,0,0,2.458948
348315,Clean Hands,2015-09-10,2015,0,0,0,1.080247
348320,Scream Week,2016-01-28,2016,0,0,0,0.959927
348346,Lethal Seduction,2015-07-11,2015,0,0,0,1.668234
348375,Adama,2015-10-21,2015,0,0,0,2.135199
348389,Stratton,2017-07-06,2017,0,0,0,2.876994
348390,Confirmation,2016-04-16,2016,0,0,0,4.63267
348391,Speech & Debate,2017-04-07,2017,0,0,0,1.506112
348396,Ave Maria,2015-05-18,2015,0,0,0,0.452077
348499,Bad Night,2015-07-21,2015,0,0,0,2.278038
348507,Breaking the Silence,1992-01-14,1992,0,0,0,1e-06
348528,This Is Not an Exit: The Fictional World of Bret Easton Ellis,1998-08-23,1998,0,869,869,0.63482
348537,Spanish Affair 2,2015-11-20,2015,4500000,0,-4500000,4.941645
348544,Roanoke: The Lost Colony,2007-05-15,2007,0,0,0,0.00353
348574,Annie's Garden,1997-10-14,1997,0,0,0,0.011778
348601,Bridget Everett: Gynecological Wonder,2015-07-11,2015,0,0,0,0.104703
348611,Sister Cities,2016-09-17,2016,0,0,0,1.846995
348631,Gourmet Detective: A Healthy Place to Die,2015-08-02,2015,0,0,0,2.491969
348634,A Christmas Detour,2015-12-01,2015,0,0,0,1.933367
348668,A Conspiracy of Faith,2016-03-03,2016,5210000,5900000,690000,6.859858
348673,Noma: My Perfect Storm,2015-11-19,2015,0,0,0,0.287519
348674,A War,2015-09-10,2015,0,1113277,1113277,4.749622
348675,The Day Will Come,2016-04-21,2016,4750000,0,-4750000,2.18891
348677,The Model,2016-02-11,2016,4000000,0,-4000000,7.772375
348678,A Man Called Ove,2015-12-25,2015,0,3371692,3371692,10.422013
348689,Memories of the Sword,2015-08-13,2015,0,0,0,1.19611
348762,Jis Desh Mein Ganga Rehta Hai,2000-10-13,2000,0,0,0,0.111472
348811,War Pigs,2015-08-03,2015,0,0,0,2.810557
348853,The Model Solution,2002-04-30,2002,0,0,0,0.361375
348857,Eugene Mirman: Vegan on His Way to the Complain Store,2015-07-15,2015,0,0,0,0.097952
348858,Scandal: Sex@students.edu,2001-03-03,2001,0,0,0,0.039199
348892,Bajrangi Bhaijaan,2015-07-17,2015,14000000,98000000,84000000,6.31224
348893,Boyka: Undisputed IV,2016-08-01,2016,0,0,0,67.955052
348896,Dare to Be Wild,2015-08-13,2015,0,0,0,0.434992
348929,You're Killing Me,2015-07-15,2015,0,0,0,0.279544
349008,Summers Past,2008-02-22,2008,0,0,0,0.084966
349028,The Interior,2015-07-27,2015,0,0,0,0.72992
349045,Looney Tunes: Rabbits Run,2015-08-04,2015,0,0,0,1.130302
349048,Daughter of the Lake,2015-08-27,2015,0,0,0,0.418226
349086,Bitcoin: The End of Money as We Know It,2015-07-18,2015,100000,0,-100000,0.505016
349135,Roboshark,2015-07-23,2015,0,0,0,1.448969
349138,Ludo,2015-07-17,2015,0,0,0,0.689882
349158,My Little Pony: Equestria Girls - Friendship Games,2015-09-26,2015,0,0,0,2.165594
349176,Assassination Classroom,2015-03-21,2015,0,0,0,1.980745
349177,Sucker,2015-08-15,2015,0,0,0,1.127008
349394,√Ä la mode,1993-09-10,1993,0,0,0,8.2e-05
349441,The Kind Words,2015-05-28,2015,0,0,0,0.14314
349498,Flying Colors,2015-05-01,2015,0,0,0,1.892599
349790,I Ship It,2014-10-16,2014,0,0,0,0.060863
349948,The Dark Below,2016-06-01,2016,0,0,0,0.734852
350060,Heartstone,2016-12-28,2016,0,0,0,2.042407
350312,Baahubali 2: The Conclusion,2017-04-27,2017,18000000,230000000,212000000,9.042261
350499,Pok√©mon the Movie: Hoopa and the Clash of Ages,2015-07-18,2015,150000000,0,-150000000,3.176182
350505,Molly Moon and the Incredible Book of Hypnotism,2015-04-11,2015,0,0,0,1.053387
350548,The Salad Mixxxer,2014-10-13,2014,0,0,0,0.039004
350554,Cha Cha Cha,1989-01-20,1989,0,0,0,0.024378
350555,The Midwife,2015-09-04,2015,0,0,0,0.823852
350566,Car Trouble,1986-02-28,1986,0,0,0,1e-06
350594,Hitlar,1980-01-01,1980,0,0,0,0.007687
350762,Mick Foley: Cheap Pops,2015-04-29,2015,0,0,0,0.021185
350765,Langsamer Sommer,1976-01-01,1976,0,0,0,0.112442
350779,The Bosses,2015-07-31,2015,0,0,0,0.333532
350808,The Milkmaid,1953-12-22,1953,0,0,0,0.001248
350831,The Cross and The Flame,1957-03-01,1957,0,0,0,0.001185
350839,Cash Only,2015-07-23,2015,0,0,0,1.460679
350845,Worlds Apart,2015-12-17,2015,0,0,0,3.076023
350846,The King of Havana,2015-09-22,2015,0,0,0,0.970239
350849,La Novia,2015-12-11,2015,0,0,0,1.62374
350904,Lost and Beautiful,2015-11-19,2015,0,0,0,0.543012
350931,The Bride He Bought Online,2015-07-18,2015,0,0,0,0.330541
351037,The Ardennes,2015-10-14,2015,2200000,0,-2200000,5.174641
351043,Amnesiac,2015-08-14,2015,3000000,0,-3000000,4.650079
351065,Zoom,2015-09-11,2015,0,0,0,2.000166
351067,Bachelor Games,2016-07-08,2016,0,0,0,1.361835
351072,Na Maloom Afraad,2014-10-06,2014,884130,2259444,1375314,0.241973
351097,The Apostate,2015-10-02,2015,0,0,0,0.694995
351145,Retribution,2015-09-25,2015,4000000,0,-4000000,6.292114
351192,Come What May,2015-11-04,2015,0,0,0,2.793913
351211,Blair Witch,2016-09-15,2016,5000000,45172994,40172994,11.901343
351232,Parallel Courses,2016-05-20,2016,0,0,0,0.56785
351242,The Intervention,2016-08-26,2016,0,0,0,4.989233
351339,Anthropoid,2016-08-12,2016,9000000,4600000,-4400000,8.475983
351365,Tammy and the Millionaire,1967-05-01,1967,0,0,0,0.010139
351423,Dock Ellis & The LSD No-No,2010-06-01,2010,0,0,0,0.094422
351454,Neruda,2016-06-17,2016,0,939101,939101,6.997583
351694,Monkey King: Hero Is Back,2015-07-10,2015,10000000,150000000,140000000,3.759301
351809,To Steal from a Thief,2016-03-03,2016,6700000,12118661,5418661,4.987123
351819,Fifty Shades of Black,2016-01-28,2016,20000000,21164799,1164799,6.785049
351862,Blue Blood,2006-04-26,2006,0,0,0,0.00353
351863,The Shaman,2015-04-18,2015,0,0,0,0.270095
351868,Appetites,2015-08-04,2015,0,0,0,0.829088
351901,12 Rounds 3: Lockdown,2015-09-11,2015,0,0,0,3.777312
351964,The Escort,2015-06-15,2015,0,0,0,6.791697
351981,Bear Story,2014-06-09,2014,0,0,0,1.775444
352024,A Gentle Spirit,1987-01-01,1987,0,0,0,0.209406
352025,Un plus une,2015-12-09,2015,0,0,0,3.302902
352036,Jay Pharoah: Can I Be Me?,2015-08-01,2015,0,0,0,0.468366
352094,Ladrones,2015-10-09,2015,0,0,0,0.728012
352128,The Dead Zone,2002-11-05,2002,0,0,0,1.17573
352156,Looking for Grace,2016-01-26,2016,0,0,0,0.224351
352157,Marguerite,2015-09-16,2015,0,497323,497323,4.391441
352161,The Clan,2015-08-13,2015,0,20381995,20381995,7.78904
352162,From Afar,2016-01-21,2016,0,30169,30169,2.412629
352164,Summer of 8,2016-04-26,2016,0,0,0,1.616992
352166,Catastasis,2015-04-15,2015,0,0,0,0.070244
352173,Drishyam,2015-07-31,2015,0,0,0,3.962602
352179,Septembers of Shiraz,2015-09-15,2015,0,0,0,2.097326
352186,Good Kids,2016-10-21,2016,0,0,0,6.950195
352197,Heart of a Dog,2015-10-21,2015,0,0,0,1.006998
352199,For Your Sake,2015-09-03,2015,0,0,0,0.536357
352200,"Rabin, the Last Day",2015-11-04,2015,4600000,0,-4600000,0.858973
352202,Behemoth,2015-09-11,2015,0,0,0,1.269798
352205,Parched,2015-11-14,2015,2700000,0,-2700000,3.322681
352208,Where to Invade Next,2015-12-23,2015,0,0,0,5.251621
352209,The Unauthorized Full House Story,2015-08-22,2015,0,0,0,0.419041
352237,Pronto,1997-06-08,1997,0,0,0,0.489636
352327,After Words,2015-08-21,2015,0,0,0,1.335301
352334,November Rule,2015-02-14,2015,0,0,0,1.603694
352342,Seasons,2016-01-27,2016,0,0,0,1.391945
352372,Darling,2015-09-24,2015,0,0,0,2.503793
352387,Fool's Day,2013-04-18,2013,0,0,0,0.058303
352490,This Beautiful Fantastic,2016-10-20,2016,0,0,0,3.202684
352492,XOXO,2016-08-26,2016,0,0,0,5.2402
352494,Ripped,2017-06-23,2017,0,0,0,1.100185
352498,First Girl I Loved,2016-10-18,2016,0,0,0,1.714399
352501,All Nighter,2017-03-10,2017,0,0,0,5.541765
352539,Brothers of War,2015-06-01,2015,1700000,0,-1700000,0.930876
352552,Hurricane of Fun: The Making of Wet Hot,2015-07-31,2015,0,0,0,1.172748
352582,Bachelors,2016-10-06,2016,0,0,0,0.31473
352694,Poison Berry in my Brain,2015-05-09,2015,0,0,0,0.621331
352695,Joshy,2016-08-12,2016,0,0,0,2.678986
352719,Molly and Me,1945-05-25,1945,0,0,0,0.4492
352720,My Good Hans,2015-10-07,2015,3500000,0,-3500000,0.117871
352733,The Scandalous Lady W,2015-08-17,2015,0,0,0,2.243536
352812,Tick Tock Tale,2010-06-10,2010,0,0,0,0.781356
352845,Lead with Your Heart,2015-09-19,2015,0,0,0,0.197249
352851,Love on the Air,2015-09-26,2015,0,0,0,0.809395
352885,The Book of Love,2017-01-13,2017,0,0,0,8.371598
352890,Morris from America,2016-08-19,2016,0,0,0,2.869366
352917,V√≠kend,2015-01-01,2015,0,0,0,0.115035
352960,Lace Crater,2015-09-10,2015,0,0,0,0.789554
352978,Chain of Command,2015-08-30,2015,5000000,0,-5000000,1.97894
353069,Mother's Day,2016-04-28,2016,25000000,48418160,23418160,8.309565
353070,Going in Style,2017-04-06,2017,25000000,84618541,59618541,15.157255
353117,The Thread,2015-04-13,2015,0,0,0,0.577185
353125,The Search for Freedom,2015-08-06,2015,0,0,0,0.358329
353148,The Land of Smiles,2015-04-17,2015,0,0,0,0.091356
353163,The Mirage,2015-08-05,2015,0,0,0,1.195524
353216,Homme Less,2015-08-07,2015,0,0,0,0.06521
353257,Earthfall,2015-06-22,2015,0,0,0,1.727617
353285,Taikon,2015-10-02,2015,0,0,0,0.134614
353311,The Wiz Live!,2015-12-03,2015,0,0,0,1.160656
353326,The Man Who Knew Infinity,2016-04-08,2016,0,11472454,11472454,8.445423
353345,The Exorcism of Molly Hartley,2015-10-09,2015,0,0,0,5.742044
353378,Big Stone Gap,2014-10-09,2014,0,0,0,2.213051
353406,Manoman,2015-01-01,2015,0,0,0,0.106093
353433,Urge,2016-02-14,2016,0,0,0,6.094066
353446,American Beach House,2015-07-02,2015,0,0,0,0.659882
353462,Tut,2015-07-19,2015,0,0,0,1.645219
353464,Talvar,2015-09-14,2015,0,0,0,1.540697
353491,The Dark Tower,2017-08-03,2017,60000000,71000000,11000000,50.903593
353500,Essex Boys: Law of Survival,2015-09-21,2015,0,0,0,0.24431
353533,Srimanthudu,2015-08-07,2015,0,0,0,0.600893
353569,Table 19,2017-01-20,2017,5000000,3305592,-1694408,8.645067
353571,Tallulah,2016-01-23,2016,0,0,0,4.957457
353595,LEGO DC Comics Super Heroes: Justice League: Attack of the Legion of Doom!,2015-08-25,2015,0,0,0,3.186387
353609,Santa's Little Helper,2015-11-17,2015,0,0,0,1.141
353610,The Condemned 2,2015-11-06,2015,0,0,0,2.645672
353616,Pitch Perfect 3,2017-12-21,2017,0,0,0,3.782498
353641,Risto R√§pp√§√§j√§ ja Sevillan saituri,2015-02-13,2015,0,0,0,0.028333
353652,Crossfire: Hate Is Like a Gun,2005-07-05,2005,0,0,0,0.002353
353653,A Town Has Turned to Dust,1958-06-19,1958,0,0,0,0.002361
353686,Visions,2015-08-28,2015,0,0,0,5.4314
353713,La nao Capitana,1947-09-29,1947,0,0,0,0.001901
353725,Our Loved Ones,2015-08-12,2015,0,0,0,0.422852
353728,Closet Monster,2016-07-15,2016,0,33962,33962,4.743517
353732,River,2016-03-11,2016,0,0,0,2.948255
353746,One Day Since Yesterday: Peter Bogdanovich & the Lost American Film,2014-08-26,2014,0,0,0,0.055552
353813,Saboot,1980-08-09,1980,0,0,0,0.017433
353866,Toilet Stories,2015-08-13,2015,0,0,0,0.103021
353879,Phantom,2015-08-28,2015,0,0,0,1.576664
353898,Manjhi The Mountain Man,2015-08-21,2015,1230000,0,-1230000,0.925847
353921,Inside Out 3,1992-09-16,1992,0,0,0,0.75
353979,Pet,2016-09-24,2016,0,0,0,9.030904
353989,Abzurdah,2015-06-04,2015,0,0,0,2.088404
354021,The Sun and the Moon,2008-08-11,2008,0,0,0,0.004706
354023,Trying to Kiss the Moon,1994-08-11,1994,0,0,0,0.001488
354072,Our Times,2015-08-13,2015,0,0,0,2.890544
354100,Becoming Bulletproof,2015-03-26,2015,0,0,0,0.127016
354105,The Old Devil,1933-01-01,1933,0,0,0,0.001263
354110,Forsaken,2015-09-16,2015,11000000,0,-11000000,12.948669
354128,Go Away Mr. Tumor,2015-08-14,2015,0,0,0,1.100294
354133,Zombeak,2006-06-06,2006,0,0,0,0.368079
354150,unINDIAN,2015-10-15,2015,0,0,0,0.873019
354216,The Devil's Candy,2017-03-17,2017,0,0,0,9.968649
354220,The Girl in the Photographs,2015-09-14,2015,0,0,0,3.486367
354251,Southbound,2015-09-17,2015,0,0,0,5.596267
354275,"Right Now, Wrong Then",2015-08-13,2015,0,0,0,1.549193
354282,Science Fiction Volume One: The Osiris Child,2017-08-31,2017,0,0,0,13.454531
354285,The Sense of an Ending,2017-03-10,2017,0,0,0,5.655716
354287,War Machine,2017-05-26,2017,60000000,0,-60000000,10.282732
354296,The Guy from Our Cemetery,2015-09-03,2015,0,0,0,0.546922
354379,Tashi and the Monk,2015-08-17,2015,0,0,0,0.984709
354388,No Home Movie,2015-08-10,2015,0,0,0,0.371059
354421,The Confessions of Thomas Quick,2015-08-14,2015,1250000,0,-1250000,0.202118
354534,The Invoking 2,2015-10-06,2015,0,0,0,1.434069
354544,Demetri Martin: Live (At The Time),2015-08-14,2015,0,0,0,0.955714
354547,Hawa,2003-07-04,2003,0,0,0,0.002361
354556,Guardians,2017-02-14,2017,7000000,0,-7000000,10.830129
354625,Orania,2013-06-13,2013,0,0,0,0.011767
354667,RangiTaranga,2015-07-03,2015,0,0,0,0.130067
354776,The Choice Is Ours,2015-03-02,2015,0,0,0,0.573175
354818,Colin Quinn: Unconstitutional,2015-08-16,2015,0,0,0,0.168862
354832,The Cookie Mobster,2014-12-27,2014,0,0,0,0.047551
354857,Regular Show: The Movie,2015-09-01,2015,3000000,0,-3000000,2.920392
354859,The Promise,2017-04-21,2017,0,0,0,9.555114
354924,The Dead Room,2015-10-01,2015,1000000,0,-1000000,3.904904
354979,Dog Eat Dog,2016-11-04,2016,0,0,0,7.330012
355008,Special Correspondents,2016-04-22,2016,0,0,0,5.453322
355020,Winter on Fire: Ukraine's Fight for Freedom,2015-10-09,2015,0,0,0,2.940533
355065,The People vs. Fritz Bauer,2015-09-13,2015,0,148461,148461,2.197807
355066,Bad Cat,2016-02-05,2016,0,0,0,2.484009
355111,Barbie in Rock 'N Royals,2015-08-13,2015,0,0,0,4.846611
355135,Hamtaro: The Captive Princess,2002-12-14,2002,0,0,0,0.005102
355177,Tig Notaro: Boyish Girl Interrupted,2015-08-22,2015,0,0,0,0.454685
355178,Amy Schumer: Live at the Apollo,2015-10-17,2015,0,0,0,1.813284
355193,Devil's Gate,2017-04-24,2017,0,0,0,1.155504
355211,An Example of Intonation,1991-01-01,1991,0,0,0,0.035502
355230,In Jackson Heights,2015-09-04,2015,0,0,0,0.154899
355254,De Palma,2016-06-10,2016,0,0,0,2.120782
355264,The Fear of Darkness,2014-01-01,2014,0,0,0,0.725264
355277,Born in China,2017-04-21,2017,0,0,0,7.709977
355335,Natasha Leggero: Live at Bimbo's,2015-08-22,2015,0,0,0,0.143351
355338,Riley's First Date?,2015-11-03,2015,0,0,0,6.051285
355389,This Changes Everything,2015-09-10,2015,0,0,0,0.142052
355436,Dream Driven,2014-11-28,2014,0,0,0,0.053078
355506,Siren,2016-12-02,2016,0,0,0,2.769514
355515,Meet Me at the Fair,1953-01-01,1953,0,0,0,0.00245
355545,Paul Taylor Creative Domain,2014-01-31,2014,0,0,0,0.01375
355594,Isla bonita,2015-11-06,2015,0,0,0,0.783217
355598,Girl in Woods,2016-06-03,2016,0,0,0,1.365827
355600,Junun,2015-10-09,2015,0,0,0,1.609769
355636,Sandook,2015-05-21,2015,0,0,0,0.021204
355730,"Signed, Sealed, Delivered: Truth Be Told",2015-09-13,2015,0,0,0,0.940223
355771,Return of the Atom,2015-09-11,2015,0,0,0,0.025294
355786,Thithi,2015-08-10,2015,0,0,0,0.306059
355890,Jane Wants a Boyfriend,2015-11-11,2015,0,0,0,0.60382
355925,Another World,2014-02-08,2014,0,0,0,0.027671
355930,Tikkun,2015-07-10,2015,0,0,0,0.859725
355984,Andy Peters: Exclamation Mark Question Point,2015-02-13,2015,0,0,0,0.049843
355998,In the Room,2015-09-15,2015,0,0,0,1.233068
356054,Curtis's Charm,1995-09-18,1995,0,0,0,0.001648
356057,Polycarp,2015-06-24,2015,0,0,0,0.099285
356090,2 Nights Till Morning,2015-08-31,2015,0,0,0,0.455394
356149,Robert the Doll,2015-08-24,2015,0,0,0,2.010895
356156,My Love Story!!,2015-10-31,2015,0,0,0,0.929577
356161,Phantom Boy,2015-10-14,2015,0,0,0,1.534156
356167,Jimi Hendrix: Electric Church,2015-09-04,2015,0,0,0,0.41538
356189,My Name Is Emily,2016-04-08,2016,0,0,0,0.550609
356191,Demon,2015-09-09,2015,0,0,0,2.143813
356200,One Breath,2016-01-28,2016,0,0,0,0.494586
356201,Collective Invention,2015-09-14,2015,0,0,0,0.368579
356216,The Rise of the Krays,2015-08-29,2015,2500000,0,-2500000,2.126507
356218,Girls Lost,2016-02-19,2016,0,0,0,1.423612
356294,25 April,2015-09-15,2015,0,0,0,0.139972
356296,Suburra,2015-10-14,2015,7000000,0,-7000000,9.391527
356298,Don't Think Twice,2016-07-22,2016,0,4417667,4417667,8.067119
356300,How to Plan an Orgy in a Small Town,2015-09-19,2015,0,0,0,1.77263
356305,Why Him?,2016-12-22,2016,38000000,118034273,80034273,14.531429
356324,Don't Blink: Robert Frank,2015-10-04,2015,0,0,0,0.135196
356325,Everything Is Copy,2015-09-29,2015,0,0,0,1.490797
356326,What We Become,2015-09-29,2015,0,0,0,2.673646
356329,Troublemakers: The Story of Land Art,2015-10-01,2015,0,0,0,0.061179
356332,The Witness,2015-10-06,2015,0,0,0,1.392919
356334,Gridlocked,2016-06-14,2016,0,0,0,3.195629
356335,Man vs. Snake,2015-09-27,2015,0,0,0,1.817092
356366,Guns for Hire,2015-10-20,2015,0,0,0,0.899071
356381,As I Open My Eyes,2015-12-23,2015,0,0,0,0.745905
356401,Wedding Doll,2015-07-15,2015,0,0,0,0.252003
356461,In un posto bellissimo,2015-08-27,2015,0,0,0,0.232439
356482,Murder in the Dark,2013-08-09,2013,0,0,0,0.211111
356483,Unnatural,2015-10-16,2015,0,0,0,1.804845
356486,Lumberjack Man,2015-10-16,2015,0,0,0,3.35736
356500,Detour,2017-01-20,2017,0,0,0,9.184739
356626,Black,2015-11-11,2015,1200000,0,-1200000,1.35894
356752,AWOL,2017-05-19,2017,0,0,0,2.146718
356757,Arianna,2015-09-24,2015,0,0,0,0.374783
356758,First Light,2015-09-24,2015,0,0,0,0.953019
356842,The Ones Below,2015-10-14,2015,0,0,0,4.943762
356846,The Gamechangers,2015-09-15,2015,0,0,0,1.222142
356862,On Reflection: B.S. Johnson on Dr. Samuel Johnson,1972-01-02,1972,0,0,0,0.0
356864,Fat Man on a Beach,1973-01-02,1973,0,0,0,0.000431
356895,37,2016-11-17,2016,0,0,0,0.955066
356898,Hong Kong Trilogy: Preschooled Preoccupied Preposterous,2015-09-12,2015,0,0,0,0.949762
356900,Divine Access,2015-04-11,2015,0,0,0,0.322568
356901,Five Nights in Maine,2016-08-05,2016,0,0,0,1.448776
356905,Oddball,2015-09-17,2015,0,0,0,3.638062
356994,Wire Cutters,2014-07-26,2014,0,0,0,0.392561
357096,I Spit on Your Grave III: Vengeance is Mine,2015-10-09,2015,0,0,0,21.505988
357106,Lust in the Mummy's Tomb,2002-10-14,2002,0,0,0,0.005944
357125,The Sixties,2013-06-14,2013,0,0,0,0.154234
357130,Tom and Jerry,1955-11-30,1955,0,0,0,0.001181
357155,Delirium,2014-10-02,2014,0,0,0,0.251674
357313,Frank and the Wondercat,2015-12-31,2015,0,0,0,0.127019
357390,Ajin: Demi-Human - Compel,2015-11-27,2015,0,0,0,1.376617
357424,Almost Adults,2016-10-15,2016,0,0,0,2.059825
357441,Karachi se Lahore,2015-07-31,2015,0,0,0,0.087996
357529,Cowboy Cavalier,1948-07-11,1948,0,0,0,0.013452
357530,My Stepdaughter,2015-08-28,2015,0,0,0,0.983397
357540,Freelance,2015-10-06,2015,455000,0,-455000,0.312737
357600,Dara O'Briain Crowd Tickler,2015-11-23,2015,0,0,0,0.558676
357681,Hitting the Apex,2015-09-02,2015,0,0,0,1.948614
357706,Irudhi Suttru,2016-01-28,2016,300000,2100000,1800000,0.756243
357784,Roukli,2015-09-17,2015,17973,0,-17973,0.132308
357786,Kizumonogatari Part 1: Tekketsu,2016-01-08,2016,0,0,0,2.312852
357799,Presenting Princess Shaw,2016-05-27,2016,0,0,0,0.146737
357837,Dancin' It's On,2015-10-16,2015,0,0,0,0.140513
357851,Let Me Make You a Martyr,2016-07-22,2016,0,0,0,2.224423
357935,Forbidden Area,1956-10-04,1956,0,0,0,0.451961
357940,Mr. Six,2015-09-16,2015,0,0,0,1.565817
357959,Sour Grape,1974-08-30,1974,0,0,0,0.049412
358076,A Letter to Three Wives,1985-12-16,1985,0,0,0,0.020574
358083,The Paradise Suite,2015-10-29,2015,0,0,0,1.023978
358199,All the Way Home,1981-12-21,1981,0,0,0,0.255935
358238,Aimy in a Cage,2016-01-08,2016,0,0,0,0.533455
358243,Paradise,2015-12-31,2015,0,0,0,0.100144
358293,Today,1997-01-02,1997,0,0,0,0.00118
358332,Cosmos Laundromat,2015-06-25,2015,0,0,0,0.426255
358353,Bound & Babysitting,2015-04-01,2015,1600000,0,-1600000,1.100177
358403,Taj Mahal,2015-12-02,2015,0,0,0,1.107576
358430,The New Kid,2015-12-23,2015,0,0,0,3.091686
358505,Our Last Tango,2015-09-12,2015,0,0,0,1.167896
358511,Baby Bump,2015-09-06,2015,0,0,0,0.419769
358532,The Monster of Mangatiti,2015-09-06,2015,0,0,0,0.542716
358615,Pirates of the Prairie,1942-11-20,1942,0,0,0,0.007178
358644,Embers,2015-09-18,2015,0,0,0,1.897133
358694,Little Angels,2015-09-24,2015,0,0,0,0.025886
358724,The Other One,2014-04-04,2014,0,0,0,0.014272
358725,Saint Amour,2016-03-02,2016,0,0,0,2.916386
358807,The Fits,2016-01-22,2016,0,0,0,2.915106
358808,Tharlo,2015-09-04,2015,0,0,0,0.130588
358859,The Event,2015-09-02,2015,0,0,0,0.375634
358881,Made in France,2015-10-27,2015,0,0,0,3.428114
358893,Angry Indian Goddesses,2015-09-18,2015,0,0,0,1.147328
358895,Being Charlie,2015-09-14,2015,0,30400,30400,2.930694
358901,Very Big Shot,2015-10-11,2015,0,0,0,0.439703
358907,Granny's Dancing on the Table,2015-09-11,2015,0,0,0,0.344339
358908,Paths of the Soul,2015-09-10,2015,0,0,0,0.518048
358912,A Month of Sundays,2016-04-28,2016,0,0,0,0.555331
358924,Miss Sharon Jones!,2015-09-11,2015,0,0,0,0.774858
358926,Couple in a Hole,2016-04-06,2016,0,0,0,0.694834
358962,Queen of Spades: The Dark Rite,2015-09-10,2015,1000000,2228115,1228115,1.896218
358980,Apocalipsis sobre el r√≠o amarillo,1960-03-25,1960,0,0,0,0.00129
358982,Eden Lodge,2015-08-24,2015,0,0,0,0.571042
359002,Daayen Ya Baayen,2010-10-29,2010,0,0,0,0.041625
359010,Ambush Trail,1946-02-17,1946,0,0,0,0.011725
359025,Camino,2016-03-04,2016,0,0,0,1.437022
359029,Follow,2015-09-26,2015,0,0,0,0.278487
359070,Hallway,2015-03-15,2015,0,0,0,0.020001
359093,The 24 Hour War,2016-11-20,2016,0,0,0,1.372084
359105,Heneral Luna,2015-09-09,2015,0,0,0,1.135678
359108,Viva,2015-11-08,2015,0,0,0,1.709199
359151,Tanna,2015-10-16,2015,0,0,0,2.114326
359152,Storie sospese,2015-09-03,2015,0,0,0,0.524942
359154,13 days of October,2015-09-10,2015,0,0,0,0.211886
359156,Don't Be Bad,2015-09-08,2015,0,0,0,4.149051
359195,13 Fighting Men,1960-03-31,1960,0,0,0,0.070647
359204,A Syrian Love Story,2015-06-09,2015,0,0,0,0.198835
359244,Craig Ferguson: Just Being Honest,2015-09-10,2015,0,0,0,0.242708
359245,Even Lambs Have Teeth,2015-10-03,2015,0,0,0,1.085982
359246,Hell House LLC,2015-10-16,2015,0,0,0,2.911975
359255,The Inhabitants,2015-10-13,2015,0,0,0,1.145165
359305,An Inspector Calls,2015-09-13,2015,0,0,0,1.954596
359325,Distractions,2015-09-11,2015,0,0,0,0.238798
359353,The Scarecrow,1972-01-10,1972,0,0,0,0.000413
359364,Human,2015-09-12,2015,13000000,0,-13000000,3.845853
359373,Interruption,2015-09-08,2015,0,0,0,0.459937
359412,Marauders,2016-07-01,2016,15000000,0,-15000000,6.389818
359413,Aur√©lie Laflamme: Les pieds sur terre,2015-04-24,2015,0,0,0,0.357328
359440,Barista,2015-11-06,2015,0,0,0,0.851903
359459,Steve Rannazzisi: Breaking Dad,2015-09-19,2015,0,0,0,0.37546
359460,The Accidental Detective,2015-09-24,2015,0,0,0,1.265446
359471,Swat: Unit 887,2015-09-29,2015,2000000,0,-2000000,1.83505
359483,Duell der Br√ºder - Die Geschichte von Adidas und Puma,2016-03-25,2016,0,0,0,1.535711
359549,Prologue,2015-06-01,2015,0,0,0,0.460712
359641,Argentina,2015-09-26,2015,0,0,0,0.105185
359660,Fear of the Flesh: The Making of The Fly,2005-10-04,2005,0,0,0,0.037698
359736,Human,2013-10-12,2013,60000,0,-60000,0.414386
359746,The Propaganda Game,2015-10-03,2015,0,0,0,2.155148
359749,78/52,2017-11-03,2017,0,0,0,2.488539
359784,Maudie,2017-04-14,2017,0,0,0,6.404957
359790,Blackway,2015-10-03,2015,0,0,0,4.710562
359805,21 Nights with Pattie,2015-11-25,2015,0,0,0,1.273174
359807,Chico - Artista Brasileiro,2015-11-26,2015,0,0,0,0.094303
359870,Burn Burn Burn,2016-10-28,2016,0,0,0,0.954408
359871,My Scientology Movie,2016-05-05,2016,0,0,0,5.509801
359983,The Lion Guard: Return of the Roar,2015-11-22,2015,0,0,0,5.97657
360007,Patchwork,2015-10-15,2015,0,0,0,6.588979
360022,"Kiss Me, Kill Me",2015-09-18,2015,0,0,0,0.124568
360029,Into the Inferno,2016-09-07,2016,0,0,0,4.682651
360030,Lo and Behold: Reveries of the Connected World,2016-03-04,2016,0,0,0,4.167907
360055,Riot,2015-09-27,2015,0,0,0,3.529513
360203,Lost in the Sun,2015-11-05,2015,25000,25000,0,3.985181
360205,Invoked,2015-08-17,2015,0,0,0,0.288275
360249,The Last King,2016-02-12,2016,5455000,0,-5455000,50.949523
360283,Heart Like a Hand Grenade,2015-10-15,2015,0,0,0,0.064102
360284,A Light Beneath Their Feet,2016-05-06,2016,0,0,0,0.145088
360292,Starship Apocalypse,2014-12-20,2014,0,0,0,0.207185
360321,Nocturna,2015-10-06,2015,0,0,0,0.774252
360328,Dartmoor Killing,2015-09-18,2015,0,0,0,0.180072
360339,Eden,2015-10-22,2015,2300000,0,-2300000,2.94307
360341,Keith Richards: Under the Influence,2015-09-18,2015,0,0,0,1.327371
360365,Tini: The New Life of Violetta,2016-05-04,2016,0,0,0,8.13774
360380,Beslan: Three Days in September,2006-01-01,2006,0,0,0,0.003741
360387,Blunt Force Trauma,2015-10-05,2015,1000000,0,-1000000,2.559923
360389,Nina,2016-04-22,2016,0,0,0,3.908626
360404,"Monster High: Boo York, Boo York",2015-10-19,2015,0,0,0,3.393803
360408,Jeff Dunham: Unhinged in Hollywood,2015-09-17,2015,0,0,0,0.702587
360551,The Priests,2015-11-05,2015,0,0,0,2.315594
360592,The Dust Storm,2016-12-13,2016,0,0,0,1.004785
360603,Crown for Christmas,2015-11-27,2015,0,0,0,1.878526
360604,Ice Sculpture Christmas,2015-11-07,2015,0,0,0,0.825129
360605,Invisible Sister,2015-10-09,2015,0,0,0,3.488085
360606,Adventures in Babysitting,2016-06-24,2016,0,0,0,15.370164
360612,Big Jet,2015-09-19,2015,0,0,0,0.086442
360626,Prescription: Murder,1968-02-20,1968,0,0,0,0.926479
360627,Columbo - Ransom for a Dead Man,1973-01-01,1973,0,0,0,0.00222
360638,The Student and Mister Henri,2015-10-07,2015,0,0,0,3.875212
360737,Center of My World,2016-11-10,2016,0,0,0,3.656889
360784,Hidden,2015-09-15,2015,0,0,0,8.644392
360799,Arrowhead,2016-06-09,2016,0,0,0,2.922931
360808,Doctor's Orders,1934-11-01,1934,0,0,0,0.031773
360809,Pikadero,2015-09-18,2015,0,0,0,0.11171
360814,Dangal,2016-12-23,2016,10400000,310000000,299600000,8.792104
360924,Red Billabong,2016-08-25,2016,0,0,0,1.089783
360998,Metamorphosis,2003-01-01,2003,0,0,0,0.053199
361018,Akron,2015-10-06,2015,0,0,0,1.325024
361025,Winning Dad,2015-10-18,2015,0,0,0,0.382444
361042,The Hollow,2015-10-24,2015,2000000,0,-2000000,2.410183
361050,Death Valley,2015-10-20,2015,0,0,0,0.56698
361066,On the Road: A Document,1964-01-01,1964,0,0,0,0.001247
361069,Blush,2015-10-22,2015,0,0,0,1.300806
361131,Hate Story 3,2015-04-12,2015,0,0,0,0.834148
361138,Urban Family,2015-08-07,2015,0,0,0,0.36416
361146,Point Zero,2016-05-26,2016,0,0,0,0.074965
361159,Navy Seals vs. Zombies,2015-10-08,2015,0,0,0,2.413622
361181,Kara Bela,2015-09-18,2015,0,0,0,1.087464
361183,Sum of Histories,2015-09-30,2015,0,0,0,0.404432
361205,Motley's Law,2015-10-15,2015,0,0,0,0.171132
361249,Nil Battey Sannata,2016-04-22,2016,0,0,0,0.625451
361251,Road to La Paz,2015-10-25,2015,0,0,0,0.247958
361261,"Signed, Sealed, Delivered: The Impossible Dream",2015-10-04,2015,0,0,0,0.409165
361263,Jesse Stone: Lost in Paradise,2015-10-18,2015,0,0,0,1.929064
361340,A Brilliant Madness,2002-04-28,2002,0,0,0,0.002353
361380,Barbie & Her Sisters in the Great Puppy Adventure,2015-10-07,2015,0,0,0,2.533076
361475,Departure,2016-05-20,2016,0,0,0,0.886506
361571,The Demons,2015-10-30,2015,0,0,0,0.932247
361597,Karbala,2015-09-08,2015,3200000,0,-3200000,0.718035
361617,11 Blocks,2015-09-27,2015,0,0,0,0.19438
361664,Giano,2014-10-03,2014,0,0,0,0.043166
361671,Ellis,2015-10-04,2015,0,0,0,1.903401
361705,Birdboy: The Forgotten Children,2015-09-24,2015,0,0,0,0.272941
361733,Horvat's Choice,1985-01-08,1985,0,0,0,0.000308
361745,Autumn Dreams,2015-10-03,2015,0,0,0,2.212724
361750,Brian Regan: Live From Radio City Music Hall,2015-09-26,2015,0,0,0,0.249596
361751,"Murder, She Baked: A Plum Pudding Murder Mystery",2015-11-15,2015,0,0,0,4.653375
361758,Outlaw: Gangster VIP,1968-01-13,1968,0,0,0,0.148347
361777,Smoke & Mirrors,2016-09-23,2016,5000000,2387127,-2612873,3.138159
361841,Drifters,2015-10-16,2015,0,0,0,0.519263
361854,The Dark Side of the Moon,2016-01-14,2016,0,0,0,1.737751
361866,Rudraksh,2004-02-13,2004,0,0,0,0.4773
361931,Ronaldo,2015-11-09,2015,0,0,0,6.339693
361980,We Are the Pirates of the Roads,2015-03-27,2015,1700000,0,-1700000,1.147538
361992,Bhai,1997-01-01,1997,0,0,0,0.039781
362026,Magnificent 7,2005-12-13,2005,0,0,0,0.102497
362045,Bajirao Mastani,2015-12-18,2015,19500000,56000000,36500000,4.683689
362046,4Got10,2015-09-11,2015,0,0,0,1.777234
362057,Martyrs,2016-01-22,2016,0,0,0,4.827887
362058,The Snow Queen 3: Fire and Ice,2016-12-29,2016,0,0,0,1.394369
362077,San Francisco 2.0,2015-09-28,2015,0,0,0,0.167761
362092,When Hari Got Married,2013-03-16,2013,0,0,0,0.09065
362100,Aashiq,2001-01-01,2001,0,0,0,0.001177
362108,Paul F. Tompkins: Crying and Driving,2015-10-10,2015,0,0,0,0.764576
362136,Prem Ratan Dhan Payo,2015-11-11,2015,23400000,67000000,43600000,2.864948
362141,Dog,2015-12-10,2015,0,0,0,0.791
362150,Vedhalam,2015-11-10,2015,0,0,0,0.429767
362151,Nuoruuteni savotat,1988-11-18,1988,0,0,0,0.049706
362154,Saving Mr. Wu,2015-09-30,2015,0,0,0,2.379103
362178,Kaili Blues,2016-03-23,2016,0,0,0,2.630331
362180,Don't Grow Up,2015-03-11,2015,0,0,0,1.940739
362185,Operator,2015-08-21,2015,0,0,0,3.294427
362202,The Crash,2017-01-13,2017,0,0,0,4.05452
362216,Collective: Unconscious,2016-03-13,2016,0,0,0,0.196095
362226,Froning: The Fittest Man In History,2015-10-01,2015,0,0,0,0.647998
362227,Night of Something Strange,2016-04-08,2016,40000,0,-40000,1.80538
362243,Family Film,2016-02-18,2016,0,0,0,0.355191
362247,After Eden,2015-09-25,2015,0,0,0,0.148733
362268,Stretch and Bobbito: Radio That Changed Lives,2015-10-01,2015,0,0,0,1.131106
362291,Chura Liyaa Hai Tumne,2003-01-01,2003,0,0,0,0.056129
362293,Voice Without a Shadow,1958-10-21,1958,0,0,0,0.271397
362343,"Trenk, the Little Knight",2015-11-05,2015,0,0,0,1.052173
362363,Directed by Sidney Lumet: How the Devil Was Made,2008-03-04,2008,0,0,0,0.003741
362373,Eaters,2015-10-06,2015,0,0,0,2.510095
362409,Trash Fire,2016-11-03,2016,0,0,0,1.914827
362430,Night of the Wild,2015-10-03,2015,0,0,0,0.698984
362439,They Found Hell,2015-10-17,2015,0,0,0,1.163551
362463,The Cantor's Son,1937-12-26,1937,0,0,0,0.001177
362478,The Preppie Connection,2016-03-18,2016,0,0,0,3.041072
362541,Jump!,2014-07-26,2014,0,0,0,0.542412
362579,Anabel,2015-10-11,2015,0,0,0,2.038121
362583,MindGamers,2015-10-04,2015,22800000,0,-22800000,1.374192
362584,Kizumonogatari Part 2: Nekketsu,2016-08-19,2016,0,0,0,2.43154
362585,Kizumonogatari Part 3: Reiketsu,2017-01-06,2017,0,0,0,3.519786
362610,I Am Your Father,2015-10-05,2015,0,0,0,1.867981
362617,Novatos,2015-10-05,2015,0,0,0,0.281774
362682,Goodbye Mr. Loser,2015-09-30,2015,0,0,0,1.207719
362699,Remainder,2015-10-08,2015,0,0,0,1.308817
362703,Diablo,2016-01-08,2016,0,0,0,5.809983
362736,The Hexecutioners,2015-10-21,2015,0,0,0,0.815302
362758,Seven Brothers,1939-09-30,1939,0,0,0,0.001788
362765,The Sound and the Shadow,2014-10-19,2014,0,0,0,0.032596
362812,Chaahat Ek Nasha...,2005-02-11,2005,0,140,140,0.003647
362844,Survivor,1999-05-13,1999,0,0,0,0.002603
362876,Calif√≥rnia,2015-12-03,2015,0,0,0,0.960311
362884,October Kiss,2015-10-17,2015,0,0,0,0.885474
362886,'Tis the Season for Love,2015-11-01,2015,0,0,0,1.004732
362974,The Exclusive : Beat the Devil's Tattoo,2015-10-22,2015,0,0,0,1.074882
362988,Anjelah Johnson: Not Fancy,2015-10-02,2015,0,0,0,0.461014
363007,Pr√©judice,2015-10-07,2015,2800000,0,-2800000,0.732354
363056,Miles,2017-06-09,2017,0,0,0,1.269793
363093,The Tiger: An Old Hunter's Tale,2015-12-16,2015,5000,11083449,11078449,3.447894
363103,Nise: The Heart of Madness,2016-04-21,2016,0,0,0,0.750462
363105,Deewane,2000-01-01,2000,0,0,0,0.028598
363126,Berlin Syndrome,2017-05-25,2017,0,201719,201719,12.211769
363157,Just Once More,1962-08-27,1962,0,0,0,0.006009
363178,Thoonga Vanam,2015-11-10,2015,0,0,0,1.215211
363185,Mastizaade,2016-01-29,2016,0,0,0,2.053519
363264,Mary Loss of Soul,2015-10-01,2015,0,0,0,0.411639
363354,Library Wars: The Last Mission,2015-10-05,2015,0,0,0,0.951997
363383,"My Night, Your Day",2015-10-26,2015,0,0,0,0.144624
363413,Pyaar Ka Punchnama 2,2015-10-16,2015,1,0,-1,1.123052
363439,Secrets of a Psychopath,2015-11-03,2015,0,0,0,0.112133
363476,Charming Christmas,2015-11-08,2015,0,0,0,0.755155
363478,I'm Not Ready for Christmas,2015-11-14,2015,0,0,0,0.947398
363479,Merry Matrimony,2015-11-22,2015,0,0,0,1.185419
363480,Christmas Incorporated,2015-11-15,2015,0,0,0,2.256822
363482,Once Upon A Holiday,2015-11-25,2015,0,0,0,1.617017
363483,12 Gifts of Christmas,2015-11-26,2015,0,0,0,1.002746
363484,Angel of Christmas,2015-11-29,2015,0,0,0,1.598157
363486,Just in Time for Christmas,2015-12-05,2015,0,0,0,1.711581
363579,The Age of Shadows,2016-09-07,2016,8620000,0,-8620000,5.155743
363607,LasseMajas detektivbyr√• - Stella Nostra,2015-10-16,2015,0,0,0,1.193855
363611,Outlaw: Gangster VIP 2,1968-04-28,1968,0,0,0,0.101554
363618,Painkillers,2015-11-15,2015,0,0,0,1.228613
363676,Sully,2016-09-07,2016,60000000,238470033,178470033,18.275689
363683,I Believe in Miracles,2015-10-13,2015,768,0,-768,0.563543
363689,The Unspoken,2015-10-24,2015,0,0,0,1.965783
363690,Tank 432,2015-10-24,2015,0,0,0,1.366625
363757,Io che amo solo te,2015-10-22,2015,0,0,0,3.046838
363790,The Advocate: A Missing Body,2015-10-08,2015,0,0,0,0.971576
363805,Bikini Model Academy,2015-09-01,2015,500000,0,-500000,0.53095
363807,"Liar, Liar, Vampire",2015-10-12,2015,3500000,0,-3500000,1.007084
363810,The Leisure Class,2015-11-02,2015,3000000,0,-3000000,1.491134
363841,Guernica,2016-04-26,2016,6229577,0,-6229577,4.068005
363844,The Ouija Exorcism,2015-10-06,2015,0,0,0,1.185324
363846,Motherland,2015-10-15,2015,0,0,0,0.976242
363889,The Funhouse Massacre,2015-11-13,2015,0,0,0,2.013548
363890,Night of the Living Dead: Darkest Dawn,2015-10-05,2015,750000,0,-750000,1.112812
363925,Opera√ß√µes Especiais,2015-10-07,2015,6000000,0,-6000000,2.514515
363960,Puolin ja toisin,2013-11-17,2013,0,0,0,0.0483
363969,These Daughters of Mine,2015-11-09,2015,0,0,0,0.762399
363992,The Wizard of Lies,2017-05-21,2017,0,0,0,13.953533
364051,The Innocents,2016-02-10,2016,6000000,0,-6000000,6.915263
364060,Middle Man,2017-06-09,2017,0,0,0,2.554282
364067,A Very Murray Christmas,2015-12-04,2015,0,0,0,6.007801
364088,Decay,2015-11-09,2015,0,0,0,0.473876
364089,Anthony Jeselnik: Thoughts and Prayers,2015-10-16,2015,0,0,0,1.171422
364111,The Anthem of the Heart,2015-09-19,2015,0,0,0,2.102159
364116,The Other Side of the Door,2016-02-25,2016,0,14332467,14332467,7.016801
364123,Andy Kaufman Plays Carnegie Hall,1980-01-01,1980,0,0,0,0.0525
364137,All Three of Us,2015-11-04,2015,0,0,0,6.811994
364150,The Godfather Trilogy: 1972-1990,1992-10-17,1992,0,0,0,0.001429
364153,Zombie Ninjas vs Black Ops,2015-10-10,2015,0,0,0,0.072206
364324,Chronicles of the Ghostly Tribe,2015-09-30,2015,0,0,0,1.934762
364379,Cat Sick Blues,2015-10-29,2015,0,0,0,0.651966
364387,Jill And Joy's Winter,2015-10-09,2015,0,0,0,0.030142
364410,The White King,2017-01-27,2017,2494400,0,-2494400,1.779393
364426,Fear Itself,2015-10-18,2015,0,0,0,0.491408
364427,Orleans,2015-09-17,2015,2500000,302000,-2198000,0.192475
364433,They Call Me Jeeg Robot,2015-05-12,2015,1900000,0,-1900000,10.649494
364540,Girl Asleep,2016-06-18,2016,1150118,0,-1150118,6.235767
364615,Toro,2016-04-22,2016,4000000,0,-4000000,2.197914
364684,Takhir and Zukhra,1945-10-21,1945,0,0,0,0.002444
364690,Natural Selection,2016-08-26,2016,0,0,0,2.504774
364781,Master and Tatyana,2015-10-16,2015,0,0,0,0.065193
364810,Triple Troubles,2015-05-15,2015,0,0,0,0.021206
364830,The Champions,2015-11-06,2015,0,0,0,0.262433
364831,Art of the Prank,2015-07-29,2015,0,0,0,0.06713
364833,The End of a Great Era,2015-10-01,2015,0,0,0,0.656706
364834,Los indolentes,1979-06-28,1979,0,0,0,0.0
364865,The Jazz Loft According to W. Eugene Smith,2016-02-02,2016,0,0,0,0.06767
364902,The Dresser,2015-10-31,2015,0,0,0,4.396196
365002,Kryptonita,2015-12-03,2015,0,0,0,0.603562
365037,Swearnet Live,2014-10-01,2014,0,0,0,0.406664
365065,Zero,2015-09-03,2015,0,0,0,1.000576
365183,Killing Them Safely,2015-04-17,2015,0,0,0,0.814786
365187,Nannaku Prematho,2016-01-13,2016,0,0,0,0.85973
365188,Homecoming,2015-08-21,2015,0,0,0,0.15518
365222,Ip Man 3,2015-12-19,2015,36000000,156844753,120844753,8.970494
365267,Strange Heaven,2015-10-16,2015,0,0,0,0.732144
365323,Invisible,2016-11-03,2016,0,0,0,0.057938
365339,Black Road,2015-10-14,2015,0,0,0,0.908656
365340,Cinema: A Public Affair,2015-02-06,2015,0,0,0,0.039483
365371,War Stories Our Mother Never Told Us,,,0,0,0,0.005625
365375,Sunny in the Dark,2015-05-01,2015,0,0,0,0.057005
365432,The Sublet,2015-11-07,2015,0,0,0,1.339355
365447,Body Team 12,2015-04-19,2015,0,0,0,0.338131
365451,"Baby, Baby, Baby",2015-10-30,2015,0,0,0,1.56871
365491,Forever,2015-10-27,2015,0,0,0,1.171801
365544,–ö—Ä–µ–ø–æ—Å—Ç—å: —â–∏—Ç–æ–º –∏ –º–µ—á–æ–º,2015-10-29,2015,0,0,0,0.349582
365566,Small People with Hats,2014-10-03,2014,0,0,0,0.121883
365707,The Queen of Ireland,2015-10-22,2015,0,0,0,0.098526
365709,Berserker,2015-11-10,2015,0,0,0,0.062357
365753,Rodeo and Juliet,2015-11-06,2015,0,0,0,0.620138
365805,Wrecker,2015-11-06,2015,0,0,0,3.377995
365909,Everything Will Be Okay,2015-01-01,2015,0,0,0,0.502436
365942,The Space Between Us,2017-01-26,2017,30000000,14793385,-15206615,11.824404
365997,A Beautiful Planet,2016-04-29,2016,0,0,0,0.878987
366005,Lullaby,2015-10-30,2015,0,0,0,0.480983
366017,You Cast A Spell On Me,2015-10-25,2015,0,0,0,0.761086
366018,A Christmas Melody,2015-12-19,2015,0,0,0,1.468471
366044,Human Failure,,,0,0,0,0.294095
366045,Reluctant Witness,2015-09-02,2015,0,0,0,0.396836
366071,Enchiridion,2012-10-12,2012,0,0,0,0.016824
366080,Kabali,2016-07-22,2016,18700000,74000000,55300000,2.017961
366104,A Decent Man,2016-02-24,2016,0,0,0,1.574392
366120,Red Rose,1980-05-23,1980,0,0,0,0.421404
366143,Binky Nelson Unpacified,2015-11-04,2015,0,0,0,3.232132
366170,Yu-Gi-Oh!: The Dark Side of Dimensions,2016-04-23,2016,0,1015339,1015339,3.23574
366249,Lapland Odyssey 2,2015-09-30,2015,1730000,0,-1730000,1.167688
366269,Satan Lives,2015-10-27,2015,0,0,0,0.037946
366324,Burning Bodhi,2016-08-25,2016,0,0,0,0.555076
366499,Zip & Zap and the Captain's Island,2016-07-29,2016,0,0,0,1.360672
366502,The Tip of the Iceberg,2016-11-03,2016,0,0,0,0.759931
366505,The Olive Tree,2016-05-06,2016,0,0,0,2.541633
366514,Up for Love,2016-05-04,2016,0,0,0,7.626166
366548,Les Dissoci√©s,2015-11-24,2015,0,0,0,2.896562
366551,Krampus: The Reckoning,2015-11-03,2015,0,0,0,0.995952
366561,Blindpassasjer,,,0,0,0,0.035294
366564,Comment c'est Loin,2015-12-09,2015,2023920,0,-2023920,4.72778
366566,Le Grand partage,2015-12-23,2015,0,0,0,3.849773
366630,The Bridge,2015-12-06,2015,0,0,0,1.397482
366631,On the Twelfth Day of Christmas,2015-12-12,2015,0,0,0,0.747467
366656,Snowtime!,2015-11-12,2015,12500000,0,-12500000,3.540621
366692,Margaret Cho: PsyCHO,2015-09-25,2015,0,0,0,0.039325
366696,The Red Pill,2016-10-07,2016,0,0,0,4.057445
366736,Friend,2015-04-10,2015,0,0,0,0.633237
366742,On Football,2016-04-21,2016,0,0,0,0.165381
366759,Ali Baba ve 7 C√ºceler,2015-11-13,2015,0,0,0,1.788631
366763,I Am Syd Stone,,,0,0,0,0.037412
366860,El Violetero,1960-11-24,1960,0,0,0,0.003333
366864,Spandex Sapiens,2015-11-05,2015,0,0,0,0.027059
366885,Public Works,2015-12-10,2015,0,0,0,1.085116
366887,Bon Bini Holland,2015-12-10,2015,0,0,0,1.062404
366901,Despite the Falling Snow,2016-01-29,2016,0,0,0,3.668802
366924,Batman: Bad Blood,2016-03-22,2016,3500000,0,-3500000,7.714405
366985,The Beautiful Beast,2013-11-06,2013,0,0,0,0.157527
367006,Seasick,1996-04-07,1996,1000000,0,-1000000,0.016713
367053,Friends and Romans,,,0,0,0,0.002001
367108,Bathroom Break,2015-10-31,2015,0,0,0,0.215093
367147,Buster's Mal Heart,2017-04-28,2017,0,73121,73121,2.796081
367197,Boom Bust Boom,2016-03-11,2016,0,0,0,0.306991
367206,Sword Master,2016-12-02,2016,0,0,0,1.931869
367215,The Fear of 13,2015-10-15,2015,0,0,0,1.824486
367275,Jare vs. Cheek,2015-11-08,2015,0,0,0,0.040827
367326,Cosmic Scrat-tastrophe,2015-11-06,2015,0,0,0,4.398221
367412,Whiplash,2013-01-18,2013,0,0,0,1.883573
367416,The von Trapp Family: A Life of Music,2015-11-12,2015,0,0,0,0.616745
367492,Bana Adƒ±nƒ± Sor,2015-03-13,2015,0,0,0,0.426635
367493,Providence,2016-02-12,2016,0,0,0,0.308563
367513,Chemsex,2015-11-23,2015,0,0,0,2.611786
367524,Kareem: Minority of One,2015-11-03,2015,0,0,0,0.497687
367536,A Gift Wrapped Christmas,2015-11-28,2015,0,0,0,1.218718
367538,The Flight Before Christmas,2015-12-01,2015,0,0,0,0.850828
367544,The Spirit of Christmas,2015-12-19,2015,0,0,0,1.373548
367551,American Hero,2015-12-11,2015,0,0,0,3.747935
367596,T√§ter√§t√§√§ - Die Kirche bleibt im Dorf 2,2015-06-25,2015,0,0,0,0.291696
367613,The Night My Mother Killed My Father,2016-04-23,2016,0,0,0,2.527909
367647,Connections,,,0,0,0,0.035294
367678,Enola Gay and the Atomic Bombing of Japan,,,0,0,0,0.0
367732,Uncle Nick,2015-12-04,2015,0,0,0,1.780118
367735,John Mulaney: The Comeback Kid,2015-11-13,2015,0,0,0,1.548502
367816,Ghostheads,2016-04-23,2016,0,0,0,1.291129
367882,The Phone,2015-10-22,2015,0,0,0,0.290605
367966,Harold and Lillian: A Hollywood Love Story,2015-11-17,2015,0,0,0,0.115872
367999,The Last Will Be the Last,2015-11-12,2015,0,0,0,2.363169
368006,24,2016-05-05,2016,10000000,15000000,5000000,1.264714
368031,Friend Request,2016-01-07,2016,9900000,2400000,-7500000,14.282584
368051,Don't Hug Me I'm Scared 5,2015-10-14,2015,0,0,0,0.405664
368128,Sins of the mind,,,0,0,0,0.0
368239,View From A Blue Moon,2015-11-11,2015,0,0,0,1.323536
368256,Condemned,2015-11-13,2015,0,0,0,2.418307
368330,Katyar Kaljat Ghusali,2015-11-12,2015,1500000,4400000,2900000,0.446454
368342,Mordkommission Berlin 1,2015-12-01,2015,0,0,0,0.738583
368596,Back in the Day,2016-05-20,2016,0,0,0,6.729595
368620,My Friend Rockefeller,2015-07-04,2015,0,0,0,0.614048
368835,Murder Rap: Inside the Biggie and Tupac Murders,2015-08-08,2015,0,0,0,0.808534
368940,Robinson Crusoe,2016-02-04,2016,13500000,3342697,-10157303,8.969705
368942,A Quiet Passion,2016-10-07,2016,8138338,1864266,-6274072,3.55933
368955,The Recruiter,2008-01-18,2008,0,0,0,0.087263
368993,Mascots,2016-10-11,2016,20000000,0,-20000000,4.136987
368999,John Bishop Supersonic Live,2015-11-16,2015,0,0,0,0.15601
369019,Captain Webb,2015-08-14,2015,0,0,0,1.053752
369032,Carnage Park,2016-07-01,2016,0,0,0,5.225689
369033,Rebirth,2016-04-17,2016,0,0,0,2.34806
369052,Debbie Macomber's Dashing Through the Snow,2015-12-13,2015,0,0,0,0.34146
369054,Christmas Land,2015-12-20,2015,0,0,0,0.831683
369057,A Prince for Christmas,2015-11-29,2015,0,0,0,0.897779
369058,Merry Kissmas,2015-12-05,2015,0,0,0,1.308278
369059,How Sarah Got Her Wings,2015-12-06,2015,0,0,0,1.246346
369165,The Ties That Bind,2015-11-27,2015,0,0,0,0.187825
369168,A Good American,2016-09-23,2016,0,0,0,0.233104
369202,Lake Bodom,2016-08-19,2016,1100000,0,-1100000,1.78089
369228,Dobbiamo parlare,2015-11-19,2015,0,0,0,0.886695
369230,Them who?,2015-11-19,2015,0,0,0,3.496436
369237,The Fourth Phase,2016-10-02,2016,0,0,0,0.847179
369245,La felicit√† √® un sistema complesso,2015-11-26,2015,0,0,0,0.737315
369299,Why Blame It on the Child?,2016-05-13,2016,0,0,0,15.918466
369336,Frontier,2001-03-09,2001,0,0,0,0.037821
369362,"Chau, Beyond the Lines",2015-08-21,2015,0,0,0,0.358231
369363,Claude Lanzmann: Spectres of the Shoah,2015-06-06,2015,0,0,0,0.093139
369364,A Girl in the River: The Price of Forgiveness,2015-10-28,2015,0,0,0,0.40722
369366,Last Day of Freedom,2015-04-11,2015,0,0,0,0.182998
369373,Stutterer,2015-07-08,2015,0,0,0,0.879433
369406,Nowhere Boys: The Book of Shadows,2016-01-01,2016,0,0,0,1.301415
369443,Fatal Intuition,2015-10-28,2015,0,0,0,2.066571
369444,Ostatni dzwonek,1989-10-27,1989,0,0,0,0.000102
369524,The Comedian,2016-12-09,2016,15000000,0,-15000000,7.924525
369557,Sing Street,2016-03-11,2016,4000000,13624522,9624522,10.672862
369567,Las inquietudes de Shanti And√≠a,1947-02-03,1947,0,0,0,0.001648
369594,This Summer Feeling,2015-10-11,2015,0,0,0,1.124403
369603,ŒúŒ±œÅŒπœáŒøœÖŒ¨ŒΩŒ± Œ£œÑŒøœÄ !,1971-01-01,1971,0,0,0,0.070589
369605,Sky Line,2015-11-20,2015,0,0,0,0.063542
369665,Trevor Noah: Lost In Translation,2015-11-22,2015,0,0,0,0.147939
369697,Norman: The Moderate Rise and Tragic Fall of a New York Fixer,2017-04-14,2017,0,0,0,6.164534
369698,Viking,2016-12-29,2016,13000000,0,-13000000,3.880153
369769,Under the Sun,2016-03-10,2016,0,0,0,2.248207
369776,Les Tuche 2: Le r√™ve am√©ricain,2016-02-03,2016,0,0,0,4.322081
369778,Chocolat,2016-02-03,2016,18500000,0,-18500000,8.079555
369796,Kevin Bridges Live: A Whole Different Story,2015-11-23,2015,0,0,0,0.510089
369820,I'm Brent Morin,2015-12-01,2015,0,0,0,0.491232
369834,Sethupathi,2016-02-18,2016,0,0,0,0.217053
369875,A Christmas Eve Miracle,2015-11-24,2015,0,0,0,0.607978
369883,Middle School: The Worst Years of My Life,2016-10-07,2016,8500000,19985196,11485196,10.222143
369885,Allied,2016-11-17,2016,85000000,119520023,34520023,13.085186
369894,Wakefield,2016-09-02,2016,0,0,0,6.835437
370014,To the Ends of the Earth,2005-07-06,2005,0,0,0,0.788353
370044,The Film Parade,1933-01-01,1933,0,0,0,0.001177
370168,Chicago Boys,2015-11-08,2015,0,0,0,0.053101
370178,Scare Campaign,2016-03-17,2016,0,0,0,2.850998
370203,The Swedish Theory of Love,2015-11-15,2015,0,0,0,0.920892
370213,Sonita,2015-11-20,2015,0,0,0,0.399658
370234,Dementia,2015-12-04,2015,0,0,0,2.443744
370260,Dylan Moran: Off The Hook,2015-11-30,2015,0,0,0,0.126416
370264,Provocateur,1995-05-31,1995,0,0,0,0.00133
370353,Women in Love,2011-06-14,2011,0,0,0,0.227826
370382,The Big Gun,1981-12-14,1981,0,0,0,0.049468
370464,The Masked Saint,2016-01-08,2016,0,0,0,0.938748
370524,Rageh Inside Iran,2007-07-01,2007,0,0,0,0.038824
370545,Ivan Tsarevich & the Grey Wolf 3,2016-01-01,2016,0,9409000,9409000,1.440595
370664,Abandoned Dead,2015-01-01,2015,0,0,0,0.059958
370665,Dilwale,2015-12-18,2015,26000000,61000000,35000000,4.081193
370687,Mythica: The Necromancer,2015-12-19,2015,0,0,0,5.82463
370722,London Spy,2015-11-09,2015,0,0,0,1.1196
370741,Flor marchita,1969-07-03,1969,0,0,0,0.00323
370755,Paterson,2016-11-17,2016,5000000,2152738,-2847262,10.300307
370765,Jessica Darling's It List,2016-06-21,2016,0,0,0,1.029507
370835,Cold Deck,2015-12-04,2015,0,0,0,0.901095
370870,Aligarh,2016-02-26,2016,0,0,0,0.351199
370902,The Land of OZ,2015-06-10,2015,0,0,0,0.786265
370964,He's a Dragon,2015-12-04,2015,18000000,1776333,-16223667,5.978316
370978,"Kiki, Love to Love",2016-04-01,2016,0,0,0,5.248189
371003,Kill Game,2015-12-05,2015,0,0,0,0.862874
371007,Ticky Tacky,2014-06-21,2014,0,0,0,0.348758
371084,Mike Epps: Don't Take It Personal,2015-12-18,2015,0,0,0,0.266603
371153,D√ºg√ºn Dernek 2: S√ºnnet,2015-12-04,2015,0,0,0,1.386145
371181,"Murder, She Baked: A Peach Cobbler Mystery",2016-01-10,2016,0,0,0,3.504021
371347,Marc Maron: More Later,2015-12-04,2015,0,0,0,0.274324
371442,Bad Roomies,2015-12-01,2015,0,0,0,1.308065
371445,As You Are,2016-12-08,2016,0,0,0,1.247405
371446,The Free World,2016-09-23,2016,0,0,0,1.437723
371447,Lovesong,2017-02-17,2017,0,6700,6700,2.605017
371449,Other People,2016-09-09,2016,0,93000,93000,3.069108
371451,Keeper of Darkness,2015-11-26,2015,0,0,0,0.894323
371459,A Good Wife,2017-01-19,2017,0,0,0,1.21945
371462,Mammal,2016-04-01,2016,0,0,0,0.274712
371463,Sand Storm,2016-01-25,2016,0,0,0,0.786994
371464,Wild,2016-04-14,2016,0,0,0,0.928616
371465,Much Ado About Nothing,2016-09-01,2016,0,0,0,0.335217
371492,Tomorrow,2015-12-02,2015,0,43471,43471,4.241058
371504,River,2015-10-13,2015,0,0,0,2.444659
371507,Locust,2014-06-25,2014,0,467363,467363,0.579741
371560,The Eyes of My Mother,2016-12-02,2016,0,0,0,7.565485
371645,Hunt for the Wilderpeople,2016-03-31,2016,0,0,0,9.259371
371647,Mahana,2016-09-01,2016,0,0,0,1.260373
371695,Owen Hart of Gold,2015-12-08,2015,0,0,0,0.089491
371738,Looking: The Movie,2016-07-24,2016,0,0,0,3.641354
371741,Ali and Nino,2016-01-27,2016,0,0,0,1.921837
371743,Sophie and the Rising Sun,2016-01-27,2016,0,0,0,1.003024
371758,And Then There Were None,,,0,0,0,5.238281
371759,Doctor Who: The Husbands of River Song,2015-12-25,2015,0,0,0,2.598769
371806,I Remember You,2015-11-13,2015,0,0,0,0.497838
371818,Ouzeri Tsitsanis,2015-12-03,2015,0,0,0,0.064911
371833,Harry Price: Ghost Hunter,2015-12-27,2015,0,0,0,0.618162
371859,The Death of Louis XIV,2016-11-02,2016,0,17355,17355,0.651404
371865,Slack Bay,2016-05-13,2016,0,112481,112481,7.917157
371899,The Puppet Syndrome,2015-11-05,2015,2000000,0,-2000000,0.158344
371942,Le nozze di Laura,2015-12-08,2015,0,0,0,0.128341
372058,Your Name.,2016-08-26,2016,0,355298270,355298270,34.461252
372113,Ahwak,2015-09-24,2015,0,0,0,0.314468
372174,House of Manson,2014-01-01,2014,0,0,0,0.229915
372226,Visaranai,2016-02-04,2016,325000,1600000,1275000,0.867549
372234,Il mare,1962-03-08,1962,0,0,0,0.191785
372297,Charlie,2015-12-24,2015,1900000,5900000,4000000,1.188662
372315,SOMM: Into the Bottle,2016-01-29,2016,0,0,0,0.751736
372355,The Black Hen,2015-12-09,2015,0,0,0,0.392167
372411,Absolutely Fabulous: The Movie,2016-07-01,2016,0,37915971,37915971,6.395748
372490,Swept Under,2015-12-06,2015,0,0,0,0.854625
372631,Marvel Super Hero Adventures: Frost Fight!,2015-12-15,2015,0,0,0,1.093779
372640,The Very Private Life of Mister Sim,2015-12-16,2015,0,0,0,1.611466
372691,White Bondage,1937-08-05,1937,0,0,0,0.341004
372754,Classmates,2016-02-20,2016,0,0,0,1.512917
372821,S: The Last Policeman: Recovery of Our Future,2015-08-29,2015,0,0,0,1.087027
372946,The Box,2003-06-06,2003,0,0,0,0.002672
372981,Marco Polo: One Hundred Eyes,2015-12-26,2015,0,0,0,2.41637
372985,Boris Without Beatrice,2016-03-04,2016,0,0,0,0.57672
373072,Tickled,2016-01-24,2016,0,0,0,7.418452
373200,Detective Chinatown,2015-12-31,2015,0,0,0,1.240222
373247,Down Under,2016-08-11,2016,2000000,0,-2000000,0.947866
373314,Misconduct,2016-02-05,2016,11000000,0,-11000000,8.996087
373348,Author: The JT LeRoy Story,2016-01-22,2016,0,0,0,0.428899
373349,Mapplethorpe: Look at the Pictures,2016-06-16,2016,0,0,0,0.557941
373355,The Lovers and the Despot,2016-09-23,2016,0,0,0,0.744523
373357,Conspiracy of Silence,1991-01-01,1991,0,0,0,0.039534
373397,Refrigerantes e Can√ß√µes de Amor,2016-08-25,2016,0,0,0,0.867506
373441,Jim: The James Foley Story,2016-01-23,2016,0,0,0,1.149859
373442,When Two Worlds Collide,2016-01-22,2016,0,0,0,0.033948
373451,Michael Jackson's Journey from Motown to Off the Wall,2016-02-06,2016,0,0,0,2.321825
373453,Brahman Naman,2016-01-24,2016,0,0,0,0.739455
373471,The Land,2016-07-29,2016,0,0,0,0.878691
373472,Holy Hell,2016-01-25,2016,0,16905,16905,1.279443
373473,Little Men,2016-08-05,2016,0,0,0,2.624004
373476,Complete Unknown,2016-08-26,2016,0,187145,187145,4.062516
373479,Eat that Question: Frank Zappa in His Own Words,2016-05-03,2016,0,0,0,0.359999
373480,Kiki,2017-05-26,2017,0,0,0,0.560965
373481,Unlocking the Cage,2016-01-25,2016,0,0,0,0.697445
373514,Night Chase,1970-11-20,1970,0,0,0,0.040583
373541,Dark Awakening,2014-09-10,2014,0,0,0,0.610094
373546,Chuck,2017-05-05,2017,0,0,0,7.132024
373569,Snatched,2017-05-03,2017,42000000,60845711,18845711,11.214779
373745,Bloodknot,1995-09-17,1995,0,0,0,0.107912
373757,Beyond Sleep,2016-01-27,2016,0,0,0,0.407649
373838,The Best Day Ever,2015-12-24,2015,0,0,0,1.564776
373841,Pass-Thru,2016-10-20,2016,0,0,0,0.226731
373878,Lusers,2015-10-01,2015,2000000,0,-2000000,0.361454
373889,The Most Beautiful Day,2016-02-25,2016,0,0,0,3.80694
373922,Three,2016-06-02,2016,0,0,0,1.12287
373976,The PHD Movie 2,2015-12-23,2015,0,0,0,0.029535
373977,Childhood's End,2015-12-14,2015,0,0,0,2.856502
374003,Hieronymus Bosch: Touched by the Devil,2015-11-20,2015,0,0,0,0.089967
374021,Groom from London,1967-04-16,1967,0,0,0,0.051059
374052,The Love Witch,2016-11-11,2016,0,0,0,4.530712
374142,White Rage,2015-11-27,2015,0,0,0,0.064238
374173,Kapoor & Sons (Since 1921),2016-03-18,2016,0,0,0,1.208654
374174,Elliott Morgan: Premature,2015-12-10,2015,0,0,0,0.058295
374205,One Piece Film: GOLD,2016-07-23,2016,0,66207073,66207073,5.40012
374247,Die Salzprinzessin,2015-12-03,2015,0,0,0,0.072735
374251,Stick Man,2016-10-05,2016,0,0,0,5.66954
374319,Prinzessin Maleen,2015-12-25,2015,0,0,0,0.147015
374416,Quo vado?,2016-01-01,2016,10000000,0,-10000000,5.18624
374430,Black Mirror: White Christmas,2014-12-16,2014,0,0,0,24.910782
374440,Spa Night,2016-01-26,2016,0,0,0,0.357906
374452,Sieranevada,2016-08-03,2016,1488410,0,-1488410,1.151032
374458,Graduation,2016-05-20,2016,2000000,343617,-1656383,2.840429
374460,A Grand Night In: The Story of Aardman,2015-12-26,2015,0,0,0,0.292057
374461,Mr. Church,2016-09-16,2016,8000000,0,-8000000,5.455625
374464,Planetarium,2016-11-16,2016,0,0,0,4.172155
374465,Things to Come,2016-03-16,2016,2100000,282382,-1817618,5.858112
374471,Porto,2017-09-14,2017,0,0,0,2.152189
374473,"I, Daniel Blake",2016-10-21,2016,0,260354,260354,18.577504
374475,Toni Erdmann,2016-07-14,2016,3537415,1390172,-2147243,9.117054
374515,Stalked by My Doctor,2015-12-26,2015,4000000,0,-4000000,1.184042
374603,Love in Paradise,2016-01-02,2016,0,0,0,0.127244
374606,Love's Complicated,2016-01-09,2016,0,0,0,1.014721
374607,Love on the Sidelines,2016-01-16,2016,0,0,0,1.600538
374609,Unleashing Mr. Darcy,2016-01-23,2016,0,0,0,0.651791
374614,Dater's Handbook,2016-01-30,2016,0,0,0,0.147323
374617,Imperium,2016-08-19,2016,0,35000,35000,8.835928
374618,Scrawl,2015-10-17,2015,0,0,0,1.039918
374671,After the Storm,2016-05-21,2016,0,0,0,4.825361
374698,Vallen,2001-10-24,2001,0,0,0,0.00129
374720,Dunkirk,2017-07-19,2017,100000000,519876949,419876949,30.938854
374739,Flower Shop Mystery: Mum's the Word,2016-01-17,2016,0,0,0,2.206077
374764,How Most Things Work,2015-11-12,2015,0,0,0,0.274793
374883,The Partisans,1963-02-21,1963,0,0,0,0.038281
375012,Under the Shadow,2016-10-07,2016,0,0,0,5.841
375082,Spaceman,2016-08-19,2016,0,0,0,1.643697
375167,Assolo,2016-01-05,2016,0,0,0,1.106699
375170,The Tag-Along,2015-11-17,2015,0,0,0,0.901885
375183,A Family Man,2017-05-18,2017,0,0,0,8.844173
375199,Jai Gangaajal,2016-03-04,2016,1500000,0,-1500000,0.338503
375290,Airlift,2016-01-22,2016,4500000,32000000,27500000,3.376147
375298,Milling the Militants,1913-03-31,1913,0,0,0,0.002307
375315,The Salesman,2016-06-24,2016,0,2402067,2402067,5.673744
375345,The Submarine Kid,2016-01-12,2016,0,0,0,1.220782
375355,Don't Hang Up,2016-10-22,2016,0,0,0,5.597094
375356,Next Year If All Goes Well,1981-08-05,1981,0,0,0,0.108121
375366,The Girl with All the Gifts,2016-09-23,2016,5005600,0,-5005600,10.444797
375384,Lie Detector,2011-07-22,2011,0,0,0,0.329646
375572,Italian Race,2016-04-07,2016,0,0,0,4.929165
375573,Chasing Great,2016-09-01,2016,0,0,0,0.645155
375599,Bad Guys Always Die,2015-11-27,2015,0,5000,5000,0.551061
375732,The Ritchie Blackmore Story,2015-11-06,2015,0,0,0,0.133132
375742,The Lure,2015-12-25,2015,1300000,101657,-1198343,2.159038
375746,Walpurgis,2015-09-25,2015,0,0,0,0.058036
375794,No manches Frida,2016-09-02,2016,0,0,0,19.454717
375798,Brice 3,2016-10-19,2016,0,0,0,7.276407
375867,Paris Can Wait,2016-09-12,2016,5000000,6700000,1700000,8.966129
375872,Heroes Wanted,2016-08-26,2016,0,0,0,2.494716
375898,Meet the Guilbys,2016-01-20,2016,0,0,0,1.161943
375950,The Country Doctor,2016-03-23,2016,0,0,0,4.308868
376003,Mercury Plains,2016-01-05,2016,0,0,0,1.217069
376004,Adulterers,2016-01-05,2016,750000,0,-750000,1.13377
376047,Fitoor,2016-02-12,2016,0,0,0,1.844693
376134,The Discovery,2017-03-31,2017,0,0,0,6.803535
376166,From the Land of the Moon,2016-10-19,2016,10300000,47748,-10252252,6.165491
376188,Demidovy,1983-08-01,1983,0,0,0,0.00022
376228,Audrie & Daisy,2016-09-23,2016,0,0,0,3.870762
376233,"Life, Animated",2016-03-03,2016,0,0,0,2.395349
376234,Newtown,2016-01-24,2016,0,0,0,0.801792
376237,Suited,2016-01-25,2016,0,0,0,0.152323
376252,Mood of the Day,2016-01-14,2016,0,0,0,0.935648
376257,Trapped,2016-01-24,2016,0,0,0,0.172762
376261,Weiner,2016-05-20,2016,0,0,0,2.990039
376263,How to Let Go of the World and Love All the Things Climate Can't Change,2016-04-02,2016,1600000,0,-1600000,0.105145
376290,Miss Sloane,2016-11-25,2016,13000000,3500605,-9499395,14.017754
376292,Paradox,2016-04-22,2016,0,0,0,1.400155
376311,Little Dead Rotting Hood,2016-01-05,2016,0,0,0,2.480478
376358,The Son of an Afghan Farmer,2012-01-06,2012,0,0,0,0.008347
376386,All These Sleepless Nights,2016-11-04,2016,0,0,0,0.570859
376387,Hooligan Sparrow,2016-07-22,2016,0,0,0,0.087553
376389,Sky Ladder: The Art of Cai Guo-Qiang,2016-01-21,2016,0,0,0,0.393677
376391,We Are X,2016-03-12,2016,0,0,0,0.636588
376394,To Mars by A-Bomb: The Secret History of Project Orion,2003-03-26,2003,175000,0,-175000,0.002983
376424,Beware the Slenderman,2016-03-11,2016,0,0,0,2.231686
376426,Tony Robbins: I Am Not Your Guru,2016-07-15,2016,0,0,0,0.942684
376453,Operation Avalanche,2016-07-29,2016,1000000,0,-1000000,2.847833
376482,Tom Segura: Mostly Stories,2016-01-08,2016,0,0,0,0.789154
376501,Outlaws and Angels,2016-01-25,2016,0,0,0,2.148608
376502,The Blackout Experiments,2016-05-21,2016,0,0,0,0.147848
376515,Becoming Mike Nichols,2016-02-22,2016,0,0,0,0.615297
376523,Nothing Left Unsaid: Gloria Vanderbilt & Anderson Cooper,2016-04-09,2016,0,0,0,0.216848
376530,The Eagle Huntress,2016-11-02,2016,0,3162153,3162153,1.43679
376534,Cameraperson,2016-09-09,2016,0,0,0,1.441494
376538,Outlaw: Heartless,1968-08-01,1968,0,0,0,0.278057
376543,Outlaw: Goro the Assassin,1968-11-28,1968,0,0,0,0.003282
376548,Outlaw: Black Dagger,1968-12-28,1968,0,0,0,0.136356
376549,The Strange House,2015-07-24,2015,0,0,0,1.703793
376553,Outlaw: Kill!,1969-03-14,1969,0,0,0,0.010282
376565,The Duelist,2016-09-29,2016,12823507,6101904,-6721603,2.981184
376570,Hush,2016-03-12,2016,0,0,0,7.205636
376579,Let's Be Evil,2016-08-05,2016,0,0,0,4.39495
376581,Amateur Night,2016-08-12,2016,0,0,0,17.208064
376599,Miles Jupp: Is The Chap You're Thinking Of,2015-11-13,2015,0,0,0,0.055419
376651,Endgame,2015-09-25,2015,0,0,0,0.211327
376659,Bad Moms,2016-07-28,2016,20000000,183936074,163936074,9.362056
376660,The Edge of Seventeen,2016-11-18,2016,9000000,18803648,9803648,9.51953
376681,X: Past Is Present,2015-11-20,2015,0,0,0,0.311335
376716,Elections Day 2,2016-02-18,2016,0,4314688,4314688,0.796854
376812,Sultan,2016-07-06,2016,10400000,102000000,91600000,6.070606
376823,Trophy Kids,2013-12-04,2013,0,0,0,0.54238
376847,Remember You,2016-01-07,2016,0,0,0,0.357995
376866,Jackie,2016-12-02,2016,9000000,13960394,4960394,8.362716
376867,Moonlight,2016-10-21,2016,4000000,65046687,61046687,14.171675
376869,Neerja,2016-02-19,2016,10721568,2978994,-7742574,1.68625
376916,Ten Years,2015-11-15,2015,0,0,0,1.042834
376934,Restart,2005-01-10,2005,0,0,0,0.004765
376951,Francis Bacon,1988-01-01,1988,0,0,0,0.000308
377136,Liquidation,2007-01-10,2007,0,0,0,0.132189
377150,A Dragon Arrives!,2016-04-27,2016,0,0,0,0.753249
377151,Fire at Sea,2016-02-18,2016,0,0,0,2.450026
377154,Being 17,2016-02-27,2016,0,0,0,4.909346
377158,United States of Love,2016-07-29,2016,0,0,0,0.612563
377170,Trailin' West,1936-09-04,1936,0,0,0,0.017679
377196,Cleopatra's Palace: In Search of a Legend,1999-01-01,1999,0,0,0,0.001256
377206,Army Dog,2016-01-12,2016,0,0,0,0.915298
377210,Fantastic Lies,2016-03-13,2016,0,0,0,0.111868
377213,Te3n,2016-06-10,2016,5069632,4817642,-251990,1.434237
377263,Frantz,2016-09-07,2016,0,880474,880474,9.098394
377264,Morgan,2016-09-01,2016,8000000,8810591,810591,12.521071
377273,Aquarius,2016-09-01,2016,762241,285930,-476311,4.860265
377274,The Ornithologist,2016-10-05,2016,0,0,0,2.451704
377275,In Bed with Victoria,2016-09-14,2016,0,0,0,12.474119
377276,Struggle for Life,2016-06-15,2016,0,0,0,2.2326
377278,After Love,2016-06-08,2016,0,0,0,4.499903
377287,The Son of Joseph,2016-04-20,2016,0,0,0,0.355947
377290,A Serious Game,2016-09-09,2016,0,0,0,1.052459
377362,Clarisse or Something About Us,2015-10-30,2015,0,0,0,0.053046
377428,All Things Valentine,2016-01-31,2016,0,0,0,0.823505
377431,Appetite For Love,2016-02-06,2016,0,0,0,0.954314
377432,Valentine Ever After,2016-02-13,2016,0,0,0,1.28333
377446,Tony Hinchcliffe: One Shot,2016-01-15,2016,0,0,0,0.502291
377447,Railroad Tigers,2016-12-23,2016,50000000,102205175,52205175,3.798504
377448,The Rocky Horror Picture Show: Let's Do the Time Warp Again,2016-10-20,2016,0,0,0,2.178526
377462,O.J.: Made in America,2016-05-20,2016,0,0,0,3.545259
377492,Dirty 30,2016-09-23,2016,0,0,0,1.579585
377516,The Rack Pack,2016-01-17,2016,0,0,0,1.357749
377565,Notias,2016-01-14,2016,0,0,0,0.59479
377587,Meet the Blacks,2016-04-01,2016,0,0,0,3.569379
377691,The Man,2017-03-02,2017,0,0,0,1.047288
377799,One Man and his Cow,2015-09-30,2015,5300000,0,-5300000,4.199624
377823,The Final Master,2015-12-10,2015,0,0,0,1.495574
377847,Scrappin',2016-05-05,2016,0,0,0,0.553254
377852,Greetings From Fukushima,2016-03-10,2016,0,0,0,0.683367
377853,"The First, the Last",2016-01-27,2016,0,0,0,1.551621
377897,Barbie: Spy Squad,2016-01-15,2016,0,0,0,4.437478
377985,Fan,2016-04-15,2016,16000000,29251596,13251596,5.127876
378018,The Void,2016-10-21,2016,0,0,0,9.082794
378064,A Silent Voice,2016-09-17,2016,0,19606617,19606617,34.852055
378087,El preg√≥n,2016-01-18,2016,0,0,0,1.997362
378092,Kill Kane,2016-03-01,2016,0,0,0,1.15662
378108,In This Corner of the World,2016-11-12,2016,0,19204593,19204593,2.914029
378111,A Stork's Journey,2017-05-11,2017,0,0,0,9.459123
378137,Hannibal Buress: Comedy Camisado,2016-02-05,2016,0,0,0,0.826674
378195,Lady Day at Emerson's Bar & Grill,2016-03-12,2016,0,0,0,0.208344
378200,The Perfect Match,2016-03-11,2016,0,0,0,3.150511
378221,Rufus,2016-01-18,2016,0,0,0,0.242644
378227,Natsamrat,2016-01-01,2016,0,0,0,0.251476
378236,The Emoji Movie,2017-07-28,2017,50000000,66913939,16913939,33.694599
378240,Yu‚òÜGi‚òÜOh!,1999-03-06,1999,0,0,0,0.471173
378263,Addicted to Sexting,2015-11-17,2015,0,0,0,0.544172
378348,A Violent Prosecutor,2016-02-03,2016,500,50,-450,1.398756
378350,The Mine,2016-01-22,2016,1200000,0,-1200000,0.842808
378379,The Lost Arcade,2015-11-14,2015,0,0,0,0.062544
378385,Jarhead 3: The Siege,2016-01-20,2016,0,0,0,3.596977
378435,Whistle If You Come Back,1993-02-12,1993,0,0,0,0.008903
378441,Notes on Blindness,2016-07-01,2016,0,0,0,1.787411
378446,Ogres,2016-03-16,2016,0,0,0,0.859031
378450,Out of Love,2016-08-11,2016,0,0,0,0.231781
378452,The Barchester Chronicles,1982-11-10,1982,0,0,0,0.027777
378477,Metrobranding,2010-02-21,2010,0,0,0,0.057651
378480,Il Solengo,2016-01-30,2016,0,0,0,0.067208
378483,Suntan,2016-03-31,2016,0,0,0,2.59425
378485,We Are the Flesh,2016-10-01,2016,0,0,0,1.608321
378503,The Wounded Angel,2016-02-11,2016,0,0,0,0.17471
378505,Hotel Dallas,2016-02-15,2016,0,0,0,0.098763
378570,The Pills - Sempre meglio che lavorare,2016-01-21,2016,0,0,0,1.451931
378607,The House,2016-01-20,2016,0,0,0,0.416882
378813,Aloys,2016-03-31,2016,0,0,0,0.77748
378918,Snatched,1973-01-31,1973,0,0,0,0.053082
379008,Whitney Cummings: I'm Your Girlfriend,2016-01-23,2016,0,0,0,0.140222
379019,My Blind Date with Life,2017-01-26,2017,0,0,0,5.470463
379220,No Filter,2016-01-07,2016,0,0,0,2.00768
379275,The Three Men of Melita Zganjer,1998-01-01,1998,0,0,0,0.089083
379291,Justice League vs. Teen Titans,2016-03-29,2016,0,0,0,6.504562
379297,Toni Braxton: Unbreak My Heart,2016-01-23,2016,0,0,0,0.319065
379300,Erased,2016-08-18,2016,0,0,0,1.129126
379335,Love Records,2016-01-29,2016,0,0,0,0.974151
379371,Pre Vis Action,2016-01-25,2016,0,0,0,0.505649
379387,Vulgar Fractions,2011-06-03,2011,0,0,0,0.121807
379388,Las Plantas,2017-01-27,2017,0,0,0,0.218588
379441,Greater,2016-08-26,2016,0,0,0,1.912697
379500,Under the Gun,2016-05-13,2016,0,0,0,0.399009
379508,Throbs at the Desk,1963-11-11,1963,0,0,0,0.115549
379689,Alcina,1999-12-01,1999,0,0,0,0.001187
379779,The Present,2014-04-22,2014,0,0,0,2.435431
379873,L'abbiamo fatta grossa,2016-01-28,2016,0,0,0,2.908434
379887,Like for Likes,2016-02-17,2016,0,0,0,0.828908
379925,The Answers,2015-02-06,2015,0,0,0,0.323318
379959,Thunder Road,2016-01-23,2016,0,0,0,0.102319
379990,Anything for Love,2016-02-14,2016,0,0,0,1.152114
379992,"Signed, Sealed, Delivered: From the Heart",2016-02-21,2016,0,0,0,1.01793
379998,Becoming Zlatan,2016-02-17,2016,0,0,0,1.49011
380007,Everybody's Fine,2016-01-01,2016,0,0,0,0.100128
380013,Nobody Walks in L.A.,2015-01-01,2015,0,0,0,0.126559
380057,Rory Scovel: The Charleston Special,2015-10-27,2015,0,0,0,0.145202
380058,Matt Besser: Besser Breaks The Record,2016-01-01,2016,0,0,0,0.029425
380061,Cameron Esposito: Marriage Material,2016-03-24,2016,0,0,0,0.163667
380075,Fog in August,2016-09-29,2016,8000000,0,-8000000,3.379405
380111,Flight Crew,2016-04-21,2016,10000000,27305571,17305571,5.42046
380124,Boo! A Madea Halloween,2016-10-21,2016,0,0,0,4.610686
380225,Like Crazy,2016-05-17,2016,0,0,0,5.516986
380254,SORI: Voice from the Heart,2016-01-27,2016,0,0,0,0.209593
380282,Peacock,2015-07-01,2015,0,0,0,0.02238
380372,The Asylum,2013-09-07,2013,0,0,0,1.002252
380438,Lettre d'une inconnue,2001-01-01,2001,0,0,0,0.001283
380565,Home Invasion,2016-02-02,2016,0,0,0,2.679641
380592,Ten Meter Tower,2016-01-29,2016,0,0,0,0.071101
380620,Creepy,2016-06-18,2016,0,0,0,1.288657
380622,Staying Vertical,2016-08-24,2016,0,0,0,1.679783
380623,Nocturama,2016-08-31,2016,0,0,0,2.445969
380694,Homegrown: The Counter-Terror Dilemma,2016-02-08,2016,0,0,0,0.352202
380699,We're Still Here: Johnny Cash's Bitter Tears Revisited,2015-11-20,2015,0,0,0,0.028462
380731,Darkweb,2016-03-08,2016,0,0,0,1.348471
380734,Forsaken,2016-02-02,2016,0,0,0,1.98305
380754,Isolation,2015-10-31,2015,0,0,0,1.365543
380762,Trivisa,2016-04-07,2016,0,0,0,1.945179
380771,Bartleby,1970-10-30,1970,0,0,0,0.001172
380808,Zero Days,2016-07-08,2016,0,0,0,3.785788
380841,Veljet,1991-12-13,1991,0,0,0,0.0
380856,A Stand Up Guy,2016-02-09,2016,0,0,0,0.624399
380864,Hardly a Butterfly,1998-01-05,1998,0,0,0,0.051495
380879,News from Planet Mars,2016-03-09,2016,0,0,0,2.266545
381008,Claire in Motion,2017-01-13,2017,0,0,0,0.899753
381009,Donald Cried,2017-03-03,2017,0,0,0,0.37476
381011,Hunter Gatherer,2016-11-16,2016,0,0,0,0.283946
381015,The Other Half,2016-12-02,2016,0,0,0,1.725625
381018,Transpecos,2016-09-09,2016,0,0,0,1.864784
381019,"Accidental Courtesy: Daryl Davis, Race & America",2016-03-13,2016,0,0,0,0.294823
381021,Best and Most Beautiful Things,2016-12-02,2016,0,0,0,0.103395
381024,Orange Sunshine,2016-03-14,2016,0,0,0,0.435053
381028,Tower,2016-03-13,2016,0,0,0,5.793238
381032,Another Evil,2017-05-05,2017,0,0,0,0.882583
381034,I Am Not a Serial Killer,2016-08-26,2016,0,0,0,6.409124
381040,My Blind Brother,2016-09-19,2016,0,0,0,9.86258
381041,Rainbow Time,2016-03-14,2016,0,0,0,0.550965
381043,Asperger's Are Us,2016-11-11,2016,0,0,0,0.356999
381044,The Bandit,2016-03-12,2016,0,0,0,0.147063
381045,Chicken People,2016-03-13,2016,0,0,0,0.635835
381046,The Dwarvenaut,2016-04-30,2016,0,0,0,0.07273
381054,Clown Service,2015-04-16,2015,0,0,0,0.021245
381058,Silicon Cowboys,2016-09-16,2016,0,0,0,1.297714
381063,The Alchemist Cookbook,2016-03-13,2016,0,0,0,0.359493
381064,American Fable,2017-02-17,2017,0,0,0,2.770366
381066,Jules and Dolores,2016-09-08,2016,0,0,0,0.532013
381069,Little Sister,2016-10-06,2016,0,0,0,2.445975
381070,Loev,2016-05-12,2016,0,0,0,1.816328
381071,My Beautiful Broken Brain,2016-03-18,2016,0,0,0,1.434217
381073,Operator,2016-03-12,2016,0,0,0,1.736931
381075,Teenage Cocktail,2016-03-12,2016,0,0,0,2.214543
381080,The Art of Organized Noize,2016-03-15,2016,0,0,0,0.761993
381090,Ghostland: The View of the Ju'Hoansi,2016-03-11,2016,0,0,0,0.034855
381096,Yarn,2016-03-12,2016,0,0,0,0.067624
381255,Down by Love,2016-03-02,2016,0,0,0,4.553004
381276,Robin Williams - Off the Wall,1978-02-04,1978,0,0,0,0.0
381277,The Yard,2016-03-11,2016,0,0,0,1.287216
381284,Hidden Figures,2016-12-10,2016,25000000,230698791,205698791,16.816834
381288,Split,2016-11-15,2016,9000000,276921998,267921998,28.920839
381289,A Dog's Purpose,2017-01-19,2017,22000000,194647323,172647323,9.863789
381298,Ghayal Once Again,2016-02-05,2016,0,0,0,0.776447
381341,Perfect Strangers,2016-02-11,2016,0,0,0,6.984664
381347,Decadence and Downfall: The Shah of Iran's Ultimate Party,2016-02-14,2016,0,0,0,0.06783
381353,Rosalie Blum,2016-03-23,2016,0,0,0,2.192453
381356,Five,2016-03-30,2016,0,0,0,4.262876
381374,Action Hero Biju,2016-02-04,2016,300000,2500000,2200000,0.350207
381418,Sanam Teri Kasam,2016-02-05,2016,0,0,0,2.004556
381449,We are the tide,2016-11-03,2016,0,0,0,0.452123
381505,The Identity Theft of Mitch Mustain,2013-05-18,2013,0,0,0,0.116471
381507,Home,2016-03-01,2016,0,0,0,0.548523
381518,Mindhorn,2017-05-05,2017,0,0,0,5.760089
381519,Ghost in the Shell Arise - Border 5: Pyrophoric Cult,2015-08-26,2015,0,0,0,2.056319
381525,WiNWiN,2016-01-27,2016,0,0,0,0.030766
381615,The Bridge Part 2,2016-03-20,2016,0,0,0,1.995138
381645,My Father Die,2016-03-12,2016,0,0,0,1.615055
381670,Vogelfrei,,,0,0,0,0.0
381685,Ricardo O'Farrill: Abrazo Genial,2016-01-22,2016,0,0,0,0.095829
381691,Maheshinte Prathikaaram,2016-02-05,2016,0,230000,230000,0.656226
381707,Our Lovers,2016-02-08,2016,1400000,0,-1400000,3.822114
381737,Manson's Lost Girls,2016-02-06,2016,0,0,0,0.341502
381767,Shelley,2016-02-14,2016,0,0,0,3.154551
381890,The Mermaid,2016-02-08,2016,60720000,553810228,493090228,5.296052
381935,Jack Goes Home,2016-03-14,2016,0,0,0,1.664214
382079,Donald Trump's The Art of the Deal: The Movie,2016-02-10,2016,0,0,0,2.058059
382088,The Division: Agent Origins,2016-01-19,2016,0,0,0,1.786294
382125,Welcome to Norway,2016-03-04,2016,0,0,0,1.068858
382127,Manifesto,2017-06-15,2017,10000,0,-10000,2.02267
382143,"I, Olga Hepnarova",2016-03-24,2016,0,0,0,1.888341
382155,Pitbull. New Order,2016-01-22,2016,0,0,0,1.921469
382170,A Bride for Rip Van Winkle,2016-03-26,2016,0,0,0,1.197393
382200,Setoutsumi,2016-07-02,2016,0,0,0,1.304027
382207,Late Bloomer,2016-08-06,2016,1600000,0,-1600000,0.542637
382212,Homo Sapiens,2016-07-29,2016,0,0,0,0.918768
382217,Vanishing Time: A Boy Who Returned,2016-11-10,2016,0,0,0,3.748235
382220,Master,2016-12-21,2016,0,0,0,1.888826
382322,Batman: The Killing Joke,2016-07-21,2016,3500000,3775000,275000,6.488277
382399,High Strung,2016-04-08,2016,0,53447,53447,6.625607
382436,"Vous √™tes tr√®s jolie, mademoiselle",,,0,0,0,0.073358
382455,Don't Call Me Son,2016-07-20,2016,0,0,0,0.552199
382474,Triumph‚Äôs Election Special 2016,2016-02-11,2016,0,0,0,0.052958
382475,The Pass,2016-03-16,2016,0,0,0,6.710179
382501,Eternity,2016-09-07,2016,0,0,0,7.88175
382509,Cezanne and I,2016-09-21,2016,0,0,0,4.495703
382511,Penny Pincher!,2016-09-28,2016,0,0,0,8.447096
382517,Open Season: Scared Silly,2015-12-31,2015,0,0,0,4.452672
382518,Last Call for Nowhere,2016-07-13,2016,0,0,0,3.909978
382523,Vaesen,2012-10-17,2012,0,0,0,0.080108
382563,Where's the Dragon?,2015-10-23,2015,0,0,0,0.993488
382581,Monster High Great Scarrier Reef,2016-02-12,2016,0,0,0,2.586309
382589,Rock'n Roll,2017-02-15,2017,0,0,0,6.677459
382591,Two Is a Family,2016-12-07,2016,0,1447740,1447740,17.181564
382595,Dalida,2016-11-30,2016,0,0,0,7.991801
382597,R.A.I.D. Special Unit,2017-02-01,2017,0,0,0,7.538272
382598,Full Speed,2016-11-11,2016,0,0,0,6.636211
382602,Sadako vs. Kayako,2016-06-18,2016,0,0,0,2.743227
382614,The Book of Henry,2017-06-16,2017,10000000,4219536,-5780464,24.553725
382651,Helix,2015-01-01,2015,0,0,0,1.287941
382653,Old Stone,2016-02-12,2016,0,0,0,0.117969
382725,Sociopathia,2015-11-19,2015,0,0,0,1.112734
382751,Junction 48,2016-02-13,2016,0,0,0,0.233651
382873,On the Other Side,2016-03-04,2016,0,0,0,0.402697
382883,Shepherds and Butchers,2017-05-12,2017,0,0,0,5.821549
382885,Very Private Lesson,1998-04-21,1998,0,0,0,0.002573
382892,Paris 05:59: Th√©o & Hugo,2016-04-27,2016,0,0,0,1.730661
382899,Mother,2016-01-27,2016,0,0,0,0.066061
382906,Rara,2016-02-13,2016,0,0,0,0.64499
382913,Mellow Mud,2016-02-26,2016,0,0,0,0.285596
382951,A Sunday Horse,2016-02-15,2016,0,0,0,1.887931
382962,If These Knishes Could Talk: The Story of the NY Accent,,,0,0,0,0.0
382995,George !,1972-06-03,1972,0,0,0,3e-06
383001,My Honor Was Loyalty,2015-06-01,2015,0,0,0,1.370703
383064,Road to Istanbul,2016-02-15,2016,0,0,0,0.332145
383121,Kindergarten Cop 2,2016-05-17,2016,0,0,0,13.927597
383140,Weaponized,2016-03-01,2016,0,0,0,1.998282
383146,Curumim,2016-02-11,2016,0,0,0,0.031767
383216,Carole King: Natural Woman,2016-02-19,2016,0,0,0,0.033154
383255,Depth Two,2016-02-13,2016,0,0,0,0.102186
383256,Love Finds You in Valentine,2016-02-14,2016,1000000,0,-1000000,0.286101
383367,Sairat,2016-04-29,2016,0,0,0,1.492993
383526,You'll Never Be Alone,2016-02-13,2016,0,0,0,0.714494
383535,They're Watching,2016-03-25,2016,3650000,0,-3650000,3.050844
383538,The Shadow Effect,2017-05-02,2017,4000000,0,-4000000,2.548897
383559,Tomcat,2016-02-13,2016,0,0,0,1.022702
383567,Theo Von: No Offense,2016-02-26,2016,0,0,0,0.401253
383618,Siv Sleeps Astray,2016-09-28,2016,0,0,0,2.660047
383725,Forgive Me,2001-10-18,2001,0,0,0,0.001177
383743,Before the Streets,2016-02-18,2016,0,0,0,0.147947
383785,Kung Fu Yoga,2017-01-27,2017,65000000,254212245,189212245,17.630487
383788,Attack of the Lederhosen Zombies,2016-12-01,2016,0,0,0,1.262382
383807,Heal the Living,2016-11-01,2016,0,0,0,4.689067
383809,Merci patron !,2016-02-24,2016,0,0,0,2.045505
383869,Back to Mom's,2016-06-01,2016,8600000,0,-8600000,6.409925
383914,Tell Me,1980-08-25,1980,0,0,0,0.09555
384021,Who's Driving Doug,2016-02-26,2016,1500000,0,-1500000,0.98172
384036,Tectonic Plate,2016-02-15,2016,0,0,0,0.031813
384111,Family Lies,2016-03-01,2016,0,0,0,0.038957
384130,Monkey Planet,2014-04-02,2014,0,0,0,0.014965
384160,How to Lose Weight in 4 Easy Steps!,2016-01-16,2016,0,0,0,0.098052
384205,The Gift,2014-07-26,2014,0,0,0,0.596106
384237,Lamerica,2015-10-15,2015,0,0,0,0.040155
384254,The Cockroach That Ate Cincinnati,1996-09-08,1996,0,0,0,0.001177
384262,Diving Into the Unknown,2016-02-19,2016,0,0,0,0.287734
384289,Peter and the Farm,2016-11-04,2016,0,0,0,0.754566
384371,Roommates Wanted,2016-04-20,2016,0,0,0,4.210927
384373,Poveda,2016-02-24,2016,0,0,0,0.032942
384450,Dead 7,2016-04-01,2016,0,0,0,1.989203
384452,Cruel Summer,2016-08-27,2016,0,0,0,0.693559
384573,The First Monday in May,2016-04-15,2016,0,0,0,0.512355
384581,Fanny's Journey,2016-05-18,2016,0,0,0,1.834993
384594,Blood Hunters,2016-10-01,2016,0,0,0,0.857218
384641,Spirits' Homecoming,2016-02-24,2016,0,0,0,1.264456
384664,Goodbye Berlin,2016-09-15,2016,0,0,0,3.244121
384669,Spicebush,2005-01-01,2005,0,0,0,0.003342
384673,National Bird,2017-05-18,2017,0,0,0,0.749444
384682,Office Christmas Party,2016-11-25,2016,45000000,114501299,69501299,8.228918
384683,The High Frontier,2016-02-19,2016,0,0,0,0.706414
384727,The Ideal,2016-06-15,2016,0,0,0,2.569793
384737,Precious Cargo,2016-07-15,2016,10500000,100659,-10399341,11.548303
384798,Kill Command,2016-05-13,2016,0,0,0,8.089782
384845,Fittest On Earth (The Story Of The 2015 Reebok CrossFit Games),2016-02-27,2016,0,0,0,1.109653
384894,Conspiracy Encounters,2016-02-09,2016,0,0,0,0.212769
385031,Dirty Lies,2016-02-27,2016,1000000,0,-1000000,2.683914
385114,Beauties of the Night,2016-09-12,2016,0,0,0,0.628191
385232,Dudes & Dragons,2015-10-10,2015,0,0,0,1.275544
385261,"Love, Lies",2016-04-13,2016,120,0,-120,0.50606
385305,24√ó36,2016-03-05,2016,0,0,0,0.397526
385317,Hot Bot,2016-03-01,2016,0,0,0,4.387615
385320,Zoombies,2016-04-29,2016,0,0,0,2.512293
385371,The Midnight Man,2016-03-01,2016,0,0,0,2.454624
385372,Chalk It Up,2016-09-13,2016,0,0,0,1.414372
385379,Mad Tiger,2015-10-16,2015,0,0,0,0.038045
385390,Love by Chance,2016-04-16,2016,0,0,0,0.756976
385581,The Brainwashing of My Dad,2015-07-29,2015,0,0,0,0.425356
385654,Life Is a Trumpet,2015-10-15,2015,0,0,0,0.061353
385722,Bling,2016-11-24,2016,15000000,0,-15000000,2.930081
385736,Kicks,2016-09-09,2016,0,0,0,5.206871
385737,Always Shine,2016-11-25,2016,0,0,0,4.412986
385738,Dreamland,2016-04-14,2016,0,0,0,0.736258
385750,Folk Hero & Funny Guy,2016-04-16,2016,0,0,0,0.702758
385761,All This Panic,2017-03-31,2017,0,0,0,0.105984
385805,Betting on Zero,2017-03-17,2017,0,0,0,0.983882
385933,Room Full of Spoons,2016-07-09,2016,0,0,0,0.087398
385962,Time Renegades,2016-04-13,2016,0,0,0,2.033396
386100,Fritz Lang,2016-04-14,2016,0,0,0,0.478011
386172,The Rift,2016-04-28,2016,0,0,0,2.764506
386501,Waffle Street,2015-09-24,2015,0,0,0,3.22727
386743,Mosquinha,1890-03-09,1890,0,0,0,0.071756
386827,Love Is All You Need?,2016-03-05,2016,0,0,0,1.850115
386830,Temps,2016-04-05,2016,0,0,0,1.45629
386891,Kicking Off,2016-04-22,2016,0,0,0,0.113795
387042,Dances Sacred and Profane,1985-10-16,1985,0,0,0,0.000844
387054,Jimmy Carr: Funny Business,2016-03-18,2016,0,0,0,1.253711
387252,Kadhalum Kadanthu Pogum,2016-03-11,2016,0,0,0,0.756886
387398,All Yours,2016-04-02,2016,0,0,0,0.545225
387399,We Go On,2016-03-05,2016,0,0,0,3.026315
387426,Okja,2017-05-19,2017,50000000,0,-50000000,15.738471
387444,The Disputation,1986-12-21,1986,0,0,0,0.31825
387558,My Feral Heart,2016-03-05,2016,0,0,0,0.327006
387700,The Passion,2016-03-20,2016,0,0,0,0.12007
387801,The Untamed,2016-05-15,2016,0,0,0,1.414419
387805,7:19,2016-09-16,2016,0,0,0,1.148379
387845,Musudan,2016-03-03,2016,500,500,0,0.460016
387886,Canola,2016-05-19,2016,0,0,0,0.316267
387889,Buddymoon,2016-07-01,2016,0,0,0,0.750058
387893,Ice Age: The Great Egg-Scapade,2016-03-20,2016,0,0,0,6.263676
387929,This House Has People in It,2016-03-16,2016,0,0,0,0.22073
387938,SuperBobrovs,2016-03-17,2016,0,0,0,1.104024
387957,Clay Pigeon,1971-08-01,1971,0,0,0,9.4e-05
387999,The High Schooler's Guide to College Parties,2016-03-16,2016,0,0,0,0.871352
388046,Donos de Portugal,2012-04-25,2012,0,0,0,0.008236
388055,The Next Industrial Revolution,2002-01-31,2002,0,0,0,0.002411
388182,Ÿá€å⁄Ü ⁄©ÿ¨ÿß Ÿá€å⁄Ü ⁄©ÿ≥,2013-08-07,2013,0,0,0,0.070407
388191,Mythica: The Iron Crown,2016-05-14,2016,0,0,0,2.504161
388192,Sicc√Æn 2,2015-07-10,2015,0,0,0,0.575968
388202,Arsenal,2017-01-06,2017,10000000,0,-10000000,4.192948
388235,Spring Broke,2016-03-22,2016,0,0,0,0.108897
388237,Tie Pime√§√§n,1963-01-04,1963,0,0,0,0.059224
388243,Bleed,2016-03-25,2016,550000,0,-550000,1.559758
388256,Mamaboy,2017-05-23,2017,700000,0,-700000,1.061991
388273,No Letting Go,2016-03-18,2016,500000,0,-500000,0.724078
388347,The Call Up,2016-07-15,2016,0,0,0,4.060687
388399,Patriots Day,2016-12-12,2016,45000000,50548152,5548152,14.547939
388403,Chongqing Hot Pot,2016-04-01,2016,0,0,0,1.601233
388410,Edgar Allan Poe's Lighthouse Keeper,2016-03-16,2016,0,0,0,0.79704
388440,The Curse of Sleeping Beauty,2016-05-05,2016,0,0,0,2.797175
388468,Grand Hotel,2016-04-08,2016,0,0,0,1.930659
388586,The Love of Ulysses,1984-03-18,1984,0,0,0,0.0
388624,Steve-O: Guilty as Charged,2016-03-20,2016,0,0,0,0.468216
388764,Bounty Hunters,2016-07-01,2016,0,0,0,0.498127
388791,SelfieParty,2016-03-31,2016,0,0,0,0.042226
388862,Countdown,2016-04-05,2016,0,0,0,3.612867
388907,Water Boyy,2015-10-22,2015,0,0,0,0.28832
388910,Klondike Kate,1943-12-17,1943,0,0,0,0.013553
389044,The Together Project,2016-06-29,2016,0,0,0,1.653932
389053,The Do-Over,2016-05-27,2016,0,0,0,11.219246
389115,6A,2016-02-17,2016,0,0,0,0.032397
389180,The House of Light,1969-03-21,1969,0,0,0,0.001665
389272,Lost & Found,2016-02-22,2016,0,0,0,6.929959
389292,Apex: The Story of the Hypercar,2016-03-29,2016,0,0,0,0.407232
389323,Papa Hemingway in Cuba,2015-11-19,2015,0,0,0,1.302155
389396,Maigret Sets a Trap,2016-03-28,2016,0,0,0,1.861683
389425,Code of Honor,2016-05-06,2016,8000000,0,-8000000,2.202722
389427,Hard Sell,2016-05-20,2016,0,0,0,1.637665
389578,Daemonium: Soldier of the Underworld,2015-11-05,2015,0,0,0,0.663943
389614,The Hidden Child,2013-06-28,2013,0,0,0,1.138013
389627,Nerdland,2016-12-06,2016,0,0,0,2.609411
389630,All We Had,2016-12-09,2016,0,0,0,1.356923
389677,Blind Vaysha,2016-02-15,2016,0,0,0,0.498439
389854,The Last Ferry,1989-03-25,1989,0,0,0,0.0
389868,Seoul Station,2016-08-17,2016,0,0,0,2.266283
389882,The Love-stricken,1992-04-01,1992,0,0,0,0.01125
389972,What a Wonderful Family!,2016-03-16,2016,0,0,0,0.629013
389995,Me cas√© con un boludo,2016-03-17,2016,0,0,0,9.915094
390051,Aftermath,2017-04-06,2017,10500000,3451,-10496549,10.150041
390054,Sand Castle,2017-04-21,2017,0,0,0,7.823933
390059,Permission,2017-04-22,2017,0,0,0,0.432723
390293,Bugs,2016-04-16,2016,0,0,0,0.037261
390296,Do Not Resist,2016-04-30,2016,0,0,0,0.563982
390298,The Happy Film,2016-04-16,2016,0,0,0,0.162634
390319,Tickling Giants,2017-03-15,2017,0,0,0,0.289103
390343,Burden,2016-04-16,2016,0,0,0,0.638724
390353,Traceroute,2016-04-28,2016,10000,0,-10000,0.26434
390357,King of the Belgians,2016-11-30,2016,0,0,0,1.407754
390376,Rag Union,2015-12-30,2015,0,0,0,0.145502
390396,Command and Control,2016-09-14,2016,0,0,0,0.269965
390409,Magnus,2016-09-09,2016,0,0,0,1.627683
390410,Shadow World,2016-04-16,2016,0,0,0,0.356383
390422,The Way We Live Now,2001-11-11,2001,0,0,0,0.251856
390437,Ki and Ka,2016-04-01,2016,0,0,0,0.947524
390497,Tunnel,2016-08-10,2016,0,0,0,4.559646
390512,The Phenom,2016-06-24,2016,0,0,0,1.166841
390520,Team Foxcatcher,2016-04-18,2016,0,0,0,2.758147
390526,Between Us,2016-04-18,2016,0,0,0,2.191353
390540,The Worst of Faces of Death,1987-06-15,1987,0,0,0,0.044306
390547,El rei borni,2016-04-24,2016,0,0,0,0.399089
390582,Here Alone,2016-04-15,2016,0,0,0,3.010304
390584,King Cobra,2016-04-16,2016,0,0,0,4.272317
390587,Tiger Raid,2016-10-07,2016,0,0,0,1.490384
390592,Adult Life Skills,2016-06-24,2016,0,0,0,2.10184
390669,One Kiss,2016-03-31,2016,0,0,0,5.266422
390734,Kingsglaive: Final Fantasy XV,2016-07-09,2016,0,269980,269980,7.692445
390747,Obit,2017-04-26,2017,0,0,0,1.728108
390766,Southwest of Salem: The Story of the San Antonio Four,2016-04-15,2016,0,0,0,0.142572
390777,Ordinary World,2016-10-14,2016,0,0,0,3.373043
390782,I'll Sleep When I'm Dead,2016-04-15,2016,0,0,0,0.301251
390837,Stephen Lynch: Hello Kalamazoo,2016-03-21,2016,0,0,0,0.724499
390880,Friday,2016-03-26,2016,0,0,0,1.00704
390883,The Dark Tapes,2017-04-17,2017,65000,0,-65000,3.525879
390930,If Cats Disappeared From the World,2016-05-14,2016,0,0,0,0.773466
390959,Shadow of the Blair Witch,2000-10-22,2000,0,0,0,0.076061
390989,Sharknado 4: The 4th Awakens,2016-07-31,2016,0,0,0,4.574494
390991,Frankie Boyle: Hurt Like You've Never Been Loved,2016-03-18,2016,0,0,0,0.255416
391004,His Girlfriend,2015-10-17,2015,0,0,0,0.098504
391039,Life+1 Day,2016-03-16,2016,0,0,0,1.237106
391069,Night Gallery,1969-04-03,1969,0,0,0,0.472069
391088,The Making of Trump,2015-11-30,2015,800000,0,-800000,0.174353
391166,Paying the Price: Killing the Children of Iraq,2000-01-01,2000,0,0,0,0.001177
391375,The Bandit Hound,2016-04-12,2016,3000000,0,-3000000,0.659235
391438,El amor no es ciego,1950-04-04,1950,0,0,0,0.001248
391477,The Mobfathers,2016-03-31,2016,0,0,0,1.600472
391486,Crossing Point,2016-05-03,2016,0,0,0,1.217114
391566,Cheerleader,2016-04-04,2016,0,0,0,0.054999
391578,"New York, New York",2016-04-15,2016,0,0,0,0.27931
391617,K√≥blic,2016-04-14,2016,3500000,0,-3500000,0.93037
391618,Rumbos,2016-04-24,2016,0,0,0,1.051531
391626,The Offering,2016-05-06,2016,0,0,0,2.671274
391629,Baaghi,2016-04-29,2016,0,0,0,1.845785
391642,The Kodai Family,2016-06-04,2016,0,0,0,1.065466
391663,Stefan Zweig: Farewell to Europe,2016-06-02,2016,0,0,0,1.874887
391698,The Beatles: Eight Days a Week - The Touring Years,2016-09-15,2016,0,0,0,7.078301
391700,We Are Family,2016-08-10,2016,0,0,0,2.668929
391709,Apprentice,2016-06-01,2016,0,0,0,2.019501
391757,Never Back Down: No Surrender,2016-06-07,2016,0,0,0,7.152451
391778,Azhar,2016-05-13,2016,0,0,0,0.71192
391779,Housefull 3,2016-06-03,2016,0,0,0,2.5038
391899,Hannibal Buress: Hannibal Takes Edinburgh,2016-04-08,2016,0,0,0,0.178533
391934,Sense and Sensibility,1981-02-01,1981,0,0,0,0.416171
391955,Maalik,2016-04-08,2016,0,0,0,0.550599
391975,2 Lava 2 Lantula!,2016-08-06,2016,0,0,0,1.655786
391995,Hillary's America: The Secret History of the Democratic Party,2016-07-01,2016,5000000,13000000,8000000,1.628629
391997,A Body to Die For: The Aaron Henry Story,1994-03-22,1994,0,0,0,0.605085
392011,Kedi,2017-02-10,2017,0,0,0,3.469644
392058,"Fear, Inc.",2016-04-15,2016,0,0,0,4.086359
392067,The Real McCoy,1999-08-13,1999,650,0,-650,0.071756
392091,Los Punks: We Are All We Have,2016-01-22,2016,0,0,0,0.107496
392124,Right Here Right Now,2016-06-22,2016,0,0,0,1.153504
392142,Max & Leon,2016-11-01,2016,12156348,7900000,-4256348,5.662109
392207,The Invisible Guardian,2017-03-03,2017,0,0,0,14.881223
392271,Rangoon,2017-02-24,2017,12003848,0,-12003848,4.419157
392386,Nikki Glaser: Perfect,2016-04-09,2016,0,0,0,0.259319
392418,The Cheerleader Murders,2017-03-17,2017,0,0,0,0.877195
392440,Highly Strung,2016-05-16,2016,0,0,0,0.038538
392553,Minimalism: A Documentary About the Important Things,2015-09-26,2015,0,0,0,2.425303
392554,The Days That Confused,2016-04-08,2016,566000,0,-566000,0.107335
392572,Rustom,2016-08-12,2016,1000000,0,-1000000,7.333139
392629,"Murder, She Baked: A Deadly Recipe",2016-06-19,2016,0,0,0,3.060973
392660,A Sunday Kind of Love,2016-04-15,2016,0,0,0,0.728584
392734,Jeremiah Tower: The Last Magnificent,2016-07-29,2016,0,0,0,0.326655
392788,The Stopover,2016-09-07,2016,0,0,0,2.524041
392790,Ma' Rosa,2016-11-09,2016,0,0,0,0.46882
392794,The Dancer,2016-09-28,2016,0,0,0,7.700619
392807,The Happiest Day in the Life of Olli M√§ki,2016-09-02,2016,0,0,0,1.876069
392812,Dogs,2016-09-28,2016,0,0,0,1.826317
392817,The Student,2016-04-12,2016,0,0,0,2.301152
392818,The Transfiguration,2017-04-07,2017,0,0,0,6.371291
392820,Gimme Danger,2016-10-28,2016,0,0,0,3.458259
392832,Nemiche per la pelle,2016-04-14,2016,0,0,0,1.504535
392882,Night's Tightrope,2016-10-08,2016,0,0,0,0.340654
392884,Korridoren,1968-12-11,1968,0,0,0,0.100913
392885,Daniel Tosh: People Pleaser,2016-04-17,2016,0,0,0,0.540652
392891,Patton Oswalt: Talking for Clapping,2016-04-22,2016,0,0,0,0.866251
392961,Adam Green's Aladdin,2016-04-15,2016,0,0,0,0.591214
392985,Gold Digger,2016-03-25,2016,0,0,0,0.406886
393003,Wildflower,2016-02-05,2016,0,0,0,0.732198
393079,Death by Death,2016-05-04,2016,0,0,0,0.250354
393134,Loop,2016-04-14,2016,0,0,0,0.037745
393158,The Cliff,2016-06-03,2016,0,0,0,0.75356
393172,Bottom of the World,2017-03-31,2017,0,0,0,1.557641
393184,Clash,2016-07-27,2016,0,0,0,1.319772
393196,Meet The Santas,2005-12-17,2005,0,0,0,0.455228
393263,Pearl,2016-04-17,2016,0,0,0,1.062942
393367,Poi E: The Story of Our Song,2016-08-04,2016,0,0,0,0.057979
393368,Disturbing the Peace,2016-03-10,2016,0,0,0,0.074699
393407,They Are Everywhere,2016-06-01,2016,0,0,0,2.006558
393441,Dishoom,2016-07-29,2016,0,0,0,1.839955
393443,Extremis,2016-04-17,2016,0,0,0,0.692809
393445,Ae Dil Hai Mushkil,2016-10-27,2016,0,0,0,3.337385
393457,Fences,2016-12-16,2016,24000000,64414761,40414761,11.599716
393519,Raw,2016-10-07,2016,3500000,4100000,600000,14.320893
393521,One Week and a Day,2016-12-14,2016,0,0,0,0.872276
393559,My Life as a Zucchini,2016-10-12,2016,8000000,292279,-7707721,7.321152
393561,Risk,2017-05-05,2017,0,0,0,2.511092
393562,Raman Raghav 2.0,2016-06-24,2016,521873,1013926,492053,1.668794
393603,The Congressman,2016-04-09,2016,0,0,0,0.480362
393629,Pure Pwnage: Teh Movie,2016-01-23,2016,220093,0,-220093,0.525851
393656,Date with Love,2016-05-21,2016,0,0,0,1.242104
393658,Tulips in Spring,2016-05-14,2016,0,0,0,0.47285
393659,Ms. Matched,2016-06-04,2016,0,0,0,1.223986
393695,Kills on Wheels,2016-04-28,2016,0,0,0,0.474027
393729,Divines,2016-08-31,2016,2791874,0,-2791874,8.987123
393731,Mercenary,2016-10-05,2016,0,0,0,1.350684
393732,Mean Dreams,2016-10-21,2016,0,0,0,4.677232
393764,The African Doctor,2016-06-08,2016,0,0,0,5.518577
393765,Priceless,2016-10-14,2016,0,0,0,5.279713
393834,Goldstone,2016-07-07,2016,0,0,0,3.110447
393841,Pelli Choopulu,2016-07-29,2016,200000,5500000,5300000,0.902294
393857,The Confessions,2016-04-21,2016,0,0,0,2.30083
393877,A.R.C.H.I.E.,2016-04-19,2016,0,0,0,0.451017
393939,Set the Thames on Fire,2016-09-15,2016,0,0,0,0.126171
393945,150 Milligrams,2016-11-18,2016,0,0,0,1.730912
393949,Joe's Violin,2016-04-14,2016,0,0,0,0.167879
393961,Food Choices,2016-04-21,2016,0,0,0,2.911189
394034,Buddha in a Traffic Jam,2016-05-13,2016,0,0,0,0.078694
394045,Casual Encounters,2016-06-07,2016,0,0,0,0.64157
394047,The Dog Lover,2016-07-08,2016,2000000,0,-2000000,1.638785
394051,Phantom of the Theatre,2016-04-29,2016,0,0,0,0.510423
394063,Chris Hardwick: Funcomfortable,2016-04-30,2016,0,0,0,0.440991
394170,Phantom Detective,2016-05-04,2016,0,0,0,2.140112
394176,Enter the Battlefield: Life on the Magic - The Gathering Pro Tour,2016-04-26,2016,0,0,0,0.177976
394185,Chokeslam,2016-10-10,2016,0,0,0,0.743825
394223,Sniper: Special Ops,2016-04-03,2016,0,0,0,3.88813
394224,Foxy and the Weight of the World,2005-01-23,2005,0,0,0,0.00377
394244,Plastic Utopia,1997-10-04,1997,0,0,0,0.215128
394260,Sweet Dreams,2016-11-10,2016,0,0,0,2.830792
394269,Lemonade,2016-04-23,2016,0,0,0,2.899155
394374,At the End of the Tunnel,2016-04-21,2016,0,0,0,3.874533
394385,Rainer Werner Fassbinder's World on a Wire: Looking Ahead to Today,2010-02-18,2010,0,0,0,0.005884
394403,Schwestern,2014-03-21,2014,0,0,0,0.014121
394412,Fiore,2016-05-25,2016,0,0,0,1.461567
394415,Rachel Feinstein: Only Whores Wear Purple,2016-04-23,2016,0,0,0,0.061308
394423,Mourning Son,2015-12-01,2015,0,0,0,0.031994
394499,Porta dos Fundos: Contrato Vital√≠cio,2016-06-30,2016,840000,0,-840000,1.357903
394632,Free to Run,2016-02-24,2016,0,0,0,0.400515
394645,De Premier,2016-10-26,2016,0,0,0,1.304871
394661,Sacrifice,2016-04-29,2016,0,0,0,3.859277
394668,Can We Take a Joke?,2015-11-13,2015,0,0,0,0.687778
394684,May God Forgive Us,2016-10-28,2016,4000000,0,-4000000,8.370964
394689,Garfunkel and Oates: Trying to be Special,2016-05-05,2016,0,0,0,0.55884
394723,El Hilo Rojo,2016-05-19,2016,0,0,0,2.325847
394759,Sheep & Wolves,2016-04-28,2016,0,0,0,6.184098
394770,11:55,2017-06-09,2017,0,0,0,0.722501
394812,The Apology,2016-04-30,2016,0,0,0,0.084257
394822,London Town,2017-08-03,2017,0,0,0,1.957074
395181,Finding Mr. Right 2,2016-04-29,2016,0,0,0,1.150839
395278,Wizard Mode,2016-05-02,2016,0,0,0,0.21412
395452,In the Forests of Siberia,2016-06-15,2016,3500000,1492523,-2007477,1.333969
395476,Cowboy Canteen,1944-02-09,1944,0,0,0,0.296663
395479,City 40,2016-04-28,2016,0,0,0,0.667225
395531,Magicians: Life in the Impossible,2016-04-30,2016,0,0,0,0.285373
395560,Capsule,2015-12-23,2015,1300000,0,-1300000,1.823626
395763,In the Shadow of Iris,2016-11-16,2016,0,0,0,2.667456
395767,Scribe,2017-01-11,2017,0,0,0,1.238471
395834,Wind River,2017-08-03,2017,11000000,184770205,173770205,40.796775
395883,Andron,2015-11-08,2015,0,0,0,3.261584
395914,Courier to the East,1991-09-07,1991,0,0,0,1e-06
395925,Rampage: President Down,2016-08-26,2016,0,0,0,2.701186
395965,A Billion Lives,2016-05-11,2016,0,0,0,0.286447
395982,Prevenge,2017-02-10,2017,0,0,0,7.651227
395985,Terra,2015-12-01,2015,0,0,0,1.47094
395992,Life,2017-03-22,2017,58000000,100541806,42541806,36.263803
396004,The Evil in Us,2016-08-19,2016,0,0,0,3.608837
396109,Gary Gulman: It's About Time,2016-05-01,2016,0,500,500,0.410738
396152,Restoration,2016-05-03,2016,0,0,0,1.074124
396232,Sour Grapes,2016-05-27,2016,0,0,0,1.104042
396263,Gantz:O,2016-10-14,2016,0,2238600,2238600,8.658666
396269,Torpedo Bay,1963-09-21,1963,0,0,0,0.005891
396289,Raising the Bar,2016-05-02,2016,600000,0,-600000,1.347996
396292,Ali Wong: Baby Cobra,2016-05-06,2016,0,0,0,1.119
396330,LEGO DC Comics Super Heroes: Justice League - Gotham City Breakout,2016-06-21,2016,0,0,0,3.581416
396392,Wedding Bells,2016-06-03,2016,0,0,0,0.679815
396394,The Convenient Groom,2016-06-18,2016,0,0,0,0.772232
396395,The Wedding March,2016-06-25,2016,0,0,0,0.637441
396398,The Meyerowitz Stories,2017-05-21,2017,0,0,0,3.510007
396535,Train to Busan,2016-07-20,2016,8820000,2129768,-6690232,22.685169
396616,The King's Choice,2016-09-29,2016,7500000,9100000,1600000,1.176258
396643,A Flying Jatt,2016-08-25,2016,0,0,0,1.428806
396744,Underfire: The Untold Story of Pfc. Tony Vaccaro,2016-10-06,2016,0,0,0,0.096045
396810,The Last Word,2017-03-03,2017,0,1783421,1783421,7.248414
396899,The Girl Without Hands,2016-12-14,2016,0,0,0,0.251089
396920,Journey To Greenland,2016-11-30,2016,0,0,0,0.764418
396965,Well Wishes,2015-09-24,2015,0,0,0,0.531661
396987,–ú–µ–¥–≤–µ–¥—å,1938-06-11,1938,0,0,0,0.007071
397003,The Asian Connection,2016-05-13,2016,0,0,0,1.908592
397093,The Beginning of Life,2016-05-05,2016,0,0,0,0.400668
397243,The Autopsy of Jane Doe,2016-12-21,2016,0,5972942,5972942,31.772396
397278,Fender Bender,2016-05-23,2016,0,0,0,2.647952
397339,The Awful Truth,,,0,0,0,0.0
397365,Madaari,2016-06-10,2016,0,0,0,1.257554
397403,Brexit: The Movie,2016-05-11,2016,430000,0,-430000,0.203742
397415,Vengeance: A Love Story,2017-03-16,2017,0,0,0,6.533244
397422,Rough Night,2017-06-15,2017,20000000,45056771,25056771,24.317924
397442,Win It All,2017-03-11,2017,0,0,0,4.096366
397514,The Windmill Massacre,2016-08-29,2016,0,0,0,4.643175
397517,Be Somebody,2016-06-10,2016,0,0,0,2.675291
397520,Anne of Green Gables,2016-02-15,2016,0,0,0,3.4751
397549,Lil Rel: RELevent,2015-09-05,2015,0,0,0,0.164076
397552,Paranormal Drive,2016-03-31,2016,0,0,0,1.621594
397717,Barry,2016-09-10,2016,0,0,0,8.631184
397837,Before I Fall,2017-03-02,2017,5000000,10025571,5025571,38.995136
397873,Cyborg X,2016-05-17,2016,1000000,0,-1000000,1.494695
397914,KISS: Rocks Vegas,2016-05-25,2016,0,0,0,0.178388
397981,Beyond the Gates,2016-06-02,2016,0,0,0,4.112883
397992,Fair Haven,2017-03-03,2017,0,0,0,1.447727
398137,The Architect,2016-05-20,2016,0,0,0,2.438503
398265,Traded,2016-06-10,2016,0,0,0,1.816076
398289,Life on the Line,2015-11-05,2015,0,0,0,7.907173
398295,Mundo C√£o,,,0,0,0,0.000331
398390,Superbia,2016-05-17,2016,0,0,0,0.04229
398395,Timecode,2016-05-18,2016,0,0,0,0.587178
398452,The Wooden Bridge,2012-02-04,2012,0,0,0,0.008236
398535,Udta Punjab,2016-06-17,2016,5980000,14900000,8920000,4.195845
398541,Teenage Kicks,2016-10-15,2016,0,0,0,0.174875
398633,Dan Soder: Not Special,2016-05-21,2016,0,0,0,0.042765
398649,Judging Japan,2016-05-22,2016,0,0,0,0.062252
398738,Bright Lights: Starring Carrie Fisher and Debbie Reynolds,2016-05-14,2016,0,0,0,1.67461
398786,Kammatipaadam,2016-05-20,2016,1500000,0,-1500000,0.994288
398792,Lost in the Pacific,2016-01-29,2016,0,0,0,1.008039
398798,The Night Watchmen,2016-09-01,2016,0,0,0,4.074173
398818,Call Me by Your Name,2017-10-27,2017,4696772,0,-4696772,4.300874
398830,La muerte de Jaime Rold√≥s,2013-05-01,2013,0,0,0,0.011224
398854,A Midsummer Night's Dream,2016-05-30,2016,0,0,0,0.338376
398891,My Bakery in Brooklyn,2016-06-30,2016,3800000,0,-3800000,2.351852
398920,He Even Has Your Eyes,2017-01-18,2017,0,0,0,6.401902
398924,A Bag of Marbles,2017-01-18,2017,0,0,0,12.389862
398929,Alibi.com,2017-02-15,2017,0,222430,222430,9.09546
398959,Roula,1995-09-11,1995,0,0,0,0.149157
399019,The Beguiled,2017-06-23,2017,10500000,25442939,14942939,36.26051
399097,The Polar Boy,2016-05-10,2016,0,0,0,0.039207
399106,Piper,2016-06-16,2016,0,0,0,11.243161
399173,The Assignment,2016-04-27,2016,5000000,0,-5000000,5.522361
399217,Tommy's Honour,2017-07-07,2017,0,0,0,1.774843
399219,Happy End,2016-05-19,2016,0,0,0,0.612191
399229,Kovat Miehet,1999-01-01,1999,0,0,0,0.312543
399300,The Bodyguard,2016-07-15,2016,0,0,0,1.645231
399417,Lazy Eye,2016-11-11,2016,0,0,0,0.316652
399612,Realive,2016-12-13,2016,7000000,0,-7000000,3.493907
399615,White Coffin,2016-07-21,2016,0,0,0,1.03082
399621,Kalashnikov,2014-02-10,2014,0,0,0,0.014201
399623,Passage to Mars,2016-05-31,2016,0,0,0,0.29762
399747,"Mother, May I Sleep with Danger?",2016-06-18,2016,0,0,0,2.529563
399790,Churchill,2017-05-25,2017,10000000,0,-10000000,7.15731
399798,Brad Williams: Fun Size,2015-05-08,2015,0,0,0,0.159446
399802,Alonzo Bodden: Historically Incorrect,2016-02-19,2016,0,0,0,0.331367
399810,Brad Williams: Daddy Issues,2016-05-20,2016,0,0,0,0.667658
399811,Ben Gleib: Neurotic Gangster,2016-06-03,2016,0,0,0,0.096509
399814,Maz Jobrani: I'm Not a Terrorist But I've Played One on TV,2015-08-21,2015,0,0,0,0.201191
399823,"Byron, Ballad for a Daemon",1998-11-15,1998,0,0,0,0.006807
399894,Daylight's End,2016-04-16,2016,2000000,0,-2000000,3.264792
399932,Quincy Jones: Burning the Light,2016-06-02,2016,0,0,0,0.123259
399938,Michael Ian Black: Noted Expert,2016-05-13,2016,0,0,0,0.150148
400001,Tr√©mulo,2015-03-08,2015,0,0,0,0.196471
400014,God's Compass,2016-04-21,2016,0,0,0,0.077313
400045,Lea to the Rescue,2016-05-30,2016,0,0,0,0.829921
400114,I Am Not Madame Bovary,2016-09-29,2016,0,0,0,2.116032
400121,The Antwerp Dolls,2015-03-21,2015,0,0,0,0.455308
400136,Resident Evil: Vendetta,2017-05-27,2017,0,0,0,13.875911
400174,Roots,2016-05-30,2016,0,0,0,1.541295
400190,Secret Summer,2016-04-02,2016,0,0,0,0.230124
400247,Gentleman,2016-06-17,2016,0,0,0,0.40596
400329,First Born,2016-06-19,2016,0,0,0,3.452014
400387,Riphagen,2016-09-22,2016,2300000,0,-2300000,2.566358
400411,Satanic,2016-07-01,2016,0,252,252,6.005878
400465,Hitler's Folly,2016-06-03,2016,0,0,0,0.187889
400547,Hurricane Bianca,2016-06-03,2016,0,0,0,6.59707
400552,Happy Burnout,2017-04-11,2017,0,0,0,1.340083
400605,Dead Rising: Endgame,2016-06-20,2016,0,0,0,3.182636
400608,Bo Burnham: Make Happy,2016-06-03,2016,0,0,0,2.127336
400610,Prey,2016-10-13,2016,0,0,0,0.914239
400668,KidPoker,2015-12-01,2015,0,0,0,0.45676
400749,Mothers of Men,1917-01-01,1917,0,0,0,0.001223
400753,The Bachelor,2016-12-01,2016,480000,0,-480000,0.187552
400791,Old Fashioned: The Story of the Wisconsin Supper Club,2015-04-10,2015,0,0,0,0.057691
400796,Irwin & Fran 2013,,,0,0,0,0.0
400928,Gifted,2017-04-12,2017,7000000,37461045,30461045,16.025911
400948,UFOs: The Best Evidence Ever Caught on Tape,1997-07-28,1997,0,0,0,0.002911
401060,Mercy,2016-06-04,2016,0,0,0,5.720163
401061,Officer Downe,2016-11-18,2016,0,0,0,1.404363
401065,The Axe Murders of Villisca,2017-01-20,2017,0,0,0,2.671452
401104,To the Bone,2017-01-22,2017,0,0,0,9.128637
401123,Beta Test,2016-07-22,2016,0,0,0,2.053175
401132,Independents' Day,2016-06-07,2016,500000,0,-500000,1.565396
401150,World Cinema,2007-05-20,2007,0,0,0,0.00353
401164,Tracktown,2017-05-12,2017,0,0,0,0.569824
401222,ISRA 88,2016-08-08,2016,0,0,0,2.718862
401294,Virtual Revolution,2016-10-12,2016,3200000,0,-3200000,1.832135
401359,Breakdown Lane,2017-01-05,2017,0,0,0,0.957068
401387,Sunspring,2016-06-09,2016,0,0,0,1.124787
401408,Leslie Caron: The Reluctant Star,2016-06-28,2016,0,0,0,0.122378
401427,Elegy,2014-09-10,2014,0,0,0,0.016472
401442,Internet Famous,2016-06-21,2016,0,0,0,2.836788
401461,The Phantom,1943-12-24,1943,0,0,0,0.001947
401484,The Sweet Life,2016-06-07,2016,0,0,0,0.988396
401513,Attraction,2017-01-26,2017,6277106,0,-6277106,7.070085
401544,Death Race 2050,2017-01-17,2017,0,0,0,5.209399
401546,The Dinner,2017-05-05,2017,0,1323312,1323312,5.175311
401593,Big Jay Oakerson: Live at Webster Hall,2016-06-17,2016,0,0,0,0.248238
401650,DC Super Hero Girls: Hero of the Year,2016-08-09,2016,0,0,0,1.402798
401687,Hopeless Romantic,2016-06-04,2016,0,0,0,0.253497
401689,Mythica: The Godslayer,2016-12-17,2016,0,0,0,3.856398
401698,Hidden Kisses,2016-08-24,2016,0,0,0,2.187098
401743,The Most Hated Woman in America,2017-03-24,2017,0,0,0,5.969528
401840,School's out,2017-05-30,2017,0,0,0,0.207775
401861,Collector,2016-10-06,2016,0,0,0,1.20963
401895,Brigada criminal,1950-12-04,1950,0,0,0,0.036471
401971,Delhi in a Day,2012-08-24,2012,0,0,0,0.013968
402042,Bosch. The Garden of Dreams,2016-06-09,2016,0,0,0,0.331978
402193,Night Guards,2016-08-01,2016,3800000,0,-3800000,11.164762
402217,Happy Wedding,2016-05-20,2016,0,0,0,0.332473
402223,Classmates,2016-06-16,2016,0,0,0,0.37441
402298,Denial,2016-09-30,2016,10000000,4073489,-5926511,10.754997
402331,Hard Target 2,2016-07-14,2016,0,0,0,5.070828
402370,Alleycats,2016-06-23,2016,0,0,0,2.429683
402423,The Vessel,2016-09-15,2016,5000000,0,-5000000,1.456857
402446,Edge of Winter,2016-07-31,2016,0,0,0,2.394264
402455,125 Years Memory,2015-12-05,2015,0,0,0,0.477985
402529,All Eyez on Me,2017-06-12,2017,45000000,0,-45000000,9.809168
402536,The Head Vanishes,2016-01-01,2016,0,0,0,0.135301
402543,Center Stage: On Pointe,2016-06-25,2016,0,0,0,1.563828
402582,Handsome: A Netflix Mystery Movie,2017-05-05,2017,0,0,0,4.021978
402612,Gondolj r√°m,2016-01-21,2016,0,0,0,0.0977
402672,Mohenjo Daro,2016-08-11,2016,15050000,16180000,1130000,1.423358
402693,100 Meters,2016-11-04,2016,0,0,0,4.212492
402857,Captive Heart: The James Mink Story,1996-04-14,1996,0,0,0,0.293905
402877,Lifeline,2016-05-06,2016,0,0,0,0.043826
402907,Odd Job,2016-08-31,2016,0,0,0,3.235725
402919,The Promise,2016-10-27,2016,300000,0,-300000,1.340429
402976,Range 15,2016-06-15,2016,0,0,0,1.650286
403011,Being George Clooney,2016-02-06,2016,0,0,0,0.100793
403052,Mower Minions,2016-07-08,2016,0,0,0,3.119394
403114,Window Horses,2016-06-13,2016,0,0,0,0.459717
403119,47 Meters Down,2017-06-15,2017,5500000,44235023,38735023,52.854103
403130,Intruder,2016-06-24,2016,0,0,0,0.659457
403163,Enemies with Benefits,2016-01-15,2016,20000,0,-20000,1.304156
403173,Pete Johansson: You Might Also Enjoy Pete Johansson,2016-07-15,2016,0,0,0,0.114229
403232,Vigilante Diaries,2016-09-01,2016,4000000,0,-4000000,3.028021
403252,The Railroad Lady,2016-08-05,2016,0,0,0,0.84232
403330,Romantically Speaking,2015-01-01,2015,0,0,0,0.133594
403357,1898. Our Last Men in the Philippines,2016-12-02,2016,0,0,0,12.129986
403368,Havenhurst,2016-08-22,2016,0,0,0,2.767271
403390,Bitter Harvest,2017-02-23,2017,20000000,557241,-19442759,3.573865
403429,Two Lottery Tickets,2016-10-07,2016,0,0,0,3.359294
403431,Brigsby Bear,2017-07-27,2017,0,0,0,2.216551
403434,Level Up,2016-08-26,2016,0,0,0,2.344607
403450,At War with Love,2016-10-27,2016,0,0,0,4.310218
403509,Boy Missing,2016-08-19,2016,0,0,0,5.157436
403570,Red Dog: True Blue,2016-12-26,2016,0,0,0,1.273964
403593,Bazodee,2016-08-05,2016,0,0,0,0.379968
403605,Headshot,2016-09-24,2016,0,0,0,4.470779
403642,The Neighbor,2016-08-19,2016,0,0,0,6.001302
403667,Adios amigos,2016-09-08,2016,0,0,0,0.32814
403867,Kaabil,2017-01-26,2017,5200000,0,-5200000,7.404544
403911,Sof√≠a de Ni√±o Rivera: Exposed,2016-06-24,2016,0,0,0,0.076602
403936,Deon Cole: Cole-Blooded Seminar,2016-06-25,2016,0,0,0,0.470688
404022,Jim Jefferies: Freedumb,2016-07-01,2016,0,0,0,1.453143
404073,Ghost Team,2016-07-21,2016,0,0,0,1.222064
404117,"Down the Deep, Dark Web",2016-06-23,2016,0,0,0,0.423709
404141,One More Time with Feeling,2016-09-08,2016,0,0,0,1.202459
404211,ATF,1999-09-06,1999,0,0,0,0.208333
404378,A Street Cat Named Bob,2016-11-04,2016,8000000,82703,-7917297,9.609879
404459,Road to Yesterday,2015-11-27,2015,0,0,0,0.153511
404461,The Curse of Robert the Doll,2016-09-12,2016,0,0,0,1.539873
404471,P√∂lynimurikauppiaat,,,0,0,0,0.0
404479,Car Bpnus,2001-01-01,2001,0,0,0,0.001177
404518,Mali Blues,2016-09-29,2016,0,0,0,0.119393
404567,Tibetana,1969-06-13,1969,0,0,0,0.001395
404584,From a House on Willow Street,2017-03-24,2017,0,0,0,10.709604
404604,Mom,2017-07-07,2017,0,0,0,1.559596
404733,Overdrive,2017-06-29,2017,0,0,0,24.124945
404762,Serena,2016-06-22,2016,0,0,0,0.15598
404791,The 101-Year-Old Man Who Skipped Out on the Bill and Disappeared,2016-12-25,2016,0,0,0,9.65288
404829,Emma's Chance,2016-07-05,2016,0,0,0,1.868918
405040,Warkop DKI Reborn: Jangkrik Boss! Part 1,2016-10-08,2016,0,0,0,0.584595
405050,Bad Girl,2016-08-11,2016,1,0,-1,0.082327
405203,Born in Heinola,2016-09-07,2016,1200000,0,-1200000,0.886639
405204,Tom of Finland,2017-01-27,2017,4200000,0,-4200000,2.808389
405265,Nightlife,2015-07-06,2015,0,0,0,0.023534
405280,Moonlight and Cactus,1944-09-08,1944,0,0,0,0.002313
405325,Dwayne Perkins: Take Note,2016-07-01,2016,0,0,0,0.129213
405388,Mono,2016-07-08,2016,0,0,0,1.262927
405446,The Human Surge,2016-08-19,2016,0,0,0,0.484825
405473,A Date for Mad Mary,2016-09-02,2016,0,0,0,1.082332
405576,Losing It,2006-09-13,2006,0,0,0,0.039211
405621,The Miki Howard Story,2016-06-12,2016,0,0,0,0.080215
405627,Joan Baez: How Sweet the Sound,2009-09-24,2009,0,0,0,0.045928
405653,The Death and Life of Otto Bloom,2016-07-28,2016,0,0,0,0.208467
405656,Joe Cinque's Consolation,2016-07-30,2016,0,0,0,0.473343
405670,Zoology,2016-11-24,2016,0,0,0,1.269667
405671,It's Not the Time of My Life,2016-10-01,2016,0,0,0,0.12749
405763,The Adventures of Cinderella's Daughter,,,0,0,0,6e-06
405775,The Wall,2017-05-12,2017,0,1803009,1803009,15.5975
405882,Don't Kill It,2016-08-27,2016,3500000,0,-3500000,5.990041
406042,Happy Bhag Jayegi,2016-08-19,2016,0,0,0,1.090249
406052,Mostly Ghostly 3: One Night in Doom House,2016-09-06,2016,0,0,0,0.969886
406099,For a Few Bullets,2016-07-15,2016,0,0,0,0.322763
406107,Dead Awake,2017-05-12,2017,0,0,0,2.808386
406125,At Cafe 6,2016-07-14,2016,0,0,0,0.687442
406204,People You May Know,2016-07-07,2016,0,0,0,0.149655
406231,Citizen Soldier,2016-08-05,2016,0,0,0,0.871518
406385,Smetto quando voglio: Masterclass,2017-02-02,2017,0,0,0,5.047357
406398,Pear Cider and Cigarettes,2016-07-01,2016,0,0,0,0.36327
406429,League of Gods,2016-07-28,2016,38000000,0,-38000000,3.109967
406431,The Hurt Business,2016-01-01,2016,0,0,0,1.206019
406449,Hatred,2016-10-07,2016,0,0,0,2.426873
406785,Inner Workings,2016-11-23,2016,0,0,0,3.365946
406808,In the Blood,2016-09-15,2016,0,0,0,0.960847
406970,My Lonely Me,2015-08-19,2015,0,0,0,0.193619
406990,What Happened to Monday,2017-08-18,2017,0,0,0,60.581223
406992,Wild Oats,2016-09-22,2016,0,0,0,1.373344
407036,On the Brain,2016-07-12,2016,10,0,-10,0.196099
407048,Scott Hall: Living on a Razor's Edge,,,0,0,0,0.003921
407171,"Signed, Sealed, Delivered: One in a Million",2016-07-24,2016,0,0,0,0.639731
407172,Summer Villa,2016-07-23,2016,0,0,0,1.235533
407173,For Love and Honor,2016-07-30,2016,0,0,0,0.091984
407204,The Giant,2016-10-14,2016,0,0,0,2.525014
407298,American Hostage,2016-03-25,2016,0,0,0,0.11167
407334,My Summer Prince,2016-08-06,2016,0,0,0,0.774052
407335,Summer in the City,2016-08-13,2016,0,0,0,0.525932
407375,Sniper: Ghost Shooter,2016-08-02,2016,3000000,0,-3000000,4.236209
407389,The Remains,2016-08-05,2016,0,0,0,2.650518
407430,A Gathering of Cats,2007-01-01,2007,0,0,0,0.221386
407448,Detroit,2017-07-28,2017,34000000,0,-34000000,9.797505
407455,Assassin X,2016-08-02,2016,0,0,0,0.591973
407518,Chosen,2016-08-08,2016,0,0,0,1.763859
407531,Bedeviled,2017-06-28,2017,0,0,0,16.227875
407559,I Am the Pretty Thing That Lives in the House,2016-09-10,2016,0,0,0,4.583609
407575,Rosa Chumbe,2015-08-08,2015,0,0,0,0.025207
407588,Floyd Norman: An Animated Life,2016-02-05,2016,0,0,0,1.079632
407613,Brian Posehn: Criminally Posehn,2016-07-22,2016,0,0,0,0.144959
407655,A Cinderella Story: If the Shoe Fits,2016-08-02,2016,0,0,0,5.761235
407757,"Sweet, Sweet Lonely Girl",2016-09-22,2016,0,0,0,1.475247
407789,Clinton Cash,2016-07-24,2016,0,0,0,1.031965
407799,The Genius of Marie Curie: The Woman Who Lit up the World,2013-05-03,2013,0,0,0,0.011396
407803,Harry Benson: Shoot First,2016-11-04,2016,0,0,0,0.821622
407806,13th,2016-10-07,2016,0,0,0,8.255986
407887,Operation Chromite,2016-07-27,2016,0,0,0,17.767346
407897,Vintage Tomorrows,2016-07-19,2016,0,0,0,0.051763
407965,A Lovas√≠j√°sz,2016-01-21,2016,0,0,0,0.049518
407992,MURDER and murder,1996-09-10,1996,0,0,0,0.076975
408024,Moka,2016-08-17,2016,0,126463,126463,2.404466
408140,Blood Moon,2016-07-25,2016,0,0,0,0.062812
408151,The Standoff,2016-09-20,2016,0,0,0,0.8557
408159,The Young Offenders,2016-09-16,2016,0,0,0,10.491428
408194,Devil's Bride,2016-09-09,2016,3100000,0,-3100000,3.55628
408203,Little Wing,2016-09-23,2016,1000000,0,-1000000,1.324337
408219,Population Zero,2016-04-26,2016,0,0,0,0.939939
408220,Justice League Dark,2017-01-24,2017,0,0,0,11.279503
408267,Godless,2017-03-09,2017,0,0,0,0.853673
408270,Wet Woman in the Wind,2016-08-05,2016,0,0,0,1.72663
408272,Catfight,2017-03-03,2017,0,0,0,5.89953
408290,Mister Universo,2016-08-06,2016,0,0,0,0.046175
408292,The Last Family,2016-09-30,2016,0,0,0,1.611039
408374,Afterlov,2017-05-18,2017,0,0,0,0.138258
408381,Monolith,2017-04-20,2017,0,0,0,2.145819
408435,Sami Blood,2017-01-20,2017,0,0,0,0.908945
408438,Indivisible,2016-09-29,2016,0,0,0,2.056498
408439,Hounds of Love,2016-10-07,2016,0,0,0,9.428387
408508,Blue Jay,2016-10-07,2016,0,0,0,3.63133
408509,Orphan,2017-03-29,2017,0,0,0,2.424793
408537,The Distinguished Citizen,2016-09-08,2016,0,0,0,3.614272
408543,A Woman's Life,2016-09-08,2016,0,0,0,0.66911
408546,David Cross: Making America Great Again,2016-08-06,2016,0,0,0,0.41566
408550,Les P√©pites,2016-10-05,2016,0,0,0,0.441771
408616,The Journey,2017-03-30,2017,0,0,0,0.859277
408619,Justin Timberlake + The Tennessee Kids,2016-09-13,2016,0,0,0,0.805846
408620,Asura: The City of Madness,2016-09-28,2016,0,0,0,3.075981
408623,The Rolling Stones Ol√© Ol√© Ol√©! : A Trip Across Latin America,2016-10-21,2016,0,0,0,0.768471
408624,A Death in the Gunj,2016-09-10,2016,0,0,0,0.516993
408626,City of Tiny Lights,2017-04-07,2017,3892200,0,-3892200,4.69328
408647,Teen Titans: The Judas Contract,2017-03-22,2017,0,0,0,17.086618
408755,The Binding,2016-08-02,2016,0,0,0,1.436852
408956,Pudana: Last of the Line,2010-02-26,2010,0,0,0,0.041176
409082,–ö–∞—Ä—É—Å–µ–ª—å,1970-08-01,1970,0,0,0,0.053571
409160,iGirl,2016-07-07,2016,0,0,0,0.685495
409297,A Dark Song,2016-10-14,2016,0,0,0,13.411614
409366,Thirst,2016-08-02,2016,0,0,0,1.795831
409421,Blame!,2017-05-20,2017,0,0,0,3.455833
409447,Hairspray Live!,2016-12-07,2016,0,0,0,3.393888
409502,I'm Not Ashamed,2016-10-21,2016,1500000,2000000,500000,2.254096
409536,Horace and Pete,2016-01-30,2016,0,0,0,1.874158
409550,Scoop!,2016-10-01,2016,0,0,0,0.319085
409676,The Houses Are Full of Smoke,1987-01-01,1987,0,0,0,0.035294
409696,Over the Garden Wall,2014-11-03,2014,0,0,0,2.802111
409820,The Lost World of Communism,2009-03-14,2009,0,0,0,0.075294
409879,Escape from the Newsroom,2002-10-28,2002,0,0,0,0.040241
409900,Forever Yours,2011-11-11,2011,0,0,0,0.04353
409903,Urok literatury,1968-01-01,1968,0,0,0,0.03648
409926,Cosmos,,,0,0,0,0.282584
410117,Lady Macbeth,2017-01-20,2017,0,923,923,9.732026
410118,Cave,2016-09-02,2016,0,0,0,2.135377
410126,Patient Seven,2016-10-11,2016,0,0,0,1.809272
410142,Lo Sound Desert,,,0,0,0,0.001393
410199,ARQ,2016-09-09,2016,0,0,0,7.134446
410205,"All Governments Lie: Truth, Deception, and the Spirit of I.F. Stone",2016-11-04,2016,0,0,0,0.121433
410212,Cold Hell,2017-01-19,2017,0,0,0,1.241803
410259,Race to Win,2016-08-05,2016,0,0,0,1.60084
410314,A Wish for Christmas,2016-11-05,2016,0,0,0,1.617905
410315,The Mistletoe Promise,2016-11-04,2016,0,0,0,1.87656
410348,Is That a Gun in Your Pocket?,2016-09-16,2016,0,0,0,1.045741
410455,All the Difference,2016-01-01,2016,0,0,0,0.029416
410537,The Amityville Terror,2016-04-01,2016,500000,0,-500000,2.429089
410554,First Kill,2017-07-21,2017,0,0,0,7.874102
410576,Bad Dad Rehab,,,0,0,0,0.000253
410634,Diggers,2016-08-11,2016,0,0,0,0.393518
410661,My Entire High School Sinking Into the Sea,2016-09-23,2016,0,0,0,0.902835
410694,Milton's Secret,2016-09-30,2016,0,0,0,0.570331
410718,Before the Flood,2016-10-21,2016,0,0,0,5.812786
410729,Zebra,2016-05-21,2016,0,0,0,0.550522
410774,Schneewittchen,2009-12-25,2009,0,0,0,0.011819
410876,Tell Me How I Die,2016-09-16,2016,0,0,0,3.491786
410921,Nothing to Lose,1994-01-01,1994,0,0,0,0.001771
410936,Murderous Tales,2016-03-24,2016,0,0,0,0.034123
410965,Jeff Foxworthy & Larry the Cable Guy: We've Been Thinking,2016-08-26,2016,0,0,0,0.382806
410970,The Reconquest,2016-09-30,2016,0,0,0,0.86896
410988,Stake Land II: The Stakelander,2016-10-14,2016,0,0,0,6.044527
411005,Godspeed,2016-11-18,2016,0,0,0,0.840211
411007,Abacus: Small Enough to Jail,2017-05-19,2017,0,0,0,0.75928
411009,Amanda Knox,2016-09-10,2016,0,0,0,9.078809
411012,Chasing Trane,2017-04-14,2017,0,393970,393970,0.519968
411013,Citizen Jane: Battle for the City,2017-04-21,2017,0,0,0,0.192367
411019,I Am Not Your Negro,2017-02-03,2017,0,0,0,11.781919
411023,The Ivory Game,2016-09-02,2016,0,0,0,1.69652
411024,Karl Marx City,2016-10-14,2016,0,0,0,0.349615
411025,Close Relations,2016-07-05,2016,0,0,0,0.143769
411039,Searchers,2016-09-12,2016,0,0,0,0.123025
411054,Guppy,2016-08-05,2016,600000,0,-600000,0.437969
411081,Summer Love,2016-08-20,2016,0,0,0,1.355957
411088,The Invisible Guest,2016-12-15,2016,4000000,0,-4000000,13.90698
411201,Dancer,2016-09-16,2016,0,0,0,0.305214
411221,Ozzy,2016-10-14,2016,10000000,0,-10000000,5.843943
411268,Line Walker,2016-08-11,2016,0,88658655,88658655,1.528202
411279,Pretham,2016-08-12,2016,0,0,0,1.134001
411282,Pier Paolo Pasolini,1995-01-01,1995,0,0,0,0.001346
411405,Small Crimes,2017-04-28,2017,0,0,0,7.219022
411432,The Executor,1981-03-04,1981,0,0,0,0.002841
411442,Time Raiders,2016-08-18,2016,0,0,0,0.526202
411456,Nine Ways to Approach Helsinki,1982-12-03,1982,0,0,0,0.005625
411516,A German Life,2016-10-15,2016,0,0,0,0.126064
411518,Triumph's Summer Election Special 2016,2016-08-11,2016,0,0,0,0.124185
411632,End of a Gun,2016-09-23,2016,7500000,0,-7500000,2.057404
411638,The Fury of a Patient Man,2016-09-09,2016,1200000,0,-1200000,16.719657
411656,Tonio,2016-10-13,2016,0,0,0,0.981837
411678,Afterimage,2016-10-22,2016,0,0,0,0.825711
411711,The Last Gold,,,0,0,0,2.3e-05
411717,Bairavaa,2017-01-12,2017,0,17000000,17000000,1.459459
411736,Batman: Return of the Caped Crusaders,2016-10-08,2016,3500000,0,-3500000,3.495883
411741,Ingrid Goes West,2017-08-11,2017,0,0,0,3.647596
411802,Batman Unlimited: Mechs vs. Mutants,2016-08-30,2016,0,0,0,1.042364
411822,Once Again,2016-08-18,2016,0,0,0,0.3861
411873,The Little Hours,2017-06-30,2017,0,0,0,13.423018
412059,Mobile Homes,2018-04-04,2018,0,0,0,0.155147
412093,Worldly Girl,2016-11-10,2016,0,0,0,0.743868
412103,Rick and Morty: State of Georgia Vs. Denver Fenton Allen,2016-07-24,2016,0,0,0,0.760622
412105,You Get Me,2017-06-19,2017,0,0,0,12.910289
412109,The King of Texas,2008-03-01,2008,0,0,0,0.005242
412120,Her Love Boils Bathwater,2016-10-29,2016,0,0,0,1.232753
412202,Handsome Devil,2017-02-15,2017,1050000,0,-1050000,16.112052
412203,In Between,2016-11-25,2016,0,0,0,2.481935
412204,Marie Curie,2016-12-01,2016,0,0,0,1.556748
412205,Past Life,2016-12-01,2016,0,0,0,0.18016
412209,Tramps,2016-09-10,2016,2000000,0,-2000000,6.754817
412213,The Women's Balcony,2016-09-29,2016,0,0,0,0.195112
412214,Last Minute,2016-02-26,2016,0,0,0,0.049134
412280,The Northlander,2016-10-14,2016,0,0,0,1.062709
412302,Gemini,2017-03-12,2017,0,0,0,0.703045
412309,How to Win the US Presidency,2016-08-01,2016,0,0,0,0.048449
412329,Glory Daze: The Life and Times of Michael Alig,2015-09-24,2015,0,0,0,0.18909
412363,The Wedding Plan,2017-05-12,2017,0,0,0,1.235839
412437,Flowers of Evil,2016-06-14,2016,0,0,0,0.887298
412467,Beyond Valkyrie: Dawn of the Fourth Reich,2016-10-03,2016,0,0,0,3.401682
412511,Cup of Love,2016-08-20,2016,0,0,0,0.523872
412518,In-Lawfully Yours,2016-09-06,2016,0,0,0,1.46537
412519,Honey 3: Dare to Dance,2016-11-30,2016,0,0,0,3.103057
412590,Hitler's Olympics,2016-07-16,2016,0,0,0,0.061541
412660,Saint George,2016-08-31,2016,0,0,0,0.507143
412669,First Round Down,2017-03-04,2017,0,0,0,0.422836
412678,Cartels,2016-05-19,2016,7000000,0,-7000000,6.942043
412698,Libera Nos,2016-09-06,2016,0,0,0,0.380865
412758,Eat Locals,2017-04-06,2017,2073816,0,-2073816,2.208627
412766,Sam Was Here,2016-09-27,2016,0,0,0,1.81409
412818,911 Nightmare,2016-01-10,2016,0,0,0,0.396768
412851,Seneca's Day,2016-08-26,2016,0,0,0,0.130838
412924,Supersonic,2016-10-02,2016,0,226286,226286,6.316596
412974,Love on a Limb,2016-10-01,2016,0,0,0,0.880199
413011,The Secret World of Lewis Carroll,2015-01-31,2015,0,0,0,0.065665
413017,I am not Salvador,2016-01-01,2016,0,0,0,0.100054
413049,American Anarchist,2016-09-02,2016,0,0,0,1.172089
413052,Hacker,2016-09-15,2016,2000000,0,-2000000,7.950711
413198,Call of Heroes,2016-08-12,2016,32000000,0,-32000000,12.597842
413232,"No, No, Nanette",1940-12-19,1940,0,0,0,0.002995
413235,The Veils of Bagdad,1953-10-06,1953,0,0,0,0.059093
413279,Team Thor,2016-08-28,2016,0,0,0,5.647799
413337,Girl in the Box,2016-09-10,2016,0,0,0,0.465513
413349,Killing Reagan,2016-10-16,2016,0,0,0,0.916082
413361,Ice Guardians,2016-09-12,2016,0,0,0,2.351255
413391,A Few Less Men,2017-03-09,2017,0,123899,123899,1.475321
413417,The Matchbreaker,2016-10-07,2016,0,0,0,2.555849
413421,Phillauri,2017-03-24,2017,0,0,0,0.600717
413430,Miesten v√§lisi√§ keskusteluja,2013-01-04,2013,0,3,3,0.011427
413440,Pumpkin Pie Wars,2016-10-15,2016,0,0,0,0.571807
413441,Autumn in the Vineyard,2016-10-08,2016,0,0,0,0.519491
413452,Cardboard Boxer,2016-09-16,2016,10000000,0,-10000000,2.379429
413467,Stingray,1985-07-14,1985,0,0,0,0.000291
413471,The Late Bloomer,2016-10-07,2016,0,0,0,4.705178
413543,Dear Zindagi,2016-11-24,2016,4300000,3376375,-923625,3.699552
413547,Kahaani 2,2016-12-01,2016,0,0,0,0.786816
413579,Best Worst Thing That Ever Could Have Happened...,2016-10-09,2016,0,0,0,0.366915
413588,Rock On 2,2016-11-11,2016,0,0,0,0.212306
413644,The Son of Bigfoot,2017-07-27,2017,0,0,0,2.984512
413648,False Confessions,2017-04-13,2017,0,0,0,0.219166
413658,Enter the Warriors Gate,2016-11-18,2016,0,0,0,7.231992
413666,Taekwondo,2016-08-18,2016,0,0,0,2.373999
413669,Charlie Chan's Greatest Case,1933-09-14,1933,0,0,0,0.00554
413687,Harmonia,2016-07-11,2016,0,0,0,0.043605
413736,Monster High: Welcome to Monster High,2016-08-27,2016,0,0,0,6.864748
413762,The Levelling,2017-05-12,2017,1282545,0,-1282545,3.526962
413764,Playground,2016-09-19,2016,0,0,0,0.121419
413765,David Lynch: The Art Life,2017-02-15,2017,0,0,0,2.901372
413770,Ethel & Ernest,2016-10-28,2016,0,0,0,1.383611
413778,Lost in Paris,2017-03-08,2017,0,0,0,0.926642
413782,Mifune: The Last Samurai,2016-11-25,2016,0,0,0,0.354285
413785,George Best: All By Himself,2016-10-14,2016,0,0,0,0.161184
413806,–û–Ω–æ,1990-02-11,1990,0,0,0,0.057547
413834,Gringo: The Dangerous Life of John McAfee,2016-09-24,2016,0,0,0,0.983778
413837,A Wedding,2017-02-22,2017,0,0,0,1.459408
413882,Ok Jaanu,2017-01-03,2017,0,345872,345872,4.448075
413927,Louise by the Shore,2016-11-23,2016,0,0,0,0.468728
413953,The Earthquake,2016-12-01,2016,0,0,0,1.258757
413992,Sweet Virginia,2017-11-17,2017,0,0,0,1.718775
413998,My Cousin Rachel,2017-06-08,2017,0,2676077,2676077,12.855228
414067,Amber Alert,2016-01-01,2016,0,0,0,0.606191
414173,jazzy@32 (a true story),2016-04-17,2016,0,0,0,0.036478
414190,iBoy,2017-01-27,2017,1500000,0,-1500000,8.015815
414276,Freaky Ali,2016-09-09,2016,0,0,0,0.446834
414382,Coaching Colburn,2015-10-25,2015,0,0,0,0.027302
414392,Ukonvaaja,2016-06-02,2016,0,0,0,0.078257
414453,Columbus,2017-08-04,2017,0,0,0,1.309265
414455,Chronically Metropolitan,2017-08-04,2017,0,0,0,1.888856
414547,Samurai Rauni,2016-09-21,2016,56000,0,-56000,0.088382
414610,Stalked by My Doctor: The Return,2016-09-05,2016,0,0,0,0.561415
414632,The First Annual 'On Cinema' Oscar Special,2013-02-24,2013,0,0,0,0.010602
414642,The Magnitsky Act. - Behind the Scenes,2016-07-28,2016,0,0,0,0.252949
414719,Interrogation,2016-08-20,2016,0,0,0,14.567726
414743,Martin Lawrence Doin‚Äô Time,2016-09-09,2016,0,0,0,0.779098
414749,Comedy Central Roast of Rob Lowe,2016-09-05,2016,0,0,0,0.561999
414762,"Signed, Sealed, Delivered: Lost Without You",2016-09-25,2016,0,0,0,0.136178
414767,Death Al Dente: A Gourmet Detective Mystery,2016-10-09,2016,0,0,0,1.271724
414771,The Last Band in Lebanon,2016-10-13,2016,0,0,0,0.49439
414779,The River Thief,2016-10-14,2016,0,0,0,0.457327
414827,Siccin 3: C√ºrm√º Ask,2016-09-02,2016,0,0,0,0.133286
414910,Tonight It's You,2016-04-01,2016,0,0,0,0.072118
414937,Maigret's Dead Man,2016-12-05,2016,0,0,0,4.373708
414977,Sam,2015-04-21,2015,0,0,0,0.203237
415021,The Captive,1915-04-22,1915,0,0,0,0.039159
415032,The Fabulous Patars,2016-12-14,2016,0,0,0,1.624115
415072,Hi-Yo Silver,1940-04-10,1940,0,0,0,0.001438
415078,Hamilton's America,2016-10-01,2016,0,0,0,0.843296
415086,What the Health,2017-03-16,2017,273428,0,-273428,7.754452
415132,Ares,2016-11-23,2016,0,0,0,8.873257
415137,Angel,2016-09-11,2016,0,0,0,1.064848
415214,Operation Mekong,2016-09-30,2016,0,173000000,173000000,35.972581
415255,The Secret of Evil,2014-09-18,2014,300000,0,-300000,0.122363
415358,Pink,2016-09-16,2016,75000000,0,-75000000,2.380732
415396,Mar√≠a (y los dem√°s),2016-10-07,2016,0,0,0,0.380641
415542,Jeff Ross Roasts Cops,2016-09-10,2016,0,0,0,0.109753
415633,Tonight She Comes,2016-10-09,2016,0,0,0,1.136537
415665,1:54,2016-10-13,2016,0,0,0,2.054256
415725,Doug Stanhope: No Place Like Home,2016-09-15,2016,0,0,0,0.196713
415730,Godfrey: Regular Black,2016-08-12,2016,0,0,0,0.135982
415735,Sebastian Maniscalco: Why Would You Do That?,2016-10-01,2016,0,0,0,0.167998
415766,Who Gets the Dog?,2016-10-06,2016,0,0,0,1.651329
415892,The Groom,2016-09-15,2016,0,0,0,0.77925
416086,Redistributors,2016-07-02,2016,500000,0,-500000,0.811783
416124,The Second Annual 'On Cinema' Oscar Special,2014-03-02,2014,0,0,0,0.014118
416127,Dark Exorcism,2015-10-15,2015,0,0,0,0.409679
416166,The Institute,2017-03-03,2017,3000000,0,-3000000,6.59951
416211,The White Helmets,2016-09-16,2016,0,0,0,3.496528
416251,Christmas List,2016-11-25,2016,0,0,0,0.600567
416256,The Caretaker,2016-09-30,2016,0,0,0,0.799093
416258,Two Fencers,1891-01-02,1891,0,0,0,0.036471
416261,All Hallow's Eve,2016-09-27,2016,0,0,0,0.774281
416290,Cedric the Entertainer: Live from the Ville,2016-09-16,2016,0,0,0,0.240942
416390,Dugma: The Button,2016-01-01,2016,0,0,0,0.345323
416437,Dear Jesse,1998-10-10,1998,0,0,0,0.001354
416445,Revengeance,2017-04-05,2017,0,0,0,1.09508
416477,The Big Sick,2017-06-23,2017,0,52620184,52620184,23.424794
416499,The Rolling Stones - Havana Moon,2016-09-23,2016,0,0,0,0.403823
416569,Love and Fury,2016-10-14,2016,0,0,0,0.249619
416635,American Summer,2016-09-09,2016,0,0,0,0.080888
416680,"Gilda, No Me Arrepiento de Este Amor",2016-09-15,2016,0,0,0,0.766199
416688,The Tribe,2016-06-18,2016,0,0,0,0.805734
416691,1 Night,2017-02-10,2017,0,0,0,2.491879
416867,Iliza Shlesinger: Confirmed Kills,2016-09-23,2016,0,0,0,1.182674
416951,Blackout,2015-07-14,2015,0,0,0,0.423677
416987,After the Reality,2016-04-21,2016,0,0,0,0.403409
416988,The Case of: JonBen√©t Ramsey,2016-09-18,2016,0,0,0,0.324125
417004,The Escape,2016-10-23,2016,0,0,0,0.325683
417026,Russell Peters: Almost Famous,2016-10-07,2016,0,0,0,0.535087
417028,The Swap,2016-10-07,2016,0,0,0,2.41012
417056,The Hollow,2016-10-07,2016,0,0,0,1.518099
417263,Britney Ever After,2017-02-18,2017,0,0,0,0.787447
417285,Los signos del zodiaco,1964-02-26,1964,0,0,0,0.001678
417320,Descendants 2,2017-07-21,2017,0,0,0,15.842073
417321,The Master: A Lego Ninjago Short,2016-09-22,2016,0,0,0,0.725278
417399,The Castle of Cloads,1970-11-27,1970,0,0,0,0.0
417406,The Possession Experiment,2016-10-14,2016,0,0,0,0.770862
417427,The Good Boy,2016-11-10,2016,0,0,0,1.254369
417489,Bon Cop Bad Cop 2,2017-05-12,2017,0,0,0,7.580299
417503,Burnout 2,2016-10-12,2016,0,0,0,3.360387
417644,CHiPS,2017-03-23,2017,25000000,26800152,1800152,12.238061
417678,"Everything, Everything",2017-05-19,2017,10000000,0,-10000000,12.108048
417820,Miss Saigon: 25th Anniversary,2016-09-22,2016,0,0,0,1.932469
417830,Diary of a Wimpy Kid: The Long Haul,2017-05-19,2017,22000000,40120144,18120144,28.176992
417870,Girls Trip,2017-07-21,2017,0,0,0,37.964872
417877,Baked in Brooklyn,2016-10-14,2016,0,0,0,2.759205
417936,Accidentally Engaged,2016-03-05,2016,0,0,0,0.851042
418029,Ultraman,1967-07-21,1967,0,0,0,0.001884
418047,The Secret Life of Chaos,2010-01-14,2010,0,0,0,0.082059
418072,Peace Code,2014-09-18,2014,1500000,0,-1500000,0.023066
418078,It Comes at Night,2017-06-09,2017,5000000,0,-5000000,20.504587
418378,Die Beautiful,2016-10-27,2016,0,0,0,0.194856
418437,Unforgettable,2017-04-20,2017,12000000,17768012,5768012,10.159713
418585,The Crooked Man,2016-10-01,2016,0,0,0,4.756152
418688,Blood on the Mountain,2016-05-26,2016,0,0,0,0.202625
418691,Shadows of the Dead,2016-10-22,2016,0,0,0,0.776117
418693,Marathon: The Patriots Day Bombing,2016-11-21,2016,0,0,0,0.349939
418697,Thank You for Your Service,2016-09-16,2016,0,0,0,0.34787
418718,Esteros,2016-05-27,2016,0,0,0,1.164059
418757,Miƒôdzy nami dobrze jest,2014-08-01,2014,0,0,0,0.030803
418772,Crisis in Six Scenes,2016-09-30,2016,0,0,0,1.358114
418787,Gatekeeper,2016-09-25,2016,0,0,0,0.060396
418969,The Irresistible Blueberry Farm,2016-10-02,2016,0,0,0,0.587236
418979,The Third Annual 'On Cinema' Oscar Special,2015-02-22,2015,0,0,0,0.020028
418985,Pete Davidson: SMD,2016-10-29,2016,0,0,0,0.143357
418990,Kyle Kinane: Loose in Chicago,2016-10-15,2016,0,0,0,0.26468
418992,Lewis Black: Black to the Future,2016-10-07,2016,0,0,0,0.089949
419037,Kurt Braunohler: Trust Me,2017-03-03,2017,0,0,0,0.410664
419147,Louis Theroux: Savile,2016-10-02,2016,0,0,0,0.706061
419192,McLaren,2017-05-25,2017,0,0,0,1.487037
419289,Allende en su laberinto,,,0,0,0,0.0
419330,Somnus,2016-10-04,2016,0,0,0,0.54252
419371,Abbey Grace,2016-04-01,2016,0,0,0,0.368931
419386,Besetment,2016-10-01,2016,0,0,0,0.605654
419428,Teli and Toli,2016-09-01,2016,0,0,0,0.118598
419430,Get Out,2017-02-24,2017,5000000,252434250,247434250,36.894806
419459,Landline,2017-07-21,2017,0,0,0,1.811506
419471,The Unbidden,2016-04-22,2016,0,0,0,0.078385
419522,Beata ignoranza,2017-02-23,2017,0,0,0,3.701125
419546,HyperNormalisation,2016-10-16,2016,36501,0,-36501,2.403055
419601,–ü–æ—ç–º–∞ –æ –∫—Ä—ã–ª—å—è—Ö,1979-07-06,1979,0,0,0,0.0525
419639,The Thinning,2016-10-12,2016,0,0,0,7.084179
419700,Sandy Wexler,2017-04-14,2017,0,0,0,10.213483
419747,Halloweed,2016-10-18,2016,0,0,0,1.114669
419771,The Monk and the Demon,2016-09-08,2016,2000000,0,-2000000,0.698922
419786,Doctor Who: Time Crash,2007-11-16,2007,0,0,0,0.434906
420245,Don't Knock Twice,2017-02-03,2017,0,0,0,11.359142
420346,The Morning After,2015-01-11,2015,0,0,0,0.139936
420481,–ü—É—Ç—å –∫ —Å–µ–±–µ,2010-04-10,2010,0,0,0,0.041267
420511,Ice Girls,2016-03-11,2016,0,0,0,0.62505
420519,Wet Dreams,1974-10-10,1974,0,0,0,0.002317
420648,The Bar,2017-03-24,2017,0,0,0,20.720113
420703,O Shaolin do Sert√£o,2016-10-13,2016,2000000,0,-2000000,0.339427
420714,Planet Earth II,2016-11-06,2016,0,0,0,5.651997
420743,Gasht-e Ershad,2012-10-01,2012,0,0,0,0.045698
420967,Girlfriends of Christmas Past,2016-10-25,2016,0,0,0,0.058558
421060,The Third Party,2016-10-13,2016,0,0,0,0.134737
421126,The Dragon Spell,2017-01-09,2017,0,0,0,1.694007
421281,Borrowed Time,2015-10-31,2015,0,0,0,3.73344
421313,Eliminators,2016-12-01,2016,0,0,0,4.401368
421365,The other me,2017-01-19,2017,0,0,0,1.116287
421443,Teleios,2017-04-06,2017,1000000,0,-1000000,2.296394
421510,Street Scenes,1970-09-14,1970,0,0,0,5e-06
421550,Payback: Straight Up,2006-10-21,2006,90000000,0,-90000000,1.236999
421552,Janeane Garofalo: If I May,2016-10-27,2016,0,0,0,0.093293
421556,Mo Mandel: Negative Reinforcement,2016-11-03,2016,0,0,0,0.083584
421619,The Constitution,2016-10-06,2016,0,0,0,0.130518
421623,A Nutcracker Christmas,2016-12-10,2016,0,0,0,0.329573
421626,Sleigh Bells Ring,2016-12-18,2016,0,0,0,1.009927
421725,Scrat: Spaced Out,2016-10-11,2016,0,0,0,2.257459
421741,Men's Games,1992-01-01,1992,0,0,0,0.044849
421758,Journey Back to Christmas,2016-11-27,2016,0,0,0,0.611601
421851,Michael Moore in TrumpLand,2016-10-18,2016,0,0,0,1.585725
421854,Joe Rogan: Triggered,2016-10-21,2016,0,0,0,0.377871
421928,Luck-Key,2016-10-13,2016,0,0,0,2.169255
421958,Terror - Ihr Urteil,2016-10-17,2016,0,0,0,0.708471
421962,Lily  & the Snowman,2015-12-13,2015,0,0,0,0.031236
422005,Tatu and Patu,2016-10-19,2016,0,0,0,0.055407
422127,It's All Good,2016-10-21,2016,75000,0,-75000,0.349211
422469,I Am Bolt,2016-11-28,2016,0,0,0,4.831133
422472,Family Possessions,2016-10-21,2016,0,0,0,0.056003
422500,Barry Crimmins: Whatever Threatens You,2016-10-23,2016,0,0,0,0.489178
422514,Killjoy's Psycho Circus,2016-10-30,2016,0,0,0,0.168822
422548,Jimmy Dore: Sentenced To Live,2015-10-06,2015,0,0,0,0.025898
422550,Sarah Colonna: I Can't Feel My Legs,2015-10-27,2015,0,0,0,0.027059
422551,Josh Blue: Delete,2016-07-26,2016,0,0,0,0.085393
422559,Willie Barcena: The Truth Hurts,2016-07-01,2016,0,0,0,0.20414
422566,I still hide to smoke,2016-11-05,2016,0,0,0,3.589741
422603,Aanandam,2016-10-21,2016,450000,2300000,1850000,0.354748
422715,The Bride,2017-01-19,2017,1500000,0,-1500000,2.678966
422842,"Hailey Dean Mystery: Murder, With Love",2016-10-23,2016,0,0,0,0.223859
422874,Money,2016-04-06,2016,0,0,0,1.732871
422878,Wanda Sykes: What Happened‚Ä¶ Ms. Sykes?,2016-10-21,2016,0,0,0,0.13719
422906,The Wizard of Baghdad,1961-03-03,1961,0,0,0,0.001665
422960,4.1 Miles,2016-09-28,2016,0,0,0,0.232762
422972,Kill Ratio,2016-12-09,2016,0,0,0,1.706017
423078,Narrien Illat,1970-11-13,1970,0,0,0,0.0
423093,7 Years,2016-10-28,2016,0,0,0,3.946603
423122,"Dana Carvey: Straight White Male, 60",2016-11-04,2016,0,0,0,0.853784
423246,Drifter,2016-10-19,2016,0,0,0,0.336244
423360,Hammer,2016-11-03,2016,0,0,0,0.711675
423367,Queen of Spades,2016-11-17,2016,0,0,0,0.756327
423377,Sugar Mountain,2016-12-09,2016,0,0,0,3.912405
423453,Sahara,2017-02-01,2017,0,7800000,7800000,8.665106
423525,Reunion 2: Bachelor Party,2016-11-02,2016,0,0,0,0.273201
423536,Ghosts of Darkness,2017-03-01,2017,0,0,0,0.817407
423681,The Chronicles of Melanie,2016-11-01,2016,0,0,0,0.225744
423733,The Darkest Dawn,2016-10-31,2016,0,0,0,0.421018
423917,Dynamite Girl,1944-10-01,1944,0,0,0,0.001253
423988,Kill Switch,2017-06-01,2017,1000000,0,-1000000,12.128887
424014,Quel bravo ragazzo,2016-11-17,2016,0,0,0,2.107399
424145,Petersburg: Only for Love,2016-09-22,2016,0,243000,243000,0.780748
424182,Female Werewolf,2015-10-16,2015,100000,0,-100000,0.688993
424208,Alcoholist,2017-05-18,2017,0,0,0,0.618552
424235,Lana Del Rey: The Greatest Story Never Told,2013-06-04,2013,0,0,0,0.020404
424322,Superbad,2016-10-13,2016,0,263000,263000,0.245606
424488,Megan Leavey,2017-06-09,2017,0,0,0,11.852169
424600,The Immortal Life of Henrietta Lacks,2017-04-22,2017,0,0,0,3.017803
424634,Wild Mouse,2017-02-17,2017,0,0,0,1.624783
424643,Bad Ben,2016-10-05,2016,300,0,-300,0.373824
424661,Legends of the Hidden Temple,2016-11-26,2016,0,0,0,0.795603
424722,Dark Fortune,2016-11-22,2016,0,0,0,0.062975
424782,I'm a Killer,2016-11-04,2016,0,0,0,1.602569
424822,Advance & Retreat,2016-11-14,2016,0,0,0,0.660941
424889,Norman Television,2016-12-06,2016,0,0,0,1.074219
424971,In View,2016-11-20,2016,0,0,0,0.062595
424998,The Case for Christ,2017-04-07,2017,0,0,0,3.674827
425002,Dan Levy: Lion,2016-11-17,2016,0,0,0,0.062949
425003,Colin Quinn: The New York Story,2016-11-18,2016,0,0,0,0.211207
425071,Decanted,2016-11-11,2016,0,0,0,0.06055
425134,How to Be a Latin Lover,2017-04-28,2017,0,26251899,26251899,7.299803
425383,Amateurs in Space,2016-11-02,2016,0,0,0,0.209318
425487,Origin,2016-10-21,2016,0,0,0,0.106215
425488,Dark Heart AKA Wagstaffe,2016-11-09,2016,0,0,0,0.494362
425498,Michael Che Matters,2016-11-25,2016,0,0,0,1.080723
425553,My Future Love,2016-11-11,2016,0,0,0,0.371238
425591,I Don't Feel at Home in This World Anymore,2017-01-19,2017,0,0,0,10.985332
425716,Small Town Killers,2017-01-12,2017,0,0,0,1.049864
425751,The Hero,2017-06-09,2017,0,3384747,3384747,6.549788
425774,The Legend of Ben Hall,2016-12-01,2016,0,0,0,1.312524
425841,Kathleen Madigan: Bothering Jesus,2016-11-10,2016,0,0,0,0.182834
425916,Salad Fingers,,,0,0,0,0.141367
425931,The Black Room,2016-10-31,2016,0,0,0,3.703992
425942,Black Snow,2017-01-19,2017,4000000,1440000,-2560000,10.067238
425961,Pitbull Tough Women,2016-11-11,2016,0,0,0,1.480751
426166,My Annoying Brother,2016-11-24,2016,0,0,0,1.610539
426224,Jedi Junior High,,,0,0,0,0.001182
426230,Band Aid,2017-06-02,2017,0,0,0,2.302455
426253,The Lovers,2017-05-05,2017,0,214078,214078,2.968282
426256,Patti Cake$,2017-08-18,2017,0,0,0,2.617894
426264,The Trip to Spain,2017-08-31,2017,0,0,0,1.223145
426265,Burning Sands,2017-01-24,2017,0,0,0,2.155753
426272,Take Me,2017-05-05,2017,0,0,0,9.222308
426469,Growing Up Smith,2017-02-03,2017,0,0,0,1.435904
426576,Shared Rooms,2016-05-14,2016,0,0,0,0.343417
426580,Bad Kids of Crestview Academy,2017-01-13,2017,5000000,0,-5000000,2.258128
426634,The Coming War on China,2016-12-05,2016,0,0,0,0.196363
426670,Dolly Parton's Christmas of Many Colors: Circle of Love,2016-11-30,2016,0,0,0,1.071796
426808,A Cinderella Christmas,2016-12-03,2016,0,0,0,2.361363
426830,Family Heist,2017-01-04,2017,0,0,0,2.872817
426903,Buffalo Running,1883-11-19,1883,0,0,0,0.229221
426958,Strangled,2016-11-10,2016,0,0,0,1.145675
427043,Charm's  Incidents,1996-10-03,1996,0,0,0,0.001193
427045,A December Bride,2016-11-20,2016,0,0,0,0.973202
427095,Kappen!,2016-12-15,2016,0,0,0,0.101708
427342,Panfilov's 28 Men,2016-11-24,2016,0,0,0,7.299014
427409,Once Upon a Line,2016-07-01,2016,0,0,0,0.215795
427413,Enemies Within,2016-02-21,2016,0,0,0,0.655624
427416,Sing,2016-11-06,2016,0,0,0,0.843769
427451,Banking on Bitcoin,2016-12-30,2016,100000,0,-100000,1.815844
427673,Sadie's Last Days on Earth,2016-12-09,2016,0,0,0,1.053465
427680,Red Wine in the Dark Night,2015-07-23,2015,0,0,0,0.388324
428074,Come Together,2016-11-27,2016,0,0,0,1.817364
428355,Nick Thune: Good Guy,2016-12-22,2016,0,0,0,0.072581
428356,Dance to Death,2017-03-16,2017,5000000,0,-5000000,2.243493
428398,Santa Claus. Battle of Mages,2016-12-24,2016,0,0,0,1.638546
428449,A Ghost Story,2017-07-07,2017,100000,15584255,15484255,24.339781
428493,God's Own Country,2017-09-01,2017,0,0,0,2.595488
428495,The Nile Hilton Incident,2017-07-12,2017,0,0,0,2.738426
428501,City of Ghosts,2017-07-14,2017,0,0,0,1.784246
428612,Strong Island,2017-01-23,2017,0,0,0,1.062246
428645,Eu Fico Loko,2017-01-12,2017,2500000,0,-2500000,1.948382
428687,Deidra & Laney Rob a Train,2017-01-23,2017,0,0,0,2.487073
428863,Snuff 102,2007-03-01,2007,0,0,0,0.544629
428950,Drain the Titanic,2016-05-05,2016,0,0,0,0.038917
429039,"Jean Ziegler, l'optimisme de la volont√©",2016-11-23,2016,0,0,0,0.087452
429070,Ismael's Ghosts,2017-05-17,2017,0,0,0,2.697064
429101,Anti Matter,2016-01-01,2016,0,0,0,4.57264
429107,Beatriz at Dinner,2017-06-09,2017,0,0,0,6.548206
429126,Reggie Watts: Spatial,2016-12-06,2016,0,0,0,0.29431
429174,Loveless,2017-06-01,2017,0,0,0,1.976804
429191,A Fantastic Woman,2017-04-06,2017,0,0,0,4.059329
429199,The Other Side of Hope,2017-02-03,2017,0,0,0,4.992125
429200,Good Time,2017-08-11,2017,0,10893246,10893246,5.798555
429238,Coin Heist,2017-01-06,2017,0,0,0,2.835202
429389,Joey Coco Diaz: Sociably UnAcceptable,2016-12-08,2016,0,0,0,0.389025
429392,Ian Harvie: May the Best Cock Win,2016-12-29,2016,0,0,0,0.080172
429450,Pandora,2016-12-07,2016,0,0,0,5.131904
429524,Drone Wars,2016-03-30,2016,0,0,0,1.451207
429662,Viceroy's House,2017-03-03,2017,0,0,0,16.153534
429698,Pork Pie,2017-02-02,2017,0,0,0,1.023355
429713,The Void,2016-11-08,2016,0,0,0,0.143416
429732,"Ana, My Love",2017-03-03,2017,0,0,0,2.160256
429779,Jena Friedman: American Cunt,2016-10-20,2016,0,0,0,0.16898
429788,Aries Spears: Comedy Blueprint,2016-11-24,2016,0,0,0,0.147048
429792,Tony Roberts: Motorcity Motormouth,2016-12-02,2016,0,0,0,0.107507
429797,Tom Papa: Human Mule,2016-12-09,2016,0,0,0,0.163387
429801,Gabriel Iglesias: I'm Sorry for What I Said When I Was Hungry,2016-12-20,2016,0,0,0,0.570288
429803,Barry Hilton: The Live Series,2015-02-17,2015,0,0,0,0.02828
429838,Cam-Girl,2016-12-20,2016,0,0,0,0.102569
429876,Brushfires,2004-10-16,2004,0,0,0,0.037655
429918,Survival Family,2017-05-14,2017,0,0,0,0.289307
430058,Votez Bougon,2016-12-16,2016,0,0,0,0.517392
430128,Internet - O Filme,2017-02-23,2017,0,0,0,2.75527
430156,David Bowie: The Last Five Years,2017-01-07,2017,0,0,0,1.559615
430158,To Walk Invisible,2016-12-29,2016,0,0,0,3.792964
430161,The Lighthouse of the Orcas,2016-12-16,2016,6000000,0,-6000000,2.449125
430250,City of Dead Men,2014-11-15,2014,0,0,0,2.667953
430263,"Have Fun, Vasya!",2017-02-16,2017,707503,4781454,4073951,1.681316
430365,With Open Arms,2017-04-05,2017,0,0,0,7.250495
430413,Six Degrees of Celebration 5,2016-12-22,2016,0,0,0,0.789132
430419,Lone Wolves,2016-12-13,2016,0,0,0,1.094645
430423,Myst√®re √† la Tour Eiffel,2015-09-11,2015,0,0,0,0.765254
430448,I Am Jane Doe,2017-02-10,2017,0,0,0,1.833216
430514,Le passe-muraille,2016-12-16,2016,0,0,0,0.067063
430598,Grey Lady,2017-04-28,2017,0,0,0,5.719089
430780,"Michael Bolton's Big, Sexy Valentine's Day Special",2017-02-07,2017,0,0,0,0.789799
430826,Casting JonBenet,2017-04-28,2017,0,0,0,1.802299
430830,Nobody Speak: Trials of the Free Press,2017-01-24,2017,0,0,0,0.765677
430834,Water & Power: A California Heist,2017-01-23,2017,0,0,0,0.225292
430973,The Woman in the Septic Tank 2: Forever Is Not Enough,2016-12-25,2016,0,0,0,0.097306
430977,Seclusion,2016-12-25,2016,0,0,0,0.736739
430985,The Diamond Fleece,1992-09-17,1992,0,0,0,0.050855
430988,Vamps,2017-02-22,2017,0,0,0,9.334447
431071,Mad Families,2017-01-12,2017,0,0,0,0.716404
431093,Everybody Loves Somebody,2017-02-10,2017,2000000,0,-2000000,7.077991
431242,Innsaei,2016-06-30,2016,0,0,0,0.255678
431244,Lost in Florence,2017-01-27,2017,0,0,0,1.125783
431251,Life Risking Romance,2016-12-14,2016,0,0,0,0.591638
431261,American Wrestler: The Wizard,2016-04-23,2016,0,0,0,2.4738
431391,Saving Banksy,2017-01-27,2017,0,0,0,0.34468
431435,Blockbuster,2017-07-13,2017,0,0,0,0.354543
431458,Dreamfish,2016-12-22,2016,0,0,0,0.36801
431490,BoJack Horseman Christmas Special: Sabrina's Christmas Wish,2014-12-19,2014,0,0,0,0.672944
431567,Onus,2016-12-26,2016,0,0,0,0.111229
431714,Long Strange Trip,2017-01-23,2017,0,0,0,0.617655
431742,The Last Dragonslayer,2016-12-25,2016,0,0,0,0.431003
431937,Mr & Mme Adelman,2017-03-08,2017,0,0,0,4.319959
432025,The Art of Loving. Story of Michalina Wislocka,2017-01-27,2017,0,0,0,0.575569
432132,Sobriety,2016-12-28,2016,0,0,0,0.073829
432364,The Covenant,2017-02-07,2017,0,0,0,1.257845
432602,An Inconvenient Sequel: Truth to Power,2017-07-28,2017,1000000,0,-1000000,2.53117
432607,Dina,2017-10-20,2017,0,0,0,2.936666
432615,Chasing Coral,2017-03-16,2017,0,0,0,1.251518
432789,The Incredible Jessica James,2017-01-27,2017,0,0,0,5.667067
432799,Spoor,2017-02-24,2017,0,0,0,1.434542
432883,Jen Kirkman: Just Keep Livin',2017-01-03,2017,0,0,0,0.322006
432959,Jim Gaffigan: Cinco,2017-01-10,2017,0,0,0,1.118338
433034,The Perfect Physique,2015-09-16,2015,0,0,0,0.233883
433054,Legion of Brothers,2017-01-21,2017,0,0,0,2.104922
433056,Oklahoma City,2017-01-21,2017,0,0,0,1.109178
433067,This Is Everything: Gigi Gorgeous,2017-01-24,2017,0,0,0,0.343367
433082,Across the Waters,2016-10-27,2016,0,0,0,0.74268
433084,Joshua: Teenager vs. Superpower,2017-01-20,2017,0,0,0,0.592573
433086,Machines,2017-11-30,2017,0,0,0,0.469489
433244,Clinical,2017-01-13,2017,0,0,0,13.934252
433245,Take the 10,2017-01-20,2017,0,0,0,2.599128
433356,The Ottoman Lieutenant,2017-03-10,2017,40000000,240978,-39759022,13.256679
433410,Self-criticism of a Bourgeois Dog,2017-01-29,2017,0,0,0,0.079173
433471,Lou,2017-06-16,2017,0,0,0,1.770297
433583,Silent Nights,2016-01-01,2016,0,0,0,0.17443
433630,Inconceivable,2017-06-30,2017,0,0,0,7.91134
433711,All Superheroes Must Die 2: The Last Superhero,,,0,0,0,0.00022
433878,The Mars Generation,2017-01-20,2017,0,0,0,0.774638
433945,Tokyo Ghoul,2017-07-29,2017,0,0,0,0.802191
434119,Confidential Assignment,2017-01-18,2017,8520000,56100000,47580000,1.75859
434166,Bye Bye Germany,2017-04-06,2017,0,0,0,0.846885
434178,Trumped: Inside the Greatest Political Upset of All Time,2017-01-27,2017,0,0,0,0.317396
434234,Hickey,2017-01-10,2017,0,0,0,0.710692
434306,Going to Kansas City,1998-07-31,1998,0,0,0,0.100491
434336,The Sunshine Makers,2015-11-01,2015,0,0,0,0.787708
434510,Replica,2005-04-01,2005,7000,0,-7000,0.002374
434616,Patients,2017-03-01,2017,0,0,0,4.670617
434661,Zombie Pizza,2017-04-27,2017,0,0,0,0.26915
434711,To Stay Alive - A Method,2016-11-19,2016,0,0,0,0.626156
434724,The King,2017-01-18,2017,0,0,0,0.925521
434758,The Summoning,2017-01-10,2017,0,0,0,0.679884
434873,It Stains the Sands Red,2016-10-08,2016,0,0,0,8.471866
434973,Sokkotanssi,1999-03-12,1999,0,0,0,0.001194
435041,Obsession,1965-08-16,1965,0,0,0,0.338256
435351,Neal Brennan: 3 Mics,2017-01-17,2017,0,0,0,0.676421
435366,Fabricated City,2017-02-09,2017,0,0,0,2.358168
435473,American Violence,2017-02-03,2017,0,0,0,7.217742
435707,Skins,2017-04-15,2017,0,0,0,3.293257
435737,Rufus 2,2017-01-16,2017,0,0,0,2.069952
435821,New Trial,2017-02-15,2017,0,0,0,1.956476
435921,L'ora legale,2017-01-19,2017,0,0,0,4.949637
436279,The Citizen,2017-01-26,2017,0,0,0,0.286341
436305,The Farthest,2017-02-26,2017,0,0,0,1.196529
436334,Django,2017-04-26,2017,0,0,0,2.251871
436339,Colo,2017-02-15,2017,0,0,0,0.459652
436340,F√©licit√©,2017-03-29,2017,0,0,0,0.318809
436343,On Body and Soul,2017-03-02,2017,0,0,0,1.737342
436352,Return to Montauk,2017-05-11,2017,0,0,0,1.737799
436450,Addicted to Porn: Chasing the Cardboard Butterfly,2017-02-03,2017,0,0,0,0.279521
436769,My Way: The Rise and Fall of Silvio Berlusconi,2016-11-08,2016,0,0,0,0.165569
436882,Tuintje in mijn hart,2017-03-02,2017,0,0,0,0.388826
436932,Jawbone,2017-05-12,2017,0,0,0,3.068554
436994,Lucid Dream,2017-02-22,2017,5000000,0,-5000000,1.748838
437031,Rescue Under Fire,2017-03-10,2017,0,5000000,5000000,33.536359
437122,Third Guest,2016-08-30,2016,0,0,0,0.048262
437220,Have a Nice Day,2017-02-17,2017,0,0,0,0.182377
437253,Œ§Œ≠ŒªŒµŒπŒøŒπ ŒûŒ≠ŒΩŒøŒπ,2016-12-15,2016,0,0,0,0.096261
437311,Orbiter 9,2017-04-07,2017,0,0,0,9.677001
437372,The Man Who Was Too Free,2017-02-23,2017,0,77156,77156,0.176653
437623,Hostages,2017-08-02,2017,0,0,0,1.320408
437752,Bill Burr: Walk Your Way Out,2017-01-31,2017,0,0,0,1.415218
437830,Zero 3,2017-01-27,2017,0,0,0,0.184337
437838,Invention of Trust,2016-01-29,2016,0,0,0,0.073932
437941,The Bolshoi,2017-05-11,2017,0,0,0,1.261872
438012,Kiljusen herrasv√§ki,1981-11-20,1981,0,0,0,0.0
438081,Duckweed,2017-01-28,2017,0,0,0,2.110254
438108,Time Tracers,1997-12-16,1997,0,0,0,0.001247
438137,Becoming Warren Buffett,2017-01-30,2017,0,0,0,1.279124
438144,Return to Life,1937-12-31,1937,0,0,0,0.001177
438283,Chapter & Verse,2016-06-12,2016,4000000,0,-4000000,0.169932
438446,Mommy Dead and Dearest,2017-03-11,2017,0,0,0,1.418073
438493,Becoming Bond,2017-03-11,2017,0,0,0,1.053472
438597,Major Grom,2017-02-19,2017,0,0,0,0.874297
438634,Summer 1993,2017-06-30,2017,0,0,0,0.60926
438635,"Ashley Madison: Sex, Lies and Cyber Attacks",2016-09-01,2016,0,0,0,0.260257
438643,Lift me up,2015-10-04,2015,0,0,0,0.131776
438665,Fittest On Earth: A Decade Of Fitness,2017-02-01,2017,0,0,0,0.867259
438910,Engineering Red,,,0,0,0,0.001586
439050,Subdue,,,0,0,0,0.072051
439056,Partners: The Movie II,2010-12-23,2010,0,0,0,0.007879
439107,Katherine Ryan: In Trouble,2017-02-14,2017,0,0,0,0.99123
439121,Mumford & Sons: We Wrote This Yesterday,2016-11-08,2016,0,0,0,0.094305
439154,The Midwife,2017-03-22,2017,0,0,0,2.127205
439263,Beautiful Vera,1950-09-22,1950,0,0,0,0.20357
439314,The Garden of Afflictions 2017,,,0,0,0,0.0
439502,Resurrecting Hassan,2017-09-22,2017,0,0,0,1.319057
439695,Unexpected Journey,2017-03-10,2017,1500000,0,-1500000,1.070002
439998,Omicidio all'italiana,2017-03-02,2017,0,0,0,2.962735
440047,"Nick Cannon: Stand Up, Don't Shoot",2017-02-10,2017,0,0,0,0.189182
440143,The Babymoon,2017-02-14,2017,0,0,0,0.456807
440145,Pablo's Hippos,2010-01-01,2010,0,0,0,0.221452
440178,Pilate and Others,1972-03-29,1972,0,0,0,0.071223
440249,After Porn Ends 2,2017-03-28,2017,0,0,0,5.523286
440266,Midday Event,2017-02-07,2017,0,0,0,0.120478
440361,Whn the day had no name,,,0,0,0,0.070588
440508,Diamond Cartel,2017-03-24,2017,7000000,0,-7000000,1.95914
440597,Wish Upon,2017-07-07,2017,0,0,0,59.578823
440642,The Spacewalker,2017-04-12,2017,7075038,9868942,2793904,10.181
440708,Mom or Dad?,2017-02-14,2017,0,0,0,2.69019
440767,Trevor Noah: Afraid of the Dark,2017-02-21,2017,0,0,0,0.995065
440777,Female Fight Club,2017-03-16,2017,2000000,0,-2000000,3.796019
441043,Asteria,2017-02-10,2017,0,0,0,0.549947
441168,From Straight A's to XXX,2017-02-11,2017,0,0,0,1.677614
441483,Tomato Red,2017-02-24,2017,0,0,0,0.339784
441652,Final Offer,1985-11-26,1985,0,0,0,0.0
441728,Hampstead,2017-06-23,2017,0,0,0,3.105815
441826,Shivering Trunks,,,0,0,0,6e-06
441881,Tubelight,2017-06-23,2017,0,0,0,3.471681
442075,Southern Fried Bigfoot,2007-11-10,2007,0,0,0,0.003752
442087,Mike Birbiglia: Thank God for Jokes,2017-02-28,2017,0,0,0,0.63551
442417,Das Experiment 770 - Geb√§ren auf Befehl,,,0,0,0,0.0
442491,Deconstructing Sgt. Pepper's Lonely Hearts Club Band,2017-02-06,2017,0,0,0,0.081571
442640,Boiling Point,2017-01-23,2017,0,0,0,0.112133
442750,The Hippopotamus,2017-03-19,2017,0,0,0,2.080934
442752,Petos,1988-03-18,1988,837000,0,-837000,0.03795
442949,Rising Fear,2016-05-30,2016,0,0,0,0.15825
443007,Fare,2017-02-21,2017,0,0,0,0.718518
443053,The Avenue,2017-01-01,2017,42000,0,-42000,0.151264
443113,The Fourth Annual 'On Cinema' Oscar Special,2016-02-28,2016,0,0,0,0.032941
443297,Moontrap: Target Earth,2017-02-07,2017,0,0,0,0.427982
443319,Phoenix Forgotten,2017-04-21,2017,2800000,3600000,800000,12.560942
443700,Altitude,2017-04-14,2017,0,0,0,11.032058
444066,Pet Fooled,2016-05-06,2016,0,0,0,0.281319
444193,The Evil Within,2017-06-13,2017,4000000,0,-4000000,2.559746
444513,Amy Schumer: The Leather Special,2017-03-07,2017,0,0,0,6.891989
444623,The Idiot,2003-04-01,2003,0,0,0,0.074146
444705,Dave Chappelle: The Age of Spin,2017-03-21,2017,0,0,0,2.520099
444706,Dave Chappelle: Deep in the Heart of Texas,2017-03-21,2017,0,0,0,2.162462
444713,Commando 2: The Black Money Trail,2017-03-02,2017,0,0,0,1.120333
444902,Dirty Dancing,2017-05-24,2017,0,0,0,11.145052
444935,Bromance,2016-10-13,2016,400000,0,-400000,0.792595
445126,Can't Buy My Love,2017-03-04,2017,0,0,0,0.661347
445224,Extraordinary Mission,2017-03-31,2017,0,0,0,2.552316
445590,Photographer,1998-05-01,1998,0,0,0,0.001187
445602,The Raking,2017-03-07,2017,0,0,0,0.734142
445605,Slam,2016-11-20,2016,0,0,0,5.372696
445727,The Bigfoot Project,2017-04-04,2017,0,0,0,0.530821
445840,Selfie,2017-06-23,2017,0,0,0,0.313827
445916,Asylum of Darkness,2017-04-10,2017,0,0,0,0.474061
445993,The Marine 5: Battleground,2017-03-16,2017,0,0,0,9.930139
446048,Jim Norton: Mouthful of Shame,2017-03-14,2017,0,0,0,0.440622
446076,The Devotion of Suspect X,2017-03-31,2017,0,0,0,0.24807
446345,La r√©volution n'est pas un d√Æner de gala,2015-12-01,2015,0,0,0,0.041902
446493,Moonlight in Vermont,2017-04-08,2017,0,0,0,0.546812
446850,Three heroes and the King of the Sea,2017-01-01,2017,0,0,0,0.468664
447061,Red Nose Day Actually,2017-03-24,2017,4000000,0,-4000000,5.753444
447091,Delisin,1975-04-04,1975,0,0,0,0.000844
447113,Monster High: Electrified,2017-04-04,2017,0,0,0,7.170738
447169,"Arrival of McKinley‚Äôs Funeral Train at Canton, Ohio",1901-09-30,1901,0,0,0,0.00118
447236,Kincsem,2017-03-16,2017,0,0,0,0.544214
447352,Taking Earth,2017-05-01,2017,400000,0,-400000,1.587246
447511,The Bridge on the River Kwai: An Appreciation by Filmmaker John Milius,2000-11-21,2000,0,0,0,0.001247
447758,Carnage: Swallowing the Past,2017-03-19,2017,0,0,0,1.336149
447818,Generation Iron 2,2017-05-12,2017,0,0,0,2.004971
448290,Half -Life,,,0,0,0,0.28268
448448,Get Me Roger Stone,2017-04-23,2017,0,0,0,0.835595
448449,Whitney: Can I Be Me,2017-04-24,2017,0,0,0,3.250568
448538,Rocaterrania,2009-10-01,2009,0,0,0,0.004807
448763,Amor.com,2017-06-01,2017,0,0,0,1.957136
448767,Johanneksen leip√§puu,1994-05-02,1994,0,0,0,0.001676
448847,The Hatton Garden Job,2017-04-14,2017,0,0,0,3.208922
448879,–ü—Ä–∏–∫–ª—é—á–µ–Ω–∏—è –î–æ–º–æ–≤—ë–Ω–∫–∞,1986-03-25,1986,0,0,0,0.001429
448992,Encounter with Fritz Lang,1964-02-05,1964,0,0,0,0.001414
449012,Allen Iverson: The Answer,2016-06-06,2016,0,0,0,0.147584
449131,Aprel,,,0,0,0,0.008903
449503,Kill 'em All,2017-05-08,2017,0,0,0,5.342381
449674,Louis C.K. 2017,2017-04-04,2017,0,0,0,4.296455
449677,The Year of Living Vicariously,2005-01-23,2005,0,0,0,0.037665
449696,The Stranger: Summoned by Shadows,1991-01-01,1991,0,0,0,3.5e-05
449742,Kavan,2017-03-31,2017,0,0,0,1.262638
449758,Five Came Back,2017-03-31,2017,0,0,0,1.218882
449863,Cant√°brico: Los dominios del oso pardo,2017-03-31,2017,0,0,0,0.436657
450225,How Not to Work & Claim Benefits... (and Other Useful Information for Wasters),2016-01-01,2016,0,0,0,0.041217
450530,Oasis,2017-03-17,2017,0,0,0,0.353742
450768,Only For One Night,2016-10-01,2016,3500000,0,-3500000,0.698883
450875,LA 92,2017-04-28,2017,0,0,0,0.855198
450945,I Am Heath Ledger,2017-04-23,2017,0,0,0,2.293791
451644,Dragonheart: Battle for the Heartfire,2017-06-13,2017,0,0,0,7.794894
451709,Lucas Brothers: On Drugs,2017-04-18,2017,0,0,0,0.552579
451955,The Double Lover,2017-05-26,2017,0,0,0,9.907026
452068,Drone,2017-05-26,2017,4000000,0,-4000000,8.413334
452142,Maigrets Night at the Crossroads,2017-04-16,2017,0,0,0,1.491167
452166,The Reagan Show,2017-04-22,2017,0,0,0,0.20617
452372,Warning: This Drug May Kill You,2017-05-01,2017,0,0,0,0.526562
452413,This Is Not What I Expected,2017-04-28,2017,0,0,0,0.46796
452606,Sultan,1978-12-01,1978,0,0,0,0.000347
452922,Supermassive Black Holes,,,0,0,0,0.04662
453008,Hell on Earth: The Fall of Syria and the Rise of ISIS,2017-06-11,2017,0,0,0,0.631435
453053,Dumb: The Story of Big Brother Magazine,2017-06-03,2017,0,0,0,0.444744
453062,Role Play: Women on Fassbinder,1992-01-01,1992,0,0,0,0.000146
453354,Ava,2017-06-21,2017,0,0,0,0.979347
453596,Kolonya Cumhuriyeti,2017-04-20,2017,0,0,0,0.173603
454361,Vir Das: Abroad Understanding,2017-04-25,2017,0,0,0,0.742094
454774,The Girl from the Song,2017-04-24,2017,0,0,0,1.072172
454787,Chris Gethard: Career Suicide,2017-05-06,2017,0,0,0,1.135015
455027,Dance of Outlaws,,,0,0,0,0.000127
455043,God of War,2017-05-27,2017,25000000,0,-25000000,4.85639
455188,Seizure,2017-04-11,2017,0,0,0,0.390678
455363,The Rise and Fall of a Jungle Giant,1958-01-01,1958,0,0,0,0.001178
455368,David Lean and His Dedicated Maniacs,2009-10-03,2009,0,0,0,0.004708
455601,Maria Bamford: Old Baby,2017-05-02,2017,0,0,0,0.846929
455661,In a Heartbeat,2017-06-01,2017,0,0,0,20.82178
455675,Hickok,2017-07-07,2017,0,0,0,2.747249
455963,A Gray State,2017-08-07,2017,0,0,0,0.392855
455968,Becoming Cary Grant,2016-12-20,2016,0,0,0,0.150702
456018,New Chefs on the Block,2016-03-05,2016,0,0,0,0.032991
456098,All About the Money,2017-06-02,2017,0,0,0,0.918121
456101,Aaron's Blood,2017-06-02,2017,0,0,0,0.410122
456187,King Charles III,2017-05-10,2017,0,0,0,0.920217
456193,"Norm Macdonald: Hitler's Dog, Gossip & Trickery",2017-05-09,2017,0,0,0,0.778068
456348,Batman & Bill,2017-05-06,2017,0,0,0,0.990632
456781,Boone: The Bounty Hunter,2017-05-09,2017,0,0,0,1.348869
456956,Neither Wolf Nor Dog,,,0,0,0,0.000308
457307,"Don't call him ""Dimon""",2017-03-02,2017,7200,0,-7200,0.351969
457470,Site Unseen: An Emma Fielding Mystery,2017-06-04,2017,0,0,0,0.86016
457962,Shimmer Lake,2017-06-09,2017,0,0,0,6.965189
458298,The Keepers,2017-05-19,2017,0,0,0,1.57617
458310,Hasan Minhaj: Homecoming King,2017-05-23,2017,0,0,0,1.531309
458335,Soundtrack,2017-07-06,2017,0,0,0,0.270556
458428,Operaci√≥n Cannabis,2009-11-01,2009,0,0,0,0.005935
458506,Tour de Pharmacy,2017-07-08,2017,0,0,0,9.560421
458618,Ivanka Trump- America's Real First Lady?,2017-05-15,2017,0,0,0,0.465977
458808,Nice Places to Die,2015-06-04,2015,0,0,0,0.085882
458961,Preston Sturges: The Rise and Fall of an American Dreamer,1990-07-02,1990,0,0,0,0.0
459295,Sarah Silverman: A Speck of Dust,2017-05-30,2017,0,0,0,0.828399
459802,Cream,2017-05-30,2017,0,0,0,0.589312
459928,12 Feet Deep,2016-01-01,2016,0,0,0,4.479536
459950,Feed,2017-07-18,2017,0,0,0,4.207731
460024,Stasis,2017-06-02,2017,0,0,0,6.868237
460135,LEGO DC Super Hero Girls: Brain Drain,2017-08-30,2017,0,0,0,8.413734
460822,"Oh, Hello: On Broadway",2017-06-13,2017,0,0,0,1.208618
460846,Security,2017-03-04,2017,15000000,0,-15000000,47.114366
460870,Shock and Awe: The Story of Electricity,2011-10-06,2011,0,0,0,0.007123
461053,S.W.A.T.: Under Siege,2017-08-01,2017,0,0,0,20.38691
461088,50 Kilos of Sour Cherry,2016-03-22,2016,0,0,0,0.034119
461089,Passer-By,1984-01-01,1984,0,0,0,0.49
461257,Queerama,2017-06-09,2017,0,0,0,0.163015
461297,Cop and a Half: New Recruit,2017-08-01,2017,0,0,0,1.248353
461533,The Everyday,2013-04-23,2013,0,0,0,0.010588
461615,Mutafukaz,2017-06-13,2017,0,0,0,0.249393
461634,Rory Scovel Tries Stand-Up for the First Time,2017-06-20,2017,0,0,0,0.593041
461805,The Putin Interviews,2017-06-12,2017,0,0,0,0.642527
461955,Rakka,2017-06-14,2017,0,0,0,2.569474
462026,Edith Walks,2017-06-23,2017,0,0,0,0.183256
462108,Chris D'Elia: Man on Fire,2017-06-27,2017,0,0,0,0.482896
462788,An Enemy of the People,1966-12-02,1966,0,0,0,0.002082
463800,Firebase,2017-06-28,2017,0,0,0,2.129137
463906,The Saint,2017-07-11,2017,0,0,0,28.23593
464111,Zygote,2017-07-12,2017,0,0,0,3.214001
464207,The Truth Is in the Stars,2017-05-01,2017,0,0,0,1.075249
464819,The Making of 'The Terminator': A Retrospective,1992-01-01,1992,0,0,0,1e-06
465044,Abduction,2017-06-28,2017,0,0,0,0.281008
467731,Tragedy in a Temporary Town,1956-02-19,1956,0,0,0,0.001189
468343,Silja - nuorena nukkunut,1956-01-01,1956,0,0,0,0.001202
468707,Thick Lashes of Lauri M√§ntyvaara,2017-07-28,2017,1254040,0,-1254040,0.347806
469172,Manuel on the Island of Wonders,1984-08-02,1984,0,0,0,0.001097
